시즌,경기ID,팀명,구분,선수명,PTS,2PM,2PA,2P%,3PM,3PA,3P%,FGM,FGA,FG%,FTM,FTA,FT%,OREB,DREB,REB,AST,STL,BLK,GD,DK,TO,PF
../kbl_data/2021-2022,S39G01N1,안양 KGC,Home,박형철,0,0,0,0.0,0,0,0.0,0,0,0.0,0,0,0.0,0,0,0,0,0,0,0,0,1,1
../kbl_data/2021-2022,S39G01N1,안양 KGC,Home,함준후,0,0,1,0.0,0,1,0.0,0,2,0.0,0,0,0.0,2,0,2,0,0,0,0,0,0,0
../kbl_data/2021-2022,S39G01N1,안양 KGC,Home,오세근,14,7,12,58.3,0,0,0.0,7,12,58.3,0,0,0.0,5,7,12,2,2,0,0,0,1,2
../kbl_data/2021-2022,S39G01N1,안양 KGC,Home,문성곤,11,1,2,50.0,3,7,42.9,4,9,44.4,0,0,0.0,2,7,9,4,2,0,0,0,0,2
../kbl_data/2021-2022,S39G01N1,안양 KGC,Home,전성현,24,5,8,62.5,4,6,66.7,9,14,64.3,2,2,100.0,0,0,0,1,1,0,0,0,0,1
../kbl_data/2021-2022,S39G01N1,안양 KGC,Home,박재한,0,0,1,0.0,0,0,0.0,0,1,0.0,0,0,0.0,1,0,1,1,0,0,1,0,1,0
../kbl_data/2021-2022,S39G01N1,안양 KGC,Home,대릴 먼로,5,1,5,20.0,1,4,25.0,2,9,22.2,0,0,0.0,0,2,2,1,1,0,0,0,0,1
../kbl_data/2021-2022,S39G01N1,안양 KGC,Home,우동현,2,1,2,50.0,0,1,0.0,1,3,33.3,0,0,0.0,1,0,1,0,0,0,0,0,0,2
../kbl_data/2021-2022,S39G01N1,안양 KGC,Home,변준형,6,1,3,33.3,1,3,33.3,2,6,33.3,1,2,50.0,1,1,2,2,0,0,0,0,2,4
../kbl_data/2021-2022,S39G01N1,안양 KGC,Home,한승희,0,0,0,0.0,0,0,0.0,0,0,0.0,0,0,0.0,0,0,0,0,0,0,0,0,0,0
../kbl_data/2021-2022,S39G01N1,안양 KGC,Home,양승면,0,0,0,0.0,0,0,0.0,0,0,0.0,0,0,0.0,0,0,0,0,0,0,0,0,0,0
../kbl_data/2021-2022,S39G01N1,안양 KGC,Home,오마리 스펠맨,23,4,7,57.1,5,11,45.5,9,18,50.0,0,0,0.0,0,9,9,2,0,4,0,1,1,3
../kbl_data/2021-2022,S39G01N1,전주 KCC,Away,송창용,3,0,0,0.0,1,1,100.0,1,1,100.0,0,0,0.0,0,1,1,0,0,0,0,0,0,0
../kbl_data/2021-2022,S39G01N1,전주 KCC,Away,이정현,13,2,5,40.0,3,9,33.3,5,14,35.7,0,0,0.0,0,2,2,8,0,0,0,0,3,3
../kbl_data/2021-2022,S39G01N1,전주 KCC,Away,정창영,7,2,2,100.0,0,4,0.0,2,6,33.3,3,3,100.0,0,3,3,3,0,0,1,0,2,2
../kbl_data/2021-2022,S39G01N1,전주 KCC,Away,라건아,20,7,10,70.0,1,3,33.3,8,13,61.5,3,6,50.0,9,9,18,1,0,0,0,0,0,0
../kbl_data/2021-2022,S39G01N1,전주 KCC,Away,김지완,3,0,3,0.0,1,3,33.3,1,6,16.7,0,0,0.0,0,1,1,1,0,0,0,0,1,4
../kbl_data/2021-2022,S39G01N1,전주 KCC,Away,김상규,7,2,5,40.0,1,2,50.0,3,7,42.9,0,0,0.0,6,2,8,0,1,1,0,0,1,1
../kbl_data/2021-2022,S39G01N1,전주 KCC,Away,유병훈,0,0,0,0.0,0,0,0.0,0,0,0.0,0,0,0.0,0,0,0,0,0,0,0,0,0,0
../kbl_data/2021-2022,S39G01N1,전주 KCC,Away,전준범,0,0,0,0.0,0,0,0.0,0,0,0.0,0,0,0.0,0,0,0,1,0,0,0,0,0,0
../kbl_data/2021-2022,S39G01N1,전주 KCC,Away,송교창,11,3,8,37.5,1,5,20.0,4,13,30.8,2,2,100.0,0,4,4,0,0,0,0,0,2,1
../kbl_data/2021-2022,S39G01N1,전주 KCC,Away,이진욱,0,0,0,0.0,0,0,0.0,0,0,0.0,0,0,0.0,0,0,0,2,0,0,0,0,0,1
../kbl_data/2021-2022,S39G01N1,전주 KCC,Away,유현준,6,0,0,0.0,2,5,40.0,2,5,40.0,0,0,0.0,0,1,1,0,0,0,0,0,1,0
../kbl_data/2021-2022,S39G01N1,전주 KCC,Away,라타비우스 윌리엄스,6,3,4,75.0,0,1,0.0,3,5,60.0,0,1,0.0,2,2,4,0,1,0,0,0,0,0
../kbl_data/2021-2022,S39G01N2,고양 오리온,Home,오용준,0,0,0,0.0,0,0,0.0,0,0,0.0,0,0,0.0,0,0,0,0,0,0,0,0,0,1
../kbl_data/2021-2022,S39G01N2,고양 오리온,Home,김강선,0,0,0,0.0,0,1,0.0,0,1,0.0,0,0,0.0,0,0,0,1,0,0,0,0,0,2
../kbl_data/2021-2022,S39G01N2,고양 오리온,Home,최현민,3,0,1,0.0,1,1,100.0,1,2,50.0,0,0,0.0,1,1,2,1,0,0,0,0,0,1
../kbl_data/2021-2022,S39G01N2,고양 오리온,Home,이대성,21,4,10,40.0,2,3,66.7,6,13,46.2,7,9,77.8,2,1,3,5,2,0,0,0,3,1
../kbl_data/2021-2022,S39G01N2,고양 오리온,Home,한호빈,11,2,2,100.0,2,7,28.6,4,9,44.4,1,1,100.0,0,0,0,2,1,0,0,0,0,1
../kbl_data/2021-2022,S39G01N2,고양 오리온,Home,최승욱,2,1,1,100.0,0,1,0.0,1,2,50.0,0,0,0.0,1,0,1,1,1,1,0,0,0,0
../kbl_data/2021-2022,S39G01N2,고양 오리온,Home,이승현,12,4,9,44.4,1,3,33.3,5,12,41.7,1,1,100.0,2,7,9,4,1,1,0,0,0,2
../kbl_data/2021-2022,S39G01N2,고양 오리온,Home,이종현,8,4,6,66.7,0,0,0.0,4,6,66.7,0,0,0.0,0,2,2,1,1,2,0,0,2,2
../kbl_data/2021-2022,S39G01N2,고양 오리온,Home,김진유,0,0,0,0.0,0,0,0.0,0,0,0.0,0,0,0.0,0,0,0,0,0,0,0,0,0,0
../kbl_data/2021-2022,S39G01N2,고양 오리온,Home,머피 할로웨이,18,8,11,72.7,0,0,0.0,8,11,72.7,2,3,66.7,1,6,7,4,0,0,0,2,1,1
../kbl_data/2021-2022,S39G01N2,고양 오리온,Home,미로슬라브 라둘리차,6,1,6,16.7,0,0,0.0,1,6,16.7,4,5,80.0,1,1,2,1,0,1,0,0,1,2
../kbl_data/2021-2022,S39G01N2,고양 오리온,Home,이정현,6,3,5,60.0,0,1,0.0,3,6,50.0,0,0,0.0,0,1,1,3,0,0,0,0,2,2
../kbl_data/2021-2022,S39G01N2,서울 SK,Away,양우섭,2,1,1,100.0,0,0,0.0,1,1,100.0,0,0,0.0,0,2,2,4,0,0,0,0,0,0
../kbl_data/2021-2022,S39G01N2,서울 SK,Away,허일영,11,3,6,50.0,1,2,50.0,4,8,50.0,2,2,100.0,2,4,6,0,0,0,0,0,1,3
../kbl_data/2021-2022,S39G01N2,서울 SK,Away,김선형,11,3,6,50.0,1,4,25.0,4,10,40.0,2,2,100.0,1,0,1,6,1,0,0,0,0,3
../kbl_data/2021-2022,S39G01N2,서울 SK,Away,최부경,8,4,7,57.1,0,0,0.0,4,7,57.1,0,0,0.0,2,2,4,0,1,1,0,0,1,3
../kbl_data/2021-2022,S39G01N2,서울 SK,Away,김승원,2,1,2,50.0,0,0,0.0,1,2,50.0,0,0,0.0,0,1,1,0,0,0,0,0,0,1
../kbl_data/2021-2022,S39G01N2,서울 SK,Away,리온 윌리엄스,4,2,4,50.0,0,0,0.0,2,4,50.0,0,0,0.0,3,0,3,1,1,0,0,0,0,0
../kbl_data/2021-2022,S39G01N2,서울 SK,Away,이현석,0,0,0,0.0,0,0,0.0,0,0,0.0,0,0,0.0,0,1,1,0,0,0,0,0,0,1
../kbl_data/2021-2022,S39G01N2,서울 SK,Away,최원혁,7,1,2,50.0,1,1,100.0,2,3,66.7,2,2,100.0,1,2,3,3,1,0,0,0,0,5
../kbl_data/2021-2022,S39G01N2,서울 SK,Away,최준용,16,3,5,60.0,2,5,40.0,5,10,50.0,4,5,80.0,0,2,2,1,0,0,0,0,1,2
../kbl_data/2021-2022,S39G01N2,서울 SK,Away,안영준,18,4,9,44.4,3,4,75.0,7,13,53.8,1,2,50.0,1,3,4,5,2,0,0,0,3,2
../kbl_data/2021-2022,S39G01N2,서울 SK,Away,자밀 워니,26,13,18,72.2,0,2,0.0,13,20,65.0,0,0,0.0,5,9,14,3,0,0,0,1,1,0
../kbl_data/2021-2022,S39G01N2,서울 SK,Away,오재현,0,0,0,0.0,0,0,0.0,0,0,0.0,0,0,0.0,0,0,0,0,0,0,0,0,0,0
../kbl_data/2021-2022,S39G01N3,울산 현대모비스,Home,이현민,0,0,0,0.0,0,0,0.0,0,0,0.0,0,0,0.0,0,0,0,0,0,0,0,0,1,4
../kbl_data/2021-2022,S39G01N3,울산 현대모비스,Home,함지훈,14,3,7,42.9,2,2,100.0,5,9,55.6,2,2,100.0,1,1,2,2,1,0,0,0,1,1
../kbl_data/2021-2022,S39G01N3,울산 현대모비스,Home,최진수,0,0,4,0.0,0,2,0.0,0,6,0.0,0,0,0.0,0,1,1,0,0,0,0,0,1,1
../kbl_data/2021-2022,S39G01N3,울산 현대모비스,Home,장재석,16,6,10,60.0,0,0,0.0,6,10,60.0,4,7,57.1,4,5,9,1,0,1,0,0,1,4
../kbl_data/2021-2022,S39G01N3,울산 현대모비스,Home,정성호,0,0,0,0.0,0,0,0.0,0,0,0.0,0,0,0.0,0,0,0,0,0,0,0,0,0,0
../kbl_data/2021-2022,S39G01N3,울산 현대모비스,Home,김영현,0,0,0,0.0,0,0,0.0,0,0,0.0,0,0,0.0,0,0,0,1,1,0,0,0,0,4
../kbl_data/2021-2022,S39G01N3,울산 현대모비스,Home,김수찬,0,0,0,0.0,0,0,0.0,0,0,0.0,0,0,0.0,0,0,0,0,0,0,0,0,0,0
../kbl_data/2021-2022,S39G01N3,울산 현대모비스,Home,서명진,21,4,5,80.0,4,6,66.7,8,11,72.7,1,1,100.0,1,1,2,8,0,0,0,0,0,2
../kbl_data/2021-2022,S39G01N3,울산 현대모비스,Home,얼 클락,10,4,9,44.4,0,3,0.0,4,12,33.3,2,2,100.0,0,8,8,4,0,5,0,1,3,1
../kbl_data/2021-2022,S39G01N3,울산 현대모비스,Home,이우석,13,5,8,62.5,1,4,25.0,6,12,50.0,0,2,0.0,0,4,4,2,0,0,0,0,4,3
../kbl_data/2021-2022,S39G01N3,울산 현대모비스,Home,신민석,9,3,3,100.0,1,4,25.0,4,7,57.1,0,0,0.0,1,2,3,0,1,1,0,0,0,1
../kbl_data/2021-2022,S39G01N3,울산 현대모비스,Home,김동준,0,0,1,0.0,0,0,0.0,0,1,0.0,0,0,0.0,1,1,2,0,0,0,0,0,1,1
../kbl_data/2021-2022,S39G01N3,대구 한국가스공사,Away,정영삼,4,2,3,66.7,0,0,0.0,2,3,66.7,0,0,0.0,0,1,1,1,0,0,0,0,0,1
../kbl_data/2021-2022,S39G01N3,대구 한국가스공사,Away,민성주,0,0,0,0.0,0,0,0.0,0,0,0.0,0,0,0.0,1,0,1,1,1,0,0,0,0,1
../kbl_data/2021-2022,S39G01N3,대구 한국가스공사,Away,차바위,2,1,1,100.0,0,0,0.0,1,1,100.0,0,0,0.0,0,2,2,3,3,0,0,0,1,2
../kbl_data/2021-2022,S39G01N3,대구 한국가스공사,Away,조상열,0,0,0,0.0,0,0,0.0,0,0,0.0,0,0,0.0,0,0,0,0,0,0,0,0,0,0
../kbl_data/2021-2022,S39G01N3,대구 한국가스공사,Away,이대헌,19,9,14,64.3,0,1,0.0,9,15,60.0,1,2,50.0,1,2,3,2,1,2,0,1,0,4
../kbl_data/2021-2022,S39G01N3,대구 한국가스공사,Away,두경민,8,1,4,25.0,1,6,16.7,2,10,20.0,3,3,100.0,0,3,3,1,1,0,0,0,0,0
../kbl_data/2021-2022,S39G01N3,대구 한국가스공사,Away,임준수,0,0,0,0.0,0,0,0.0,0,0,0.0,0,0,0.0,0,0,0,0,0,0,0,0,0,0
../kbl_data/2021-2022,S39G01N3,대구 한국가스공사,Away,김낙현,21,3,6,50.0,4,8,50.0,7,14,50.0,3,5,60.0,0,2,2,5,0,1,0,0,0,2
../kbl_data/2021-2022,S39G01N3,대구 한국가스공사,Away,전현우,5,1,1,100.0,0,1,0.0,1,2,50.0,3,3,100.0,1,3,4,1,0,0,0,0,0,2
../kbl_data/2021-2022,S39G01N3,대구 한국가스공사,Away,클리프 알렉산더,3,1,1,100.0,0,0,0.0,1,1,100.0,1,2,50.0,0,2,2,1,0,0,0,0,1,1
../kbl_data/2021-2022,S39G01N3,대구 한국가스공사,Away,앤드류 니콜슨,32,11,17,64.7,2,3,66.7,13,20,65.0,4,4,100.0,2,4,6,3,2,0,0,1,2,3
../kbl_data/2021-2022,S39G01N3,대구 한국가스공사,Away,신승민,0,0,0,0.0,0,1,0.0,0,1,0.0,0,0,0.0,0,2,2,2,0,0,0,0,1,5
../kbl_data/2021-2022,S39G01N4,수원 KT,Home,김동욱,9,0,5,0.0,2,3,66.7,2,8,25.0,3,3,100.0,0,2,2,2,1,0,0,0,0,1
../kbl_data/2021-2022,S39G01N4,수원 KT,Home,김영환,2,1,1,100.0,0,4,0.0,1,5,20.0,0,1,0.0,0,1,1,1,2,0,0,0,1,0
../kbl_data/2021-2022,S39G01N4,수원 KT,Home,김현민,0,0,0,0.0,0,0,0.0,0,0,0.0,0,0,0.0,0,0,0,0,0,0,0,0,0,2
../kbl_data/2021-2022,S39G01N4,수원 KT,Home,김윤태,0,0,0,0.0,0,0,0.0,0,0,0.0,0,0,0.0,0,0,0,0,0,0,0,0,0,0
../kbl_data/2021-2022,S39G01N4,수원 KT,Home,최창진,0,0,0,0.0,0,0,0.0,0,0,0.0,0,0,0.0,0,0,0,0,0,0,0,0,0,0
../kbl_data/2021-2022,S39G01N4,수원 KT,Home,정성우,17,5,9,55.6,2,5,40.0,7,14,50.0,1,2,50.0,0,1,1,4,0,0,1,0,1,1
../kbl_data/2021-2022,S39G01N4,수원 KT,Home,양홍석,11,1,3,33.3,2,7,28.6,3,10,30.0,3,5,60.0,1,6,7,3,3,0,0,0,3,0
../kbl_data/2021-2022,S39G01N4,수원 KT,Home,박준영,0,0,0,0.0,0,1,0.0,0,1,0.0,0,0,0.0,1,1,2,1,0,0,0,0,0,0
../kbl_data/2021-2022,S39G01N4,수원 KT,Home,캐디 라렌,6,2,8,25.0,0,1,0.0,2,9,22.2,2,2,100.0,2,4,6,0,0,1,0,0,1,3
../kbl_data/2021-2022,S39G01N4,수원 KT,Home,박지원,5,0,6,0.0,1,4,25.0,1,10,10.0,2,2,100.0,0,3,3,1,3,0,0,0,1,0
../kbl_data/2021-2022,S39G01N4,수원 KT,Home,마이크 마이어스,9,4,8,50.0,0,0,0.0,4,8,50.0,1,2,50.0,4,7,11,2,0,1,0,1,0,3
../kbl_data/2021-2022,S39G01N4,수원 KT,Home,하윤기,8,2,6,33.3,0,0,0.0,2,6,33.3,4,6,66.7,2,1,3,0,1,2,0,0,3,2
../kbl_data/2021-2022,S39G01N4,원주 DB,Away,윤호영,3,1,2,50.0,0,0,0.0,1,2,50.0,1,2,50.0,1,1,2,1,0,1,0,0,1,3
../kbl_data/2021-2022,S39G01N4,원주 DB,Away,박찬희,4,2,2,100.0,0,3,0.0,2,5,40.0,0,2,0.0,1,5,6,8,1,0,0,0,2,0
../kbl_data/2021-2022,S39G01N4,원주 DB,Away,김종규,15,6,11,54.5,1,3,33.3,7,14,50.0,0,0,0.0,1,5,6,0,1,4,1,1,4,2
../kbl_data/2021-2022,S39G01N4,원주 DB,Away,허웅,26,4,6,66.7,6,8,75.0,10,14,71.4,0,0,0.0,1,4,5,6,0,1,1,0,3,0
../kbl_data/2021-2022,S39G01N4,원주 DB,Away,김영훈,0,0,0,0.0,0,1,0.0,0,1,0.0,0,0,0.0,0,0,0,0,0,0,0,0,0,2
../kbl_data/2021-2022,S39G01N4,원주 DB,Away,김철욱,0,0,2,0.0,0,0,0.0,0,2,0.0,0,0,0.0,0,1,1,0,0,0,0,0,0,3
../kbl_data/2021-2022,S39G01N4,원주 DB,Away,박상권,0,0,0,0.0,0,0,0.0,0,0,0.0,0,0,0.0,0,0,0,0,0,0,0,0,0,0
../kbl_data/2021-2022,S39G01N4,원주 DB,Away,김훈,5,1,2,50.0,1,2,50.0,2,4,50.0,0,0,0.0,0,1,1,0,0,0,0,0,1,1
../kbl_data/2021-2022,S39G01N4,원주 DB,Away,나카무라 타이치,2,1,3,33.3,0,2,0.0,1,5,20.0,0,0,0.0,1,2,3,1,1,0,0,0,1,2
../kbl_data/2021-2022,S39G01N4,원주 DB,Away,얀테 메이튼,4,1,6,16.7,0,1,0.0,1,7,14.3,2,2,100.0,2,0,2,1,1,1,0,0,1,4
../kbl_data/2021-2022,S39G01N4,원주 DB,Away,레나드 프리먼,7,3,9,33.3,0,1,0.0,3,10,30.0,1,1,100.0,3,13,16,2,1,3,0,0,0,1
../kbl_data/2021-2022,S39G01N4,원주 DB,Away,정호영,7,2,3,66.7,1,2,50.0,3,5,60.0,0,0,0.0,0,0,0,0,0,0,0,0,1,0
../kbl_data/2021-2022,S39G01N5,서울 삼성,Home,김동량,0,0,0,0.0,0,0,0.0,0,0,0.0,0,0,0.0,0,0,0,0,0,0,0,0,0,0
../kbl_data/2021-2022,S39G01N5,서울 삼성,Home,장민국,10,0,0,0.0,3,4,75.0,3,4,75.0,1,2,50.0,0,2,2,0,1,1,0,0,3,3
../kbl_data/2021-2022,S39G01N5,서울 삼성,Home,김시래,2,1,5,20.0,0,1,0.0,1,6,16.7,0,1,0.0,0,4,4,8,0,0,0,0,2,2
../kbl_data/2021-2022,S39G01N5,서울 삼성,Home,김현수,18,3,5,60.0,3,5,60.0,6,10,60.0,3,3,100.0,0,1,1,1,1,0,1,0,1,3
../kbl_data/2021-2022,S39G01N5,서울 삼성,Home,임동섭,7,1,5,20.0,1,3,33.3,2,8,25.0,2,2,100.0,0,2,2,4,0,1,1,0,0,4
../kbl_data/2021-2022,S39G01N5,서울 삼성,Home,이동엽,12,2,3,66.7,2,3,66.7,4,6,66.7,2,3,66.7,1,3,4,7,1,0,0,0,3,3
../kbl_data/2021-2022,S39G01N5,서울 삼성,Home,아이제아 힉스,22,10,11,90.9,0,2,0.0,10,13,76.9,2,3,66.7,2,4,6,1,1,1,0,1,4,4
../kbl_data/2021-2022,S39G01N5,서울 삼성,Home,박민우,0,0,0,0.0,0,0,0.0,0,0,0.0,0,0,0.0,0,0,0,0,0,0,0,0,0,0
../kbl_data/2021-2022,S39G01N5,서울 삼성,Home,차민석,5,2,4,50.0,0,1,0.0,2,5,40.0,1,2,50.0,2,1,3,0,0,0,0,0,1,2
../kbl_data/2021-2022,S39G01N5,서울 삼성,Home,전형준,0,0,0,0.0,0,0,0.0,0,0,0.0,0,0,0.0,0,0,0,0,0,0,0,0,0,1
../kbl_data/2021-2022,S39G01N5,서울 삼성,Home,다니엘 오셰푸,14,7,11,63.6,0,0,0.0,7,11,63.6,0,0,0.0,2,5,7,2,0,2,0,2,2,2
../kbl_data/2021-2022,S39G01N5,서울 삼성,Home,이원석,10,2,2,100.0,1,1,100.0,3,3,100.0,3,3,100.0,0,0,0,1,0,1,1,0,0,1
../kbl_data/2021-2022,S39G01N5,창원 LG,Away,변기훈,11,1,6,16.7,2,4,50.0,3,10,30.0,3,3,100.0,1,1,2,2,0,0,1,0,1,5
../kbl_data/2021-2022,S39G01N5,창원 LG,Away,이관희,12,1,5,20.0,1,3,33.3,2,8,25.0,7,8,87.5,0,0,0,2,0,0,0,0,0,4
../kbl_data/2021-2022,S39G01N5,창원 LG,Away,정희재,0,0,0,0.0,0,0,0.0,0,0,0.0,0,0,0.0,0,0,0,0,0,0,0,0,0,0
../kbl_data/2021-2022,S39G01N5,창원 LG,Away,서민수,0,0,1,0.0,0,2,0.0,0,3,0.0,0,0,0.0,0,2,2,0,0,0,0,0,0,0
../kbl_data/2021-2022,S39G01N5,창원 LG,Away,한상혁,0,0,0,0.0,0,0,0.0,0,0,0.0,0,0,0.0,0,0,0,0,0,0,0,0,0,0
../kbl_data/2021-2022,S39G01N5,창원 LG,Away,이재도,19,4,8,50.0,2,10,20.0,6,18,33.3,5,5,100.0,6,3,9,6,2,0,0,0,4,1
../kbl_data/2021-2022,S39G01N5,창원 LG,Away,김준일,6,3,4,75.0,0,0,0.0,3,4,75.0,0,0,0.0,0,2,2,1,2,0,0,0,4,4
../kbl_data/2021-2022,S39G01N5,창원 LG,Away,정해원,6,0,0,0.0,2,5,40.0,2,5,40.0,0,0,0.0,0,2,2,1,0,0,0,0,0,2
../kbl_data/2021-2022,S39G01N5,창원 LG,Away,박정현,2,1,2,50.0,0,1,0.0,1,3,33.3,0,0,0.0,1,2,3,1,1,0,0,0,0,2
../kbl_data/2021-2022,S39G01N5,창원 LG,Away,압둘 말릭 아부,14,4,5,80.0,2,2,100.0,6,7,85.7,0,0,0.0,2,2,4,0,1,0,0,1,1,0
../kbl_data/2021-2022,S39G01N5,창원 LG,Away,아셈 마레이,22,7,13,53.8,0,0,0.0,7,13,53.8,8,12,66.7,2,8,10,2,3,1,2,0,1,4
../kbl_data/2021-2022,S39G01N5,창원 LG,Away,이승우,0,0,0,0.0,0,0,0.0,0,0,0.0,0,0,0.0,0,0,0,0,0,0,0,0,0,0
../kbl_data/2021-2022,S39G01N6,전주 KCC,Home,송창용,2,1,1,100.0,0,1,0.0,1,2,50.0,0,0,0.0,1,0,1,0,0,0,0,0,0,0
../kbl_data/2021-2022,S39G01N6,전주 KCC,Home,이정현,52,10,22,45.5,8,14,57.1,18,36,50.0,8,12,66.7,0,8,8,6,2,2,0,0,6,12
../kbl_data/2021-2022,S39G01N6,전주 KCC,Home,정창영,0,0,0,0.0,0,2,0.0,0,2,0.0,0,0,0.0,0,2,2,3,0,0,0,0,1,1
../kbl_data/2021-2022,S39G01N6,전주 KCC,Home,라건아,13,6,11,54.5,0,2,0.0,6,13,46.2,1,2,50.0,4,10,14,2,1,0,0,0,0,3
../kbl_data/2021-2022,S39G01N6,전주 KCC,Home,김지완,12,3,7,42.9,2,4,50.0,5,11,45.5,0,2,0.0,0,4,4,5,2,0,0,0,3,3
../kbl_data/2021-2022,S39G01N6,전주 KCC,Home,김상규,0,0,0,0.0,0,0,0.0,0,0,0.0,0,0,0.0,0,0,0,0,0,0,0,0,0,1
../kbl_data/2021-2022,S39G01N6,전주 KCC,Home,유병훈,0,0,1,0.0,0,1,0.0,0,2,0.0,0,0,0.0,0,0,0,0,0,0,0,0,0,3
../kbl_data/2021-2022,S39G01N6,전주 KCC,Home,전준범,0,0,0,0.0,0,0,0.0,0,0,0.0,0,0,0.0,0,0,0,0,0,0,0,0,0,0
../kbl_data/2021-2022,S39G01N6,전주 KCC,Home,송교창,17,7,10,70.0,1,3,33.3,8,13,61.5,0,0,0.0,1,2,3,0,0,2,0,1,2,2
../kbl_data/2021-2022,S39G01N6,전주 KCC,Home,이진욱,0,0,0,0.0,0,0,0.0,0,0,0.0,0,0,0.0,0,0,0,0,0,0,0,0,0,0
../kbl_data/2021-2022,S39G01N6,전주 KCC,Home,유현준,9,3,5,60.0,0,0,0.0,3,5,60.0,3,3,100.0,0,1,1,6,1,1,0,0,2,2
../kbl_data/2021-2022,S39G01N6,전주 KCC,Home,라타비우스 윌리엄스,4,1,6,16.7,0,0,0.0,1,6,16.7,2,2,100.0,5,2,7,0,0,0,0,0,1,1
../kbl_data/2021-2022,S39G01N6,고양 오리온,Away,오용준,0,0,0,0.0,0,1,0.0,0,1,0.0,0,0,0.0,0,0,0,0,0,0,0,0,0,0
../kbl_data/2021-2022,S39G01N6,고양 오리온,Away,김강선,13,2,3,66.7,3,5,60.0,5,8,62.5,0,0,0.0,1,0,1,1,1,0,0,0,1,3
../kbl_data/2021-2022,S39G01N6,고양 오리온,Away,최현민,2,1,1,100.0,0,4,0.0,1,5,20.0,0,0,0.0,0,1,1,1,1,0,0,0,0,1
../kbl_data/2021-2022,S39G01N6,고양 오리온,Away,이대성,8,4,5,80.0,0,3,0.0,4,8,50.0,0,0,0.0,0,4,4,5,1,0,1,0,3,2
../kbl_data/2021-2022,S39G01N6,고양 오리온,Away,한호빈,9,2,2,100.0,1,3,33.3,3,5,60.0,2,2,100.0,0,2,2,5,1,0,0,0,0,1
../kbl_data/2021-2022,S39G01N6,고양 오리온,Away,최승욱,2,1,1,100.0,0,0,0.0,1,1,100.0,0,0,0.0,1,0,1,0,0,0,0,0,0,0
../kbl_data/2021-2022,S39G01N6,고양 오리온,Away,이승현,15,5,10,50.0,1,4,25.0,6,14,42.9,2,2,100.0,3,4,7,4,1,0,0,0,1,2
../kbl_data/2021-2022,S39G01N6,고양 오리온,Away,이종현,0,0,1,0.0,0,0,0.0,0,1,0.0,0,0,0.0,1,0,1,0,0,0,0,0,1,0
../kbl_data/2021-2022,S39G01N6,고양 오리온,Away,김진유,0,0,0,0.0,0,0,0.0,0,0,0.0,0,0,0.0,0,1,1,0,0,0,0,0,0,0
../kbl_data/2021-2022,S39G01N6,고양 오리온,Away,머피 할로웨이,12,6,8,75.0,0,0,0.0,6,8,75.0,0,1,0.0,2,3,5,2,2,0,0,1,0,1
../kbl_data/2021-2022,S39G01N6,고양 오리온,Away,미로슬라브 라둘리차,19,7,13,53.8,1,2,50.0,8,15,53.3,2,2,100.0,3,6,9,3,2,1,0,0,2,2
../kbl_data/2021-2022,S39G01N6,고양 오리온,Away,이정현,52,10,22,45.5,8,14,57.1,18,36,50.0,8,12,66.7,0,8,8,6,2,2,0,0,6,12
../kbl_data/2021-2022,S39G01N7,대구 한국가스공사,Home,정영삼,2,1,1,100.0,0,3,0.0,1,4,25.0,0,0,0.0,0,1,1,3,0,0,0,0,0,5
../kbl_data/2021-2022,S39G01N7,대구 한국가스공사,Home,민성주,0,0,0,0.0,0,0,0.0,0,0,0.0,0,0,0.0,0,0,0,0,0,0,0,0,0,0
../kbl_data/2021-2022,S39G01N7,대구 한국가스공사,Home,차바위,2,0,0,0.0,0,3,0.0,0,3,0.0,2,2,100.0,4,7,11,3,1,1,0,0,1,3
../kbl_data/2021-2022,S39G01N7,대구 한국가스공사,Home,조상열,6,0,0,0.0,2,3,66.7,2,3,66.7,0,0,0.0,1,0,1,0,1,0,0,0,1,0
../kbl_data/2021-2022,S39G01N7,대구 한국가스공사,Home,이대헌,8,4,7,57.1,0,0,0.0,4,7,57.1,0,0,0.0,1,6,7,3,0,0,0,0,2,4
../kbl_data/2021-2022,S39G01N7,대구 한국가스공사,Home,두경민,14,3,7,42.9,2,7,28.6,5,14,35.7,2,2,100.0,0,1,1,1,2,0,0,0,7,2
../kbl_data/2021-2022,S39G01N7,대구 한국가스공사,Home,임준수,0,0,0,0.0,0,0,0.0,0,0,0.0,0,0,0.0,0,0,0,0,0,0,0,0,0,0
../kbl_data/2021-2022,S39G01N7,대구 한국가스공사,Home,김낙현,17,4,5,80.0,3,7,42.9,7,12,58.3,0,0,0.0,1,2,3,7,0,0,0,0,3,2
../kbl_data/2021-2022,S39G01N7,대구 한국가스공사,Home,전현우,0,0,0,0.0,0,1,0.0,0,1,0.0,0,0,0.0,0,0,0,1,0,0,0,0,0,0
../kbl_data/2021-2022,S39G01N7,대구 한국가스공사,Home,클리프 알렉산더,4,2,5,40.0,0,0,0.0,2,5,40.0,0,0,0.0,1,2,3,0,0,0,0,0,1,1
../kbl_data/2021-2022,S39G01N7,대구 한국가스공사,Home,앤드류 니콜슨,29,6,12,50.0,4,6,66.7,10,18,55.6,5,5,100.0,0,6,6,1,0,0,0,0,0,1
../kbl_data/2021-2022,S39G01N7,대구 한국가스공사,Home,신승민,6,1,4,25.0,1,2,50.0,2,6,33.3,1,2,50.0,3,7,10,1,0,0,0,0,0,3
../kbl_data/2021-2022,S39G01N7,안양 KGC,Away,박형철,0,0,0,0.0,0,0,0.0,0,0,0.0,0,0,0.0,0,0,0,0,0,0,0,0,0,0
../kbl_data/2021-2022,S39G01N7,안양 KGC,Away,함준후,0,0,1,0.0,0,0,0.0,0,1,0.0,0,0,0.0,0,2,2,0,2,0,0,0,2,1
../kbl_data/2021-2022,S39G01N7,안양 KGC,Away,오세근,11,4,7,57.1,0,1,0.0,4,8,50.0,3,6,50.0,0,2,2,1,1,0,0,0,1,3
../kbl_data/2021-2022,S39G01N7,안양 KGC,Away,문성곤,13,2,2,100.0,3,8,37.5,5,10,50.0,0,0,0.0,1,2,3,2,1,0,0,1,0,2
../kbl_data/2021-2022,S39G01N7,안양 KGC,Away,전성현,5,1,5,20.0,1,5,20.0,2,10,20.0,0,0,0.0,0,1,1,5,1,0,0,0,0,0
../kbl_data/2021-2022,S39G01N7,안양 KGC,Away,박재한,0,0,0,0.0,0,1,0.0,0,1,0.0,0,0,0.0,0,0,0,0,0,0,0,0,1,1
../kbl_data/2021-2022,S39G01N7,안양 KGC,Away,대릴 먼로,5,1,1,100.0,1,1,100.0,2,2,100.0,0,0,0.0,1,2,3,0,0,0,0,0,0,1
../kbl_data/2021-2022,S39G01N7,안양 KGC,Away,우동현,0,0,0,0.0,0,1,0.0,0,1,0.0,0,0,0.0,0,0,0,1,0,0,0,0,0,0
../kbl_data/2021-2022,S39G01N7,안양 KGC,Away,변준형,10,1,3,33.3,2,4,50.0,3,7,42.9,2,2,100.0,0,2,2,3,2,1,1,0,1,5
../kbl_data/2021-2022,S39G01N7,안양 KGC,Away,한승희,3,1,2,50.0,0,0,0.0,1,2,50.0,1,2,50.0,2,3,5,1,1,1,0,0,0,1
../kbl_data/2021-2022,S39G01N7,안양 KGC,Away,양승면,0,0,0,0.0,0,0,0.0,0,0,0.0,0,0,0.0,0,0,0,0,0,0,0,0,0,0
../kbl_data/2021-2022,S39G01N7,안양 KGC,Away,오마리 스펠맨,26,6,11,54.5,4,12,33.3,10,23,43.5,2,5,40.0,1,11,12,3,2,4,0,0,4,1
../kbl_data/2021-2022,S39G01N8,원주 DB,Home,윤호영,0,0,0,0.0,0,0,0.0,0,0,0.0,0,0,0.0,0,0,0,0,0,0,0,0,0,0
../kbl_data/2021-2022,S39G01N8,원주 DB,Home,박찬희,16,5,9,55.6,2,2,100.0,7,11,63.6,0,0,0.0,1,3,4,5,5,0,0,0,1,3
../kbl_data/2021-2022,S39G01N8,원주 DB,Home,김종규,12,6,10,60.0,0,1,0.0,6,11,54.5,0,0,0.0,2,7,9,1,1,1,0,0,5,2
../kbl_data/2021-2022,S39G01N8,원주 DB,Home,허웅,11,4,5,80.0,0,3,0.0,4,8,50.0,3,5,60.0,0,3,3,4,1,1,0,0,4,2
../kbl_data/2021-2022,S39G01N8,원주 DB,Home,김영훈,0,0,0,0.0,0,1,0.0,0,1,0.0,0,0,0.0,0,0,0,1,1,0,1,0,0,1
../kbl_data/2021-2022,S39G01N8,원주 DB,Home,김철욱,6,2,3,66.7,0,1,0.0,2,4,50.0,2,2,100.0,0,2,2,0,0,0,0,0,0,4
../kbl_data/2021-2022,S39G01N8,원주 DB,Home,김훈,0,0,1,0.0,0,1,0.0,0,2,0.0,0,0,0.0,1,0,1,1,0,0,0,0,0,0
../kbl_data/2021-2022,S39G01N8,원주 DB,Home,나카무라 타이치,2,1,1,100.0,0,2,0.0,1,3,33.3,0,0,0.0,0,2,2,0,1,0,0,0,1,1
../kbl_data/2021-2022,S39G01N8,원주 DB,Home,이용우,0,0,0,0.0,0,0,0.0,0,0,0.0,0,0,0.0,0,0,0,0,0,0,0,0,0,0
../kbl_data/2021-2022,S39G01N8,원주 DB,Home,얀테 메이튼,21,9,16,56.2,0,1,0.0,9,17,52.9,3,5,60.0,5,3,8,3,1,0,0,1,0,4
../kbl_data/2021-2022,S39G01N8,원주 DB,Home,레나드 프리먼,8,4,6,66.7,0,0,0.0,4,6,66.7,0,0,0.0,1,5,6,0,0,0,0,1,1,0
../kbl_data/2021-2022,S39G01N8,원주 DB,Home,정호영,5,1,2,50.0,1,3,33.3,2,5,40.0,0,0,0.0,0,1,1,3,0,0,0,0,1,3
../kbl_data/2021-2022,S39G01N8,울산 현대모비스,Away,이현민,8,2,2,100.0,1,2,50.0,3,4,75.0,1,2,50.0,1,0,1,4,1,0,0,0,3,0
../kbl_data/2021-2022,S39G01N8,울산 현대모비스,Away,함지훈,11,3,8,37.5,0,2,0.0,3,10,30.0,5,6,83.3,1,1,2,1,1,0,0,0,2,1
../kbl_data/2021-2022,S39G01N8,울산 현대모비스,Away,최진수,0,0,1,0.0,0,1,0.0,0,2,0.0,0,0,0.0,0,2,2,0,1,0,0,0,1,1
../kbl_data/2021-2022,S39G01N8,울산 현대모비스,Away,장재석,7,3,9,33.3,0,0,0.0,3,9,33.3,1,2,50.0,1,1,2,1,2,1,0,0,1,3
../kbl_data/2021-2022,S39G01N8,울산 현대모비스,Away,정성호,6,0,0,0.0,2,3,66.7,2,3,66.7,0,0,0.0,1,1,2,0,0,0,0,0,0,0
../kbl_data/2021-2022,S39G01N8,울산 현대모비스,Away,김영현,3,0,0,0.0,1,3,33.3,1,3,33.3,0,0,0.0,0,0,0,2,0,0,1,0,1,1
../kbl_data/2021-2022,S39G01N8,울산 현대모비스,Away,김수찬,3,0,1,0.0,1,2,50.0,1,3,33.3,0,0,0.0,1,1,2,2,1,0,0,0,0,2
../kbl_data/2021-2022,S39G01N8,울산 현대모비스,Away,서명진,3,0,2,0.0,1,4,25.0,1,6,16.7,0,0,0.0,0,2,2,6,0,0,0,0,4,2
../kbl_data/2021-2022,S39G01N8,울산 현대모비스,Away,얼 클락,25,9,18,50.0,2,3,66.7,11,21,52.4,1,2,50.0,3,12,15,2,1,1,0,1,2,4
../kbl_data/2021-2022,S39G01N8,울산 현대모비스,Away,라숀 토마스,0,0,0,0.0,0,0,0.0,0,0,0.0,0,0,0.0,0,0,0,0,0,0,0,0,0,0
../kbl_data/2021-2022,S39G01N8,울산 현대모비스,Away,신민석,0,0,0,0.0,0,0,0.0,0,0,0.0,0,0,0.0,1,3,4,1,2,0,0,0,2,2
../kbl_data/2021-2022,S39G01N8,울산 현대모비스,Away,김동준,3,1,1,100.0,0,0,0.0,1,1,100.0,1,1,100.0,0,0,0,0,0,0,0,0,1,0
../kbl_data/2021-2022,S39G01N9,서울 SK,Home,허일영,3,0,1,0.0,1,1,100.0,1,2,50.0,0,0,0.0,1,1,2,1,0,0,0,0,1,2
../kbl_data/2021-2022,S39G01N9,서울 SK,Home,김선형,20,5,9,55.6,3,7,42.9,8,16,50.0,1,1,100.0,1,2,3,7,2,0,1,0,2,1
../kbl_data/2021-2022,S39G01N9,서울 SK,Home,최부경,9,4,7,57.1,0,0,0.0,4,7,57.1,1,1,100.0,5,4,9,0,0,0,0,0,1,2
../kbl_data/2021-2022,S39G01N9,서울 SK,Home,리온 윌리엄스,2,0,3,0.0,0,1,0.0,0,4,0.0,2,2,100.0,1,2,3,0,0,0,0,0,0,0
../kbl_data/2021-2022,S39G01N9,서울 SK,Home,이원대,0,0,0,0.0,0,0,0.0,0,0,0.0,0,0,0.0,1,0,1,0,0,0,0,0,0,1
../kbl_data/2021-2022,S39G01N9,서울 SK,Home,이현석,0,0,0,0.0,0,1,0.0,0,1,0.0,0,0,0.0,0,0,0,0,1,0,0,0,0,0
../kbl_data/2021-2022,S39G01N9,서울 SK,Home,최원혁,2,1,1,100.0,0,1,0.0,1,2,50.0,0,0,0.0,1,3,4,4,2,0,0,0,1,4
../kbl_data/2021-2022,S39G01N9,서울 SK,Home,최준용,22,2,3,66.7,3,10,30.0,5,13,38.5,9,14,64.3,0,8,8,3,2,1,0,0,1,2
../kbl_data/2021-2022,S39G01N9,서울 SK,Home,안영준,7,1,4,25.0,1,4,25.0,2,8,25.0,2,2,100.0,1,0,1,1,0,1,0,0,4,1
../kbl_data/2021-2022,S39G01N9,서울 SK,Home,자밀 워니,20,8,17,47.1,0,1,0.0,8,18,44.4,4,4,100.0,3,6,9,2,1,1,0,0,2,2
../kbl_data/2021-2022,S39G01N9,서울 SK,Home,김형빈,0,0,0,0.0,0,0,0.0,0,0,0.0,0,0,0.0,0,0,0,0,0,0,0,0,0,0
../kbl_data/2021-2022,S39G01N9,서울 SK,Home,오재현,2,1,1,100.0,0,0,0.0,1,1,100.0,0,0,0.0,0,3,3,1,0,0,0,0,0,4
../kbl_data/2021-2022,S39G01N9,서울 삼성,Away,김동량,0,0,0,0.0,0,0,0.0,0,0,0.0,0,0,0.0,0,0,0,0,0,0,0,0,0,0
../kbl_data/2021-2022,S39G01N9,서울 삼성,Away,장민국,5,1,3,33.3,1,3,33.3,2,6,33.3,0,0,0.0,1,1,2,2,0,1,0,0,1,2
../kbl_data/2021-2022,S39G01N9,서울 삼성,Away,김시래,8,1,3,33.3,1,3,33.3,2,6,33.3,3,4,75.0,0,3,3,7,0,0,1,0,2,5
../kbl_data/2021-2022,S39G01N9,서울 삼성,Away,김현수,20,2,5,40.0,4,9,44.4,6,14,42.9,4,4,100.0,0,0,0,0,1,0,0,0,0,2
../kbl_data/2021-2022,S39G01N9,서울 삼성,Away,임동섭,3,0,1,0.0,1,5,20.0,1,6,16.7,0,0,0.0,1,1,2,1,0,0,0,0,0,1
../kbl_data/2021-2022,S39G01N9,서울 삼성,Away,이호현,0,0,1,0.0,0,1,0.0,0,2,0.0,0,2,0.0,0,0,0,2,1,0,0,0,0,0
../kbl_data/2021-2022,S39G01N9,서울 삼성,Away,아이제아 힉스,17,7,12,58.3,0,2,0.0,7,14,50.0,3,3,100.0,0,5,5,2,2,0,0,1,3,3
../kbl_data/2021-2022,S39G01N9,서울 삼성,Away,박민우,0,0,0,0.0,0,0,0.0,0,0,0.0,0,0,0.0,0,0,0,0,1,0,0,0,0,0
../kbl_data/2021-2022,S39G01N9,서울 삼성,Away,차민석,6,3,5,60.0,0,1,0.0,3,6,50.0,0,0,0.0,2,3,5,1,2,0,0,0,2,2
../kbl_data/2021-2022,S39G01N9,서울 삼성,Away,전형준,0,0,1,0.0,0,2,0.0,0,3,0.0,0,0,0.0,0,0,0,0,0,0,0,0,1,2
../kbl_data/2021-2022,S39G01N9,서울 삼성,Away,다니엘 오셰푸,6,3,5,60.0,0,0,0.0,3,5,60.0,0,0,0.0,1,11,12,2,0,0,0,0,2,1
../kbl_data/2021-2022,S39G01N9,서울 삼성,Away,이원석,8,4,5,80.0,0,2,0.0,4,7,57.1,0,1,0.0,1,5,6,0,1,1,0,0,1,2
../kbl_data/2021-2022,S39G01N10,창원 LG,Home,강병현,0,0,0,0.0,0,0,0.0,0,0,0.0,0,0,0.0,0,0,0,0,0,0,0,0,0,0
../kbl_data/2021-2022,S39G01N10,창원 LG,Home,변기훈,0,0,1,0.0,0,1,0.0,0,2,0.0,0,0,0.0,0,0,0,0,0,0,0,0,1,1
../kbl_data/2021-2022,S39G01N10,창원 LG,Home,이관희,11,1,7,14.3,3,8,37.5,4,15,26.7,0,0,0.0,1,1,2,4,3,0,0,0,3,2
../kbl_data/2021-2022,S39G01N10,창원 LG,Home,정희재,5,1,3,33.3,1,4,25.0,2,7,28.6,0,0,0.0,2,1,3,1,0,0,0,0,0,3
../kbl_data/2021-2022,S39G01N10,창원 LG,Home,서민수,3,0,0,0.0,1,1,100.0,1,1,100.0,0,0,0.0,0,2,2,1,0,0,0,0,0,2
../kbl_data/2021-2022,S39G01N10,창원 LG,Home,이재도,18,4,6,66.7,1,3,33.3,5,9,55.6,7,7,100.0,0,1,1,4,4,0,1,0,1,1
../kbl_data/2021-2022,S39G01N10,창원 LG,Home,박정현,10,5,8,62.5,0,2,0.0,5,10,50.0,0,0,0.0,3,4,7,0,0,0,0,0,2,2
../kbl_data/2021-2022,S39G01N10,창원 LG,Home,이광진,0,0,0,0.0,0,0,0.0,0,0,0.0,0,0,0.0,0,0,0,0,0,0,0,0,0,0
../kbl_data/2021-2022,S39G01N10,창원 LG,Home,압둘 말릭 아부,5,1,5,20.0,1,2,50.0,2,7,28.6,0,0,0.0,1,1,2,1,0,0,0,1,1,3
../kbl_data/2021-2022,S39G01N10,창원 LG,Home,아셈 마레이,20,6,13,46.2,0,0,0.0,6,13,46.2,8,10,80.0,5,0,5,3,5,0,1,0,3,3
../kbl_data/2021-2022,S39G01N10,창원 LG,Home,이승우,4,1,3,33.3,0,0,0.0,1,3,33.3,2,2,100.0,0,3,3,1,0,0,0,0,1,2
../kbl_data/2021-2022,S39G01N10,창원 LG,Home,김종호,0,0,2,0.0,0,0,0.0,0,2,0.0,0,0,0.0,1,0,1,0,2,0,0,0,0,2
../kbl_data/2021-2022,S39G01N10,수원 KT,Away,김동욱,11,1,2,50.0,3,5,60.0,4,7,57.1,0,0,0.0,0,0,0,8,0,0,0,0,4,1
../kbl_data/2021-2022,S39G01N10,수원 KT,Away,김영환,1,0,1,0.0,0,3,0.0,0,4,0.0,1,2,50.0,0,0,0,0,0,0,0,0,0,0
../kbl_data/2021-2022,S39G01N10,수원 KT,Away,김현민,0,0,0,0.0,0,0,0.0,0,0,0.0,0,0,0.0,0,0,0,0,0,0,0,0,0,0
../kbl_data/2021-2022,S39G01N10,수원 KT,Away,김윤태,0,0,0,0.0,0,0,0.0,0,0,0.0,0,0,0.0,0,0,0,0,0,0,0,0,0,0
../kbl_data/2021-2022,S39G01N10,수원 KT,Away,최창진,5,2,5,40.0,0,0,0.0,2,5,40.0,1,1,100.0,0,1,1,3,0,0,0,0,2,2
../kbl_data/2021-2022,S39G01N10,수원 KT,Away,정성우,29,3,4,75.0,7,9,77.8,10,13,76.9,2,2,100.0,1,0,1,1,3,0,0,0,1,3
../kbl_data/2021-2022,S39G01N10,수원 KT,Away,양홍석,12,3,4,75.0,2,3,66.7,5,7,71.4,0,0,0.0,1,2,3,2,1,0,0,0,3,3
../kbl_data/2021-2022,S39G01N10,수원 KT,Away,박준영,0,0,1,0.0,0,1,0.0,0,2,0.0,0,0,0.0,0,1,1,0,0,0,0,0,1,1
../kbl_data/2021-2022,S39G01N10,수원 KT,Away,캐디 라렌,6,3,5,60.0,0,2,0.0,3,7,42.9,0,0,0.0,2,6,8,0,1,0,0,1,2,5
../kbl_data/2021-2022,S39G01N10,수원 KT,Away,박지원,4,0,1,0.0,0,1,0.0,0,2,0.0,4,4,100.0,0,2,2,1,1,1,0,0,0,1
../kbl_data/2021-2022,S39G01N10,수원 KT,Away,마이크 마이어스,13,6,7,85.7,0,0,0.0,6,7,85.7,1,2,50.0,5,6,11,3,2,2,0,1,1,4
../kbl_data/2021-2022,S39G01N10,수원 KT,Away,하윤기,11,5,7,71.4,0,0,0.0,5,7,71.4,1,3,33.3,2,5,7,1,0,0,0,0,2,3
../kbl_data/2021-2022,S39G01N11,고양 오리온,Home,오용준,0,0,0,0.0,0,0,0.0,0,0,0.0,0,0,0.0,0,0,0,0,0,0,0,0,1,0
../kbl_data/2021-2022,S39G01N11,고양 오리온,Home,김강선,6,0,0,0.0,2,2,100.0,2,2,100.0,0,0,0.0,0,0,0,0,0,0,0,0,0,5
../kbl_data/2021-2022,S39G01N11,고양 오리온,Home,최현민,4,2,3,66.7,0,1,0.0,2,4,50.0,0,0,0.0,2,1,3,0,0,0,0,0,1,1
../kbl_data/2021-2022,S39G01N11,고양 오리온,Home,이대성,13,3,6,50.0,1,5,20.0,4,11,36.4,4,4,100.0,1,0,1,7,0,0,0,0,3,0
../kbl_data/2021-2022,S39G01N11,고양 오리온,Home,한호빈,10,1,5,20.0,2,6,33.3,3,11,27.3,2,2,100.0,0,2,2,3,2,0,0,0,2,2
../kbl_data/2021-2022,S39G01N11,고양 오리온,Home,최승욱,0,0,0,0.0,0,0,0.0,0,0,0.0,0,0,0.0,0,1,1,0,0,0,0,0,0,0
../kbl_data/2021-2022,S39G01N11,고양 오리온,Home,이승현,2,1,3,33.3,0,1,0.0,1,4,25.0,0,0,0.0,0,3,3,1,1,0,0,0,2,2
../kbl_data/2021-2022,S39G01N11,고양 오리온,Home,이종현,13,3,4,75.0,0,0,0.0,3,4,75.0,7,8,87.5,0,4,4,0,1,0,0,0,1,1
../kbl_data/2021-2022,S39G01N11,고양 오리온,Home,김진유,5,1,2,50.0,1,1,100.0,2,3,66.7,0,0,0.0,0,0,0,0,0,0,0,0,1,0
../kbl_data/2021-2022,S39G01N11,고양 오리온,Home,머피 할로웨이,23,11,15,73.3,0,1,0.0,11,16,68.8,1,5,20.0,7,7,14,3,2,0,0,3,0,3
../kbl_data/2021-2022,S39G01N11,고양 오리온,Home,미로슬라브 라둘리차,8,4,7,57.1,0,0,0.0,4,7,57.1,0,0,0.0,2,3,5,1,0,0,0,0,2,2
../kbl_data/2021-2022,S39G01N11,고양 오리온,Home,이정현,18,3,5,60.0,2,4,50.0,5,9,55.6,6,8,75.0,2,3,5,3,1,0,1,0,0,3
../kbl_data/2021-2022,S39G01N11,안양 KGC,Away,박형철,0,0,0,0.0,0,0,0.0,0,0,0.0,0,0,0.0,0,0,0,0,0,0,0,0,0,1
../kbl_data/2021-2022,S39G01N11,안양 KGC,Away,함준후,0,0,0,0.0,0,0,0.0,0,0,0.0,0,0,0.0,0,0,0,0,0,0,0,0,0,0
../kbl_data/2021-2022,S39G01N11,안양 KGC,Away,오세근,18,8,15,53.3,0,0,0.0,8,15,53.3,2,3,66.7,4,6,10,3,1,0,0,0,1,4
../kbl_data/2021-2022,S39G01N11,안양 KGC,Away,문성곤,11,4,4,100.0,1,3,33.3,5,7,71.4,0,0,0.0,3,4,7,3,5,0,0,0,0,3
../kbl_data/2021-2022,S39G01N11,안양 KGC,Away,전성현,23,5,8,62.5,3,12,25.0,8,20,40.0,4,4,100.0,2,0,2,4,1,1,0,0,1,2
../kbl_data/2021-2022,S39G01N11,안양 KGC,Away,박재한,0,0,0,0.0,0,0,0.0,0,0,0.0,0,0,0.0,0,0,0,0,0,0,0,0,0,0
../kbl_data/2021-2022,S39G01N11,안양 KGC,Away,대릴 먼로,22,6,10,60.0,2,11,18.2,8,21,38.1,4,7,57.1,3,9,12,7,1,0,0,0,5,5
../kbl_data/2021-2022,S39G01N11,안양 KGC,Away,우동현,0,0,0,0.0,0,0,0.0,0,0,0.0,0,0,0.0,0,0,0,0,0,0,0,0,0,0
../kbl_data/2021-2022,S39G01N11,안양 KGC,Away,변준형,22,5,7,71.4,2,8,25.0,7,15,46.7,6,7,85.7,3,1,4,5,1,0,0,0,4,3
../kbl_data/2021-2022,S39G01N11,안양 KGC,Away,한승희,2,1,2,50.0,0,0,0.0,1,2,50.0,0,0,0.0,1,0,1,0,0,0,0,0,0,3
../kbl_data/2021-2022,S39G01N11,안양 KGC,Away,양승면,0,0,0,0.0,0,0,0.0,0,0,0.0,0,0,0.0,0,0,0,0,0,0,0,0,0,0
../kbl_data/2021-2022,S39G01N11,안양 KGC,Away,주현우,0,0,0,0.0,0,0,0.0,0,0,0.0,0,0,0.0,0,0,0,0,0,0,0,0,0,0
../kbl_data/2021-2022,S39G01N12,서울 삼성,Home,김동량,0,0,0,0.0,0,0,0.0,0,0,0.0,0,0,0.0,0,0,0,0,0,0,0,0,0,0
../kbl_data/2021-2022,S39G01N12,서울 삼성,Home,장민국,7,3,4,75.0,0,0,0.0,3,4,75.0,1,2,50.0,3,1,4,0,1,0,0,0,0,2
../kbl_data/2021-2022,S39G01N12,서울 삼성,Home,김시래,18,5,7,71.4,0,2,0.0,5,9,55.6,8,8,100.0,0,3,3,8,3,0,0,0,0,2
../kbl_data/2021-2022,S39G01N12,서울 삼성,Home,김현수,8,2,6,33.3,1,5,20.0,3,11,27.3,1,2,50.0,0,3,3,0,0,0,0,0,2,5
../kbl_data/2021-2022,S39G01N12,서울 삼성,Home,임동섭,19,2,7,28.6,5,8,62.5,7,15,46.7,0,0,0.0,0,4,4,2,0,1,0,0,1,3
../kbl_data/2021-2022,S39G01N12,서울 삼성,Home,이호현,2,1,4,25.0,0,2,0.0,1,6,16.7,0,0,0.0,0,2,2,3,1,0,0,0,0,2
../kbl_data/2021-2022,S39G01N12,서울 삼성,Home,아이제아 힉스,23,9,14,64.3,0,0,0.0,9,14,64.3,5,5,100.0,2,8,10,0,0,2,0,0,1,2
../kbl_data/2021-2022,S39G01N12,서울 삼성,Home,박민우,0,0,0,0.0,0,0,0.0,0,0,0.0,0,0,0.0,0,0,0,0,0,0,0,0,0,0
../kbl_data/2021-2022,S39G01N12,서울 삼성,Home,차민석,2,0,1,0.0,0,0,0.0,0,1,0.0,2,2,100.0,3,0,3,0,0,0,0,0,0,2
../kbl_data/2021-2022,S39G01N12,서울 삼성,Home,전형준,0,0,0,0.0,0,0,0.0,0,0,0.0,0,0,0.0,0,0,0,0,0,0,0,0,0,0
../kbl_data/2021-2022,S39G01N12,서울 삼성,Home,다니엘 오셰푸,3,1,2,50.0,0,0,0.0,1,2,50.0,1,2,50.0,2,2,4,1,1,1,0,0,1,0
../kbl_data/2021-2022,S39G01N12,서울 삼성,Home,이원석,6,1,2,50.0,0,1,0.0,1,3,33.3,4,4,100.0,2,4,6,1,0,0,0,0,0,4
../kbl_data/2021-2022,S39G01N12,전주 KCC,Away,송창용,0,0,0,0.0,0,0,0.0,0,0,0.0,0,0,0.0,0,0,0,0,0,0,0,0,0,0
../kbl_data/2021-2022,S39G01N12,전주 KCC,Away,이정현,15,5,5,100.0,1,6,16.7,6,11,54.5,2,3,66.7,0,1,1,5,3,0,0,0,2,1
../kbl_data/2021-2022,S39G01N12,전주 KCC,Away,정창영,14,3,6,50.0,1,3,33.3,4,9,44.4,5,6,83.3,1,2,3,2,0,0,0,0,1,1
../kbl_data/2021-2022,S39G01N12,전주 KCC,Away,라건아,20,5,8,62.5,2,4,50.0,7,12,58.3,4,6,66.7,3,8,11,2,0,1,0,0,3,3
../kbl_data/2021-2022,S39G01N12,전주 KCC,Away,김지완,0,0,1,0.0,0,4,0.0,0,5,0.0,0,0,0.0,0,1,1,2,0,0,0,0,0,4
../kbl_data/2021-2022,S39G01N12,전주 KCC,Away,김상규,2,1,1,100.0,0,1,0.0,1,2,50.0,0,0,0.0,2,0,2,0,0,0,0,0,0,2
../kbl_data/2021-2022,S39G01N12,전주 KCC,Away,유병훈,0,0,1,0.0,0,0,0.0,0,1,0.0,0,0,0.0,0,0,0,0,0,0,0,0,0,0
../kbl_data/2021-2022,S39G01N12,전주 KCC,Away,전준범,3,0,1,0.0,1,3,33.3,1,4,25.0,0,0,0.0,0,1,1,0,0,0,0,0,0,0
../kbl_data/2021-2022,S39G01N12,전주 KCC,Away,송교창,20,5,8,62.5,2,4,50.0,7,12,58.3,4,4,100.0,0,4,4,2,0,1,0,1,0,4
../kbl_data/2021-2022,S39G01N12,전주 KCC,Away,이진욱,0,0,1,0.0,0,1,0.0,0,2,0.0,0,0,0.0,0,2,2,0,1,0,0,0,0,3
../kbl_data/2021-2022,S39G01N12,전주 KCC,Away,유현준,11,1,1,100.0,1,3,33.3,2,4,50.0,6,7,85.7,0,3,3,4,0,0,0,0,1,1
../kbl_data/2021-2022,S39G01N12,전주 KCC,Away,라타비우스 윌리엄스,1,0,1,0.0,0,0,0.0,0,1,0.0,1,2,50.0,1,1,2,0,0,0,0,0,0,3
../kbl_data/2021-2022,S39G01N13,수원 KT,Home,김동욱,2,1,3,33.3,0,1,0.0,1,4,25.0,0,0,0.0,0,2,2,2,0,0,0,0,0,1
../kbl_data/2021-2022,S39G01N13,수원 KT,Home,김영환,17,4,7,57.1,2,7,28.6,6,14,42.9,3,5,60.0,2,2,4,3,0,0,0,0,0,1
../kbl_data/2021-2022,S39G01N13,수원 KT,Home,김현민,0,0,0,0.0,0,0,0.0,0,0,0.0,0,0,0.0,1,0,1,1,2,0,0,0,1,1
../kbl_data/2021-2022,S39G01N13,수원 KT,Home,김윤태,0,0,0,0.0,0,0,0.0,0,0,0.0,0,0,0.0,0,0,0,0,0,0,0,0,0,0
../kbl_data/2021-2022,S39G01N13,수원 KT,Home,최창진,0,0,1,0.0,0,0,0.0,0,1,0.0,0,2,0.0,0,1,1,1,1,0,0,0,2,0
../kbl_data/2021-2022,S39G01N13,수원 KT,Home,정성우,6,0,1,0.0,2,5,40.0,2,6,33.3,0,0,0.0,0,1,1,2,1,0,0,0,2,4
../kbl_data/2021-2022,S39G01N13,수원 KT,Home,양홍석,16,3,5,60.0,3,4,75.0,6,9,66.7,1,2,50.0,4,8,12,1,2,0,0,0,0,3
../kbl_data/2021-2022,S39G01N13,수원 KT,Home,박준영,4,2,2,100.0,0,0,0.0,2,2,100.0,0,0,0.0,0,0,0,0,0,0,0,0,0,0
../kbl_data/2021-2022,S39G01N13,수원 KT,Home,캐디 라렌,29,10,16,62.5,2,6,33.3,12,22,54.5,3,3,100.0,4,7,11,1,2,1,0,2,2,4
../kbl_data/2021-2022,S39G01N13,수원 KT,Home,박지원,6,3,4,75.0,0,1,0.0,3,5,60.0,0,1,0.0,2,2,4,4,0,0,0,0,3,3
../kbl_data/2021-2022,S39G01N13,수원 KT,Home,마이크 마이어스,3,1,3,33.3,0,0,0.0,1,3,33.3,1,2,50.0,1,0,1,2,0,0,0,0,2,3
../kbl_data/2021-2022,S39G01N13,수원 KT,Home,하윤기,12,6,7,85.7,0,0,0.0,6,7,85.7,0,0,0.0,4,2,6,1,1,2,0,0,0,3
../kbl_data/2021-2022,S39G01N13,대구 한국가스공사,Away,정영삼,0,0,1,0.0,0,1,0.0,0,2,0.0,0,0,0.0,0,0,0,0,0,0,0,0,0,2
../kbl_data/2021-2022,S39G01N13,대구 한국가스공사,Away,민성주,0,0,0,0.0,0,0,0.0,0,0,0.0,0,0,0.0,0,0,0,0,0,0,0,0,0,0
../kbl_data/2021-2022,S39G01N13,대구 한국가스공사,Away,홍경기,4,0,0,0.0,1,1,100.0,1,1,100.0,1,2,50.0,1,0,1,1,0,0,0,0,0,2
../kbl_data/2021-2022,S39G01N13,대구 한국가스공사,Away,차바위,2,1,1,100.0,0,2,0.0,1,3,33.3,0,0,0.0,2,2,4,3,0,0,0,0,0,1
../kbl_data/2021-2022,S39G01N13,대구 한국가스공사,Away,조상열,5,1,2,50.0,1,3,33.3,2,5,40.0,0,0,0.0,0,3,3,2,2,0,1,0,2,2
../kbl_data/2021-2022,S39G01N13,대구 한국가스공사,Away,이대헌,20,9,15,60.0,0,3,0.0,9,18,50.0,2,5,40.0,2,5,7,2,2,0,0,0,2,1
../kbl_data/2021-2022,S39G01N13,대구 한국가스공사,Away,임준수,0,0,0,0.0,0,1,0.0,0,1,0.0,0,0,0.0,0,0,0,1,0,0,0,0,1,0
../kbl_data/2021-2022,S39G01N13,대구 한국가스공사,Away,김낙현,7,2,2,100.0,1,6,16.7,3,8,37.5,0,0,0.0,1,1,2,2,1,0,0,0,0,1
../kbl_data/2021-2022,S39G01N13,대구 한국가스공사,Away,전현우,3,0,1,0.0,1,4,25.0,1,5,20.0,0,0,0.0,1,0,1,1,1,0,0,0,2,2
../kbl_data/2021-2022,S39G01N13,대구 한국가스공사,Away,클리프 알렉산더,3,1,3,33.3,0,0,0.0,1,3,33.3,1,2,50.0,2,4,6,0,0,1,0,1,1,3
../kbl_data/2021-2022,S39G01N13,대구 한국가스공사,Away,앤드류 니콜슨,24,5,8,62.5,3,6,50.0,8,14,57.1,5,6,83.3,0,5,5,3,0,1,1,0,3,2
../kbl_data/2021-2022,S39G01N13,대구 한국가스공사,Away,신승민,10,4,5,80.0,0,0,0.0,4,5,80.0,2,2,100.0,0,0,0,1,0,0,0,0,2,1
../kbl_data/2021-2022,S39G01N14,창원 LG,Home,강병현,3,0,0,0.0,1,2,50.0,1,2,50.0,0,0,0.0,0,2,2,0,0,0,0,0,0,1
../kbl_data/2021-2022,S39G01N14,창원 LG,Home,변기훈,0,0,0,0.0,0,0,0.0,0,0,0.0,0,0,0.0,1,0,1,1,0,0,0,0,0,0
../kbl_data/2021-2022,S39G01N14,창원 LG,Home,이관희,26,5,7,71.4,4,8,50.0,9,15,60.0,4,5,80.0,0,0,0,5,0,0,0,0,2,0
../kbl_data/2021-2022,S39G01N14,창원 LG,Home,정희재,0,0,0,0.0,0,0,0.0,0,0,0.0,0,0,0.0,0,0,0,0,0,0,0,0,0,0
../kbl_data/2021-2022,S39G01N14,창원 LG,Home,서민수,10,1,4,25.0,2,5,40.0,3,9,33.3,2,2,100.0,1,3,4,0,1,1,0,0,1,4
../kbl_data/2021-2022,S39G01N14,창원 LG,Home,한상혁,0,0,1,0.0,0,0,0.0,0,1,0.0,0,0,0.0,1,1,2,1,0,0,0,0,1,1
../kbl_data/2021-2022,S39G01N14,창원 LG,Home,이재도,13,1,3,33.3,3,5,60.0,4,8,50.0,2,2,100.0,0,2,2,2,0,0,0,0,3,2
../kbl_data/2021-2022,S39G01N14,창원 LG,Home,정해원,1,0,2,0.0,0,2,0.0,0,4,0.0,1,2,50.0,0,2,2,1,1,0,0,0,1,3
../kbl_data/2021-2022,S39G01N14,창원 LG,Home,박정현,2,1,9,11.1,0,1,0.0,1,10,10.0,0,0,0.0,1,2,3,0,0,0,0,0,2,3
../kbl_data/2021-2022,S39G01N14,창원 LG,Home,압둘 말릭 아부,3,0,3,0.0,1,1,100.0,1,4,25.0,0,0,0.0,1,0,1,0,0,0,0,0,0,0
../kbl_data/2021-2022,S39G01N14,창원 LG,Home,아셈 마레이,13,5,10,50.0,0,0,0.0,5,10,50.0,3,8,37.5,11,11,22,1,3,3,0,0,1,4
../kbl_data/2021-2022,S39G01N14,창원 LG,Home,이승우,0,0,2,0.0,0,0,0.0,0,2,0.0,0,0,0.0,0,1,1,0,0,0,0,0,1,1
../kbl_data/2021-2022,S39G01N14,원주 DB,Away,윤호영,3,0,2,0.0,1,1,100.0,1,3,33.3,0,0,0.0,2,0,2,1,1,1,0,0,1,3
../kbl_data/2021-2022,S39G01N14,원주 DB,Away,박찬희,7,3,4,75.0,0,0,0.0,3,4,75.0,1,3,33.3,0,3,3,6,1,0,0,0,2,3
../kbl_data/2021-2022,S39G01N14,원주 DB,Away,김종규,10,5,7,71.4,0,1,0.0,5,8,62.5,0,0,0.0,2,5,7,0,0,2,0,0,1,4
../kbl_data/2021-2022,S39G01N14,원주 DB,Away,허웅,14,4,9,44.4,1,6,16.7,5,15,33.3,3,3,100.0,0,3,3,1,0,0,0,0,1,1
../kbl_data/2021-2022,S39G01N14,원주 DB,Away,김영훈,6,1,1,100.0,1,5,20.0,2,6,33.3,1,1,100.0,4,2,6,1,0,0,1,0,0,4
../kbl_data/2021-2022,S39G01N14,원주 DB,Away,배강률,0,0,0,0.0,0,0,0.0,0,0,0.0,0,0,0.0,0,0,0,0,0,0,0,0,0,0
../kbl_data/2021-2022,S39G01N14,원주 DB,Away,김훈,0,0,0,0.0,0,0,0.0,0,0,0.0,0,0,0.0,0,0,0,0,0,0,0,0,0,0
../kbl_data/2021-2022,S39G01N14,원주 DB,Away,나카무라 타이치,5,1,3,33.3,1,4,25.0,2,7,28.6,0,0,0.0,0,1,1,1,1,0,0,0,1,2
../kbl_data/2021-2022,S39G01N14,원주 DB,Away,이준희,0,0,0,0.0,0,0,0.0,0,0,0.0,0,0,0.0,0,0,0,0,0,0,0,0,0,0
../kbl_data/2021-2022,S39G01N14,원주 DB,Away,얀테 메이튼,20,7,16,43.8,0,2,0.0,7,18,38.9,6,9,66.7,0,7,7,2,0,2,0,0,2,1
../kbl_data/2021-2022,S39G01N14,원주 DB,Away,레나드 프리먼,8,4,8,50.0,0,0,0.0,4,8,50.0,0,0,0.0,3,7,10,1,1,1,0,0,1,1
../kbl_data/2021-2022,S39G01N14,원주 DB,Away,정호영,0,0,1,0.0,0,1,0.0,0,2,0.0,0,0,0.0,1,0,1,1,0,1,0,0,1,1
../kbl_data/2021-2022,S39G01N15,전주 KCC,Home,송창용,5,0,1,0.0,1,4,25.0,1,5,20.0,2,2,100.0,2,3,5,0,0,0,1,0,0,1
../kbl_data/2021-2022,S39G01N15,전주 KCC,Home,이정현,25,5,10,50.0,3,9,33.3,8,19,42.1,6,6,100.0,3,2,5,4,1,1,1,0,5,3
../kbl_data/2021-2022,S39G01N15,전주 KCC,Home,정창영,17,4,4,100.0,1,4,25.0,5,8,62.5,6,7,85.7,0,5,5,2,1,0,0,0,1,4
../kbl_data/2021-2022,S39G01N15,전주 KCC,Home,라건아,14,6,10,60.0,0,1,0.0,6,11,54.5,2,2,100.0,7,10,17,5,1,0,0,0,3,1
../kbl_data/2021-2022,S39G01N15,전주 KCC,Home,김지완,0,0,3,0.0,0,1,0.0,0,4,0.0,0,0,0.0,0,0,0,0,0,0,0,0,0,0
../kbl_data/2021-2022,S39G01N15,전주 KCC,Home,김상규,0,0,1,0.0,0,1,0.0,0,2,0.0,0,0,0.0,1,0,1,1,0,0,0,0,0,1
../kbl_data/2021-2022,S39G01N15,전주 KCC,Home,유병훈,5,1,1,100.0,1,2,50.0,2,3,66.7,0,0,0.0,1,0,1,1,0,0,0,0,0,3
../kbl_data/2021-2022,S39G01N15,전주 KCC,Home,전준범,0,0,0,0.0,0,0,0.0,0,0,0.0,0,0,0.0,0,0,0,0,0,0,0,0,0,0
../kbl_data/2021-2022,S39G01N15,전주 KCC,Home,송교창,13,2,6,33.3,3,8,37.5,5,14,35.7,0,0,0.0,1,7,8,2,0,0,0,0,3,0
../kbl_data/2021-2022,S39G01N15,전주 KCC,Home,이진욱,0,0,0,0.0,0,0,0.0,0,0,0.0,0,0,0.0,0,0,0,0,0,0,0,0,0,0
../kbl_data/2021-2022,S39G01N15,전주 KCC,Home,유현준,2,0,4,0.0,0,1,0.0,0,5,0.0,2,2,100.0,0,3,3,1,1,0,0,0,3,4
../kbl_data/2021-2022,S39G01N15,전주 KCC,Home,라타비우스 윌리엄스,4,1,3,33.3,0,0,0.0,1,3,33.3,2,2,100.0,1,3,4,0,0,0,0,0,1,1
../kbl_data/2021-2022,S39G01N15,서울 SK,Away,양우섭,0,0,1,0.0,0,1,0.0,0,2,0.0,0,0,0.0,2,0,2,3,0,0,0,0,0,0
../kbl_data/2021-2022,S39G01N15,서울 SK,Away,허일영,12,1,1,100.0,3,6,50.0,4,7,57.1,1,2,50.0,1,3,4,0,1,1,0,0,0,3
../kbl_data/2021-2022,S39G01N15,서울 SK,Away,김선형,13,6,12,50.0,0,3,0.0,6,15,40.0,1,2,50.0,1,1,2,3,1,0,0,0,1,2
../kbl_data/2021-2022,S39G01N15,서울 SK,Away,최부경,4,2,4,50.0,0,0,0.0,2,4,50.0,0,0,0.0,1,1,2,1,1,2,0,0,1,3
../kbl_data/2021-2022,S39G01N15,서울 SK,Away,리온 윌리엄스,0,0,1,0.0,0,0,0.0,0,1,0.0,0,0,0.0,0,5,5,0,0,0,0,0,0,0
../kbl_data/2021-2022,S39G01N15,서울 SK,Away,배병준,0,0,0,0.0,0,0,0.0,0,0,0.0,0,0,0.0,0,0,0,0,0,0,0,0,0,1
../kbl_data/2021-2022,S39G01N15,서울 SK,Away,이현석,0,0,0,0.0,0,0,0.0,0,0,0.0,0,0,0.0,0,0,0,0,1,0,0,0,0,0
../kbl_data/2021-2022,S39G01N15,서울 SK,Away,최원혁,5,2,4,50.0,0,2,0.0,2,6,33.3,1,2,50.0,0,1,1,3,1,0,0,0,1,3
../kbl_data/2021-2022,S39G01N15,서울 SK,Away,최준용,11,4,7,57.1,0,7,0.0,4,14,28.6,3,4,75.0,1,5,6,2,0,1,0,0,1,2
../kbl_data/2021-2022,S39G01N15,서울 SK,Away,안영준,22,9,14,64.3,1,3,33.3,10,17,58.8,1,2,50.0,1,3,4,1,4,0,0,0,1,3
../kbl_data/2021-2022,S39G01N15,서울 SK,Away,자밀 워니,15,7,11,63.6,0,1,0.0,7,12,58.3,1,2,50.0,1,9,10,8,3,2,0,0,3,4
../kbl_data/2021-2022,S39G01N15,서울 SK,Away,오재현,0,0,0,0.0,0,0,0.0,0,0,0.0,0,0,0.0,0,0,0,0,0,0,0,0,0,0
../kbl_data/2021-2022,S39G01N16,안양 KGC,Home,박형철,0,0,0,0.0,0,0,0.0,0,0,0.0,0,0,0.0,0,0,0,0,0,0,0,0,0,0
../kbl_data/2021-2022,S39G01N16,안양 KGC,Home,함준후,3,0,1,0.0,1,1,100.0,1,2,50.0,0,0,0.0,1,0,1,2,0,0,0,0,0,2
../kbl_data/2021-2022,S39G01N16,안양 KGC,Home,오세근,15,6,11,54.5,0,0,0.0,6,11,54.5,3,4,75.0,1,2,3,1,1,0,0,0,1,4
../kbl_data/2021-2022,S39G01N16,안양 KGC,Home,문성곤,5,1,3,33.3,1,3,33.3,2,6,33.3,0,0,0.0,1,2,3,6,3,0,0,0,1,4
../kbl_data/2021-2022,S39G01N16,안양 KGC,Home,전성현,12,4,6,66.7,0,5,0.0,4,11,36.4,4,4,100.0,1,2,3,1,2,1,0,0,5,2
../kbl_data/2021-2022,S39G01N16,안양 KGC,Home,박재한,0,0,0,0.0,0,0,0.0,0,0,0.0,0,0,0.0,0,0,0,1,0,0,0,0,1,2
../kbl_data/2021-2022,S39G01N16,안양 KGC,Home,대릴 먼로,2,1,1,100.0,0,0,0.0,1,1,100.0,0,0,0.0,1,0,1,0,0,0,0,0,0,0
../kbl_data/2021-2022,S39G01N16,안양 KGC,Home,우동현,2,1,1,100.0,0,0,0.0,1,1,100.0,0,0,0.0,0,0,0,0,0,0,0,0,0,0
../kbl_data/2021-2022,S39G01N16,안양 KGC,Home,변준형,16,3,5,60.0,3,6,50.0,6,11,54.5,1,2,50.0,0,3,3,3,2,0,0,0,5,4
../kbl_data/2021-2022,S39G01N16,안양 KGC,Home,한승희,2,0,0,0.0,0,0,0.0,0,0,0.0,2,2,100.0,1,2,3,0,0,0,1,0,1,1
../kbl_data/2021-2022,S39G01N16,안양 KGC,Home,양승면,0,0,0,0.0,0,0,0.0,0,0,0.0,0,0,0.0,0,0,0,0,0,0,0,0,0,0
../kbl_data/2021-2022,S39G01N16,안양 KGC,Home,오마리 스펠맨,29,7,11,63.6,4,11,36.4,11,22,50.0,3,5,60.0,0,11,11,5,1,3,0,3,5,1
../kbl_data/2021-2022,S39G01N16,울산 현대모비스,Away,이현민,3,1,1,100.0,0,0,0.0,1,1,100.0,1,1,100.0,0,0,0,1,0,0,0,0,1,1
../kbl_data/2021-2022,S39G01N16,울산 현대모비스,Away,함지훈,11,4,6,66.7,1,1,100.0,5,7,71.4,0,0,0.0,2,0,2,4,0,0,0,0,1,3
../kbl_data/2021-2022,S39G01N16,울산 현대모비스,Away,최진수,2,1,3,33.3,0,1,0.0,1,4,25.0,0,0,0.0,2,1,3,0,1,0,0,0,0,2
../kbl_data/2021-2022,S39G01N16,울산 현대모비스,Away,장재석,11,5,6,83.3,0,0,0.0,5,6,83.3,1,2,50.0,2,2,4,0,0,2,0,0,2,3
../kbl_data/2021-2022,S39G01N16,울산 현대모비스,Away,정성호,0,0,0,0.0,0,0,0.0,0,0,0.0,0,0,0.0,0,0,0,0,0,0,0,0,0,0
../kbl_data/2021-2022,S39G01N16,울산 현대모비스,Away,김영현,8,1,2,50.0,2,2,100.0,3,4,75.0,0,2,0.0,0,2,2,3,3,0,0,0,0,2
../kbl_data/2021-2022,S39G01N16,울산 현대모비스,Away,김수찬,2,1,1,100.0,0,0,0.0,1,1,100.0,0,0,0.0,0,1,1,1,1,0,1,0,0,0
../kbl_data/2021-2022,S39G01N16,울산 현대모비스,Away,서명진,10,2,6,33.3,2,5,40.0,4,11,36.4,0,3,0.0,0,6,6,9,5,0,0,0,4,1
../kbl_data/2021-2022,S39G01N16,울산 현대모비스,Away,얼 클락,25,8,12,66.7,1,3,33.3,9,15,60.0,6,6,100.0,1,5,6,1,0,0,0,3,1,2
../kbl_data/2021-2022,S39G01N16,울산 현대모비스,Away,이우석,11,1,2,50.0,3,4,75.0,4,6,66.7,0,0,0.0,1,2,3,2,0,0,0,0,2,1
../kbl_data/2021-2022,S39G01N16,울산 현대모비스,Away,라숀 토마스,16,7,15,46.7,0,0,0.0,7,15,46.7,2,2,100.0,4,4,8,3,2,1,1,1,1,3
../kbl_data/2021-2022,S39G01N16,울산 현대모비스,Away,신민석,4,2,2,100.0,0,2,0.0,2,4,50.0,0,0,0.0,0,0,0,0,1,0,0,0,0,0
../kbl_data/2021-2022,S39G01N17,고양 오리온,Home,김강선,10,2,2,100.0,2,5,40.0,4,7,57.1,0,0,0.0,0,1,1,2,1,0,0,0,1,2
../kbl_data/2021-2022,S39G01N17,고양 오리온,Home,최현민,0,0,0,0.0,0,2,0.0,0,2,0.0,0,0,0.0,0,0,0,1,0,0,0,0,0,0
../kbl_data/2021-2022,S39G01N17,고양 오리온,Home,이대성,24,5,8,62.5,4,5,80.0,9,13,69.2,2,2,100.0,0,6,6,3,3,0,0,0,4,2
../kbl_data/2021-2022,S39G01N17,고양 오리온,Home,한호빈,5,0,1,0.0,1,3,33.3,1,4,25.0,2,2,100.0,1,5,6,2,0,0,0,0,1,1
../kbl_data/2021-2022,S39G01N17,고양 오리온,Home,최승욱,2,1,1,100.0,0,0,0.0,1,1,100.0,0,0,0.0,1,0,1,0,0,0,0,0,0,0
../kbl_data/2021-2022,S39G01N17,고양 오리온,Home,이승현,15,7,8,87.5,0,0,0.0,7,8,87.5,1,1,100.0,1,4,5,2,3,0,0,0,0,0
../kbl_data/2021-2022,S39G01N17,고양 오리온,Home,이종현,8,3,8,37.5,0,0,0.0,3,8,37.5,2,2,100.0,2,4,6,1,0,1,0,0,1,2
../kbl_data/2021-2022,S39G01N17,고양 오리온,Home,김진유,0,0,0,0.0,0,1,0.0,0,1,0.0,0,0,0.0,0,0,0,0,0,0,0,0,0,1
../kbl_data/2021-2022,S39G01N17,고양 오리온,Home,머피 할로웨이,6,3,5,60.0,0,0,0.0,3,5,60.0,0,2,0.0,2,4,6,3,2,1,0,1,3,3
../kbl_data/2021-2022,S39G01N17,고양 오리온,Home,조한진,2,0,0,0.0,0,1,0.0,0,1,0.0,2,2,100.0,0,1,1,1,2,0,0,0,0,0
../kbl_data/2021-2022,S39G01N17,고양 오리온,Home,미로슬라브 라둘리차,8,3,7,42.9,0,0,0.0,3,7,42.9,2,3,66.7,1,5,6,3,0,1,0,0,5,2
../kbl_data/2021-2022,S39G01N17,고양 오리온,Home,이정현,9,2,2,100.0,1,3,33.3,3,5,60.0,2,2,100.0,0,1,1,2,1,0,0,0,1,1
../kbl_data/2021-2022,S39G01N17,대구 한국가스공사,Away,정영삼,0,0,1,0.0,0,0,0.0,0,1,0.0,0,0,0.0,0,0,0,0,1,0,1,0,0,2
../kbl_data/2021-2022,S39G01N17,대구 한국가스공사,Away,민성주,2,1,1,100.0,0,0,0.0,1,1,100.0,0,0,0.0,0,1,1,0,0,0,0,0,1,2
../kbl_data/2021-2022,S39G01N17,대구 한국가스공사,Away,차바위,4,2,3,66.7,0,2,0.0,2,5,40.0,0,0,0.0,3,4,7,2,1,0,0,0,1,3
../kbl_data/2021-2022,S39G01N17,대구 한국가스공사,Away,조상열,6,0,0,0.0,2,4,50.0,2,4,50.0,0,0,0.0,0,1,1,0,0,0,0,0,0,1
../kbl_data/2021-2022,S39G01N17,대구 한국가스공사,Away,이대헌,6,3,5,60.0,0,1,0.0,3,6,50.0,0,0,0.0,2,2,4,1,1,0,1,0,0,3
../kbl_data/2021-2022,S39G01N17,대구 한국가스공사,Away,두경민,6,0,2,0.0,2,6,33.3,2,8,25.0,0,0,0.0,0,2,2,7,1,0,0,0,4,1
../kbl_data/2021-2022,S39G01N17,대구 한국가스공사,Away,임준수,0,0,1,0.0,0,0,0.0,0,1,0.0,0,0,0.0,0,0,0,0,0,0,0,0,1,0
../kbl_data/2021-2022,S39G01N17,대구 한국가스공사,Away,김낙현,5,0,3,0.0,1,3,33.3,1,6,16.7,2,2,100.0,0,1,1,2,0,0,0,0,3,1
../kbl_data/2021-2022,S39G01N17,대구 한국가스공사,Away,전현우,5,1,1,100.0,1,4,25.0,2,5,40.0,0,0,0.0,0,0,0,1,1,0,0,0,0,2
../kbl_data/2021-2022,S39G01N17,대구 한국가스공사,Away,클리프 알렉산더,15,7,12,58.3,0,0,0.0,7,12,58.3,1,2,50.0,3,7,10,0,1,1,0,1,4,2
../kbl_data/2021-2022,S39G01N17,대구 한국가스공사,Away,앤드류 니콜슨,15,5,12,41.7,1,6,16.7,6,18,33.3,2,2,100.0,1,1,2,0,1,1,0,1,0,1
../kbl_data/2021-2022,S39G01N17,대구 한국가스공사,Away,신승민,3,1,3,33.3,0,1,0.0,1,4,25.0,1,3,33.3,2,0,2,3,0,0,0,0,0,3
../kbl_data/2021-2022,S39G01N18,서울 삼성,Home,장민국,8,1,2,50.0,2,3,66.7,3,5,60.0,0,0,0.0,0,1,1,0,0,0,1,0,0,5
../kbl_data/2021-2022,S39G01N18,서울 삼성,Home,김시래,11,4,8,50.0,1,3,33.3,5,11,45.5,0,0,0.0,1,7,8,10,0,0,0,0,3,2
../kbl_data/2021-2022,S39G01N18,서울 삼성,Home,김현수,4,2,4,50.0,0,4,0.0,2,8,25.0,0,0,0.0,0,0,0,0,0,0,0,0,2,0
../kbl_data/2021-2022,S39G01N18,서울 삼성,Home,임동섭,9,3,5,60.0,1,6,16.7,4,11,36.4,0,0,0.0,0,0,0,0,0,0,0,0,1,0
../kbl_data/2021-2022,S39G01N18,서울 삼성,Home,배수용,0,0,0,0.0,0,0,0.0,0,0,0.0,0,0,0.0,0,0,0,0,0,0,0,0,0,0
../kbl_data/2021-2022,S39G01N18,서울 삼성,Home,이호현,2,1,1,100.0,0,0,0.0,1,1,100.0,0,0,0.0,0,1,1,2,0,0,0,0,0,1
../kbl_data/2021-2022,S39G01N18,서울 삼성,Home,아이제아 힉스,19,8,13,61.5,0,0,0.0,8,13,61.5,3,6,50.0,2,4,6,1,2,1,1,1,3,2
../kbl_data/2021-2022,S39G01N18,서울 삼성,Home,박민우,3,0,1,0.0,1,1,100.0,1,2,50.0,0,0,0.0,0,0,0,0,0,0,0,0,0,0
../kbl_data/2021-2022,S39G01N18,서울 삼성,Home,차민석,4,2,2,100.0,0,0,0.0,2,2,100.0,0,0,0.0,1,1,2,1,0,0,1,0,0,3
../kbl_data/2021-2022,S39G01N18,서울 삼성,Home,전형준,2,0,2,0.0,0,0,0.0,0,2,0.0,2,2,100.0,0,1,1,3,0,0,0,0,0,0
../kbl_data/2021-2022,S39G01N18,서울 삼성,Home,다니엘 오셰푸,10,5,5,100.0,0,0,0.0,5,5,100.0,0,0,0.0,4,4,8,1,0,0,0,0,2,1
../kbl_data/2021-2022,S39G01N18,서울 삼성,Home,이원석,8,4,5,80.0,0,1,0.0,4,6,66.7,0,0,0.0,4,0,4,0,0,3,0,0,4,5
../kbl_data/2021-2022,S39G01N18,수원 KT,Away,김동욱,9,0,2,0.0,3,3,100.0,3,5,60.0,0,0,0.0,0,3,3,3,0,0,0,0,0,2
../kbl_data/2021-2022,S39G01N18,수원 KT,Away,김영환,8,2,4,50.0,1,2,50.0,3,6,50.0,1,1,100.0,1,0,1,2,0,0,0,0,1,3
../kbl_data/2021-2022,S39G01N18,수원 KT,Away,김현민,5,0,0,0.0,1,2,50.0,1,2,50.0,2,2,100.0,1,1,2,0,0,0,0,0,0,0
../kbl_data/2021-2022,S39G01N18,수원 KT,Away,김윤태,0,0,0,0.0,0,1,0.0,0,1,0.0,0,0,0.0,0,0,0,0,0,0,0,0,0,1
../kbl_data/2021-2022,S39G01N18,수원 KT,Away,최창진,0,0,0,0.0,0,0,0.0,0,0,0.0,0,0,0.0,0,1,1,2,0,0,0,0,0,1
../kbl_data/2021-2022,S39G01N18,수원 KT,Away,정성우,6,2,4,50.0,0,2,0.0,2,6,33.3,2,2,100.0,2,2,4,7,2,1,0,0,2,2
../kbl_data/2021-2022,S39G01N18,수원 KT,Away,양홍석,16,5,7,71.4,1,5,20.0,6,12,50.0,3,3,100.0,1,3,4,4,2,0,0,0,0,0
../kbl_data/2021-2022,S39G01N18,수원 KT,Away,박준영,2,1,2,50.0,0,0,0.0,1,2,50.0,0,0,0.0,0,0,0,0,0,0,0,0,0,1
../kbl_data/2021-2022,S39G01N18,수원 KT,Away,캐디 라렌,11,2,6,33.3,1,3,33.3,3,9,33.3,4,4,100.0,3,2,5,1,1,1,0,0,1,3
../kbl_data/2021-2022,S39G01N18,수원 KT,Away,박지원,3,1,1,100.0,0,1,0.0,1,2,50.0,1,2,50.0,0,0,0,5,3,0,1,0,1,2
../kbl_data/2021-2022,S39G01N18,수원 KT,Away,마이크 마이어스,12,6,12,50.0,0,0,0.0,6,12,50.0,0,2,0.0,6,1,7,2,1,0,0,0,1,1
../kbl_data/2021-2022,S39G01N18,수원 KT,Away,하윤기,23,10,13,76.9,0,0,0.0,10,13,76.9,3,4,75.0,1,1,2,0,1,0,0,1,1,2
../kbl_data/2021-2022,S39G01N19,원주 DB,Home,윤호영,0,0,1,0.0,0,1,0.0,0,2,0.0,0,0,0.0,2,0,2,1,0,1,0,0,0,1
../kbl_data/2021-2022,S39G01N19,원주 DB,Home,박찬희,10,2,8,25.0,2,5,40.0,4,13,30.8,0,0,0.0,0,2,2,4,0,0,0,0,0,2
../kbl_data/2021-2022,S39G01N19,원주 DB,Home,김종규,6,1,5,20.0,0,3,0.0,1,8,12.5,4,7,57.1,2,8,10,2,1,0,0,0,1,2
../kbl_data/2021-2022,S39G01N19,원주 DB,Home,허웅,23,0,0,0.0,4,8,50.0,4,8,50.0,11,11,100.0,0,0,0,4,1,0,0,0,3,0
../kbl_data/2021-2022,S39G01N19,원주 DB,Home,김영훈,3,0,1,0.0,1,5,20.0,1,6,16.7,0,0,0.0,1,1,2,0,0,0,0,0,2,3
../kbl_data/2021-2022,S39G01N19,원주 DB,Home,김철욱,10,2,4,50.0,2,5,40.0,4,9,44.4,0,0,0.0,1,5,6,0,0,1,0,0,2,2
../kbl_data/2021-2022,S39G01N19,원주 DB,Home,김훈,4,2,2,100.0,0,2,0.0,2,4,50.0,0,0,0.0,0,2,2,0,0,1,0,0,0,1
../kbl_data/2021-2022,S39G01N19,원주 DB,Home,나카무라 타이치,0,0,0,0.0,0,1,0.0,0,1,0.0,0,0,0.0,0,0,0,0,0,0,0,0,1,0
../kbl_data/2021-2022,S39G01N19,원주 DB,Home,이준희,0,0,0,0.0,0,1,0.0,0,1,0.0,0,0,0.0,0,0,0,0,0,1,0,0,0,3
../kbl_data/2021-2022,S39G01N19,원주 DB,Home,얀테 메이튼,1,0,0,0.0,0,0,0.0,0,0,0.0,1,2,50.0,0,0,0,0,0,0,0,0,0,0
../kbl_data/2021-2022,S39G01N19,원주 DB,Home,레나드 프리먼,18,9,10,90.0,0,1,0.0,9,11,81.8,0,0,0.0,5,10,15,5,1,0,0,1,3,5
../kbl_data/2021-2022,S39G01N19,원주 DB,Home,정호영,6,3,3,100.0,0,2,0.0,3,5,60.0,0,0,0.0,2,1,3,2,2,1,1,0,1,3
../kbl_data/2021-2022,S39G01N19,대구 한국가스공사,Away,정영삼,0,0,0,0.0,0,1,0.0,0,1,0.0,0,0,0.0,0,1,1,1,0,0,0,0,1,2
../kbl_data/2021-2022,S39G01N19,대구 한국가스공사,Away,민성주,0,0,0,0.0,0,0,0.0,0,0,0.0,0,0,0.0,0,0,0,0,0,0,0,0,0,0
../kbl_data/2021-2022,S39G01N19,대구 한국가스공사,Away,차바위,8,3,3,100.0,0,3,0.0,3,6,50.0,2,2,100.0,1,1,2,2,0,0,1,0,0,4
../kbl_data/2021-2022,S39G01N19,대구 한국가스공사,Away,조상열,3,0,0,0.0,1,1,100.0,1,1,100.0,0,0,0.0,0,0,0,1,0,0,0,0,0,2
../kbl_data/2021-2022,S39G01N19,대구 한국가스공사,Away,이대헌,15,5,11,45.5,1,3,33.3,6,14,42.9,2,4,50.0,2,7,9,3,1,0,0,0,2,4
../kbl_data/2021-2022,S39G01N19,대구 한국가스공사,Away,두경민,14,3,10,30.0,2,5,40.0,5,15,33.3,2,2,100.0,4,3,7,6,2,0,0,0,1,2
../kbl_data/2021-2022,S39G01N19,대구 한국가스공사,Away,임준수,0,0,0,0.0,0,0,0.0,0,0,0.0,0,0,0.0,0,0,0,0,0,0,0,0,0,0
../kbl_data/2021-2022,S39G01N19,대구 한국가스공사,Away,김낙현,10,2,7,28.6,2,6,33.3,4,13,30.8,0,0,0.0,1,4,5,5,1,0,0,0,3,1
../kbl_data/2021-2022,S39G01N19,대구 한국가스공사,Away,전현우,5,1,2,50.0,1,4,25.0,2,6,33.3,0,0,0.0,1,2,3,0,0,0,0,0,0,2
../kbl_data/2021-2022,S39G01N19,대구 한국가스공사,Away,클리프 알렉산더,23,9,17,52.9,0,0,0.0,9,17,52.9,5,7,71.4,2,9,11,0,1,1,0,5,1,3
../kbl_data/2021-2022,S39G01N19,대구 한국가스공사,Away,앤드류 니콜슨,0,0,0,0.0,0,0,0.0,0,0,0.0,0,0,0.0,0,0,0,0,0,0,0,0,0,0
../kbl_data/2021-2022,S39G01N19,대구 한국가스공사,Away,신승민,4,0,1,0.0,1,1,100.0,1,2,50.0,1,2,50.0,1,1,2,3,1,0,0,0,0,2
../kbl_data/2021-2022,S39G01N20,서울 SK,Home,허일영,5,2,4,50.0,0,2,0.0,2,6,33.3,1,2,50.0,0,2,2,1,0,0,0,0,0,2
../kbl_data/2021-2022,S39G01N20,서울 SK,Home,김선형,11,2,5,40.0,2,4,50.0,4,9,44.4,1,2,50.0,1,3,4,10,1,0,0,0,4,0
../kbl_data/2021-2022,S39G01N20,서울 SK,Home,최부경,10,4,7,57.1,0,0,0.0,4,7,57.1,2,2,100.0,2,1,3,0,1,0,1,0,0,2
../kbl_data/2021-2022,S39G01N20,서울 SK,Home,김승원,0,0,0,0.0,0,0,0.0,0,0,0.0,0,0,0.0,0,0,0,0,0,0,0,0,0,0
../kbl_data/2021-2022,S39G01N20,서울 SK,Home,리온 윌리엄스,3,1,1,100.0,0,0,0.0,1,1,100.0,1,2,50.0,1,2,3,0,0,0,0,0,0,3
../kbl_data/2021-2022,S39G01N20,서울 SK,Home,이원대,0,0,0,0.0,0,2,0.0,0,2,0.0,0,0,0.0,0,1,1,2,1,0,0,0,0,2
../kbl_data/2021-2022,S39G01N20,서울 SK,Home,이현석,0,0,0,0.0,0,0,0.0,0,0,0.0,0,0,0.0,0,0,0,0,0,1,0,0,0,0
../kbl_data/2021-2022,S39G01N20,서울 SK,Home,최원혁,0,0,1,0.0,0,2,0.0,0,3,0.0,0,0,0.0,2,1,3,3,1,0,0,0,0,2
../kbl_data/2021-2022,S39G01N20,서울 SK,Home,최준용,13,2,6,33.3,3,4,75.0,5,10,50.0,0,2,0.0,0,3,3,5,3,1,0,0,1,4
../kbl_data/2021-2022,S39G01N20,서울 SK,Home,안영준,11,5,11,45.5,0,2,0.0,5,13,38.5,1,1,100.0,0,5,5,1,1,0,0,0,1,4
../kbl_data/2021-2022,S39G01N20,서울 SK,Home,자밀 워니,36,14,22,63.6,1,2,50.0,15,24,62.5,5,7,71.4,7,5,12,2,1,0,0,0,2,1
../kbl_data/2021-2022,S39G01N20,서울 SK,Home,오재현,0,0,0,0.0,0,0,0.0,0,0,0.0,0,0,0.0,0,0,0,0,0,0,0,0,0,0
../kbl_data/2021-2022,S39G01N20,울산 현대모비스,Away,이현민,2,1,1,100.0,0,0,0.0,1,1,100.0,0,0,0.0,0,1,1,1,0,0,1,0,1,2
../kbl_data/2021-2022,S39G01N20,울산 현대모비스,Away,함지훈,7,2,8,25.0,0,1,0.0,2,9,22.2,3,6,50.0,4,3,7,1,1,1,0,0,1,1
../kbl_data/2021-2022,S39G01N20,울산 현대모비스,Away,최진수,15,1,1,100.0,3,6,50.0,4,7,57.1,4,4,100.0,0,3,3,1,0,1,0,0,2,3
../kbl_data/2021-2022,S39G01N20,울산 현대모비스,Away,장재석,6,3,6,50.0,0,0,0.0,3,6,50.0,0,0,0.0,1,2,3,0,1,2,0,0,1,4
../kbl_data/2021-2022,S39G01N20,울산 현대모비스,Away,정성호,3,0,0,0.0,1,3,33.3,1,3,33.3,0,0,0.0,0,0,0,2,1,0,0,0,0,0
../kbl_data/2021-2022,S39G01N20,울산 현대모비스,Away,김영현,0,0,0,0.0,0,0,0.0,0,0,0.0,0,0,0.0,0,0,0,0,0,0,0,0,0,0
../kbl_data/2021-2022,S39G01N20,울산 현대모비스,Away,김수찬,0,0,0,0.0,0,0,0.0,0,0,0.0,0,0,0.0,0,0,0,1,0,0,0,0,0,0
../kbl_data/2021-2022,S39G01N20,울산 현대모비스,Away,서명진,8,1,2,50.0,2,6,33.3,3,8,37.5,0,0,0.0,0,4,4,5,1,0,0,0,4,3
../kbl_data/2021-2022,S39G01N20,울산 현대모비스,Away,얼 클락,13,5,10,50.0,1,6,16.7,6,16,37.5,0,1,0.0,3,6,9,1,1,1,0,1,2,2
../kbl_data/2021-2022,S39G01N20,울산 현대모비스,Away,이우석,17,4,4,100.0,1,4,25.0,5,8,62.5,6,8,75.0,1,2,3,7,0,1,0,0,0,0
../kbl_data/2021-2022,S39G01N20,울산 현대모비스,Away,라숀 토마스,10,5,8,62.5,0,0,0.0,5,8,62.5,0,1,0.0,2,4,6,1,0,1,0,0,2,4
../kbl_data/2021-2022,S39G01N20,울산 현대모비스,Away,신민석,0,0,0,0.0,0,0,0.0,0,0,0.0,0,0,0.0,0,0,0,0,0,0,0,0,0,0
../kbl_data/2021-2022,S39G01N21,창원 LG,Home,강병현,3,0,1,0.0,1,2,50.0,1,3,33.3,0,0,0.0,1,0,1,1,0,1,0,0,0,2
../kbl_data/2021-2022,S39G01N21,창원 LG,Home,변기훈,2,1,3,33.3,0,2,0.0,1,5,20.0,0,0,0.0,1,1,2,0,0,0,0,0,0,1
../kbl_data/2021-2022,S39G01N21,창원 LG,Home,이관희,7,1,5,20.0,1,5,20.0,2,10,20.0,2,2,100.0,0,1,1,1,2,0,0,0,2,2
../kbl_data/2021-2022,S39G01N21,창원 LG,Home,정희재,7,2,3,66.7,1,3,33.3,3,6,50.0,0,0,0.0,1,2,3,0,1,0,0,0,3,2
../kbl_data/2021-2022,S39G01N21,창원 LG,Home,서민수,7,2,5,40.0,1,4,25.0,3,9,33.3,0,0,0.0,2,6,8,1,0,1,0,0,0,4
../kbl_data/2021-2022,S39G01N21,창원 LG,Home,한상혁,2,1,1,100.0,0,1,0.0,1,2,50.0,0,0,0.0,0,0,0,0,0,0,0,0,0,0
../kbl_data/2021-2022,S39G01N21,창원 LG,Home,이재도,18,4,5,80.0,3,7,42.9,7,12,58.3,1,2,50.0,0,3,3,6,2,0,0,0,1,0
../kbl_data/2021-2022,S39G01N21,창원 LG,Home,정해원,0,0,0,0.0,0,1,0.0,0,1,0.0,0,0,0.0,0,0,0,0,0,0,0,0,0,1
../kbl_data/2021-2022,S39G01N21,창원 LG,Home,박정현,0,0,0,0.0,0,0,0.0,0,0,0.0,0,0,0.0,0,0,0,0,0,0,0,0,0,0
../kbl_data/2021-2022,S39G01N21,창원 LG,Home,압둘 말릭 아부,0,0,2,0.0,0,1,0.0,0,3,0.0,0,0,0.0,2,2,4,0,0,0,0,0,0,2
../kbl_data/2021-2022,S39G01N21,창원 LG,Home,아셈 마레이,17,7,15,46.7,0,0,0.0,7,15,46.7,3,4,75.0,7,5,12,0,3,0,0,0,2,3
../kbl_data/2021-2022,S39G01N21,창원 LG,Home,이승우,0,0,0,0.0,0,0,0.0,0,0,0.0,0,0,0.0,0,0,0,0,0,0,0,0,0,0
../kbl_data/2021-2022,S39G01N21,전주 KCC,Away,송창용,0,0,1,0.0,0,1,0.0,0,2,0.0,0,0,0.0,0,1,1,1,1,0,0,0,0,0
../kbl_data/2021-2022,S39G01N21,전주 KCC,Away,이정현,0,0,1,0.0,0,1,0.0,0,2,0.0,0,0,0.0,0,0,0,1,0,0,0,0,2,2
../kbl_data/2021-2022,S39G01N21,전주 KCC,Away,정창영,10,1,3,33.3,2,2,100.0,3,5,60.0,2,2,100.0,0,2,2,3,1,0,0,0,2,2
../kbl_data/2021-2022,S39G01N21,전주 KCC,Away,라건아,12,5,7,71.4,0,2,0.0,5,9,55.6,2,2,100.0,0,7,7,0,0,1,0,0,2,0
../kbl_data/2021-2022,S39G01N21,전주 KCC,Away,김지완,13,2,3,66.7,3,5,60.0,5,8,62.5,0,0,0.0,1,1,2,3,0,0,0,0,1,2
../kbl_data/2021-2022,S39G01N21,전주 KCC,Away,김상규,0,0,0,0.0,0,0,0.0,0,0,0.0,0,0,0.0,0,0,0,0,0,0,0,0,0,0
../kbl_data/2021-2022,S39G01N21,전주 KCC,Away,유병훈,0,0,0,0.0,0,0,0.0,0,0,0.0,0,0,0.0,0,0,0,0,0,0,0,0,0,0
../kbl_data/2021-2022,S39G01N21,전주 KCC,Away,전준범,3,0,0,0.0,1,1,100.0,1,1,100.0,0,0,0.0,0,1,1,0,0,0,1,0,0,2
../kbl_data/2021-2022,S39G01N21,전주 KCC,Away,송교창,11,5,9,55.6,0,3,0.0,5,12,41.7,1,2,50.0,0,5,5,2,2,2,0,0,2,3
../kbl_data/2021-2022,S39G01N21,전주 KCC,Away,이진욱,8,1,1,100.0,2,3,66.7,3,4,75.0,0,0,0.0,0,0,0,0,0,0,0,0,0,1
../kbl_data/2021-2022,S39G01N21,전주 KCC,Away,유현준,10,5,8,62.5,0,2,0.0,5,10,50.0,0,0,0.0,1,0,1,6,1,0,0,0,1,1
../kbl_data/2021-2022,S39G01N21,전주 KCC,Away,라타비우스 윌리엄스,4,2,4,50.0,0,0,0.0,2,4,50.0,0,2,0.0,4,6,10,1,1,0,0,2,0,1
../kbl_data/2021-2022,S39G01N22,수원 KT,Home,김동욱,9,0,0,0.0,3,9,33.3,3,9,33.3,0,0,0.0,0,3,3,1,1,0,0,0,2,1
../kbl_data/2021-2022,S39G01N22,수원 KT,Home,김영환,5,2,4,50.0,0,4,0.0,2,8,25.0,1,3,33.3,0,1,1,1,0,0,0,0,0,3
../kbl_data/2021-2022,S39G01N22,수원 KT,Home,김현민,0,0,0,0.0,0,1,0.0,0,1,0.0,0,0,0.0,0,1,1,0,0,0,0,0,0,1
../kbl_data/2021-2022,S39G01N22,수원 KT,Home,김윤태,0,0,0,0.0,0,0,0.0,0,0,0.0,0,0,0.0,0,0,0,0,0,0,0,0,0,0
../kbl_data/2021-2022,S39G01N22,수원 KT,Home,최창진,0,0,0,0.0,0,0,0.0,0,0,0.0,0,0,0.0,0,0,0,0,0,0,0,0,0,0
../kbl_data/2021-2022,S39G01N22,수원 KT,Home,정성우,16,3,6,50.0,2,3,66.7,5,9,55.6,4,6,66.7,0,2,2,5,2,0,0,0,2,2
../kbl_data/2021-2022,S39G01N22,수원 KT,Home,양홍석,12,0,2,0.0,4,8,50.0,4,10,40.0,0,0,0.0,1,6,7,3,1,1,0,0,1,3
../kbl_data/2021-2022,S39G01N22,수원 KT,Home,박준영,0,0,0,0.0,0,0,0.0,0,0,0.0,0,0,0.0,0,0,0,0,0,0,0,0,0,0
../kbl_data/2021-2022,S39G01N22,수원 KT,Home,캐디 라렌,22,8,16,50.0,2,7,28.6,10,23,43.5,0,1,0.0,7,11,18,1,0,2,0,1,3,0
../kbl_data/2021-2022,S39G01N22,수원 KT,Home,박지원,0,0,1,0.0,0,3,0.0,0,4,0.0,0,0,0.0,0,2,2,2,0,0,0,0,0,2
../kbl_data/2021-2022,S39G01N22,수원 KT,Home,마이크 마이어스,4,2,3,66.7,0,0,0.0,2,3,66.7,0,0,0.0,2,3,5,1,0,0,0,0,1,1
../kbl_data/2021-2022,S39G01N22,수원 KT,Home,하윤기,4,1,2,50.0,0,0,0.0,1,2,50.0,2,2,100.0,1,4,5,1,0,1,0,0,1,0
../kbl_data/2021-2022,S39G01N22,고양 오리온,Away,김강선,9,0,1,0.0,2,7,28.6,2,8,25.0,3,3,100.0,0,0,0,2,2,0,0,0,0,0
../kbl_data/2021-2022,S39G01N22,고양 오리온,Away,최현민,2,1,2,50.0,0,0,0.0,1,2,50.0,0,0,0.0,1,0,1,1,0,0,0,0,0,1
../kbl_data/2021-2022,S39G01N22,고양 오리온,Away,이대성,10,2,9,22.2,2,4,50.0,4,13,30.8,0,0,0.0,1,4,5,1,0,0,0,0,1,2
../kbl_data/2021-2022,S39G01N22,고양 오리온,Away,한호빈,3,1,1,100.0,0,3,0.0,1,4,25.0,1,2,50.0,0,4,4,4,2,0,0,0,1,3
../kbl_data/2021-2022,S39G01N22,고양 오리온,Away,최승욱,0,0,0,0.0,0,0,0.0,0,0,0.0,0,0,0.0,0,0,0,1,0,0,0,0,0,0
../kbl_data/2021-2022,S39G01N22,고양 오리온,Away,이승현,12,6,15,40.0,0,2,0.0,6,17,35.3,0,0,0.0,1,4,5,3,0,1,0,0,1,0
../kbl_data/2021-2022,S39G01N22,고양 오리온,Away,이종현,0,0,0,0.0,0,0,0.0,0,0,0.0,0,0,0.0,0,2,2,0,0,0,0,0,1,0
../kbl_data/2021-2022,S39G01N22,고양 오리온,Away,김진유,0,0,0,0.0,0,0,0.0,0,0,0.0,0,0,0.0,0,0,0,0,0,0,0,0,0,2
../kbl_data/2021-2022,S39G01N22,고양 오리온,Away,머피 할로웨이,15,7,10,70.0,0,0,0.0,7,10,70.0,1,4,25.0,1,10,11,1,0,2,0,3,1,3
../kbl_data/2021-2022,S39G01N22,고양 오리온,Away,조한진,3,0,0,0.0,1,2,50.0,1,2,50.0,0,0,0.0,0,1,1,0,0,0,0,0,0,1
../kbl_data/2021-2022,S39G01N22,고양 오리온,Away,미로슬라브 라둘리차,5,1,4,25.0,1,3,33.3,2,7,28.6,0,0,0.0,4,4,8,2,1,0,0,0,5,2
../kbl_data/2021-2022,S39G01N22,고양 오리온,Away,이정현,3,0,3,0.0,1,1,100.0,1,4,25.0,0,0,0.0,0,0,0,2,2,0,0,0,0,4
../kbl_data/2021-2022,S39G01N23,울산 현대모비스,Home,이현민,0,0,1,0.0,0,2,0.0,0,3,0.0,0,0,0.0,1,0,1,3,0,0,0,0,0,1
../kbl_data/2021-2022,S39G01N23,울산 현대모비스,Home,함지훈,13,2,5,40.0,2,2,100.0,4,7,57.1,3,4,75.0,2,2,4,1,0,0,0,0,0,1
../kbl_data/2021-2022,S39G01N23,울산 현대모비스,Home,최진수,4,2,3,66.7,0,0,0.0,2,3,66.7,0,0,0.0,0,0,0,0,1,1,0,0,0,2
../kbl_data/2021-2022,S39G01N23,울산 현대모비스,Home,장재석,12,5,8,62.5,0,0,0.0,5,8,62.5,2,5,40.0,1,4,5,1,0,0,0,0,2,2
../kbl_data/2021-2022,S39G01N23,울산 현대모비스,Home,정성호,0,0,0,0.0,0,0,0.0,0,0,0.0,0,0,0.0,0,0,0,0,0,0,0,0,0,0
../kbl_data/2021-2022,S39G01N23,울산 현대모비스,Home,김영현,4,0,0,0.0,1,3,33.3,1,3,33.3,1,2,50.0,0,0,0,0,0,0,1,0,0,2
../kbl_data/2021-2022,S39G01N23,울산 현대모비스,Home,김수찬,0,0,0,0.0,0,0,0.0,0,0,0.0,0,0,0.0,0,0,0,0,0,0,0,0,0,0
../kbl_data/2021-2022,S39G01N23,울산 현대모비스,Home,서명진,15,3,6,50.0,3,5,60.0,6,11,54.5,0,0,0.0,0,3,3,5,1,0,0,0,4,1
../kbl_data/2021-2022,S39G01N23,울산 현대모비스,Home,얼 클락,4,1,8,12.5,0,0,0.0,1,8,12.5,2,2,100.0,1,3,4,0,0,2,0,0,1,1
../kbl_data/2021-2022,S39G01N23,울산 현대모비스,Home,이우석,4,2,4,50.0,0,0,0.0,2,4,50.0,0,0,0.0,0,1,1,1,0,1,0,0,0,4
../kbl_data/2021-2022,S39G01N23,울산 현대모비스,Home,라숀 토마스,7,2,6,33.3,0,0,0.0,2,6,33.3,3,4,75.0,1,3,4,1,1,0,0,0,2,5
../kbl_data/2021-2022,S39G01N23,울산 현대모비스,Home,신민석,13,2,3,66.7,3,7,42.9,5,10,50.0,0,0,0.0,1,3,4,0,0,0,0,0,0,1
../kbl_data/2021-2022,S39G01N23,서울 삼성,Away,장민국,0,0,4,0.0,0,3,0.0,0,7,0.0,0,0,0.0,1,1,2,0,0,0,0,0,0,5
../kbl_data/2021-2022,S39G01N23,서울 삼성,Away,김시래,10,3,8,37.5,0,2,0.0,3,10,30.0,4,4,100.0,0,3,3,14,2,0,0,0,4,2
../kbl_data/2021-2022,S39G01N23,서울 삼성,Away,김현수,2,1,3,33.3,0,2,0.0,1,5,20.0,0,0,0.0,0,3,3,0,0,0,0,0,1,0
../kbl_data/2021-2022,S39G01N23,서울 삼성,Away,임동섭,6,3,4,75.0,0,2,0.0,3,6,50.0,0,0,0.0,1,5,6,1,0,0,0,0,0,4
../kbl_data/2021-2022,S39G01N23,서울 삼성,Away,이동엽,9,3,5,60.0,0,1,0.0,3,6,50.0,3,6,50.0,2,4,6,3,1,0,0,0,0,1
../kbl_data/2021-2022,S39G01N23,서울 삼성,Away,배수용,0,0,0,0.0,0,0,0.0,0,0,0.0,0,0,0.0,0,0,0,0,0,0,0,0,0,0
../kbl_data/2021-2022,S39G01N23,서울 삼성,Away,이호현,0,0,0,0.0,0,0,0.0,0,0,0.0,0,0,0.0,0,0,0,0,0,0,0,0,0,0
../kbl_data/2021-2022,S39G01N23,서울 삼성,Away,아이제아 힉스,29,11,14,78.6,0,0,0.0,11,14,78.6,7,8,87.5,5,3,8,2,0,2,0,2,1,4
../kbl_data/2021-2022,S39G01N23,서울 삼성,Away,차민석,7,1,6,16.7,1,3,33.3,2,9,22.2,2,2,100.0,2,1,3,0,0,0,0,0,1,1
../kbl_data/2021-2022,S39G01N23,서울 삼성,Away,전형준,0,0,0,0.0,0,0,0.0,0,0,0.0,0,0,0.0,0,0,0,0,0,0,0,0,0,0
../kbl_data/2021-2022,S39G01N23,서울 삼성,Away,다니엘 오셰푸,8,4,6,66.7,0,0,0.0,4,6,66.7,0,0,0.0,3,4,7,0,1,0,0,1,0,1
../kbl_data/2021-2022,S39G01N23,서울 삼성,Away,이원석,10,3,4,75.0,1,1,100.0,4,5,80.0,1,1,100.0,1,3,4,0,1,0,0,0,0,3
../kbl_data/2021-2022,S39G01N24,대구 한국가스공사,Home,정영삼,0,0,0,0.0,0,1,0.0,0,1,0.0,0,0,0.0,1,0,1,0,0,0,0,0,0,0
../kbl_data/2021-2022,S39G01N24,대구 한국가스공사,Home,민성주,0,0,0,0.0,0,0,0.0,0,0,0.0,0,0,0.0,0,0,0,0,0,0,0,0,0,0
../kbl_data/2021-2022,S39G01N24,대구 한국가스공사,Home,차바위,5,1,3,33.3,1,3,33.3,2,6,33.3,0,0,0.0,1,2,3,0,0,0,1,0,1,5
../kbl_data/2021-2022,S39G01N24,대구 한국가스공사,Home,조상열,0,0,0,0.0,0,0,0.0,0,0,0.0,0,0,0.0,0,0,0,0,0,0,0,0,0,0
../kbl_data/2021-2022,S39G01N24,대구 한국가스공사,Home,이대헌,8,3,4,75.0,0,2,0.0,3,6,50.0,2,4,50.0,4,4,8,2,1,0,0,0,3,3
../kbl_data/2021-2022,S39G01N24,대구 한국가스공사,Home,두경민,15,3,4,75.0,2,8,25.0,5,12,41.7,3,4,75.0,3,3,6,3,2,0,0,0,6,3
../kbl_data/2021-2022,S39G01N24,대구 한국가스공사,Home,임준수,0,0,0,0.0,0,0,0.0,0,0,0.0,0,0,0.0,0,0,0,0,0,0,0,0,0,0
../kbl_data/2021-2022,S39G01N24,대구 한국가스공사,Home,김낙현,8,2,3,66.7,0,6,0.0,2,9,22.2,4,6,66.7,1,1,2,4,0,0,0,0,3,3
../kbl_data/2021-2022,S39G01N24,대구 한국가스공사,Home,전현우,20,2,4,50.0,5,7,71.4,7,11,63.6,1,1,100.0,0,0,0,2,0,0,0,0,1,1
../kbl_data/2021-2022,S39G01N24,대구 한국가스공사,Home,클리프 알렉산더,6,3,6,50.0,0,0,0.0,3,6,50.0,0,0,0.0,1,4,5,3,0,1,0,1,0,3
../kbl_data/2021-2022,S39G01N24,대구 한국가스공사,Home,앤드류 니콜슨,10,4,9,44.4,0,3,0.0,4,12,33.3,2,2,100.0,0,7,7,0,0,0,0,0,0,1
../kbl_data/2021-2022,S39G01N24,대구 한국가스공사,Home,신승민,1,0,0,0.0,0,0,0.0,0,0,0.0,1,2,50.0,1,0,1,1,0,0,0,0,0,4
../kbl_data/2021-2022,S39G01N24,창원 LG,Away,강병현,0,0,0,0.0,0,1,0.0,0,1,0.0,0,0,0.0,1,0,1,1,0,0,0,0,1,2
../kbl_data/2021-2022,S39G01N24,창원 LG,Away,이관희,12,4,9,44.4,0,2,0.0,4,11,36.4,4,4,100.0,1,4,5,6,3,0,0,0,0,2
../kbl_data/2021-2022,S39G01N24,창원 LG,Away,정희재,5,1,1,100.0,1,2,50.0,2,3,66.7,0,0,0.0,0,2,2,0,0,0,0,0,0,5
../kbl_data/2021-2022,S39G01N24,창원 LG,Away,서민수,15,1,2,50.0,4,7,57.1,5,9,55.6,1,1,100.0,0,3,3,3,1,0,0,0,0,2
../kbl_data/2021-2022,S39G01N24,창원 LG,Away,이재도,14,1,3,33.3,3,9,33.3,4,12,33.3,3,4,75.0,1,3,4,4,3,0,0,0,3,1
../kbl_data/2021-2022,S39G01N24,창원 LG,Away,정해원,5,1,1,100.0,1,2,50.0,2,3,66.7,0,0,0.0,3,1,4,0,0,0,0,0,0,3
../kbl_data/2021-2022,S39G01N24,창원 LG,Away,박정현,6,3,5,60.0,0,0,0.0,3,5,60.0,0,2,0.0,2,0,2,1,0,0,0,0,1,3
../kbl_data/2021-2022,S39G01N24,창원 LG,Away,이광진,0,0,0,0.0,0,0,0.0,0,0,0.0,0,0,0.0,0,1,1,0,0,0,0,0,0,0
../kbl_data/2021-2022,S39G01N24,창원 LG,Away,윤원상,5,1,2,50.0,1,3,33.3,2,5,40.0,0,0,0.0,0,0,0,0,0,0,0,0,0,0
../kbl_data/2021-2022,S39G01N24,창원 LG,Away,압둘 말릭 아부,10,5,6,83.3,0,1,0.0,5,7,71.4,0,1,0.0,0,3,3,0,1,2,0,2,1,3
../kbl_data/2021-2022,S39G01N24,창원 LG,Away,아셈 마레이,16,5,11,45.5,0,1,0.0,5,12,41.7,6,8,75.0,9,7,16,3,3,0,0,0,2,2
../kbl_data/2021-2022,S39G01N24,창원 LG,Away,이승우,4,1,2,50.0,0,2,0.0,1,4,25.0,2,2,100.0,0,2,2,0,0,0,0,0,1,2
../kbl_data/2021-2022,S39G01N25,안양 KGC,Home,박형철,0,0,0,0.0,0,1,0.0,0,1,0.0,0,0,0.0,0,1,1,1,0,0,0,0,1,5
../kbl_data/2021-2022,S39G01N25,안양 KGC,Home,함준후,4,2,3,66.7,0,3,0.0,2,6,33.3,0,0,0.0,0,1,1,0,0,0,2,0,0,1
../kbl_data/2021-2022,S39G01N25,안양 KGC,Home,오세근,23,10,12,83.3,1,1,100.0,11,13,84.6,0,0,0.0,2,3,5,0,0,0,0,0,0,4
../kbl_data/2021-2022,S39G01N25,안양 KGC,Home,문성곤,7,3,3,100.0,0,4,0.0,3,7,42.9,1,4,25.0,1,3,4,5,2,0,0,0,1,2
../kbl_data/2021-2022,S39G01N25,안양 KGC,Home,전성현,22,4,7,57.1,3,6,50.0,7,13,53.8,5,6,83.3,1,1,2,5,4,0,0,0,1,3
../kbl_data/2021-2022,S39G01N25,안양 KGC,Home,정강호,0,0,0,0.0,0,0,0.0,0,0,0.0,0,0,0.0,0,0,0,0,0,0,0,0,0,0
../kbl_data/2021-2022,S39G01N25,안양 KGC,Home,이우정,3,0,1,0.0,1,1,100.0,1,2,50.0,0,0,0.0,0,0,0,0,0,0,0,0,0,2
../kbl_data/2021-2022,S39G01N25,안양 KGC,Home,대릴 먼로,8,3,5,60.0,0,0,0.0,3,5,60.0,2,2,100.0,2,3,5,4,1,0,0,0,0,0
../kbl_data/2021-2022,S39G01N25,안양 KGC,Home,변준형,11,2,2,100.0,2,5,40.0,4,7,57.1,1,2,50.0,0,2,2,5,1,0,0,0,5,4
../kbl_data/2021-2022,S39G01N25,안양 KGC,Home,한승희,4,1,2,50.0,0,0,0.0,1,2,50.0,2,2,100.0,2,1,3,1,0,0,0,0,2,3
../kbl_data/2021-2022,S39G01N25,안양 KGC,Home,양승면,0,0,0,0.0,0,0,0.0,0,0,0.0,0,0,0.0,0,0,0,0,0,0,0,0,0,0
../kbl_data/2021-2022,S39G01N25,안양 KGC,Home,오마리 스펠맨,22,6,9,66.7,3,7,42.9,9,16,56.2,1,3,33.3,1,7,8,4,1,2,0,3,3,2
../kbl_data/2021-2022,S39G01N25,서울 SK,Away,양우섭,0,0,0,0.0,0,1,0.0,0,1,0.0,0,0,0.0,1,1,2,2,0,0,0,0,2,0
../kbl_data/2021-2022,S39G01N25,서울 SK,Away,허일영,7,2,2,100.0,1,1,100.0,3,3,100.0,0,0,0.0,1,1,2,0,0,0,0,0,1,4
../kbl_data/2021-2022,S39G01N25,서울 SK,Away,김선형,12,2,13,15.4,1,3,33.3,3,16,18.8,5,7,71.4,1,4,5,6,1,0,0,0,5,2
../kbl_data/2021-2022,S39G01N25,서울 SK,Away,최부경,2,1,1,100.0,0,0,0.0,1,1,100.0,0,2,0.0,1,1,2,1,0,0,0,0,0,1
../kbl_data/2021-2022,S39G01N25,서울 SK,Away,리온 윌리엄스,7,1,2,50.0,1,1,100.0,2,3,66.7,2,2,100.0,1,1,2,0,1,0,0,0,0,1
../kbl_data/2021-2022,S39G01N25,서울 SK,Away,이현석,0,0,0,0.0,0,0,0.0,0,0,0.0,0,0,0.0,0,0,0,1,0,0,0,0,0,1
../kbl_data/2021-2022,S39G01N25,서울 SK,Away,최원혁,2,1,2,50.0,0,1,0.0,1,3,33.3,0,0,0.0,1,0,1,1,0,0,0,0,0,2
../kbl_data/2021-2022,S39G01N25,서울 SK,Away,최준용,23,7,13,53.8,1,3,33.3,8,16,50.0,6,7,85.7,1,5,6,4,3,1,0,0,1,0
../kbl_data/2021-2022,S39G01N25,서울 SK,Away,안영준,22,4,8,50.0,4,6,66.7,8,14,57.1,2,2,100.0,5,2,7,0,3,0,0,0,0,2
../kbl_data/2021-2022,S39G01N25,서울 SK,Away,자밀 워니,21,9,17,52.9,0,0,0.0,9,17,52.9,3,4,75.0,3,7,10,1,1,0,0,0,2,3
../kbl_data/2021-2022,S39G01N25,서울 SK,Away,김형빈,0,0,0,0.0,0,0,0.0,0,0,0.0,0,0,0.0,0,0,0,0,0,0,0,0,0,0
../kbl_data/2021-2022,S39G01N25,서울 SK,Away,오재현,3,0,1,0.0,1,2,50.0,1,3,33.3,0,0,0.0,0,0,0,1,1,0,0,0,1,3
../kbl_data/2021-2022,S39G01N26,원주 DB,Home,윤호영,8,1,1,100.0,2,2,100.0,3,3,100.0,0,0,0.0,2,1,3,3,0,1,0,0,1,0
../kbl_data/2021-2022,S39G01N26,원주 DB,Home,박찬희,9,1,8,12.5,1,1,100.0,2,9,22.2,4,6,66.7,1,2,3,6,0,0,0,0,1,0
../kbl_data/2021-2022,S39G01N26,원주 DB,Home,김종규,20,7,10,70.0,0,2,0.0,7,12,58.3,6,7,85.7,3,8,11,2,0,2,0,1,0,2
../kbl_data/2021-2022,S39G01N26,원주 DB,Home,허웅,13,3,6,50.0,2,5,40.0,5,11,45.5,1,2,50.0,3,2,5,4,2,0,0,0,2,1
../kbl_data/2021-2022,S39G01N26,원주 DB,Home,김영훈,0,0,0,0.0,0,2,0.0,0,2,0.0,0,0,0.0,0,1,1,0,0,0,0,0,0,2
../kbl_data/2021-2022,S39G01N26,원주 DB,Home,배강률,0,0,0,0.0,0,0,0.0,0,0,0.0,0,0,0.0,0,2,2,0,0,0,0,0,0,1
../kbl_data/2021-2022,S39G01N26,원주 DB,Home,김철욱,0,0,1,0.0,0,2,0.0,0,3,0.0,0,0,0.0,0,0,0,0,0,1,0,0,2,3
../kbl_data/2021-2022,S39G01N26,원주 DB,Home,박상권,0,0,0,0.0,0,0,0.0,0,0,0.0,0,0,0.0,0,0,0,0,0,0,0,0,0,0
../kbl_data/2021-2022,S39G01N26,원주 DB,Home,김훈,0,0,1,0.0,0,0,0.0,0,1,0.0,0,0,0.0,1,1,2,0,0,0,0,0,0,2
../kbl_data/2021-2022,S39G01N26,원주 DB,Home,나카무라 타이치,7,0,2,0.0,1,4,25.0,1,6,16.7,4,4,100.0,0,4,4,3,0,0,0,0,1,2
../kbl_data/2021-2022,S39G01N26,원주 DB,Home,레나드 프리먼,14,4,10,40.0,0,1,0.0,4,11,36.4,6,6,100.0,1,7,8,2,2,1,0,0,1,3
../kbl_data/2021-2022,S39G01N26,원주 DB,Home,정호영,4,2,6,33.3,0,2,0.0,2,8,25.0,0,0,0.0,1,5,6,1,0,0,0,0,2,4
../kbl_data/2021-2022,S39G01N26,서울 삼성,Away,장민국,0,0,2,0.0,0,1,0.0,0,3,0.0,0,0,0.0,0,2,2,0,1,0,0,0,0,2
../kbl_data/2021-2022,S39G01N26,서울 삼성,Away,김시래,15,2,7,28.6,1,1,100.0,3,8,37.5,8,8,100.0,0,5,5,4,0,0,0,0,1,3
../kbl_data/2021-2022,S39G01N26,서울 삼성,Away,김현수,2,1,3,33.3,0,4,0.0,1,7,14.3,0,0,0.0,0,2,2,1,0,0,0,0,1,1
../kbl_data/2021-2022,S39G01N26,서울 삼성,Away,임동섭,17,0,5,0.0,5,11,45.5,5,16,31.2,2,2,100.0,2,5,7,2,0,0,0,0,1,1
../kbl_data/2021-2022,S39G01N26,서울 삼성,Away,이동엽,1,0,5,0.0,0,2,0.0,0,7,0.0,1,2,50.0,4,4,8,3,1,0,0,0,1,4
../kbl_data/2021-2022,S39G01N26,서울 삼성,Away,배수용,0,0,0,0.0,0,0,0.0,0,0,0.0,0,0,0.0,0,0,0,0,0,0,0,0,0,0
../kbl_data/2021-2022,S39G01N26,서울 삼성,Away,이호현,0,0,0,0.0,0,0,0.0,0,0,0.0,0,0,0.0,0,0,0,0,0,0,0,0,0,0
../kbl_data/2021-2022,S39G01N26,서울 삼성,Away,아이제아 힉스,18,6,15,40.0,0,2,0.0,6,17,35.3,6,8,75.0,4,3,7,0,3,1,0,1,1,4
../kbl_data/2021-2022,S39G01N26,서울 삼성,Away,차민석,4,0,1,0.0,1,1,100.0,1,2,50.0,1,2,50.0,1,0,1,1,0,1,0,0,0,3
../kbl_data/2021-2022,S39G01N26,서울 삼성,Away,전형준,0,0,0,0.0,0,0,0.0,0,0,0.0,0,0,0.0,0,0,0,0,0,0,0,0,0,0
../kbl_data/2021-2022,S39G01N26,서울 삼성,Away,다니엘 오셰푸,2,1,4,25.0,0,0,0.0,1,4,25.0,0,0,0.0,1,4,5,0,0,0,0,0,0,1
../kbl_data/2021-2022,S39G01N26,서울 삼성,Away,이원석,7,3,6,50.0,0,2,0.0,3,8,37.5,1,2,50.0,2,4,6,1,1,1,0,1,3,3
../kbl_data/2021-2022,S39G01N27,대구 한국가스공사,Home,정영삼,0,0,0,0.0,0,2,0.0,0,2,0.0,0,0,0.0,0,0,0,0,0,0,0,0,0,3
../kbl_data/2021-2022,S39G01N27,대구 한국가스공사,Home,민성주,0,0,0,0.0,0,0,0.0,0,0,0.0,0,0,0.0,0,0,0,0,0,0,0,0,0,0
../kbl_data/2021-2022,S39G01N27,대구 한국가스공사,Home,차바위,4,2,2,100.0,0,2,0.0,2,4,50.0,0,0,0.0,3,4,7,5,0,0,0,0,2,5
../kbl_data/2021-2022,S39G01N27,대구 한국가스공사,Home,조상열,2,1,4,25.0,0,2,0.0,1,6,16.7,0,0,0.0,1,0,1,0,0,0,0,0,1,1
../kbl_data/2021-2022,S39G01N27,대구 한국가스공사,Home,이대헌,12,5,10,50.0,0,1,0.0,5,11,45.5,2,5,40.0,2,4,6,4,0,0,0,0,2,0
../kbl_data/2021-2022,S39G01N27,대구 한국가스공사,Home,임준수,0,0,0,0.0,0,0,0.0,0,0,0.0,0,0,0.0,0,0,0,0,0,0,0,0,0,0
../kbl_data/2021-2022,S39G01N27,대구 한국가스공사,Home,김낙현,9,1,5,20.0,2,6,33.3,3,11,27.3,1,2,50.0,0,2,2,2,0,1,0,0,3,3
../kbl_data/2021-2022,S39G01N27,대구 한국가스공사,Home,전현우,2,1,4,25.0,0,2,0.0,1,6,16.7,0,0,0.0,0,2,2,0,1,0,0,0,0,4
../kbl_data/2021-2022,S39G01N27,대구 한국가스공사,Home,양준우,3,0,1,0.0,1,1,100.0,1,2,50.0,0,0,0.0,0,1,1,0,0,0,0,0,0,1
../kbl_data/2021-2022,S39G01N27,대구 한국가스공사,Home,클리프 알렉산더,4,2,2,100.0,0,0,0.0,2,2,100.0,0,0,0.0,2,2,4,0,1,0,0,0,0,2
../kbl_data/2021-2022,S39G01N27,대구 한국가스공사,Home,앤드류 니콜슨,29,7,17,41.2,4,6,66.7,11,23,47.8,3,6,50.0,0,12,12,2,1,0,1,2,3,1
../kbl_data/2021-2022,S39G01N27,대구 한국가스공사,Home,신승민,2,1,1,100.0,0,0,0.0,1,1,100.0,0,0,0.0,0,1,1,0,0,0,0,0,0,3
../kbl_data/2021-2022,S39G01N27,전주 KCC,Away,송창용,3,1,1,100.0,0,0,0.0,1,1,100.0,1,2,50.0,0,0,0,0,0,0,0,0,0,1
../kbl_data/2021-2022,S39G01N27,전주 KCC,Away,이정현,16,2,5,40.0,1,2,50.0,3,7,42.9,9,10,90.0,0,6,6,3,1,0,0,0,2,4
../kbl_data/2021-2022,S39G01N27,전주 KCC,Away,라건아,6,3,8,37.5,0,0,0.0,3,8,37.5,0,0,0.0,5,3,8,2,0,1,0,1,0,3
../kbl_data/2021-2022,S39G01N27,전주 KCC,Away,김지완,2,1,3,33.3,0,6,0.0,1,9,11.1,0,0,0.0,0,0,0,2,0,0,1,0,1,0
../kbl_data/2021-2022,S39G01N27,전주 KCC,Away,김상규,0,0,0,0.0,0,2,0.0,0,2,0.0,0,0,0.0,1,2,3,0,0,0,0,0,1,1
../kbl_data/2021-2022,S39G01N27,전주 KCC,Away,유병훈,0,0,0,0.0,0,0,0.0,0,0,0.0,0,0,0.0,0,0,0,1,0,0,0,0,0,0
../kbl_data/2021-2022,S39G01N27,전주 KCC,Away,전준범,10,0,1,0.0,3,8,37.5,3,9,33.3,1,2,50.0,1,4,5,0,1,1,0,0,0,2
../kbl_data/2021-2022,S39G01N27,전주 KCC,Away,송교창,6,3,7,42.9,0,5,0.0,3,12,25.0,0,2,0.0,2,5,7,3,1,0,0,0,2,1
../kbl_data/2021-2022,S39G01N27,전주 KCC,Away,이진욱,0,0,1,0.0,0,1,0.0,0,2,0.0,0,0,0.0,1,0,1,1,0,0,0,0,0,4
../kbl_data/2021-2022,S39G01N27,전주 KCC,Away,유현준,12,1,2,50.0,2,6,33.3,3,8,37.5,4,4,100.0,0,2,2,5,2,0,0,0,2,1
../kbl_data/2021-2022,S39G01N27,전주 KCC,Away,라타비우스 윌리엄스,13,5,6,83.3,0,0,0.0,5,6,83.3,3,4,75.0,2,8,10,0,0,0,0,0,0,3
../kbl_data/2021-2022,S39G01N27,전주 KCC,Away,김동현,0,0,0,0.0,0,0,0.0,0,0,0.0,0,0,0.0,0,0,0,0,0,0,0,0,0,0
../kbl_data/2021-2022,S39G01N28,창원 LG,Home,강병현,3,0,0,0.0,1,2,50.0,1,2,50.0,0,2,0.0,0,0,0,0,0,0,0,0,1,2
../kbl_data/2021-2022,S39G01N28,창원 LG,Home,이관희,12,2,9,22.2,1,6,16.7,3,15,20.0,5,6,83.3,2,3,5,3,1,1,0,0,1,2
../kbl_data/2021-2022,S39G01N28,창원 LG,Home,정희재,12,1,2,50.0,3,7,42.9,4,9,44.4,1,2,50.0,1,2,3,2,2,0,0,0,1,4
../kbl_data/2021-2022,S39G01N28,창원 LG,Home,서민수,13,4,5,80.0,1,4,25.0,5,9,55.6,2,2,100.0,2,1,3,1,1,0,0,0,0,5
../kbl_data/2021-2022,S39G01N28,창원 LG,Home,이재도,3,0,1,0.0,1,6,16.7,1,7,14.3,0,0,0.0,2,5,7,9,0,0,0,0,2,2
../kbl_data/2021-2022,S39G01N28,창원 LG,Home,정해원,0,0,0,0.0,0,0,0.0,0,0,0.0,0,0,0.0,0,0,0,0,0,0,0,0,0,0
../kbl_data/2021-2022,S39G01N28,창원 LG,Home,박정현,0,0,3,0.0,0,0,0.0,0,3,0.0,0,0,0.0,0,2,2,0,1,0,0,0,1,4
../kbl_data/2021-2022,S39G01N28,창원 LG,Home,이광진,0,0,0,0.0,0,1,0.0,0,1,0.0,0,0,0.0,0,1,1,0,0,0,0,0,0,1
../kbl_data/2021-2022,S39G01N28,창원 LG,Home,윤원상,0,0,0,0.0,0,0,0.0,0,0,0.0,0,0,0.0,0,0,0,0,0,0,0,0,1,0
../kbl_data/2021-2022,S39G01N28,창원 LG,Home,압둘 말릭 아부,4,2,3,66.7,0,1,0.0,2,4,50.0,0,0,0.0,0,1,1,0,0,0,0,0,1,0
../kbl_data/2021-2022,S39G01N28,창원 LG,Home,아셈 마레이,30,14,21,66.7,0,0,0.0,14,21,66.7,2,5,40.0,9,7,16,3,0,1,0,0,0,2
../kbl_data/2021-2022,S39G01N28,창원 LG,Home,이승우,4,2,2,100.0,0,0,0.0,2,2,100.0,0,0,0.0,1,2,3,0,0,0,0,0,0,2
../kbl_data/2021-2022,S39G01N28,안양 KGC,Away,함준후,2,1,1,100.0,0,0,0.0,1,1,100.0,0,0,0.0,0,0,0,1,2,1,0,0,0,5
../kbl_data/2021-2022,S39G01N28,안양 KGC,Away,오세근,17,6,13,46.2,0,0,0.0,6,13,46.2,5,5,100.0,2,2,4,0,0,1,0,0,0,4
../kbl_data/2021-2022,S39G01N28,안양 KGC,Away,문성곤,10,2,2,100.0,2,2,100.0,4,4,100.0,0,0,0.0,1,7,8,3,2,1,0,0,3,4
../kbl_data/2021-2022,S39G01N28,안양 KGC,Away,전성현,18,3,5,60.0,2,6,33.3,5,11,45.5,6,7,85.7,0,4,4,1,0,0,0,0,0,3
../kbl_data/2021-2022,S39G01N28,안양 KGC,Away,정강호,0,0,0,0.0,0,0,0.0,0,0,0.0,0,0,0.0,0,0,0,0,0,0,0,0,0,0
../kbl_data/2021-2022,S39G01N28,안양 KGC,Away,이우정,0,0,0,0.0,0,2,0.0,0,2,0.0,0,0,0.0,2,0,2,0,0,0,0,0,0,2
../kbl_data/2021-2022,S39G01N28,안양 KGC,Away,대릴 먼로,5,0,1,0.0,1,2,50.0,1,3,33.3,2,2,100.0,1,2,3,2,0,0,0,0,1,2
../kbl_data/2021-2022,S39G01N28,안양 KGC,Away,우동현,0,0,0,0.0,0,0,0.0,0,0,0.0,0,0,0.0,0,0,0,0,0,0,0,0,0,0
../kbl_data/2021-2022,S39G01N28,안양 KGC,Away,변준형,17,5,9,55.6,1,4,25.0,6,13,46.2,4,6,66.7,1,1,2,3,3,0,0,0,2,3
../kbl_data/2021-2022,S39G01N28,안양 KGC,Away,한승희,2,1,1,100.0,0,0,0.0,1,1,100.0,0,0,0.0,1,0,1,0,0,0,0,0,0,0
../kbl_data/2021-2022,S39G01N28,안양 KGC,Away,양승면,0,0,0,0.0,0,0,0.0,0,0,0.0,0,0,0.0,0,0,0,0,0,0,0,0,0,0
../kbl_data/2021-2022,S39G01N28,안양 KGC,Away,오마리 스펠맨,15,4,8,50.0,2,8,25.0,6,16,37.5,1,2,50.0,1,6,7,5,0,0,0,1,0,0
../kbl_data/2021-2022,S39G01N29,수원 KT,Home,김동욱,6,0,2,0.0,2,6,33.3,2,8,25.0,0,0,0.0,1,1,2,2,1,0,0,0,2,0
../kbl_data/2021-2022,S39G01N29,수원 KT,Home,김영환,14,2,3,66.7,3,8,37.5,5,11,45.5,1,1,100.0,3,1,4,1,0,1,0,0,2,4
../kbl_data/2021-2022,S39G01N29,수원 KT,Home,김현민,1,0,0,0.0,0,0,0.0,0,0,0.0,1,2,50.0,1,0,1,0,0,0,0,0,0,1
../kbl_data/2021-2022,S39G01N29,수원 KT,Home,김윤태,0,0,0,0.0,0,0,0.0,0,0,0.0,0,0,0.0,0,0,0,0,0,0,0,0,0,0
../kbl_data/2021-2022,S39G01N29,수원 KT,Home,최창진,0,0,0,0.0,0,0,0.0,0,0,0.0,0,0,0.0,0,0,0,0,0,0,0,0,0,1
../kbl_data/2021-2022,S39G01N29,수원 KT,Home,정성우,12,3,7,42.9,2,5,40.0,5,12,41.7,0,0,0.0,2,2,4,5,3,0,0,0,4,4
../kbl_data/2021-2022,S39G01N29,수원 KT,Home,양홍석,16,3,4,75.0,3,5,60.0,6,9,66.7,1,2,50.0,5,1,6,7,0,0,0,0,2,4
../kbl_data/2021-2022,S39G01N29,수원 KT,Home,박준영,0,0,0,0.0,0,0,0.0,0,0,0.0,0,0,0.0,0,1,1,0,0,0,0,0,0,2
../kbl_data/2021-2022,S39G01N29,수원 KT,Home,캐디 라렌,14,4,13,30.8,1,7,14.3,5,20,25.0,3,6,50.0,5,9,14,1,1,1,0,0,1,1
../kbl_data/2021-2022,S39G01N29,수원 KT,Home,박지원,2,1,5,20.0,0,0,0.0,1,5,20.0,0,0,0.0,0,0,0,1,1,0,0,0,0,1
../kbl_data/2021-2022,S39G01N29,수원 KT,Home,마이크 마이어스,2,1,2,50.0,0,0,0.0,1,2,50.0,0,0,0.0,1,2,3,2,0,0,0,0,1,0
../kbl_data/2021-2022,S39G01N29,수원 KT,Home,하윤기,9,4,7,57.1,0,0,0.0,4,7,57.1,1,2,50.0,2,6,8,0,1,0,0,0,1,2
../kbl_data/2021-2022,S39G01N29,서울 SK,Away,허일영,0,0,1,0.0,0,2,0.0,0,3,0.0,0,0,0.0,0,2,2,0,0,0,0,0,0,3
../kbl_data/2021-2022,S39G01N29,서울 SK,Away,김선형,22,6,11,54.5,3,6,50.0,9,17,52.9,1,2,50.0,0,1,1,5,1,1,1,0,2,2
../kbl_data/2021-2022,S39G01N29,서울 SK,Away,최부경,2,1,4,25.0,0,0,0.0,1,4,25.0,0,0,0.0,1,3,4,0,0,0,0,0,0,4
../kbl_data/2021-2022,S39G01N29,서울 SK,Away,리온 윌리엄스,1,0,2,0.0,0,0,0.0,0,2,0.0,1,2,50.0,0,1,1,0,0,0,0,0,1,0
../kbl_data/2021-2022,S39G01N29,서울 SK,Away,이원대,0,0,0,0.0,0,0,0.0,0,0,0.0,0,0,0.0,0,0,0,0,0,0,0,0,2,0
../kbl_data/2021-2022,S39G01N29,서울 SK,Away,이현석,0,0,0,0.0,0,0,0.0,0,0,0.0,0,0,0.0,0,0,0,0,0,0,0,0,0,2
../kbl_data/2021-2022,S39G01N29,서울 SK,Away,최원혁,0,0,0,0.0,0,0,0.0,0,0,0.0,0,0,0.0,0,1,1,2,1,0,0,0,0,0
../kbl_data/2021-2022,S39G01N29,서울 SK,Away,최준용,28,9,16,56.2,2,4,50.0,11,20,55.0,4,5,80.0,4,8,12,5,0,1,0,1,3,2
../kbl_data/2021-2022,S39G01N29,서울 SK,Away,장문호,0,0,0,0.0,0,0,0.0,0,0,0.0,0,0,0.0,0,0,0,0,0,0,0,0,0,0
../kbl_data/2021-2022,S39G01N29,서울 SK,Away,안영준,13,2,4,50.0,2,4,50.0,4,8,50.0,3,6,50.0,0,3,3,2,1,0,0,0,1,2
../kbl_data/2021-2022,S39G01N29,서울 SK,Away,자밀 워니,15,6,12,50.0,0,0,0.0,6,12,50.0,3,4,75.0,7,7,14,1,3,1,0,0,1,3
../kbl_data/2021-2022,S39G01N29,서울 SK,Away,오재현,0,0,0,0.0,0,0,0.0,0,0,0.0,0,0,0.0,0,0,0,0,0,0,0,0,0,0
../kbl_data/2021-2022,S39G01N30,울산 현대모비스,Home,이현민,2,0,1,0.0,0,0,0.0,0,1,0.0,2,2,100.0,0,0,0,2,1,0,0,0,1,1
../kbl_data/2021-2022,S39G01N30,울산 현대모비스,Home,함지훈,4,2,4,50.0,0,2,0.0,2,6,33.3,0,2,0.0,3,2,5,1,1,0,0,0,1,1
../kbl_data/2021-2022,S39G01N30,울산 현대모비스,Home,최진수,0,0,0,0.0,0,0,0.0,0,0,0.0,0,0,0.0,0,0,0,0,0,0,0,0,1,0
../kbl_data/2021-2022,S39G01N30,울산 현대모비스,Home,장재석,8,4,6,66.7,0,0,0.0,4,6,66.7,0,0,0.0,0,2,2,0,2,1,0,0,1,3
../kbl_data/2021-2022,S39G01N30,울산 현대모비스,Home,정성호,3,0,0,0.0,1,4,25.0,1,4,25.0,0,0,0.0,0,0,0,2,1,1,0,0,0,0
../kbl_data/2021-2022,S39G01N30,울산 현대모비스,Home,김수찬,3,0,0,0.0,1,2,50.0,1,2,50.0,0,0,0.0,0,0,0,0,0,0,0,0,0,1
../kbl_data/2021-2022,S39G01N30,울산 현대모비스,Home,서명진,5,1,3,33.3,1,5,20.0,2,8,25.0,0,0,0.0,0,1,1,2,0,0,0,0,3,0
../kbl_data/2021-2022,S39G01N30,울산 현대모비스,Home,얼 클락,10,5,12,41.7,0,3,0.0,5,15,33.3,0,0,0.0,5,2,7,3,1,0,0,0,2,0
../kbl_data/2021-2022,S39G01N30,울산 현대모비스,Home,이우석,8,4,6,66.7,0,2,0.0,4,8,50.0,0,0,0.0,2,2,4,2,2,0,0,0,1,2
../kbl_data/2021-2022,S39G01N30,울산 현대모비스,Home,라숀 토마스,18,7,16,43.8,0,0,0.0,7,16,43.8,4,6,66.7,5,8,13,1,1,0,1,1,4,4
../kbl_data/2021-2022,S39G01N30,울산 현대모비스,Home,신민석,3,0,2,0.0,1,6,16.7,1,8,12.5,0,0,0.0,2,2,4,2,1,0,0,0,1,2
../kbl_data/2021-2022,S39G01N30,울산 현대모비스,Home,김동준,3,0,0,0.0,1,2,50.0,1,2,50.0,0,0,0.0,0,0,0,1,0,0,0,0,1,0
../kbl_data/2021-2022,S39G01N30,고양 오리온,Away,김강선,6,0,2,0.0,2,4,50.0,2,6,33.3,0,0,0.0,0,2,2,0,0,0,0,0,1,2
../kbl_data/2021-2022,S39G01N30,고양 오리온,Away,최현민,8,2,3,66.7,1,1,100.0,3,4,75.0,1,1,100.0,0,0,0,0,1,0,0,0,2,2
../kbl_data/2021-2022,S39G01N30,고양 오리온,Away,이대성,10,3,6,50.0,1,1,100.0,4,7,57.1,1,1,100.0,0,2,2,6,2,0,0,0,3,1
../kbl_data/2021-2022,S39G01N30,고양 오리온,Away,한호빈,2,1,1,100.0,0,4,0.0,1,5,20.0,0,0,0.0,1,1,2,2,1,0,0,0,4,1
../kbl_data/2021-2022,S39G01N30,고양 오리온,Away,최승욱,2,1,1,100.0,0,0,0.0,1,1,100.0,0,0,0.0,1,0,1,0,0,0,0,0,0,0
../kbl_data/2021-2022,S39G01N30,고양 오리온,Away,이승현,14,6,13,46.2,0,0,0.0,6,13,46.2,2,2,100.0,1,4,5,2,0,0,0,0,0,3
../kbl_data/2021-2022,S39G01N30,고양 오리온,Away,이종현,17,6,8,75.0,1,1,100.0,7,9,77.8,2,2,100.0,1,4,5,1,1,0,0,0,0,0
../kbl_data/2021-2022,S39G01N30,고양 오리온,Away,김진유,0,0,0,0.0,0,0,0.0,0,0,0.0,0,0,0.0,1,1,2,1,0,0,0,0,0,0
../kbl_data/2021-2022,S39G01N30,고양 오리온,Away,머피 할로웨이,14,7,9,77.8,0,0,0.0,7,9,77.8,0,0,0.0,2,4,6,2,1,0,0,1,1,0
../kbl_data/2021-2022,S39G01N30,고양 오리온,Away,조한진,3,0,0,0.0,1,1,100.0,1,1,100.0,0,0,0.0,0,0,0,1,0,0,0,0,0,0
../kbl_data/2021-2022,S39G01N30,고양 오리온,Away,미로슬라브 라둘리차,7,2,5,40.0,0,1,0.0,2,6,33.3,3,4,75.0,0,8,8,4,0,0,0,0,2,2
../kbl_data/2021-2022,S39G01N30,고양 오리온,Away,이정현,12,6,8,75.0,0,2,0.0,6,10,60.0,0,0,0.0,0,1,1,6,2,0,0,0,0,0
../kbl_data/2021-2022,S39G01N31,대구 한국가스공사,Home,정영삼,0,0,0,0.0,0,0,0.0,0,0,0.0,0,0,0.0,0,0,0,0,0,0,0,0,0,1
../kbl_data/2021-2022,S39G01N31,대구 한국가스공사,Home,민성주,0,0,0,0.0,0,0,0.0,0,0,0.0,0,0,0.0,0,0,0,0,0,0,0,0,0,0
../kbl_data/2021-2022,S39G01N31,대구 한국가스공사,Home,차바위,3,1,1,100.0,0,1,0.0,1,2,50.0,1,2,50.0,1,4,5,4,0,0,1,0,1,3
../kbl_data/2021-2022,S39G01N31,대구 한국가스공사,Home,조상열,17,4,5,80.0,2,5,40.0,6,10,60.0,3,4,75.0,2,1,3,2,1,0,0,0,1,3
../kbl_data/2021-2022,S39G01N31,대구 한국가스공사,Home,이대헌,0,0,0,0.0,0,0,0.0,0,0,0.0,0,0,0.0,0,0,0,0,0,0,0,0,0,0
../kbl_data/2021-2022,S39G01N31,대구 한국가스공사,Home,임준수,0,0,0,0.0,0,0,0.0,0,0,0.0,0,0,0.0,0,0,0,0,0,0,0,0,0,0
../kbl_data/2021-2022,S39G01N31,대구 한국가스공사,Home,김낙현,6,1,1,100.0,0,4,0.0,1,5,20.0,4,4,100.0,0,4,4,6,1,0,0,0,2,1
../kbl_data/2021-2022,S39G01N31,대구 한국가스공사,Home,전현우,11,1,4,25.0,3,9,33.3,4,13,30.8,0,0,0.0,4,1,5,1,0,0,0,0,1,2
../kbl_data/2021-2022,S39G01N31,대구 한국가스공사,Home,양준우,2,1,1,100.0,0,0,0.0,1,1,100.0,0,0,0.0,0,0,0,2,0,0,0,0,1,0
../kbl_data/2021-2022,S39G01N31,대구 한국가스공사,Home,클리프 알렉산더,10,3,5,60.0,0,0,0.0,3,5,60.0,4,4,100.0,2,4,6,0,0,0,0,1,0,2
../kbl_data/2021-2022,S39G01N31,대구 한국가스공사,Home,앤드류 니콜슨,35,12,21,57.1,1,4,25.0,13,25,52.0,8,9,88.9,3,7,10,0,1,3,0,2,1,2
../kbl_data/2021-2022,S39G01N31,대구 한국가스공사,Home,신승민,11,2,4,50.0,1,2,50.0,3,6,50.0,4,4,100.0,3,6,9,2,1,0,0,0,3,5
../kbl_data/2021-2022,S39G01N31,서울 삼성,Away,장민국,7,2,6,33.3,1,2,50.0,3,8,37.5,0,0,0.0,1,2,3,0,1,0,0,0,0,3
../kbl_data/2021-2022,S39G01N31,서울 삼성,Away,김시래,10,1,6,16.7,2,4,50.0,3,10,30.0,2,2,100.0,1,0,1,7,1,0,0,0,3,3
../kbl_data/2021-2022,S39G01N31,서울 삼성,Away,김현수,11,1,7,14.3,3,5,60.0,4,12,33.3,0,0,0.0,0,2,2,4,1,0,0,0,1,3
../kbl_data/2021-2022,S39G01N31,서울 삼성,Away,임동섭,4,2,4,50.0,0,4,0.0,2,8,25.0,0,0,0.0,0,1,1,0,0,0,0,0,0,2
../kbl_data/2021-2022,S39G01N31,서울 삼성,Away,이동엽,8,0,3,0.0,2,4,50.0,2,7,28.6,2,2,100.0,2,3,5,2,0,0,0,0,1,2
../kbl_data/2021-2022,S39G01N31,서울 삼성,Away,이호현,0,0,0,0.0,0,0,0.0,0,0,0.0,0,0,0.0,0,0,0,0,0,0,0,0,0,0
../kbl_data/2021-2022,S39G01N31,서울 삼성,Away,아이제아 힉스,15,5,10,50.0,0,0,0.0,5,10,50.0,5,7,71.4,5,4,9,1,0,3,0,1,1,5
../kbl_data/2021-2022,S39G01N31,서울 삼성,Away,박민우,0,0,0,0.0,0,0,0.0,0,0,0.0,0,0,0.0,0,0,0,0,0,0,0,0,0,0
../kbl_data/2021-2022,S39G01N31,서울 삼성,Away,차민석,7,2,5,40.0,1,1,100.0,3,6,50.0,0,0,0.0,0,1,1,0,0,0,0,0,0,2
../kbl_data/2021-2022,S39G01N31,서울 삼성,Away,전형준,0,0,0,0.0,0,0,0.0,0,0,0.0,0,0,0.0,0,1,1,3,0,0,0,0,0,1
../kbl_data/2021-2022,S39G01N31,서울 삼성,Away,다니엘 오셰푸,12,6,6,100.0,0,0,0.0,6,6,100.0,0,1,0.0,2,2,4,1,1,0,0,1,1,1
../kbl_data/2021-2022,S39G01N31,서울 삼성,Away,이원석,12,4,7,57.1,1,2,50.0,5,9,55.6,1,3,33.3,4,2,6,1,1,2,0,0,2,4
../kbl_data/2021-2022,S39G01N32,서울 SK,Home,양우섭,5,1,1,100.0,1,2,50.0,2,3,66.7,0,0,0.0,0,0,0,0,0,0,0,0,1,1
../kbl_data/2021-2022,S39G01N32,서울 SK,Home,허일영,12,3,3,100.0,2,3,66.7,5,6,83.3,0,0,0.0,0,1,1,0,1,0,0,0,1,3
../kbl_data/2021-2022,S39G01N32,서울 SK,Home,김선형,11,1,2,50.0,3,4,75.0,4,6,66.7,0,0,0.0,0,2,2,6,0,0,0,0,0,1
../kbl_data/2021-2022,S39G01N32,서울 SK,Home,최부경,4,2,4,50.0,0,0,0.0,2,4,50.0,0,0,0.0,1,6,7,1,0,0,0,1,1,1
../kbl_data/2021-2022,S39G01N32,서울 SK,Home,김승원,0,0,0,0.0,0,1,0.0,0,1,0.0,0,0,0.0,1,1,2,1,0,0,0,0,0,0
../kbl_data/2021-2022,S39G01N32,서울 SK,Home,리온 윌리엄스,3,1,1,100.0,0,2,0.0,1,3,33.3,1,2,50.0,0,5,5,0,2,0,0,0,1,1
../kbl_data/2021-2022,S39G01N32,서울 SK,Home,이현석,2,0,1,0.0,0,3,0.0,0,4,0.0,2,2,100.0,0,1,1,1,0,0,0,0,0,0
../kbl_data/2021-2022,S39G01N32,서울 SK,Home,최원혁,0,0,1,0.0,0,1,0.0,0,2,0.0,0,0,0.0,1,0,1,0,0,0,0,0,0,1
../kbl_data/2021-2022,S39G01N32,서울 SK,Home,최준용,17,5,7,71.4,1,4,25.0,6,11,54.5,4,4,100.0,0,2,2,2,1,1,0,0,1,0
../kbl_data/2021-2022,S39G01N32,서울 SK,Home,안영준,12,4,6,66.7,0,3,0.0,4,9,44.4,4,6,66.7,3,4,7,2,2,1,0,0,2,1
../kbl_data/2021-2022,S39G01N32,서울 SK,Home,자밀 워니,17,7,10,70.0,1,1,100.0,8,11,72.7,0,0,0.0,2,8,10,2,0,1,0,0,1,1
../kbl_data/2021-2022,S39G01N32,서울 SK,Home,오재현,12,6,6,100.0,0,3,0.0,6,9,66.7,0,2,0.0,0,1,1,3,1,0,2,0,0,3
../kbl_data/2021-2022,S39G01N32,원주 DB,Away,윤호영,5,1,2,50.0,1,2,50.0,2,4,50.0,0,0,0.0,0,3,3,2,0,0,0,0,1,1
../kbl_data/2021-2022,S39G01N32,원주 DB,Away,박찬희,0,0,4,0.0,0,1,0.0,0,5,0.0,0,0,0.0,0,1,1,5,2,0,0,0,0,0
../kbl_data/2021-2022,S39G01N32,원주 DB,Away,김종규,8,4,6,66.7,0,2,0.0,4,8,50.0,0,0,0.0,1,4,5,0,0,0,0,0,1,3
../kbl_data/2021-2022,S39G01N32,원주 DB,Away,허웅,9,2,2,100.0,1,3,33.3,3,5,60.0,2,2,100.0,1,0,1,2,1,0,0,0,1,3
../kbl_data/2021-2022,S39G01N32,원주 DB,Away,김영훈,0,0,0,0.0,0,2,0.0,0,2,0.0,0,0,0.0,0,1,1,0,0,0,1,0,0,1
../kbl_data/2021-2022,S39G01N32,원주 DB,Away,배강률,0,0,0,0.0,0,0,0.0,0,0,0.0,0,0,0.0,1,0,1,0,0,0,0,0,1,0
../kbl_data/2021-2022,S39G01N32,원주 DB,Away,김철욱,9,4,4,100.0,0,3,0.0,4,7,57.1,1,3,33.3,0,2,2,0,1,0,0,0,0,2
../kbl_data/2021-2022,S39G01N32,원주 DB,Away,박상권,6,0,2,0.0,2,2,100.0,2,4,50.0,0,0,0.0,0,0,0,0,0,0,0,0,2,5
../kbl_data/2021-2022,S39G01N32,원주 DB,Away,김훈,0,0,0,0.0,0,2,0.0,0,2,0.0,0,0,0.0,2,1,3,0,0,0,0,0,0,2
../kbl_data/2021-2022,S39G01N32,원주 DB,Away,나카무라 타이치,7,2,4,50.0,1,7,14.3,3,11,27.3,0,0,0.0,0,3,3,5,0,1,1,0,2,1
../kbl_data/2021-2022,S39G01N32,원주 DB,Away,레나드 프리먼,18,7,13,53.8,1,2,50.0,8,15,53.3,1,2,50.0,4,5,9,4,0,0,0,2,2,0
../kbl_data/2021-2022,S39G01N32,원주 DB,Away,정호영,6,3,6,50.0,0,2,0.0,3,8,37.5,0,0,0.0,1,1,2,2,0,0,0,0,2,0
../kbl_data/2021-2022,S39G01N33,전주 KCC,Home,송창용,6,0,1,0.0,2,5,40.0,2,6,33.3,0,0,0.0,3,1,4,1,0,0,1,0,0,5
../kbl_data/2021-2022,S39G01N33,전주 KCC,Home,이정현,13,5,6,83.3,1,10,10.0,6,16,37.5,0,0,0.0,0,3,3,1,1,0,0,0,6,1
../kbl_data/2021-2022,S39G01N33,전주 KCC,Home,라건아,36,12,17,70.6,2,3,66.7,14,20,70.0,6,8,75.0,6,10,16,4,2,2,0,0,2,3
../kbl_data/2021-2022,S39G01N33,전주 KCC,Home,김지완,31,11,14,78.6,2,5,40.0,13,19,68.4,3,4,75.0,1,3,4,8,1,0,0,0,1,1
../kbl_data/2021-2022,S39G01N33,전주 KCC,Home,김상규,4,2,3,66.7,0,5,0.0,2,8,25.0,0,0,0.0,0,0,0,0,0,1,0,0,0,4
../kbl_data/2021-2022,S39G01N33,전주 KCC,Home,유병훈,8,2,5,40.0,1,3,33.3,3,8,37.5,1,1,100.0,1,1,2,2,2,0,1,0,1,2
../kbl_data/2021-2022,S39G01N33,전주 KCC,Home,전준범,9,2,3,66.7,1,5,20.0,3,8,37.5,2,2,100.0,1,2,3,0,2,0,0,0,2,0
../kbl_data/2021-2022,S39G01N33,전주 KCC,Home,박세진,0,0,0,0.0,0,0,0.0,0,0,0.0,0,0,0.0,0,0,0,0,0,0,0,0,0,0
../kbl_data/2021-2022,S39G01N33,전주 KCC,Home,이진욱,0,0,0,0.0,0,1,0.0,0,1,0.0,0,0,0.0,0,0,0,1,0,0,0,0,1,0
../kbl_data/2021-2022,S39G01N33,전주 KCC,Home,유현준,0,0,0,0.0,0,0,0.0,0,0,0.0,0,0,0.0,0,0,0,1,0,0,0,0,0,2
../kbl_data/2021-2022,S39G01N33,전주 KCC,Home,라타비우스 윌리엄스,2,1,2,50.0,0,1,0.0,1,3,33.3,0,0,0.0,1,1,2,0,0,0,0,0,0,4
../kbl_data/2021-2022,S39G01N33,전주 KCC,Home,김동현,0,0,0,0.0,0,0,0.0,0,0,0.0,0,0,0.0,0,0,0,0,0,0,0,0,0,0
../kbl_data/2021-2022,S39G01N33,울산 현대모비스,Away,이현민,11,1,2,50.0,3,4,75.0,4,6,66.7,0,0,0.0,0,0,0,8,1,0,0,0,1,4
../kbl_data/2021-2022,S39G01N33,울산 현대모비스,Away,함지훈,23,9,14,64.3,0,1,0.0,9,15,60.0,5,6,83.3,2,7,9,7,1,0,0,0,2,0
../kbl_data/2021-2022,S39G01N33,울산 현대모비스,Away,최진수,0,0,0,0.0,0,0,0.0,0,0,0.0,0,0,0.0,0,0,0,0,0,0,0,0,0,1
../kbl_data/2021-2022,S39G01N33,울산 현대모비스,Away,장재석,4,1,4,25.0,0,0,0.0,1,4,25.0,2,2,100.0,3,1,4,1,0,0,0,0,1,3
../kbl_data/2021-2022,S39G01N33,울산 현대모비스,Away,정성호,3,0,0,0.0,1,2,50.0,1,2,50.0,0,0,0.0,0,1,1,0,0,0,0,0,0,0
../kbl_data/2021-2022,S39G01N33,울산 현대모비스,Away,김수찬,10,3,4,75.0,1,4,25.0,4,8,50.0,1,1,100.0,1,0,1,1,1,0,0,0,2,5
../kbl_data/2021-2022,S39G01N33,울산 현대모비스,Away,서명진,10,3,7,42.9,1,5,20.0,4,12,33.3,1,1,100.0,1,2,3,2,1,0,0,0,1,2
../kbl_data/2021-2022,S39G01N33,울산 현대모비스,Away,얼 클락,9,3,9,33.3,1,1,100.0,4,10,40.0,0,1,0.0,5,5,10,2,0,4,0,0,5,3
../kbl_data/2021-2022,S39G01N33,울산 현대모비스,Away,이우석,19,6,10,60.0,2,4,50.0,8,14,57.1,1,1,100.0,1,1,2,1,2,1,0,0,2,3
../kbl_data/2021-2022,S39G01N33,울산 현대모비스,Away,라숀 토마스,14,4,8,50.0,0,0,0.0,4,8,50.0,6,7,85.7,3,6,9,2,2,0,0,0,2,2
../kbl_data/2021-2022,S39G01N33,울산 현대모비스,Away,신민석,5,1,1,100.0,1,3,33.3,2,4,50.0,0,0,0.0,0,1,1,0,1,0,0,0,3,2
../kbl_data/2021-2022,S39G01N33,울산 현대모비스,Away,김동준,0,0,0,0.0,0,0,0.0,0,0,0.0,0,0,0.0,0,0,0,0,0,0,0,0,0,0
../kbl_data/2021-2022,S39G01N34,창원 LG,Home,강병현,3,0,1,0.0,1,1,100.0,1,2,50.0,0,0,0.0,0,0,0,0,0,0,0,0,0,3
../kbl_data/2021-2022,S39G01N34,창원 LG,Home,이관희,11,3,7,42.9,1,3,33.3,4,10,40.0,2,2,100.0,3,4,7,2,1,0,0,0,0,2
../kbl_data/2021-2022,S39G01N34,창원 LG,Home,정희재,1,0,0,0.0,0,1,0.0,0,1,0.0,1,2,50.0,0,0,0,0,0,0,0,0,0,2
../kbl_data/2021-2022,S39G01N34,창원 LG,Home,서민수,0,0,0,0.0,0,1,0.0,0,1,0.0,0,0,0.0,0,1,1,0,0,0,0,0,2,2
../kbl_data/2021-2022,S39G01N34,창원 LG,Home,한상혁,0,0,0,0.0,0,0,0.0,0,0,0.0,0,0,0.0,0,0,0,0,0,0,0,0,0,0
../kbl_data/2021-2022,S39G01N34,창원 LG,Home,이재도,14,5,8,62.5,1,1,100.0,6,9,66.7,1,1,100.0,0,3,3,6,0,0,0,0,3,0
../kbl_data/2021-2022,S39G01N34,창원 LG,Home,정해원,0,0,0,0.0,0,1,0.0,0,1,0.0,0,0,0.0,0,0,0,0,0,0,0,0,0,0
../kbl_data/2021-2022,S39G01N34,창원 LG,Home,박정현,4,1,4,25.0,0,1,0.0,1,5,20.0,2,4,50.0,3,5,8,2,3,0,0,0,0,1
../kbl_data/2021-2022,S39G01N34,창원 LG,Home,이광진,6,1,1,100.0,1,3,33.3,2,4,50.0,1,2,50.0,0,0,0,1,1,0,0,1,0,2
../kbl_data/2021-2022,S39G01N34,창원 LG,Home,압둘 말릭 아부,2,1,3,33.3,0,0,0.0,1,3,33.3,0,0,0.0,2,2,4,0,1,1,0,0,3,0
../kbl_data/2021-2022,S39G01N34,창원 LG,Home,아셈 마레이,30,12,22,54.5,0,0,0.0,12,22,54.5,6,7,85.7,4,12,16,3,0,3,0,0,3,3
../kbl_data/2021-2022,S39G01N34,창원 LG,Home,이승우,2,1,1,100.0,0,1,0.0,1,2,50.0,0,0,0.0,0,0,0,1,0,0,0,0,1,2
../kbl_data/2021-2022,S39G01N34,고양 오리온,Away,김강선,2,1,2,50.0,0,2,0.0,1,4,25.0,0,0,0.0,1,0,1,0,0,0,0,0,0,2
../kbl_data/2021-2022,S39G01N34,고양 오리온,Away,최현민,5,1,5,20.0,1,3,33.3,2,8,25.0,0,0,0.0,3,1,4,0,1,0,0,0,0,1
../kbl_data/2021-2022,S39G01N34,고양 오리온,Away,이대성,0,0,2,0.0,0,2,0.0,0,4,0.0,0,0,0.0,0,1,1,6,0,0,0,0,0,1
../kbl_data/2021-2022,S39G01N34,고양 오리온,Away,한호빈,11,3,4,75.0,1,3,33.3,4,7,57.1,2,2,100.0,0,2,2,5,1,0,0,0,1,3
../kbl_data/2021-2022,S39G01N34,고양 오리온,Away,최승욱,0,0,0,0.0,0,0,0.0,0,0,0.0,0,0,0.0,0,0,0,0,0,0,0,0,0,0
../kbl_data/2021-2022,S39G01N34,고양 오리온,Away,이승현,14,7,13,53.8,0,1,0.0,7,14,50.0,0,0,0.0,1,4,5,2,1,0,0,0,1,1
../kbl_data/2021-2022,S39G01N34,고양 오리온,Away,이종현,6,3,7,42.9,0,0,0.0,3,7,42.9,0,0,0.0,1,1,2,0,1,0,0,0,1,1
../kbl_data/2021-2022,S39G01N34,고양 오리온,Away,김진유,0,0,0,0.0,0,1,0.0,0,1,0.0,0,0,0.0,1,0,1,1,0,0,0,0,0,1
../kbl_data/2021-2022,S39G01N34,고양 오리온,Away,머피 할로웨이,17,7,8,87.5,1,1,100.0,8,9,88.9,0,2,0.0,2,10,12,2,2,1,1,1,4,3
../kbl_data/2021-2022,S39G01N34,고양 오리온,Away,조한진,0,0,0,0.0,0,0,0.0,0,0,0.0,0,0,0.0,0,0,0,0,0,0,0,0,0,0
../kbl_data/2021-2022,S39G01N34,고양 오리온,Away,미로슬라브 라둘리차,8,3,5,60.0,0,0,0.0,3,5,60.0,2,3,66.7,1,1,2,0,0,1,0,0,1,1
../kbl_data/2021-2022,S39G01N34,고양 오리온,Away,이정현,3,0,6,0.0,1,2,50.0,1,8,12.5,0,0,0.0,0,0,0,2,1,0,1,0,1,3
../kbl_data/2021-2022,S39G01N35,서울 삼성,Home,장민국,6,0,0,0.0,2,6,33.3,2,6,33.3,0,0,0.0,0,2,2,0,0,0,0,0,1,1
../kbl_data/2021-2022,S39G01N35,서울 삼성,Home,김시래,2,1,4,25.0,0,1,0.0,1,5,20.0,0,0,0.0,0,3,3,5,0,0,1,0,2,2
../kbl_data/2021-2022,S39G01N35,서울 삼성,Home,김현수,8,0,1,0.0,2,5,40.0,2,6,33.3,2,2,100.0,0,1,1,1,0,0,1,0,0,0
../kbl_data/2021-2022,S39G01N35,서울 삼성,Home,임동섭,11,1,5,20.0,3,7,42.9,4,12,33.3,0,0,0.0,1,7,8,2,0,0,0,0,0,1
../kbl_data/2021-2022,S39G01N35,서울 삼성,Home,이동엽,11,4,8,50.0,1,2,50.0,5,10,50.0,0,0,0.0,1,2,3,3,1,0,0,0,3,2
../kbl_data/2021-2022,S39G01N35,서울 삼성,Home,배수용,8,1,1,100.0,2,3,66.7,3,4,75.0,0,0,0.0,1,1,2,1,0,0,0,0,0,1
../kbl_data/2021-2022,S39G01N35,서울 삼성,Home,이호현,0,0,0,0.0,0,0,0.0,0,0,0.0,0,0,0.0,0,0,0,0,0,0,0,0,0,0
../kbl_data/2021-2022,S39G01N35,서울 삼성,Home,아이제아 힉스,14,5,7,71.4,0,0,0.0,5,7,71.4,4,5,80.0,0,3,3,1,0,2,0,0,5,5
../kbl_data/2021-2022,S39G01N35,서울 삼성,Home,차민석,2,1,1,100.0,0,0,0.0,1,1,100.0,0,0,0.0,0,0,0,1,0,0,0,0,1,1
../kbl_data/2021-2022,S39G01N35,서울 삼성,Home,전형준,0,0,0,0.0,0,0,0.0,0,0,0.0,0,0,0.0,0,0,0,0,0,0,0,0,0,0
../kbl_data/2021-2022,S39G01N35,서울 삼성,Home,다니엘 오셰푸,10,5,7,71.4,0,0,0.0,5,7,71.4,0,0,0.0,1,7,8,1,1,0,0,1,2,2
../kbl_data/2021-2022,S39G01N35,서울 삼성,Home,이원석,6,3,6,50.0,0,0,0.0,3,6,50.0,0,0,0.0,5,4,9,0,0,0,1,0,0,2
../kbl_data/2021-2022,S39G01N35,안양 KGC,Away,함준후,0,0,0,0.0,0,1,0.0,0,1,0.0,0,0,0.0,0,0,0,0,0,0,0,0,0,0
../kbl_data/2021-2022,S39G01N35,안양 KGC,Away,오세근,16,5,8,62.5,1,3,33.3,6,11,54.5,3,4,75.0,2,2,4,2,1,0,1,0,0,0
../kbl_data/2021-2022,S39G01N35,안양 KGC,Away,문성곤,11,2,2,100.0,2,2,100.0,4,4,100.0,1,2,50.0,2,2,4,1,2,0,0,0,1,0
../kbl_data/2021-2022,S39G01N35,안양 KGC,Away,전성현,7,2,6,33.3,1,6,16.7,3,12,25.0,0,0,0.0,0,1,1,2,0,1,0,0,1,3
../kbl_data/2021-2022,S39G01N35,안양 KGC,Away,정강호,0,0,0,0.0,0,0,0.0,0,0,0.0,0,0,0.0,0,0,0,0,0,0,0,0,0,0
../kbl_data/2021-2022,S39G01N35,안양 KGC,Away,이우정,0,0,0,0.0,0,0,0.0,0,0,0.0,0,0,0.0,0,0,0,0,0,0,0,0,0,1
../kbl_data/2021-2022,S39G01N35,안양 KGC,Away,대릴 먼로,6,2,6,33.3,0,2,0.0,2,8,25.0,2,4,50.0,1,6,7,2,1,1,0,0,1,1
../kbl_data/2021-2022,S39G01N35,안양 KGC,Away,우동현,0,0,1,0.0,0,2,0.0,0,3,0.0,0,0,0.0,0,1,1,0,1,0,0,0,0,2
../kbl_data/2021-2022,S39G01N35,안양 KGC,Away,변준형,16,6,6,100.0,1,6,16.7,7,12,58.3,1,2,50.0,0,1,1,6,3,0,2,0,1,4
../kbl_data/2021-2022,S39G01N35,안양 KGC,Away,한승희,7,2,2,100.0,1,2,50.0,3,4,75.0,0,0,0.0,0,0,0,0,1,0,0,0,0,2
../kbl_data/2021-2022,S39G01N35,안양 KGC,Away,양승면,0,0,0,0.0,0,0,0.0,0,0,0.0,0,0,0.0,0,0,0,0,0,0,0,0,0,0
../kbl_data/2021-2022,S39G01N35,안양 KGC,Away,오마리 스펠맨,4,0,4,0.0,1,2,50.0,1,6,16.7,1,2,50.0,0,9,9,2,0,1,0,0,4,2
../kbl_data/2021-2022,S39G01N36,전주 KCC,Home,송창용,6,1,3,33.3,1,3,33.3,2,6,33.3,1,2,50.0,0,3,3,1,1,0,0,0,0,1
../kbl_data/2021-2022,S39G01N36,전주 KCC,Home,이정현,18,5,7,71.4,1,2,50.0,6,9,66.7,5,6,83.3,0,2,2,1,0,0,0,0,1,3
../kbl_data/2021-2022,S39G01N36,전주 KCC,Home,라건아,14,3,5,60.0,1,2,50.0,4,7,57.1,5,7,71.4,2,6,8,2,1,0,0,0,2,4
../kbl_data/2021-2022,S39G01N36,전주 KCC,Home,김지완,19,4,7,57.1,3,8,37.5,7,15,46.7,2,2,100.0,0,2,2,3,2,0,0,0,0,3
../kbl_data/2021-2022,S39G01N36,전주 KCC,Home,김상규,3,0,0,0.0,1,3,33.3,1,3,33.3,0,0,0.0,1,3,4,2,0,0,0,0,0,0
../kbl_data/2021-2022,S39G01N36,전주 KCC,Home,유병훈,0,0,0,0.0,0,1,0.0,0,1,0.0,0,0,0.0,0,0,0,1,0,0,0,0,0,1
../kbl_data/2021-2022,S39G01N36,전주 KCC,Home,전준범,6,0,2,0.0,2,5,40.0,2,7,28.6,0,0,0.0,0,2,2,3,0,0,0,0,1,2
../kbl_data/2021-2022,S39G01N36,전주 KCC,Home,이진욱,0,0,0,0.0,0,0,0.0,0,0,0.0,0,0,0.0,0,0,0,0,0,0,0,0,0,2
../kbl_data/2021-2022,S39G01N36,전주 KCC,Home,유현준,6,1,2,50.0,1,2,50.0,2,4,50.0,1,2,50.0,0,2,2,4,0,0,0,0,4,0
../kbl_data/2021-2022,S39G01N36,전주 KCC,Home,곽동기,0,0,0,0.0,0,0,0.0,0,0,0.0,0,0,0.0,0,0,0,0,0,0,0,0,0,0
../kbl_data/2021-2022,S39G01N36,전주 KCC,Home,라타비우스 윌리엄스,9,4,6,66.7,0,0,0.0,4,6,66.7,1,2,50.0,1,5,6,0,0,2,0,2,0,1
../kbl_data/2021-2022,S39G01N36,전주 KCC,Home,김동현,1,0,0,0.0,0,1,0.0,0,1,0.0,1,2,50.0,0,0,0,0,0,0,0,0,0,0
../kbl_data/2021-2022,S39G01N36,원주 DB,Away,윤호영,4,2,6,33.3,0,0,0.0,2,6,33.3,0,0,0.0,1,3,4,3,0,0,0,0,0,2
../kbl_data/2021-2022,S39G01N36,원주 DB,Away,박찬희,10,2,5,40.0,2,5,40.0,4,10,40.0,0,0,0.0,2,1,3,9,4,0,0,0,1,1
../kbl_data/2021-2022,S39G01N36,원주 DB,Away,김종규,11,5,9,55.6,0,1,0.0,5,10,50.0,1,1,100.0,2,2,4,0,0,0,0,0,1,5
../kbl_data/2021-2022,S39G01N36,원주 DB,Away,허웅,23,3,7,42.9,5,9,55.6,8,16,50.0,2,2,100.0,1,4,5,1,0,0,0,0,1,1
../kbl_data/2021-2022,S39G01N36,원주 DB,Away,김영훈,6,0,1,0.0,2,4,50.0,2,5,40.0,0,0,0.0,2,1,3,0,0,0,0,0,0,5
../kbl_data/2021-2022,S39G01N36,원주 DB,Away,박상권,2,1,1,100.0,0,0,0.0,1,1,100.0,0,0,0.0,0,0,0,0,0,0,0,0,0,1
../kbl_data/2021-2022,S39G01N36,원주 DB,Away,나카무라 타이치,3,0,1,0.0,1,2,50.0,1,3,33.3,0,0,0.0,0,0,0,4,0,0,0,0,0,0
../kbl_data/2021-2022,S39G01N36,원주 DB,Away,이준희,5,1,5,20.0,1,1,100.0,2,6,33.3,0,0,0.0,1,1,2,0,0,0,0,0,0,2
../kbl_data/2021-2022,S39G01N36,원주 DB,Away,얀테 메이튼,10,3,7,42.9,0,1,0.0,3,8,37.5,4,6,66.7,1,6,7,1,1,0,0,0,1,2
../kbl_data/2021-2022,S39G01N36,원주 DB,Away,레나드 프리먼,12,5,6,83.3,0,1,0.0,5,7,71.4,2,2,100.0,5,5,10,2,1,0,0,0,1,1
../kbl_data/2021-2022,S39G01N36,원주 DB,Away,정호영,1,0,0,0.0,0,0,0.0,0,0,0.0,1,2,50.0,0,1,1,0,0,0,0,0,0,0
../kbl_data/2021-2022,S39G01N36,원주 DB,Away,이민석,3,0,0,0.0,1,4,25.0,1,4,25.0,0,0,0.0,1,0,1,0,0,0,0,0,0,1
../kbl_data/2021-2022,S39G01N37,수원 KT,Home,김동욱,9,0,0,0.0,2,5,40.0,2,5,40.0,3,3,100.0,1,2,3,6,1,0,0,0,2,2
../kbl_data/2021-2022,S39G01N37,수원 KT,Home,김영환,6,3,4,75.0,0,3,0.0,3,7,42.9,0,0,0.0,0,1,1,0,1,0,0,0,0,1
../kbl_data/2021-2022,S39G01N37,수원 KT,Home,김현민,4,2,4,50.0,0,1,0.0,2,5,40.0,0,0,0.0,2,1,3,1,0,0,0,0,0,3
../kbl_data/2021-2022,S39G01N37,수원 KT,Home,김윤태,0,0,0,0.0,0,0,0.0,0,0,0.0,0,0,0.0,0,0,0,0,0,0,0,0,0,0
../kbl_data/2021-2022,S39G01N37,수원 KT,Home,최창진,4,2,2,100.0,0,0,0.0,2,2,100.0,0,1,0.0,0,0,0,2,1,0,0,0,0,1
../kbl_data/2021-2022,S39G01N37,수원 KT,Home,정성우,18,6,11,54.5,1,6,16.7,7,17,41.2,3,3,100.0,0,3,3,5,4,0,0,0,2,3
../kbl_data/2021-2022,S39G01N37,수원 KT,Home,양홍석,14,5,8,62.5,1,2,50.0,6,10,60.0,1,3,33.3,2,3,5,3,3,1,0,0,3,1
../kbl_data/2021-2022,S39G01N37,수원 KT,Home,박준영,0,0,0,0.0,0,0,0.0,0,0,0.0,0,0,0.0,0,0,0,0,0,0,0,0,0,0
../kbl_data/2021-2022,S39G01N37,수원 KT,Home,캐디 라렌,19,7,9,77.8,1,3,33.3,8,12,66.7,2,3,66.7,3,5,8,1,0,1,0,3,4,4
../kbl_data/2021-2022,S39G01N37,수원 KT,Home,박지원,4,1,4,25.0,0,0,0.0,1,4,25.0,2,3,66.7,0,0,0,1,1,0,0,0,0,1
../kbl_data/2021-2022,S39G01N37,수원 KT,Home,마이크 마이어스,9,4,11,36.4,0,0,0.0,4,11,36.4,1,4,25.0,4,2,6,1,1,1,0,1,1,3
../kbl_data/2021-2022,S39G01N37,수원 KT,Home,하윤기,11,4,7,57.1,0,0,0.0,4,7,57.1,3,5,60.0,5,2,7,1,0,0,0,0,2,3
../kbl_data/2021-2022,S39G01N37,울산 현대모비스,Away,이현민,10,1,1,100.0,2,2,100.0,3,3,100.0,2,2,100.0,0,0,0,5,3,0,0,0,3,3
../kbl_data/2021-2022,S39G01N37,울산 현대모비스,Away,함지훈,12,1,7,14.3,2,3,66.7,3,10,30.0,4,4,100.0,1,3,4,6,1,3,0,0,3,2
../kbl_data/2021-2022,S39G01N37,울산 현대모비스,Away,최진수,10,3,4,75.0,1,4,25.0,4,8,50.0,1,1,100.0,1,0,1,2,2,1,0,1,2,0
../kbl_data/2021-2022,S39G01N37,울산 현대모비스,Away,장재석,4,1,2,50.0,0,0,0.0,1,2,50.0,2,2,100.0,0,3,3,2,0,0,0,0,0,3
../kbl_data/2021-2022,S39G01N37,울산 현대모비스,Away,정성호,0,0,0,0.0,0,0,0.0,0,0,0.0,0,0,0.0,0,0,0,0,0,0,0,0,0,0
../kbl_data/2021-2022,S39G01N37,울산 현대모비스,Away,김영현,0,0,0,0.0,0,0,0.0,0,0,0.0,0,0,0.0,0,0,0,0,0,0,0,0,0,0
../kbl_data/2021-2022,S39G01N37,울산 현대모비스,Away,김수찬,0,0,0,0.0,0,0,0.0,0,0,0.0,0,0,0.0,0,0,0,0,0,0,0,0,0,0
../kbl_data/2021-2022,S39G01N37,울산 현대모비스,Away,서명진,14,3,4,75.0,2,3,66.7,5,7,71.4,2,2,100.0,0,2,2,4,0,0,0,0,2,3
../kbl_data/2021-2022,S39G01N37,울산 현대모비스,Away,얼 클락,9,3,5,60.0,1,2,50.0,4,7,57.1,0,0,0.0,2,3,5,1,0,0,0,0,0,1
../kbl_data/2021-2022,S39G01N37,울산 현대모비스,Away,이우석,15,4,8,50.0,1,3,33.3,5,11,45.5,4,5,80.0,1,5,6,3,0,1,0,0,2,2
../kbl_data/2021-2022,S39G01N37,울산 현대모비스,Away,라숀 토마스,23,8,15,53.3,0,0,0.0,8,15,53.3,7,11,63.6,4,4,8,2,2,0,1,1,2,5
../kbl_data/2021-2022,S39G01N37,울산 현대모비스,Away,신민석,5,1,1,100.0,1,1,100.0,2,2,100.0,0,0,0.0,1,0,1,1,0,0,0,0,0,3
../kbl_data/2021-2022,S39G01N38,서울 SK,Home,양우섭,6,0,1,0.0,2,4,50.0,2,5,40.0,0,0,0.0,0,0,0,0,0,0,0,0,0,0
../kbl_data/2021-2022,S39G01N38,서울 SK,Home,허일영,4,0,0,0.0,1,3,33.3,1,3,33.3,1,2,50.0,0,6,6,0,0,0,0,0,0,2
../kbl_data/2021-2022,S39G01N38,서울 SK,Home,김선형,18,4,6,66.7,3,5,60.0,7,11,63.6,1,2,50.0,2,1,3,9,0,0,0,0,0,1
../kbl_data/2021-2022,S39G01N38,서울 SK,Home,최부경,8,3,3,100.0,0,0,0.0,3,3,100.0,2,2,100.0,0,5,5,0,0,1,0,0,1,1
../kbl_data/2021-2022,S39G01N38,서울 SK,Home,리온 윌리엄스,9,4,6,66.7,0,0,0.0,4,6,66.7,1,1,100.0,1,2,3,0,0,0,0,0,0,0
../kbl_data/2021-2022,S39G01N38,서울 SK,Home,배병준,0,0,0,0.0,0,0,0.0,0,0,0.0,0,0,0.0,0,0,0,0,0,0,0,0,0,0
../kbl_data/2021-2022,S39G01N38,서울 SK,Home,이현석,0,0,0,0.0,0,0,0.0,0,0,0.0,0,0,0.0,0,0,0,0,0,0,0,0,1,1
../kbl_data/2021-2022,S39G01N38,서울 SK,Home,최원혁,3,0,0,0.0,1,2,50.0,1,2,50.0,0,0,0.0,1,1,2,1,0,0,0,0,1,1
../kbl_data/2021-2022,S39G01N38,서울 SK,Home,최준용,15,1,3,33.3,4,8,50.0,5,11,45.5,1,1,100.0,0,1,1,1,1,3,0,0,3,3
../kbl_data/2021-2022,S39G01N38,서울 SK,Home,안영준,8,4,5,80.0,0,2,0.0,4,7,57.1,0,0,0.0,1,4,5,8,1,0,0,0,2,2
../kbl_data/2021-2022,S39G01N38,서울 SK,Home,자밀 워니,19,7,15,46.7,1,1,100.0,8,16,50.0,2,2,100.0,3,10,13,3,1,0,0,0,2,0
../kbl_data/2021-2022,S39G01N38,서울 SK,Home,오재현,4,2,3,66.7,0,0,0.0,2,3,66.7,0,0,0.0,0,0,0,1,0,0,0,0,1,4
../kbl_data/2021-2022,S39G01N38,대구 한국가스공사,Away,정영삼,2,1,2,50.0,0,0,0.0,1,2,50.0,0,0,0.0,0,0,0,0,2,0,0,0,0,0
../kbl_data/2021-2022,S39G01N38,대구 한국가스공사,Away,민성주,0,0,0,0.0,0,0,0.0,0,0,0.0,0,0,0.0,0,0,0,0,0,0,0,0,0,0
../kbl_data/2021-2022,S39G01N38,대구 한국가스공사,Away,차바위,5,1,4,25.0,1,2,50.0,2,6,33.3,0,0,0.0,0,3,3,2,2,0,1,0,1,4
../kbl_data/2021-2022,S39G01N38,대구 한국가스공사,Away,조상열,3,0,0,0.0,1,2,50.0,1,2,50.0,0,0,0.0,0,1,1,0,1,0,1,0,0,1
../kbl_data/2021-2022,S39G01N38,대구 한국가스공사,Away,이대헌,19,8,14,57.1,1,2,50.0,9,16,56.2,0,0,0.0,5,3,8,5,2,0,0,0,1,2
../kbl_data/2021-2022,S39G01N38,대구 한국가스공사,Away,두경민,5,1,1,100.0,1,5,20.0,2,6,33.3,0,0,0.0,1,1,2,4,1,0,0,0,0,1
../kbl_data/2021-2022,S39G01N38,대구 한국가스공사,Away,임준수,0,0,0,0.0,0,0,0.0,0,0,0.0,0,0,0.0,0,0,0,0,0,0,0,0,0,0
../kbl_data/2021-2022,S39G01N38,대구 한국가스공사,Away,김낙현,19,3,5,60.0,4,10,40.0,7,15,46.7,1,2,50.0,1,1,2,9,0,0,0,0,2,1
../kbl_data/2021-2022,S39G01N38,대구 한국가스공사,Away,전현우,0,0,0,0.0,0,4,0.0,0,4,0.0,0,0,0.0,1,2,3,0,0,0,0,0,1,3
../kbl_data/2021-2022,S39G01N38,대구 한국가스공사,Away,클리프 알렉산더,6,2,3,66.7,0,0,0.0,2,3,66.7,2,2,100.0,1,2,3,0,0,0,0,0,0,2
../kbl_data/2021-2022,S39G01N38,대구 한국가스공사,Away,앤드류 니콜슨,25,8,15,53.3,3,7,42.9,11,22,50.0,0,1,0.0,2,9,11,1,0,0,0,0,1,0
../kbl_data/2021-2022,S39G01N38,대구 한국가스공사,Away,신승민,0,0,1,0.0,0,0,0.0,0,1,0.0,0,0,0.0,0,0,0,0,0,0,0,0,0,1
../kbl_data/2021-2022,S39G01N39,원주 DB,Home,윤호영,0,0,0,0.0,0,1,0.0,0,1,0.0,0,0,0.0,0,1,1,2,0,1,0,0,0,0
../kbl_data/2021-2022,S39G01N39,원주 DB,Home,박찬희,9,3,5,60.0,1,5,20.0,4,10,40.0,0,0,0.0,1,4,5,4,1,0,0,0,1,3
../kbl_data/2021-2022,S39G01N39,원주 DB,Home,김종규,2,1,3,33.3,0,1,0.0,1,4,25.0,0,0,0.0,0,3,3,0,0,0,0,1,1,3
../kbl_data/2021-2022,S39G01N39,원주 DB,Home,허웅,8,1,4,25.0,2,6,33.3,3,10,30.0,0,0,0.0,0,1,1,1,0,0,0,0,2,1
../kbl_data/2021-2022,S39G01N39,원주 DB,Home,김영훈,3,0,0,0.0,1,4,25.0,1,4,25.0,0,0,0.0,3,1,4,2,0,0,0,0,0,4
../kbl_data/2021-2022,S39G01N39,원주 DB,Home,김철욱,0,0,1,0.0,0,0,0.0,0,1,0.0,0,0,0.0,1,0,1,0,0,1,0,0,0,2
../kbl_data/2021-2022,S39G01N39,원주 DB,Home,박상권,0,0,0,0.0,0,1,0.0,0,1,0.0,0,0,0.0,0,0,0,0,0,0,0,0,0,0
../kbl_data/2021-2022,S39G01N39,원주 DB,Home,나카무라 타이치,3,0,2,0.0,1,2,50.0,1,4,25.0,0,0,0.0,0,1,1,2,0,0,0,0,0,1
../kbl_data/2021-2022,S39G01N39,원주 DB,Home,이준희,0,0,0,0.0,0,3,0.0,0,3,0.0,0,0,0.0,0,0,0,1,0,0,0,0,1,0
../kbl_data/2021-2022,S39G01N39,원주 DB,Home,얀테 메이튼,25,6,11,54.5,2,3,66.7,8,14,57.1,7,9,77.8,0,9,9,0,1,0,0,0,1,3
../kbl_data/2021-2022,S39G01N39,원주 DB,Home,레나드 프리먼,8,4,6,66.7,0,0,0.0,4,6,66.7,0,0,0.0,1,4,5,0,0,0,0,0,1,0
../kbl_data/2021-2022,S39G01N39,원주 DB,Home,정호영,4,1,1,100.0,0,2,0.0,1,3,33.3,2,2,100.0,1,0,1,2,2,0,0,0,2,1
../kbl_data/2021-2022,S39G01N39,안양 KGC,Away,함준후,0,0,0,0.0,0,0,0.0,0,0,0.0,0,0,0.0,0,0,0,0,0,0,0,0,0,1
../kbl_data/2021-2022,S39G01N39,안양 KGC,Away,오세근,13,5,12,41.7,0,0,0.0,5,12,41.7,3,4,75.0,0,6,6,1,0,0,0,0,2,1
../kbl_data/2021-2022,S39G01N39,안양 KGC,Away,문성곤,13,5,6,83.3,1,4,25.0,6,10,60.0,0,0,0.0,4,5,9,2,2,0,0,1,0,2
../kbl_data/2021-2022,S39G01N39,안양 KGC,Away,전성현,22,2,7,28.6,3,6,50.0,5,13,38.5,9,10,90.0,0,2,2,0,0,0,0,0,1,0
../kbl_data/2021-2022,S39G01N39,안양 KGC,Away,정강호,0,0,0,0.0,0,0,0.0,0,0,0.0,0,0,0.0,0,0,0,0,0,0,0,0,0,0
../kbl_data/2021-2022,S39G01N39,안양 KGC,Away,이우정,0,0,0,0.0,0,0,0.0,0,0,0.0,0,0,0.0,0,0,0,0,0,0,0,0,0,1
../kbl_data/2021-2022,S39G01N39,안양 KGC,Away,대릴 먼로,10,3,4,75.0,0,3,0.0,3,7,42.9,4,5,80.0,2,11,13,10,0,0,1,1,3,2
../kbl_data/2021-2022,S39G01N39,안양 KGC,Away,우동현,0,0,0,0.0,0,0,0.0,0,0,0.0,0,0,0.0,0,0,0,0,0,0,0,0,0,0
../kbl_data/2021-2022,S39G01N39,안양 KGC,Away,변준형,12,3,7,42.9,2,5,40.0,5,12,41.7,0,0,0.0,0,4,4,4,3,0,0,0,1,3
../kbl_data/2021-2022,S39G01N39,안양 KGC,Away,한승희,0,0,1,0.0,0,0,0.0,0,1,0.0,0,0,0.0,0,3,3,0,1,0,1,0,0,1
../kbl_data/2021-2022,S39G01N39,안양 KGC,Away,양승면,0,0,0,0.0,0,0,0.0,0,0,0.0,0,0,0.0,0,0,0,0,0,0,0,0,0,0
../kbl_data/2021-2022,S39G01N39,안양 KGC,Away,오마리 스펠맨,3,0,2,0.0,1,1,100.0,1,3,33.3,0,0,0.0,0,0,0,0,0,0,0,0,2,3
../kbl_data/2021-2022,S39G01N40,울산 현대모비스,Home,이현민,5,0,1,0.0,1,1,100.0,1,2,50.0,2,4,50.0,1,1,2,3,0,0,0,0,4,3
../kbl_data/2021-2022,S39G01N40,울산 현대모비스,Home,함지훈,9,4,4,100.0,0,0,0.0,4,4,100.0,1,2,50.0,1,3,4,5,0,0,0,0,2,2
../kbl_data/2021-2022,S39G01N40,울산 현대모비스,Home,최진수,13,5,7,71.4,1,3,33.3,6,10,60.0,0,0,0.0,1,3,4,1,0,0,0,2,0,4
../kbl_data/2021-2022,S39G01N40,울산 현대모비스,Home,장재석,6,3,7,42.9,0,0,0.0,3,7,42.9,0,0,0.0,1,3,4,3,0,1,0,0,1,1
../kbl_data/2021-2022,S39G01N40,울산 현대모비스,Home,정성호,0,0,0,0.0,0,0,0.0,0,0,0.0,0,0,0.0,0,0,0,0,0,0,0,0,0,0
../kbl_data/2021-2022,S39G01N40,울산 현대모비스,Home,김영현,0,0,0,0.0,0,0,0.0,0,0,0.0,0,0,0.0,0,0,0,0,0,0,0,0,0,0
../kbl_data/2021-2022,S39G01N40,울산 현대모비스,Home,김수찬,0,0,0,0.0,0,0,0.0,0,0,0.0,0,0,0.0,0,0,0,0,0,0,0,0,0,2
../kbl_data/2021-2022,S39G01N40,울산 현대모비스,Home,서명진,10,2,3,66.7,1,3,33.3,3,6,50.0,3,4,75.0,0,3,3,5,0,0,0,0,2,0
../kbl_data/2021-2022,S39G01N40,울산 현대모비스,Home,얼 클락,14,3,7,42.9,2,5,40.0,5,12,41.7,2,2,100.0,3,13,16,1,0,1,0,0,2,3
../kbl_data/2021-2022,S39G01N40,울산 현대모비스,Home,이우석,15,3,4,75.0,2,5,40.0,5,9,55.6,3,3,100.0,1,2,3,1,0,0,0,0,1,1
../kbl_data/2021-2022,S39G01N40,울산 현대모비스,Home,라숀 토마스,8,3,4,75.0,0,0,0.0,3,4,75.0,2,3,66.7,0,2,2,1,0,0,0,0,0,0
../kbl_data/2021-2022,S39G01N40,울산 현대모비스,Home,신민석,0,0,0,0.0,0,0,0.0,0,0,0.0,0,0,0.0,0,0,0,0,0,0,0,0,0,1
../kbl_data/2021-2022,S39G01N40,창원 LG,Away,강병현,2,1,2,50.0,0,2,0.0,1,4,25.0,0,0,0.0,0,0,0,0,0,0,0,0,0,1
../kbl_data/2021-2022,S39G01N40,창원 LG,Away,이관희,18,6,12,50.0,1,4,25.0,7,16,43.8,3,4,75.0,0,3,3,2,2,0,0,0,0,5
../kbl_data/2021-2022,S39G01N40,창원 LG,Away,정희재,3,0,0,0.0,0,4,0.0,0,4,0.0,3,3,100.0,3,1,4,1,2,0,0,0,0,1
../kbl_data/2021-2022,S39G01N40,창원 LG,Away,서민수,10,2,2,100.0,2,6,33.3,4,8,50.0,0,0,0.0,3,1,4,2,1,0,0,0,0,4
../kbl_data/2021-2022,S39G01N40,창원 LG,Away,한상혁,0,0,0,0.0,0,0,0.0,0,0,0.0,0,0,0.0,0,0,0,0,0,0,0,0,0,0
../kbl_data/2021-2022,S39G01N40,창원 LG,Away,이재도,14,5,9,55.6,1,5,20.0,6,14,42.9,1,1,100.0,2,3,5,5,0,0,0,0,1,1
../kbl_data/2021-2022,S39G01N40,창원 LG,Away,정해원,0,0,0,0.0,0,0,0.0,0,0,0.0,0,0,0.0,0,0,0,0,0,0,0,0,0,0
../kbl_data/2021-2022,S39G01N40,창원 LG,Away,박정현,0,0,0,0.0,0,0,0.0,0,0,0.0,0,0,0.0,1,0,1,1,0,0,0,0,0,1
../kbl_data/2021-2022,S39G01N40,창원 LG,Away,이광진,0,0,0,0.0,0,1,0.0,0,1,0.0,0,0,0.0,1,1,2,0,0,0,0,0,0,0
../kbl_data/2021-2022,S39G01N40,창원 LG,Away,압둘 말릭 아부,4,2,2,100.0,0,0,0.0,2,2,100.0,0,2,0.0,1,1,2,0,0,0,0,1,0,2
../kbl_data/2021-2022,S39G01N40,창원 LG,Away,아셈 마레이,16,7,18,38.9,0,2,0.0,7,20,35.0,2,5,40.0,4,4,8,0,2,2,0,0,1,2
../kbl_data/2021-2022,S39G01N40,창원 LG,Away,이승우,2,1,4,25.0,0,1,0.0,1,5,20.0,0,0,0.0,0,2,2,1,0,1,0,0,0,2
../kbl_data/2021-2022,S39G01N41,서울 삼성,Home,장민국,0,0,0,0.0,0,0,0.0,0,0,0.0,0,0,0.0,0,0,0,1,0,0,0,0,0,0
../kbl_data/2021-2022,S39G01N41,서울 삼성,Home,김시래,9,1,5,20.0,2,5,40.0,3,10,30.0,1,1,100.0,0,5,5,6,3,0,0,0,4,2
../kbl_data/2021-2022,S39G01N41,서울 삼성,Home,김현수,8,1,4,25.0,2,3,66.7,3,7,42.9,0,0,0.0,0,2,2,1,0,0,0,0,0,2
../kbl_data/2021-2022,S39G01N41,서울 삼성,Home,임동섭,8,1,5,20.0,2,9,22.2,3,14,21.4,0,0,0.0,0,1,1,1,0,0,0,0,1,1
../kbl_data/2021-2022,S39G01N41,서울 삼성,Home,이동엽,4,1,2,50.0,0,2,0.0,1,4,25.0,2,2,100.0,2,0,2,3,0,0,0,0,2,4
../kbl_data/2021-2022,S39G01N41,서울 삼성,Home,배수용,0,0,0,0.0,0,0,0.0,0,0,0.0,0,0,0.0,1,1,2,1,0,1,0,0,0,0
../kbl_data/2021-2022,S39G01N41,서울 삼성,Home,이호현,0,0,0,0.0,0,0,0.0,0,0,0.0,0,0,0.0,0,0,0,0,0,0,0,0,0,0
../kbl_data/2021-2022,S39G01N41,서울 삼성,Home,아이제아 힉스,17,6,11,54.5,1,2,50.0,7,13,53.8,2,2,100.0,2,7,9,1,1,1,0,1,5,4
../kbl_data/2021-2022,S39G01N41,서울 삼성,Home,차민석,3,1,1,100.0,0,1,0.0,1,2,50.0,1,2,50.0,2,0,2,0,0,0,0,0,0,3
../kbl_data/2021-2022,S39G01N41,서울 삼성,Home,전형준,0,0,0,0.0,0,0,0.0,0,0,0.0,0,0,0.0,0,0,0,0,0,0,0,0,0,2
../kbl_data/2021-2022,S39G01N41,서울 삼성,Home,다니엘 오셰푸,16,7,13,53.8,0,0,0.0,7,13,53.8,2,2,100.0,5,2,7,1,0,0,0,0,0,0
../kbl_data/2021-2022,S39G01N41,서울 삼성,Home,이원석,11,2,5,40.0,1,1,100.0,3,6,50.0,4,6,66.7,3,5,8,0,0,1,1,0,1,0
../kbl_data/2021-2022,S39G01N41,고양 오리온,Away,김강선,12,3,4,75.0,2,3,66.7,5,7,71.4,0,0,0.0,2,1,3,0,1,0,1,0,0,1
../kbl_data/2021-2022,S39G01N41,고양 오리온,Away,최현민,2,1,2,50.0,0,0,0.0,1,2,50.0,0,0,0.0,0,0,0,0,0,0,0,0,0,0
../kbl_data/2021-2022,S39G01N41,고양 오리온,Away,이대성,12,4,5,80.0,1,3,33.3,5,8,62.5,1,2,50.0,1,2,3,4,0,1,0,0,1,2
../kbl_data/2021-2022,S39G01N41,고양 오리온,Away,한호빈,3,0,1,0.0,1,4,25.0,1,5,20.0,0,0,0.0,0,2,2,3,0,0,0,0,0,3
../kbl_data/2021-2022,S39G01N41,고양 오리온,Away,최승욱,0,0,0,0.0,0,0,0.0,0,0,0.0,0,0,0.0,0,0,0,0,0,0,0,0,0,0
../kbl_data/2021-2022,S39G01N41,고양 오리온,Away,이승현,19,9,14,64.3,0,2,0.0,9,16,56.2,1,1,100.0,1,0,1,4,2,1,0,0,0,3
../kbl_data/2021-2022,S39G01N41,고양 오리온,Away,이종현,2,1,2,50.0,0,0,0.0,1,2,50.0,0,0,0.0,0,0,0,0,0,0,0,0,2,2
../kbl_data/2021-2022,S39G01N41,고양 오리온,Away,김진유,4,1,1,100.0,0,0,0.0,1,1,100.0,2,2,100.0,1,1,2,0,1,0,0,0,0,0
../kbl_data/2021-2022,S39G01N41,고양 오리온,Away,머피 할로웨이,9,4,11,36.4,0,0,0.0,4,11,36.4,1,2,50.0,3,8,11,3,6,0,0,0,1,0
../kbl_data/2021-2022,S39G01N41,고양 오리온,Away,조한진,0,0,0,0.0,0,1,0.0,0,1,0.0,0,0,0.0,1,0,1,0,0,0,0,0,0,0
../kbl_data/2021-2022,S39G01N41,고양 오리온,Away,미로슬라브 라둘리차,8,4,6,66.7,0,1,0.0,4,7,57.1,0,0,0.0,0,5,5,1,0,1,0,0,0,4
../kbl_data/2021-2022,S39G01N41,고양 오리온,Away,이정현,10,2,5,40.0,2,4,50.0,4,9,44.4,0,0,0.0,0,2,2,6,0,0,0,0,1,3
../kbl_data/2021-2022,S39G01N42,수원 KT,Home,김동욱,12,1,6,16.7,3,4,75.0,4,10,40.0,1,2,50.0,0,1,1,9,0,0,0,0,3,1
../kbl_data/2021-2022,S39G01N42,수원 KT,Home,김영환,11,3,5,60.0,1,4,25.0,4,9,44.4,2,2,100.0,0,2,2,3,0,1,0,0,0,3
../kbl_data/2021-2022,S39G01N42,수원 KT,Home,김현민,0,0,0,0.0,0,0,0.0,0,0,0.0,0,0,0.0,0,0,0,0,0,0,0,0,0,0
../kbl_data/2021-2022,S39G01N42,수원 KT,Home,김윤태,0,0,0,0.0,0,0,0.0,0,0,0.0,0,0,0.0,0,0,0,0,0,0,0,0,0,1
../kbl_data/2021-2022,S39G01N42,수원 KT,Home,최창진,12,2,4,50.0,1,2,50.0,3,6,50.0,5,5,100.0,4,2,6,2,1,0,1,0,2,4
../kbl_data/2021-2022,S39G01N42,수원 KT,Home,정성우,6,3,6,50.0,0,4,0.0,3,10,30.0,0,0,0.0,0,0,0,2,0,0,1,0,1,4
../kbl_data/2021-2022,S39G01N42,수원 KT,Home,양홍석,21,6,8,75.0,3,7,42.9,9,15,60.0,0,0,0.0,4,7,11,1,1,1,1,0,2,2
../kbl_data/2021-2022,S39G01N42,수원 KT,Home,박준영,0,0,0,0.0,0,1,0.0,0,1,0.0,0,0,0.0,0,0,0,0,0,0,0,0,0,1
../kbl_data/2021-2022,S39G01N42,수원 KT,Home,캐디 라렌,23,4,9,44.4,5,7,71.4,9,16,56.2,0,0,0.0,2,11,13,0,1,0,0,0,1,2
../kbl_data/2021-2022,S39G01N42,수원 KT,Home,박지원,6,3,3,100.0,0,0,0.0,3,3,100.0,0,0,0.0,0,2,2,2,1,0,0,0,0,1
../kbl_data/2021-2022,S39G01N42,수원 KT,Home,마이크 마이어스,5,2,4,50.0,0,0,0.0,2,4,50.0,1,1,100.0,5,3,8,2,1,0,0,0,1,2
../kbl_data/2021-2022,S39G01N42,수원 KT,Home,하윤기,0,0,1,0.0,0,0,0.0,0,1,0.0,0,0,0.0,0,1,1,1,1,0,0,0,0,0
../kbl_data/2021-2022,S39G01N42,전주 KCC,Away,송창용,10,1,1,100.0,2,4,50.0,3,5,60.0,2,2,100.0,2,1,3,1,2,0,1,0,2,2
../kbl_data/2021-2022,S39G01N42,전주 KCC,Away,이정현,17,2,7,28.6,4,7,57.1,6,14,42.9,1,3,33.3,0,0,0,2,0,0,0,0,1,2
../kbl_data/2021-2022,S39G01N42,전주 KCC,Away,라건아,13,3,8,37.5,2,3,66.7,5,11,45.5,1,3,33.3,1,10,11,2,0,1,0,0,0,2
../kbl_data/2021-2022,S39G01N42,전주 KCC,Away,김지완,15,3,3,100.0,2,4,50.0,5,7,71.4,3,4,75.0,0,2,2,2,1,0,0,0,2,4
../kbl_data/2021-2022,S39G01N42,전주 KCC,Away,김상규,0,0,1,0.0,0,1,0.0,0,2,0.0,0,0,0.0,1,1,2,4,1,0,0,0,0,1
../kbl_data/2021-2022,S39G01N42,전주 KCC,Away,유병훈,1,0,5,0.0,0,0,0.0,0,5,0.0,1,2,50.0,0,0,0,1,0,0,0,0,1,0
../kbl_data/2021-2022,S39G01N42,전주 KCC,Away,전준범,2,1,1,100.0,0,4,0.0,1,5,20.0,0,0,0.0,0,0,0,3,0,0,0,0,0,1
../kbl_data/2021-2022,S39G01N42,전주 KCC,Away,이진욱,0,0,0,0.0,0,0,0.0,0,0,0.0,0,0,0.0,0,0,0,0,0,0,0,0,0,0
../kbl_data/2021-2022,S39G01N42,전주 KCC,Away,유현준,5,1,2,50.0,1,1,100.0,2,3,66.7,0,0,0.0,1,2,3,5,1,0,0,0,3,1
../kbl_data/2021-2022,S39G01N42,전주 KCC,Away,곽동기,2,0,1,0.0,0,0,0.0,0,1,0.0,2,2,100.0,1,0,1,0,0,0,0,0,1,0
../kbl_data/2021-2022,S39G01N42,전주 KCC,Away,라타비우스 윌리엄스,7,3,6,50.0,0,1,0.0,3,7,42.9,1,2,50.0,1,3,4,0,0,0,1,0,1,1
../kbl_data/2021-2022,S39G01N42,전주 KCC,Away,김동현,2,0,0,0.0,0,0,0.0,0,0,0.0,2,4,50.0,0,0,0,0,0,0,0,0,0,2
../kbl_data/2021-2022,S39G01N43,창원 LG,Home,강병현,3,0,0,0.0,1,2,50.0,1,2,50.0,0,0,0.0,0,1,1,1,0,0,0,0,2,2
../kbl_data/2021-2022,S39G01N43,창원 LG,Home,이관희,29,7,11,63.6,3,8,37.5,10,19,52.6,6,6,100.0,0,3,3,2,2,0,0,0,3,1
../kbl_data/2021-2022,S39G01N43,창원 LG,Home,정희재,5,1,2,50.0,1,1,100.0,2,3,66.7,0,0,0.0,1,2,3,3,0,0,0,0,1,3
../kbl_data/2021-2022,S39G01N43,창원 LG,Home,서민수,8,1,6,16.7,2,10,20.0,3,16,18.8,0,0,0.0,3,2,5,3,0,2,0,0,0,4
../kbl_data/2021-2022,S39G01N43,창원 LG,Home,한상혁,0,0,0,0.0,0,0,0.0,0,0,0.0,0,0,0.0,0,0,0,0,0,0,0,0,0,0
../kbl_data/2021-2022,S39G01N43,창원 LG,Home,이재도,17,3,4,75.0,3,8,37.5,6,12,50.0,2,2,100.0,1,2,3,5,2,0,0,0,1,4
../kbl_data/2021-2022,S39G01N43,창원 LG,Home,정해원,0,0,0,0.0,0,0,0.0,0,0,0.0,0,0,0.0,0,0,0,0,0,0,0,0,0,0
../kbl_data/2021-2022,S39G01N43,창원 LG,Home,박정현,2,1,2,50.0,0,0,0.0,1,2,50.0,0,0,0.0,0,2,2,0,0,0,0,0,0,0
../kbl_data/2021-2022,S39G01N43,창원 LG,Home,이광진,3,0,0,0.0,1,4,25.0,1,4,25.0,0,0,0.0,0,2,2,1,0,0,0,0,0,3
../kbl_data/2021-2022,S39G01N43,창원 LG,Home,압둘 말릭 아부,2,1,2,50.0,0,1,0.0,1,3,33.3,0,0,0.0,1,0,1,2,0,1,0,1,0,3
../kbl_data/2021-2022,S39G01N43,창원 LG,Home,아셈 마레이,16,7,13,53.8,0,0,0.0,7,13,53.8,2,6,33.3,5,7,12,3,0,0,0,0,2,5
../kbl_data/2021-2022,S39G01N43,창원 LG,Home,이승우,0,0,1,0.0,0,0,0.0,0,1,0.0,0,0,0.0,0,3,3,0,0,0,0,0,0,0
../kbl_data/2021-2022,S39G01N43,서울 SK,Away,양우섭,2,1,2,50.0,0,0,0.0,1,2,50.0,0,0,0.0,0,0,0,1,0,0,0,0,0,1
../kbl_data/2021-2022,S39G01N43,서울 SK,Away,허일영,8,2,5,40.0,0,1,0.0,2,6,33.3,4,4,100.0,2,2,4,0,0,0,0,0,0,2
../kbl_data/2021-2022,S39G01N43,서울 SK,Away,김선형,10,1,2,50.0,1,3,33.3,2,5,40.0,5,6,83.3,0,4,4,5,3,0,0,0,2,3
../kbl_data/2021-2022,S39G01N43,서울 SK,Away,최부경,6,3,4,75.0,0,0,0.0,3,4,75.0,0,0,0.0,0,2,2,0,0,0,0,0,0,3
../kbl_data/2021-2022,S39G01N43,서울 SK,Away,김승원,0,0,0,0.0,0,0,0.0,0,0,0.0,0,0,0.0,0,0,0,0,0,0,0,0,0,0
../kbl_data/2021-2022,S39G01N43,서울 SK,Away,리온 윌리엄스,0,0,4,0.0,0,0,0.0,0,4,0.0,0,2,0.0,1,1,2,0,0,1,0,0,0,1
../kbl_data/2021-2022,S39G01N43,서울 SK,Away,이원대,0,0,0,0.0,0,0,0.0,0,0,0.0,0,0,0.0,0,0,0,1,0,0,0,0,0,1
../kbl_data/2021-2022,S39G01N43,서울 SK,Away,이현석,0,0,0,0.0,0,0,0.0,0,0,0.0,0,0,0.0,0,0,0,0,0,0,0,0,0,0
../kbl_data/2021-2022,S39G01N43,서울 SK,Away,최준용,18,4,5,80.0,3,10,30.0,7,15,46.7,1,2,50.0,3,6,9,2,0,3,0,1,4,1
../kbl_data/2021-2022,S39G01N43,서울 SK,Away,안영준,14,6,12,50.0,0,1,0.0,6,13,46.2,2,2,100.0,1,4,5,3,0,0,0,0,0,1
../kbl_data/2021-2022,S39G01N43,서울 SK,Away,자밀 워니,21,9,20,45.0,0,1,0.0,9,21,42.9,3,6,50.0,5,10,15,2,0,0,0,1,0,4
../kbl_data/2021-2022,S39G01N43,서울 SK,Away,오재현,9,2,3,66.7,0,0,0.0,2,3,66.7,5,7,71.4,2,3,5,1,2,0,0,0,3,3
../kbl_data/2021-2022,S39G01N44,원주 DB,Home,윤호영,0,0,1,0.0,0,2,0.0,0,3,0.0,0,0,0.0,0,1,1,1,0,0,0,0,0,2
../kbl_data/2021-2022,S39G01N44,원주 DB,Home,박찬희,4,1,3,33.3,0,0,0.0,1,3,33.3,2,4,50.0,0,2,2,5,2,0,1,0,2,3
../kbl_data/2021-2022,S39G01N44,원주 DB,Home,김종규,8,2,7,28.6,1,2,50.0,3,9,33.3,1,2,50.0,1,9,10,0,1,2,0,0,2,3
../kbl_data/2021-2022,S39G01N44,원주 DB,Home,허웅,13,5,9,55.6,0,10,0.0,5,19,26.3,3,5,60.0,0,1,1,2,0,0,0,0,1,2
../kbl_data/2021-2022,S39G01N44,원주 DB,Home,김영훈,3,0,0,0.0,1,2,50.0,1,2,50.0,0,0,0.0,0,1,1,1,0,0,0,0,0,0
../kbl_data/2021-2022,S39G01N44,원주 DB,Home,배강률,0,0,0,0.0,0,0,0.0,0,0,0.0,0,0,0.0,0,0,0,0,0,0,0,0,0,0
../kbl_data/2021-2022,S39G01N44,원주 DB,Home,김철욱,2,1,2,50.0,0,0,0.0,1,2,50.0,0,0,0.0,0,0,0,1,0,0,0,0,0,1
../kbl_data/2021-2022,S39G01N44,원주 DB,Home,박상권,0,0,0,0.0,0,0,0.0,0,0,0.0,0,0,0.0,0,0,0,0,0,0,0,0,0,0
../kbl_data/2021-2022,S39G01N44,원주 DB,Home,나카무라 타이치,6,3,3,100.0,0,1,0.0,3,4,75.0,0,0,0.0,1,1,2,1,0,0,0,0,0,2
../kbl_data/2021-2022,S39G01N44,원주 DB,Home,얀테 메이튼,13,2,9,22.2,1,2,50.0,3,11,27.3,6,10,60.0,3,6,9,0,2,0,0,0,1,1
../kbl_data/2021-2022,S39G01N44,원주 DB,Home,레나드 프리먼,13,5,9,55.6,1,1,100.0,6,10,60.0,0,0,0.0,3,14,17,1,0,1,0,2,1,1
../kbl_data/2021-2022,S39G01N44,원주 DB,Home,정호영,6,3,4,75.0,0,1,0.0,3,5,60.0,0,0,0.0,0,1,1,3,0,0,0,0,0,4
../kbl_data/2021-2022,S39G01N44,고양 오리온,Away,김강선,1,0,0,0.0,0,3,0.0,0,3,0.0,1,2,50.0,0,2,2,3,0,0,0,0,0,1
../kbl_data/2021-2022,S39G01N44,고양 오리온,Away,최현민,0,0,0,0.0,0,1,0.0,0,1,0.0,0,0,0.0,0,0,0,0,0,0,0,0,0,1
../kbl_data/2021-2022,S39G01N44,고양 오리온,Away,임종일,0,0,0,0.0,0,0,0.0,0,0,0.0,0,0,0.0,0,1,1,1,0,0,0,0,0,0
../kbl_data/2021-2022,S39G01N44,고양 오리온,Away,이대성,21,9,12,75.0,0,5,0.0,9,17,52.9,3,6,50.0,1,3,4,2,0,0,0,0,0,2
../kbl_data/2021-2022,S39G01N44,고양 오리온,Away,한호빈,17,4,5,80.0,3,5,60.0,7,10,70.0,0,0,0.0,0,3,3,1,1,0,0,0,2,2
../kbl_data/2021-2022,S39G01N44,고양 오리온,Away,최승욱,0,0,0,0.0,0,0,0.0,0,0,0.0,0,0,0.0,0,0,0,0,0,0,0,0,0,0
../kbl_data/2021-2022,S39G01N44,고양 오리온,Away,이승현,8,4,9,44.4,0,1,0.0,4,10,40.0,0,0,0.0,1,6,7,2,0,0,0,0,0,3
../kbl_data/2021-2022,S39G01N44,고양 오리온,Away,이종현,2,0,3,0.0,0,0,0.0,0,3,0.0,2,2,100.0,1,0,1,0,0,0,0,0,1,0
../kbl_data/2021-2022,S39G01N44,고양 오리온,Away,김진유,0,0,0,0.0,0,0,0.0,0,0,0.0,0,0,0.0,1,0,1,0,1,0,0,0,0,0
../kbl_data/2021-2022,S39G01N44,고양 오리온,Away,머피 할로웨이,2,1,7,14.3,0,0,0.0,1,7,14.3,0,0,0.0,1,9,10,2,3,1,0,1,2,1
../kbl_data/2021-2022,S39G01N44,고양 오리온,Away,미로슬라브 라둘리차,4,0,6,0.0,0,0,0.0,0,6,0.0,4,4,100.0,0,8,8,1,0,0,0,0,4,4
../kbl_data/2021-2022,S39G01N44,고양 오리온,Away,이정현,17,6,7,85.7,1,4,25.0,7,11,63.6,2,4,50.0,1,4,5,0,1,1,1,0,0,3
../kbl_data/2021-2022,S39G01N45,수원 KT,Home,김동욱,10,2,3,66.7,2,2,100.0,4,5,80.0,0,0,0.0,0,1,1,5,1,0,0,0,1,1
../kbl_data/2021-2022,S39G01N45,수원 KT,Home,김영환,5,1,4,25.0,1,2,50.0,2,6,33.3,0,0,0.0,1,2,3,4,2,0,0,0,1,4
../kbl_data/2021-2022,S39G01N45,수원 KT,Home,김현민,14,5,8,62.5,1,6,16.7,6,14,42.9,1,2,50.0,5,6,11,0,0,0,0,0,2,4
../kbl_data/2021-2022,S39G01N45,수원 KT,Home,김윤태,0,0,0,0.0,0,1,0.0,0,1,0.0,0,0,0.0,0,0,0,0,0,0,0,0,0,0
../kbl_data/2021-2022,S39G01N45,수원 KT,Home,최창진,0,0,0,0.0,0,0,0.0,0,0,0.0,0,0,0.0,0,1,1,2,0,0,0,0,0,2
../kbl_data/2021-2022,S39G01N45,수원 KT,Home,정성우,9,3,7,42.9,1,7,14.3,4,14,28.6,0,0,0.0,0,3,3,8,3,0,0,0,0,3
../kbl_data/2021-2022,S39G01N45,수원 KT,Home,양홍석,11,1,1,100.0,3,7,42.9,4,8,50.0,0,0,0.0,1,9,10,2,1,0,0,0,1,1
../kbl_data/2021-2022,S39G01N45,수원 KT,Home,박준영,5,2,2,100.0,0,0,0.0,2,2,100.0,1,2,50.0,0,2,2,0,0,0,0,0,0,0
../kbl_data/2021-2022,S39G01N45,수원 KT,Home,캐디 라렌,12,5,8,62.5,0,2,0.0,5,10,50.0,2,5,40.0,3,9,12,2,0,2,0,2,4,2
../kbl_data/2021-2022,S39G01N45,수원 KT,Home,박지원,0,0,1,0.0,0,0,0.0,0,1,0.0,0,0,0.0,1,0,1,1,0,0,0,0,0,0
../kbl_data/2021-2022,S39G01N45,수원 KT,Home,마이크 마이어스,14,7,8,87.5,0,0,0.0,7,8,87.5,0,0,0.0,1,3,4,1,0,0,0,2,4,2
../kbl_data/2021-2022,S39G01N45,수원 KT,Home,하윤기,6,1,2,50.0,0,0,0.0,1,2,50.0,4,4,100.0,2,0,2,0,0,0,0,0,0,0
../kbl_data/2021-2022,S39G01N45,안양 KGC,Away,함준후,0,0,0,0.0,0,0,0.0,0,0,0.0,0,0,0.0,0,0,0,0,0,0,0,0,0,2
../kbl_data/2021-2022,S39G01N45,안양 KGC,Away,오세근,6,2,8,25.0,0,1,0.0,2,9,22.2,2,4,50.0,1,4,5,4,0,0,2,0,3,3
../kbl_data/2021-2022,S39G01N45,안양 KGC,Away,문성곤,20,2,5,40.0,4,9,44.4,6,14,42.9,4,6,66.7,4,2,6,4,2,0,0,0,1,1
../kbl_data/2021-2022,S39G01N45,안양 KGC,Away,전성현,7,2,8,25.0,1,8,12.5,3,16,18.8,0,0,0.0,3,2,5,1,1,0,0,0,0,0
../kbl_data/2021-2022,S39G01N45,안양 KGC,Away,정강호,0,0,0,0.0,0,1,0.0,0,1,0.0,0,0,0.0,0,0,0,0,0,0,0,0,0,2
../kbl_data/2021-2022,S39G01N45,안양 KGC,Away,이우정,0,0,0,0.0,0,0,0.0,0,0,0.0,0,0,0.0,0,0,0,0,0,0,0,0,0,0
../kbl_data/2021-2022,S39G01N45,안양 KGC,Away,대릴 먼로,0,0,0,0.0,0,0,0.0,0,0,0.0,0,0,0.0,0,0,0,1,0,0,0,0,0,0
../kbl_data/2021-2022,S39G01N45,안양 KGC,Away,우동현,0,0,0,0.0,0,1,0.0,0,1,0.0,0,0,0.0,0,0,0,0,0,0,0,0,0,0
../kbl_data/2021-2022,S39G01N45,안양 KGC,Away,변준형,10,3,8,37.5,1,3,33.3,4,11,36.4,1,3,33.3,0,1,1,6,4,0,0,0,2,1
../kbl_data/2021-2022,S39G01N45,안양 KGC,Away,한승희,4,2,6,33.3,0,2,0.0,2,8,25.0,0,0,0.0,3,3,6,0,0,0,0,0,0,4
../kbl_data/2021-2022,S39G01N45,안양 KGC,Away,양승면,0,0,0,0.0,0,0,0.0,0,0,0.0,0,0,0.0,0,0,0,0,0,0,0,0,0,0
../kbl_data/2021-2022,S39G01N45,안양 KGC,Away,오마리 스펠맨,16,5,12,41.7,1,4,25.0,6,16,37.5,3,6,50.0,6,9,15,1,2,3,0,0,3,2
../kbl_data/2021-2022,S39G01N46,대구 한국가스공사,Home,정영삼,8,4,4,100.0,0,0,0.0,4,4,100.0,0,0,0.0,0,1,1,0,1,0,0,0,1,1
../kbl_data/2021-2022,S39G01N46,대구 한국가스공사,Home,민성주,0,0,1,0.0,0,0,0.0,0,1,0.0,0,0,0.0,0,0,0,0,0,0,0,0,0,0
../kbl_data/2021-2022,S39G01N46,대구 한국가스공사,Home,차바위,1,0,1,0.0,0,2,0.0,0,3,0.0,1,2,50.0,0,5,5,0,0,0,0,0,0,2
../kbl_data/2021-2022,S39G01N46,대구 한국가스공사,Home,조상열,0,0,1,0.0,0,1,0.0,0,2,0.0,0,0,0.0,0,0,0,0,0,0,0,0,0,0
../kbl_data/2021-2022,S39G01N46,대구 한국가스공사,Home,이대헌,15,7,10,70.0,0,1,0.0,7,11,63.6,1,3,33.3,3,3,6,3,0,0,0,0,2,2
../kbl_data/2021-2022,S39G01N46,대구 한국가스공사,Home,임준수,0,0,0,0.0,0,1,0.0,0,1,0.0,0,0,0.0,1,0,1,1,0,0,0,0,0,0
../kbl_data/2021-2022,S39G01N46,대구 한국가스공사,Home,김낙현,17,5,8,62.5,1,5,20.0,6,13,46.2,4,5,80.0,0,1,1,8,0,0,0,0,2,1
../kbl_data/2021-2022,S39G01N46,대구 한국가스공사,Home,전현우,5,1,2,50.0,1,6,16.7,2,8,25.0,0,0,0.0,0,3,3,1,1,1,0,0,1,1
../kbl_data/2021-2022,S39G01N46,대구 한국가스공사,Home,양준우,0,0,0,0.0,0,0,0.0,0,0,0.0,0,0,0.0,0,0,0,0,0,0,0,0,0,1
../kbl_data/2021-2022,S39G01N46,대구 한국가스공사,Home,클리프 알렉산더,3,1,1,100.0,0,0,0.0,1,1,100.0,1,1,100.0,0,4,4,0,0,0,0,1,0,5
../kbl_data/2021-2022,S39G01N46,대구 한국가스공사,Home,앤드류 니콜슨,21,8,14,57.1,1,4,25.0,9,18,50.0,2,3,66.7,3,7,10,0,0,0,1,1,3,1
../kbl_data/2021-2022,S39G01N46,대구 한국가스공사,Home,신승민,0,0,0,0.0,0,0,0.0,0,0,0.0,0,0,0.0,0,0,0,0,0,0,0,0,0,1
../kbl_data/2021-2022,S39G01N46,울산 현대모비스,Away,이현민,9,3,6,50.0,1,4,25.0,4,10,40.0,0,0,0.0,0,0,0,1,1,0,0,0,0,2
../kbl_data/2021-2022,S39G01N46,울산 현대모비스,Away,함지훈,8,2,6,33.3,0,0,0.0,2,6,33.3,4,5,80.0,1,3,4,4,0,0,0,0,0,2
../kbl_data/2021-2022,S39G01N46,울산 현대모비스,Away,최진수,8,1,3,33.3,2,5,40.0,3,8,37.5,0,0,0.0,1,3,4,0,1,0,0,0,0,3
../kbl_data/2021-2022,S39G01N46,울산 현대모비스,Away,장재석,2,1,5,20.0,0,0,0.0,1,5,20.0,0,0,0.0,2,4,6,4,1,0,0,0,1,0
../kbl_data/2021-2022,S39G01N46,울산 현대모비스,Away,정성호,6,0,0,0.0,2,7,28.6,2,7,28.6,0,0,0.0,0,1,1,0,1,0,0,0,0,0
../kbl_data/2021-2022,S39G01N46,울산 현대모비스,Away,김영현,3,0,0,0.0,1,1,100.0,1,1,100.0,0,0,0.0,0,0,0,0,0,0,0,0,0,1
../kbl_data/2021-2022,S39G01N46,울산 현대모비스,Away,김수찬,0,0,0,0.0,0,0,0.0,0,0,0.0,0,0,0.0,0,0,0,0,0,0,0,0,0,0
../kbl_data/2021-2022,S39G01N46,울산 현대모비스,Away,서명진,13,2,5,40.0,3,6,50.0,5,11,45.5,0,0,0.0,0,5,5,4,0,0,0,0,1,3
../kbl_data/2021-2022,S39G01N46,울산 현대모비스,Away,얼 클락,13,5,8,62.5,1,3,33.3,6,11,54.5,0,0,0.0,2,4,6,1,0,0,0,1,3,1
../kbl_data/2021-2022,S39G01N46,울산 현대모비스,Away,이우석,3,0,0,0.0,1,3,33.3,1,3,33.3,0,0,0.0,1,0,1,1,0,0,0,0,0,3
../kbl_data/2021-2022,S39G01N46,울산 현대모비스,Away,라숀 토마스,14,4,5,80.0,0,0,0.0,4,5,80.0,6,6,100.0,3,3,6,2,2,0,0,0,2,5
../kbl_data/2021-2022,S39G01N46,울산 현대모비스,Away,신민석,0,0,0,0.0,0,0,0.0,0,0,0.0,0,0,0.0,0,0,0,0,0,0,0,0,0,0
../kbl_data/2021-2022,S39G01N47,전주 KCC,Home,송창용,2,1,1,100.0,0,0,0.0,1,1,100.0,0,0,0.0,0,0,0,0,0,0,0,0,0,0
../kbl_data/2021-2022,S39G01N47,전주 KCC,Home,이정현,26,6,7,85.7,3,8,37.5,9,15,60.0,5,6,83.3,0,2,2,2,0,0,0,0,2,4
../kbl_data/2021-2022,S39G01N47,전주 KCC,Home,라건아,12,6,9,66.7,0,3,0.0,6,12,50.0,0,0,0.0,1,6,7,5,1,1,0,0,1,2
../kbl_data/2021-2022,S39G01N47,전주 KCC,Home,김지완,9,2,5,40.0,0,2,0.0,2,7,28.6,5,6,83.3,0,5,5,5,0,0,0,0,0,2
../kbl_data/2021-2022,S39G01N47,전주 KCC,Home,김상규,10,2,2,100.0,2,3,66.7,4,5,80.0,0,0,0.0,0,2,2,1,1,0,0,0,0,0
../kbl_data/2021-2022,S39G01N47,전주 KCC,Home,유병훈,0,0,0,0.0,0,0,0.0,0,0,0.0,0,0,0.0,0,0,0,0,0,0,0,0,0,0
../kbl_data/2021-2022,S39G01N47,전주 KCC,Home,전준범,5,1,2,50.0,1,2,50.0,2,4,50.0,0,0,0.0,0,2,2,1,0,1,0,0,0,1
../kbl_data/2021-2022,S39G01N47,전주 KCC,Home,이진욱,5,1,1,100.0,1,2,50.0,2,3,66.7,0,0,0.0,0,0,0,0,0,0,0,0,1,3
../kbl_data/2021-2022,S39G01N47,전주 KCC,Home,유현준,11,1,3,33.3,3,4,75.0,4,7,57.1,0,0,0.0,0,2,2,3,3,0,1,0,2,2
../kbl_data/2021-2022,S39G01N47,전주 KCC,Home,라타비우스 윌리엄스,6,3,4,75.0,0,0,0.0,3,4,75.0,0,1,0.0,1,3,4,0,0,0,0,0,0,2
../kbl_data/2021-2022,S39G01N47,전주 KCC,Home,곽정훈,0,0,0,0.0,0,0,0.0,0,0,0.0,0,0,0.0,0,0,0,0,0,0,0,0,0,0
../kbl_data/2021-2022,S39G01N47,전주 KCC,Home,김동현,0,0,0,0.0,0,0,0.0,0,0,0.0,0,0,0.0,0,0,0,0,0,0,0,0,0,0
../kbl_data/2021-2022,S39G01N47,창원 LG,Away,강병현,0,0,0,0.0,0,0,0.0,0,0,0.0,0,0,0.0,0,1,1,0,0,0,0,0,0,1
../kbl_data/2021-2022,S39G01N47,창원 LG,Away,이관희,26,3,7,42.9,6,9,66.7,9,16,56.2,2,2,100.0,0,4,4,3,0,1,0,0,1,3
../kbl_data/2021-2022,S39G01N47,창원 LG,Away,정희재,15,0,0,0.0,5,7,71.4,5,7,71.4,0,0,0.0,0,7,7,2,1,1,0,0,1,3
../kbl_data/2021-2022,S39G01N47,창원 LG,Away,서민수,6,0,0,0.0,2,3,66.7,2,3,66.7,0,0,0.0,1,0,1,1,0,0,0,0,1,0
../kbl_data/2021-2022,S39G01N47,창원 LG,Away,한상혁,2,1,2,50.0,0,0,0.0,1,2,50.0,0,0,0.0,0,1,1,0,0,0,0,0,0,0
../kbl_data/2021-2022,S39G01N47,창원 LG,Away,이재도,17,3,6,50.0,3,7,42.9,6,13,46.2,2,2,100.0,2,2,4,4,2,0,0,0,2,1
../kbl_data/2021-2022,S39G01N47,창원 LG,Away,정해원,5,1,1,100.0,1,3,33.3,2,4,50.0,0,0,0.0,0,1,1,0,2,0,0,0,0,5
../kbl_data/2021-2022,S39G01N47,창원 LG,Away,박정현,0,0,0,0.0,0,0,0.0,0,0,0.0,0,0,0.0,0,0,0,0,0,0,0,0,0,0
../kbl_data/2021-2022,S39G01N47,창원 LG,Away,이광진,0,0,0,0.0,0,3,0.0,0,3,0.0,0,0,0.0,0,1,1,0,0,0,0,0,1,2
../kbl_data/2021-2022,S39G01N47,창원 LG,Away,압둘 말릭 아부,2,1,3,33.3,0,1,0.0,1,4,25.0,0,0,0.0,0,0,0,0,0,0,0,0,1,2
../kbl_data/2021-2022,S39G01N47,창원 LG,Away,아셈 마레이,12,5,9,55.6,0,0,0.0,5,9,55.6,2,4,50.0,4,7,11,8,1,0,0,0,1,2
../kbl_data/2021-2022,S39G01N47,창원 LG,Away,이승우,0,0,0,0.0,0,0,0.0,0,0,0.0,0,0,0.0,0,0,0,0,0,0,0,0,0,0
../kbl_data/2021-2022,S39G01N48,수원 KT,Home,김동욱,6,0,1,0.0,2,3,66.7,2,4,50.0,0,0,0.0,0,3,3,5,1,0,0,0,0,0
../kbl_data/2021-2022,S39G01N48,수원 KT,Home,김영환,16,5,8,62.5,1,2,50.0,6,10,60.0,3,3,100.0,2,1,3,5,1,0,0,0,1,1
../kbl_data/2021-2022,S39G01N48,수원 KT,Home,김현민,0,0,0,0.0,0,1,0.0,0,1,0.0,0,0,0.0,1,0,1,1,1,1,0,0,1,1
../kbl_data/2021-2022,S39G01N48,수원 KT,Home,김윤태,0,0,1,0.0,0,1,0.0,0,2,0.0,0,0,0.0,1,0,1,1,1,0,0,0,0,0
../kbl_data/2021-2022,S39G01N48,수원 KT,Home,김민욱,0,0,0,0.0,0,1,0.0,0,1,0.0,0,0,0.0,0,0,0,0,0,0,0,0,0,1
../kbl_data/2021-2022,S39G01N48,수원 KT,Home,최창진,0,0,0,0.0,0,0,0.0,0,0,0.0,0,0,0.0,0,0,0,0,2,0,0,0,1,2
../kbl_data/2021-2022,S39G01N48,수원 KT,Home,정성우,10,3,8,37.5,1,2,50.0,4,10,40.0,1,3,33.3,1,0,1,5,1,0,0,0,4,2
../kbl_data/2021-2022,S39G01N48,수원 KT,Home,양홍석,20,6,6,100.0,2,4,50.0,8,10,80.0,2,4,50.0,1,11,12,3,1,0,0,0,3,0
../kbl_data/2021-2022,S39G01N48,수원 KT,Home,캐디 라렌,26,10,12,83.3,2,3,66.7,12,15,80.0,0,0,0.0,0,4,4,0,0,1,0,0,2,3
../kbl_data/2021-2022,S39G01N48,수원 KT,Home,박지원,6,2,3,66.7,0,0,0.0,2,3,66.7,2,2,100.0,1,2,3,1,1,1,0,0,1,4
../kbl_data/2021-2022,S39G01N48,수원 KT,Home,마이크 마이어스,4,2,5,40.0,0,0,0.0,2,5,40.0,0,0,0.0,1,5,6,0,0,0,0,1,2,2
../kbl_data/2021-2022,S39G01N48,수원 KT,Home,하윤기,8,3,3,100.0,0,0,0.0,3,3,100.0,2,2,100.0,0,2,2,1,0,0,0,3,0,2
../kbl_data/2021-2022,S39G01N48,고양 오리온,Away,오용준,0,0,0,0.0,0,1,0.0,0,1,0.0,0,0,0.0,0,3,3,0,1,0,0,0,0,0
../kbl_data/2021-2022,S39G01N48,고양 오리온,Away,김강선,2,1,2,50.0,0,1,0.0,1,3,33.3,0,0,0.0,2,0,2,0,0,0,1,0,0,3
../kbl_data/2021-2022,S39G01N48,고양 오리온,Away,최현민,0,0,0,0.0,0,0,0.0,0,0,0.0,0,0,0.0,0,0,0,0,0,0,0,0,0,0
../kbl_data/2021-2022,S39G01N48,고양 오리온,Away,임종일,0,0,0,0.0,0,1,0.0,0,1,0.0,0,2,0.0,0,0,0,0,0,0,0,0,1,1
../kbl_data/2021-2022,S39G01N48,고양 오리온,Away,이대성,25,6,12,50.0,3,6,50.0,9,18,50.0,4,4,100.0,1,0,1,5,1,0,1,0,4,3
../kbl_data/2021-2022,S39G01N48,고양 오리온,Away,한호빈,8,1,1,100.0,2,5,40.0,3,6,50.0,0,0,0.0,0,2,2,5,2,0,0,0,0,4
../kbl_data/2021-2022,S39G01N48,고양 오리온,Away,최승욱,0,0,0,0.0,0,0,0.0,0,0,0.0,0,0,0.0,1,1,2,2,0,0,0,0,1,0
../kbl_data/2021-2022,S39G01N48,고양 오리온,Away,이승현,11,4,14,28.6,1,2,50.0,5,16,31.2,0,0,0.0,2,2,4,3,0,0,0,0,2,1
../kbl_data/2021-2022,S39G01N48,고양 오리온,Away,이종현,6,2,3,66.7,0,0,0.0,2,3,66.7,2,2,100.0,1,2,3,0,0,0,0,0,0,0
../kbl_data/2021-2022,S39G01N48,고양 오리온,Away,머피 할로웨이,19,9,13,69.2,0,0,0.0,9,13,69.2,1,2,50.0,3,6,9,3,2,0,0,1,4,0
../kbl_data/2021-2022,S39G01N48,고양 오리온,Away,미로슬라브 라둘리차,9,3,6,50.0,1,1,100.0,4,7,57.1,0,1,0.0,1,3,4,1,1,0,0,0,0,1
../kbl_data/2021-2022,S39G01N48,고양 오리온,Away,이정현,1,0,2,0.0,0,2,0.0,0,4,0.0,1,2,50.0,0,0,0,3,0,1,0,0,1,1
../kbl_data/2021-2022,S39G01N49,대구 한국가스공사,Home,정영삼,0,0,0,0.0,0,0,0.0,0,0,0.0,0,0,0.0,0,0,0,0,0,0,0,0,0,0
../kbl_data/2021-2022,S39G01N49,대구 한국가스공사,Home,민성주,0,0,0,0.0,0,0,0.0,0,0,0.0,0,0,0.0,0,0,0,0,0,0,0,0,0,0
../kbl_data/2021-2022,S39G01N49,대구 한국가스공사,Home,차바위,10,3,7,42.9,1,2,50.0,4,9,44.4,1,2,50.0,2,4,6,2,2,0,0,0,1,4
../kbl_data/2021-2022,S39G01N49,대구 한국가스공사,Home,조상열,4,0,0,0.0,1,4,25.0,1,4,25.0,1,2,50.0,1,1,2,5,0,0,0,0,0,3
../kbl_data/2021-2022,S39G01N49,대구 한국가스공사,Home,이대헌,25,10,14,71.4,1,2,50.0,11,16,68.8,2,3,66.7,3,4,7,0,0,0,0,1,2,0
../kbl_data/2021-2022,S39G01N49,대구 한국가스공사,Home,임준수,2,1,1,100.0,0,0,0.0,1,1,100.0,0,0,0.0,0,0,0,0,0,0,1,0,0,0
../kbl_data/2021-2022,S39G01N49,대구 한국가스공사,Home,김낙현,5,1,2,50.0,1,7,14.3,2,9,22.2,0,0,0.0,3,1,4,4,2,0,0,0,4,4
../kbl_data/2021-2022,S39G01N49,대구 한국가스공사,Home,전현우,7,2,3,66.7,1,4,25.0,3,7,42.9,0,0,0.0,0,2,2,3,1,0,0,0,0,1
../kbl_data/2021-2022,S39G01N49,대구 한국가스공사,Home,양준우,8,1,2,50.0,2,3,66.7,3,5,60.0,0,0,0.0,1,1,2,6,1,0,0,0,1,3
../kbl_data/2021-2022,S39G01N49,대구 한국가스공사,Home,클리프 알렉산더,4,1,1,100.0,0,1,0.0,1,2,50.0,2,4,50.0,1,3,4,0,1,1,0,0,0,0
../kbl_data/2021-2022,S39G01N49,대구 한국가스공사,Home,앤드류 니콜슨,19,6,10,60.0,2,5,40.0,8,15,53.3,1,2,50.0,3,14,17,0,1,0,0,1,4,1
../kbl_data/2021-2022,S39G01N49,대구 한국가스공사,Home,신승민,2,1,3,33.3,0,2,0.0,1,5,20.0,0,0,0.0,2,2,4,2,0,0,0,0,2,4
../kbl_data/2021-2022,S39G01N49,서울 삼성,Away,장민국,3,0,0,0.0,1,2,50.0,1,2,50.0,0,0,0.0,1,0,1,0,1,0,0,0,0,2
../kbl_data/2021-2022,S39G01N49,서울 삼성,Away,김시래,4,0,1,0.0,1,3,33.3,1,4,25.0,1,2,50.0,0,4,4,7,0,0,1,0,5,0
../kbl_data/2021-2022,S39G01N49,서울 삼성,Away,김현수,4,1,3,33.3,0,5,0.0,1,8,12.5,2,4,50.0,0,1,1,1,0,0,0,0,0,1
../kbl_data/2021-2022,S39G01N49,서울 삼성,Away,임동섭,3,0,1,0.0,1,4,25.0,1,5,20.0,0,0,0.0,0,4,4,0,1,0,1,0,2,4
../kbl_data/2021-2022,S39G01N49,서울 삼성,Away,이동엽,6,0,3,0.0,2,5,40.0,2,8,25.0,0,0,0.0,0,0,0,2,2,0,0,0,0,2
../kbl_data/2021-2022,S39G01N49,서울 삼성,Away,배수용,1,0,1,0.0,0,1,0.0,0,2,0.0,1,2,50.0,1,0,1,2,0,1,0,0,0,1
../kbl_data/2021-2022,S39G01N49,서울 삼성,Away,이호현,2,1,2,50.0,0,1,0.0,1,3,33.3,0,0,0.0,0,3,3,4,0,0,0,0,0,0
../kbl_data/2021-2022,S39G01N49,서울 삼성,Away,아이제아 힉스,11,3,6,50.0,1,3,33.3,4,9,44.4,2,4,50.0,0,4,4,0,2,1,0,0,0,2
../kbl_data/2021-2022,S39G01N49,서울 삼성,Away,차민석,7,3,4,75.0,0,1,0.0,3,5,60.0,1,2,50.0,0,0,0,0,0,0,0,0,1,2
../kbl_data/2021-2022,S39G01N49,서울 삼성,Away,전형준,0,0,0,0.0,0,1,0.0,0,1,0.0,0,0,0.0,0,0,0,1,1,0,0,0,1,2
../kbl_data/2021-2022,S39G01N49,서울 삼성,Away,다니엘 오셰푸,11,4,8,50.0,1,1,100.0,5,9,55.6,0,0,0.0,1,6,7,0,1,1,0,1,2,1
../kbl_data/2021-2022,S39G01N49,서울 삼성,Away,이원석,4,2,4,50.0,0,0,0.0,2,4,50.0,0,0,0.0,2,0,2,0,0,0,0,0,1,2
../kbl_data/2021-2022,S39G01N50,서울 SK,Home,양우섭,4,2,2,100.0,0,1,0.0,2,3,66.7,0,0,0.0,2,0,2,1,1,0,0,0,0,0
../kbl_data/2021-2022,S39G01N50,서울 SK,Home,허일영,8,1,3,33.3,2,5,40.0,3,8,37.5,0,0,0.0,3,1,4,1,2,0,0,0,0,3
../kbl_data/2021-2022,S39G01N50,서울 SK,Home,김선형,16,4,9,44.4,2,3,66.7,6,12,50.0,2,3,66.7,1,1,2,4,0,1,0,0,0,1
../kbl_data/2021-2022,S39G01N50,서울 SK,Home,최부경,2,1,2,50.0,0,0,0.0,1,2,50.0,0,0,0.0,0,4,4,1,0,0,0,0,0,0
../kbl_data/2021-2022,S39G01N50,서울 SK,Home,리온 윌리엄스,2,1,2,50.0,0,0,0.0,1,2,50.0,0,0,0.0,0,2,2,0,1,0,0,0,1,4
../kbl_data/2021-2022,S39G01N50,서울 SK,Home,이현석,0,0,0,0.0,0,0,0.0,0,0,0.0,0,0,0.0,0,0,0,0,0,0,0,0,0,0
../kbl_data/2021-2022,S39G01N50,서울 SK,Home,최원혁,0,0,0,0.0,0,0,0.0,0,0,0.0,0,0,0.0,0,0,0,0,0,0,0,0,0,0
../kbl_data/2021-2022,S39G01N50,서울 SK,Home,최준용,6,1,5,20.0,1,3,33.3,2,8,25.0,1,2,50.0,0,4,4,1,0,2,0,0,2,2
../kbl_data/2021-2022,S39G01N50,서울 SK,Home,안영준,24,5,8,62.5,4,6,66.7,9,14,64.3,2,2,100.0,2,4,6,1,1,0,0,0,0,3
../kbl_data/2021-2022,S39G01N50,서울 SK,Home,자밀 워니,27,10,15,66.7,0,2,0.0,10,17,58.8,7,8,87.5,3,9,12,4,1,1,0,0,2,1
../kbl_data/2021-2022,S39G01N50,서울 SK,Home,김형빈,0,0,0,0.0,0,0,0.0,0,0,0.0,0,0,0.0,0,0,0,0,0,0,0,0,0,0
../kbl_data/2021-2022,S39G01N50,서울 SK,Home,오재현,2,0,1,0.0,0,1,0.0,0,2,0.0,2,2,100.0,0,4,4,2,0,0,0,0,0,3
../kbl_data/2021-2022,S39G01N50,수원 KT,Away,김동욱,8,1,3,33.3,2,6,33.3,3,9,33.3,0,0,0.0,0,1,1,3,0,0,0,0,1,2
../kbl_data/2021-2022,S39G01N50,수원 KT,Away,김영환,0,0,1,0.0,0,3,0.0,0,4,0.0,0,0,0.0,2,2,4,0,0,0,0,0,0,0
../kbl_data/2021-2022,S39G01N50,수원 KT,Away,김현민,0,0,0,0.0,0,0,0.0,0,0,0.0,0,0,0.0,0,0,0,0,0,0,0,0,0,0
../kbl_data/2021-2022,S39G01N50,수원 KT,Away,김윤태,0,0,0,0.0,0,0,0.0,0,0,0.0,0,0,0.0,0,0,0,0,0,0,0,0,0,0
../kbl_data/2021-2022,S39G01N50,수원 KT,Away,최창진,7,3,6,50.0,0,3,0.0,3,9,33.3,1,1,100.0,2,3,5,1,0,0,1,0,2,4
../kbl_data/2021-2022,S39G01N50,수원 KT,Away,정성우,14,5,10,50.0,1,4,25.0,6,14,42.9,1,3,33.3,2,1,3,2,0,0,0,0,1,3
../kbl_data/2021-2022,S39G01N50,수원 KT,Away,양홍석,4,2,2,100.0,0,3,0.0,2,5,40.0,0,0,0.0,1,2,3,0,0,0,0,0,0,1
../kbl_data/2021-2022,S39G01N50,수원 KT,Away,박준영,0,0,0,0.0,0,0,0.0,0,0,0.0,0,0,0.0,0,0,0,0,0,0,0,0,0,0
../kbl_data/2021-2022,S39G01N50,수원 KT,Away,캐디 라렌,9,3,11,27.3,1,7,14.3,4,18,22.2,0,0,0.0,6,10,16,1,1,1,0,0,2,3
../kbl_data/2021-2022,S39G01N50,수원 KT,Away,박지원,2,1,3,33.3,0,0,0.0,1,3,33.3,0,2,0.0,2,1,3,2,1,0,0,0,0,1
../kbl_data/2021-2022,S39G01N50,수원 KT,Away,마이크 마이어스,11,4,7,57.1,0,0,0.0,4,7,57.1,3,4,75.0,1,1,2,0,1,0,0,0,1,2
../kbl_data/2021-2022,S39G01N50,수원 KT,Away,하윤기,10,5,8,62.5,0,0,0.0,5,8,62.5,0,2,0.0,1,2,3,0,0,0,0,1,1,0
../kbl_data/2021-2022,S39G01N51,안양 KGC,Home,함준후,0,0,0,0.0,0,0,0.0,0,0,0.0,0,0,0.0,0,1,1,0,0,0,0,0,0,2
../kbl_data/2021-2022,S39G01N51,안양 KGC,Home,오세근,14,5,9,55.6,0,2,0.0,5,11,45.5,4,4,100.0,3,3,6,3,0,0,0,0,4,3
../kbl_data/2021-2022,S39G01N51,안양 KGC,Home,문성곤,2,1,3,33.3,0,5,0.0,1,8,12.5,0,0,0.0,3,4,7,0,1,0,1,0,0,4
../kbl_data/2021-2022,S39G01N51,안양 KGC,Home,전성현,20,3,10,30.0,4,6,66.7,7,16,43.8,2,3,66.7,0,2,2,2,2,0,0,0,1,0
../kbl_data/2021-2022,S39G01N51,안양 KGC,Home,정강호,0,0,0,0.0,0,0,0.0,0,0,0.0,0,0,0.0,0,0,0,0,0,0,0,0,0,0
../kbl_data/2021-2022,S39G01N51,안양 KGC,Home,이우정,0,0,0,0.0,0,0,0.0,0,0,0.0,0,0,0.0,0,0,0,0,0,0,0,0,0,0
../kbl_data/2021-2022,S39G01N51,안양 KGC,Home,대릴 먼로,1,0,1,0.0,0,0,0.0,0,1,0.0,1,2,50.0,0,0,0,0,1,0,0,0,0,0
../kbl_data/2021-2022,S39G01N51,안양 KGC,Home,우동현,0,0,0,0.0,0,0,0.0,0,0,0.0,0,0,0.0,0,0,0,0,0,0,0,0,0,0
../kbl_data/2021-2022,S39G01N51,안양 KGC,Home,변준형,12,3,7,42.9,0,3,0.0,3,10,30.0,6,9,66.7,2,1,3,7,2,1,0,0,1,4
../kbl_data/2021-2022,S39G01N51,안양 KGC,Home,한승희,0,0,1,0.0,0,0,0.0,0,1,0.0,0,0,0.0,0,1,1,0,0,0,0,0,0,1
../kbl_data/2021-2022,S39G01N51,안양 KGC,Home,양승면,0,0,1,0.0,0,0,0.0,0,1,0.0,0,0,0.0,0,0,0,0,0,0,0,0,0,0
../kbl_data/2021-2022,S39G01N51,안양 KGC,Home,오마리 스펠맨,30,9,13,69.2,2,7,28.6,11,20,55.0,6,7,85.7,6,12,18,1,2,2,0,1,0,2
../kbl_data/2021-2022,S39G01N51,서울 삼성,Away,장민국,0,0,0,0.0,0,0,0.0,0,0,0.0,0,0,0.0,0,1,1,0,0,0,0,0,0,0
../kbl_data/2021-2022,S39G01N51,서울 삼성,Away,김시래,15,3,7,42.9,2,7,28.6,5,14,35.7,3,4,75.0,1,3,4,7,3,0,0,0,1,3
../kbl_data/2021-2022,S39G01N51,서울 삼성,Away,김현수,3,0,1,0.0,1,1,100.0,1,2,50.0,0,0,0.0,1,1,2,2,0,0,0,0,1,2
../kbl_data/2021-2022,S39G01N51,서울 삼성,Away,임동섭,8,1,2,50.0,2,9,22.2,3,11,27.3,0,0,0.0,2,2,4,1,0,0,0,0,0,4
../kbl_data/2021-2022,S39G01N51,서울 삼성,Away,이동엽,8,1,2,50.0,2,4,50.0,3,6,50.0,0,0,0.0,3,3,6,1,0,0,0,0,0,2
../kbl_data/2021-2022,S39G01N51,서울 삼성,Away,배수용,5,1,3,33.3,1,2,50.0,2,5,40.0,0,2,0.0,2,3,5,1,0,0,0,0,0,4
../kbl_data/2021-2022,S39G01N51,서울 삼성,Away,이호현,0,0,0,0.0,0,0,0.0,0,0,0.0,0,0,0.0,0,0,0,0,0,0,0,0,0,0
../kbl_data/2021-2022,S39G01N51,서울 삼성,Away,아이제아 힉스,22,7,14,50.0,2,3,66.7,9,17,52.9,2,4,50.0,3,7,10,1,2,1,0,0,6,4
../kbl_data/2021-2022,S39G01N51,서울 삼성,Away,차민석,0,0,0,0.0,0,1,0.0,0,1,0.0,0,0,0.0,0,2,2,1,0,0,0,0,0,1
../kbl_data/2021-2022,S39G01N51,서울 삼성,Away,전형준,3,0,2,0.0,1,1,100.0,1,3,33.3,0,0,0.0,0,1,1,0,0,0,0,0,1,2
../kbl_data/2021-2022,S39G01N51,서울 삼성,Away,다니엘 오셰푸,6,3,4,75.0,0,1,0.0,3,5,60.0,0,0,0.0,1,4,5,1,1,0,0,1,0,1
../kbl_data/2021-2022,S39G01N51,서울 삼성,Away,이원석,5,1,2,50.0,1,2,50.0,2,4,50.0,0,0,0.0,1,1,2,0,0,0,0,0,1,1
../kbl_data/2021-2022,S39G01N52,울산 현대모비스,Home,이현민,2,1,4,25.0,0,3,0.0,1,7,14.3,0,0,0.0,0,1,1,1,1,0,0,0,0,1
../kbl_data/2021-2022,S39G01N52,울산 현대모비스,Home,함지훈,14,7,8,87.5,0,0,0.0,7,8,87.5,0,1,0.0,3,2,5,0,1,0,0,0,2,1
../kbl_data/2021-2022,S39G01N52,울산 현대모비스,Home,최진수,7,0,2,0.0,2,6,33.3,2,8,25.0,1,2,50.0,1,2,3,2,0,2,0,0,0,3
../kbl_data/2021-2022,S39G01N52,울산 현대모비스,Home,장재석,6,3,6,50.0,0,0,0.0,3,6,50.0,0,0,0.0,0,1,1,3,0,0,0,0,1,1
../kbl_data/2021-2022,S39G01N52,울산 현대모비스,Home,정성호,2,1,1,100.0,0,1,0.0,1,2,50.0,0,0,0.0,2,1,3,2,0,0,0,0,0,0
../kbl_data/2021-2022,S39G01N52,울산 현대모비스,Home,김영현,0,0,0,0.0,0,0,0.0,0,0,0.0,0,0,0.0,0,0,0,0,0,0,0,0,0,0
../kbl_data/2021-2022,S39G01N52,울산 현대모비스,Home,김수찬,0,0,0,0.0,0,0,0.0,0,0,0.0,0,0,0.0,0,1,1,0,0,0,0,0,0,0
../kbl_data/2021-2022,S39G01N52,울산 현대모비스,Home,서명진,5,1,5,20.0,0,4,0.0,1,9,11.1,3,4,75.0,0,1,1,2,1,0,0,0,2,1
../kbl_data/2021-2022,S39G01N52,울산 현대모비스,Home,얼 클락,11,1,2,50.0,3,4,75.0,4,6,66.7,0,0,0.0,1,7,8,0,0,2,0,1,2,3
../kbl_data/2021-2022,S39G01N52,울산 현대모비스,Home,이우석,18,6,11,54.5,0,4,0.0,6,15,40.0,6,6,100.0,1,6,7,4,2,1,0,0,0,1
../kbl_data/2021-2022,S39G01N52,울산 현대모비스,Home,라숀 토마스,10,5,8,62.5,0,0,0.0,5,8,62.5,0,0,0.0,2,4,6,1,1,0,0,1,0,3
../kbl_data/2021-2022,S39G01N52,울산 현대모비스,Home,신민석,0,0,0,0.0,0,0,0.0,0,0,0.0,0,0,0.0,0,0,0,0,0,0,0,0,0,0
../kbl_data/2021-2022,S39G01N52,전주 KCC,Away,송창용,0,0,1,0.0,0,3,0.0,0,4,0.0,0,0,0.0,0,2,2,0,1,0,0,0,0,3
../kbl_data/2021-2022,S39G01N52,전주 KCC,Away,이정현,16,2,7,28.6,3,5,60.0,5,12,41.7,3,5,60.0,3,2,5,7,2,1,0,0,3,3
../kbl_data/2021-2022,S39G01N52,전주 KCC,Away,라건아,28,12,21,57.1,0,2,0.0,12,23,52.2,4,6,66.7,3,7,10,0,1,2,0,0,0,1
../kbl_data/2021-2022,S39G01N52,전주 KCC,Away,김지완,8,1,5,20.0,2,3,66.7,3,8,37.5,0,0,0.0,0,4,4,3,1,0,0,0,1,2
../kbl_data/2021-2022,S39G01N52,전주 KCC,Away,김상규,7,3,4,75.0,0,2,0.0,3,6,50.0,1,2,50.0,2,4,6,2,0,1,0,0,1,4
../kbl_data/2021-2022,S39G01N52,전주 KCC,Away,유병훈,0,0,1,0.0,0,0,0.0,0,1,0.0,0,0,0.0,0,0,0,0,0,0,0,0,1,0
../kbl_data/2021-2022,S39G01N52,전주 KCC,Away,전준범,3,0,0,0.0,1,4,25.0,1,4,25.0,0,0,0.0,0,0,0,0,0,1,0,0,2,0
../kbl_data/2021-2022,S39G01N52,전주 KCC,Away,이진욱,0,0,0,0.0,0,1,0.0,0,1,0.0,0,0,0.0,1,0,1,0,0,0,0,0,1,1
../kbl_data/2021-2022,S39G01N52,전주 KCC,Away,유현준,6,3,3,100.0,0,1,0.0,3,4,75.0,0,0,0.0,0,3,3,5,0,0,0,0,2,2
../kbl_data/2021-2022,S39G01N52,전주 KCC,Away,라타비우스 윌리엄스,10,5,5,100.0,0,0,0.0,5,5,100.0,0,1,0.0,3,4,7,0,0,0,0,0,0,1
../kbl_data/2021-2022,S39G01N52,전주 KCC,Away,곽정훈,0,0,0,0.0,0,0,0.0,0,0,0.0,0,0,0.0,0,0,0,0,0,0,0,0,0,0
../kbl_data/2021-2022,S39G01N52,전주 KCC,Away,김동현,0,0,1,0.0,0,0,0.0,0,1,0.0,0,0,0.0,0,1,1,1,0,0,0,0,0,0
../kbl_data/2021-2022,S39G01N53,고양 오리온,Home,오용준,0,0,0,0.0,0,0,0.0,0,0,0.0,0,0,0.0,0,0,0,0,0,0,0,0,0,0
../kbl_data/2021-2022,S39G01N53,고양 오리온,Home,김강선,0,0,0,0.0,0,0,0.0,0,0,0.0,0,0,0.0,0,0,0,0,0,0,0,0,0,2
../kbl_data/2021-2022,S39G01N53,고양 오리온,Home,최현민,12,2,2,100.0,2,4,50.0,4,6,66.7,2,2,100.0,1,1,2,0,0,0,0,0,1,2
../kbl_data/2021-2022,S39G01N53,고양 오리온,Home,이대성,16,4,4,100.0,0,1,0.0,4,5,80.0,8,8,100.0,0,0,0,3,2,0,0,0,1,1
../kbl_data/2021-2022,S39G01N53,고양 오리온,Home,한호빈,12,1,1,100.0,3,5,60.0,4,6,66.7,1,2,50.0,0,1,1,4,0,0,0,0,4,3
../kbl_data/2021-2022,S39G01N53,고양 오리온,Home,최승욱,0,0,0,0.0,0,0,0.0,0,0,0.0,0,0,0.0,0,0,0,1,1,0,0,0,0,0
../kbl_data/2021-2022,S39G01N53,고양 오리온,Home,이승현,20,7,13,53.8,1,1,100.0,8,14,57.1,3,3,100.0,1,5,6,2,1,0,0,0,5,3
../kbl_data/2021-2022,S39G01N53,고양 오리온,Home,이종현,2,1,1,100.0,0,0,0.0,1,1,100.0,0,0,0.0,0,2,2,0,0,0,0,0,0,2
../kbl_data/2021-2022,S39G01N53,고양 오리온,Home,머피 할로웨이,16,7,12,58.3,0,0,0.0,7,12,58.3,2,3,66.7,1,11,12,2,2,1,0,0,4,2
../kbl_data/2021-2022,S39G01N53,고양 오리온,Home,김세창,2,1,1,100.0,0,1,0.0,1,2,50.0,0,0,0.0,0,2,2,2,1,0,0,0,1,2
../kbl_data/2021-2022,S39G01N53,고양 오리온,Home,미로슬라브 라둘리차,2,1,2,50.0,0,0,0.0,1,2,50.0,0,0,0.0,1,0,1,0,1,0,0,0,0,1
../kbl_data/2021-2022,S39G01N53,고양 오리온,Home,이정현,10,3,6,50.0,1,2,50.0,4,8,50.0,1,1,100.0,0,0,0,7,3,0,1,0,1,1
../kbl_data/2021-2022,S39G01N53,창원 LG,Away,강병현,0,0,0,0.0,0,0,0.0,0,0,0.0,0,0,0.0,0,0,0,0,0,0,0,0,0,0
../kbl_data/2021-2022,S39G01N53,창원 LG,Away,변기훈,2,1,1,100.0,0,1,0.0,1,2,50.0,0,0,0.0,0,0,0,3,2,0,0,0,1,5
../kbl_data/2021-2022,S39G01N53,창원 LG,Away,이관희,20,5,5,100.0,2,4,50.0,7,9,77.8,4,5,80.0,0,2,2,2,3,0,0,0,4,4
../kbl_data/2021-2022,S39G01N53,창원 LG,Away,정희재,11,4,4,100.0,1,2,50.0,5,6,83.3,0,0,0.0,0,1,1,3,0,0,0,0,1,3
../kbl_data/2021-2022,S39G01N53,창원 LG,Away,서민수,0,0,2,0.0,0,1,0.0,0,3,0.0,0,0,0.0,1,2,3,0,0,0,0,0,1,1
../kbl_data/2021-2022,S39G01N53,창원 LG,Away,이재도,19,4,9,44.4,3,9,33.3,7,18,38.9,2,2,100.0,1,1,2,7,2,0,0,0,1,0
../kbl_data/2021-2022,S39G01N53,창원 LG,Away,박정현,12,2,7,28.6,1,2,50.0,3,9,33.3,5,6,83.3,1,2,3,3,3,1,0,0,3,2
../kbl_data/2021-2022,S39G01N53,창원 LG,Away,이광진,0,0,0,0.0,0,0,0.0,0,0,0.0,0,0,0.0,0,0,0,0,0,0,0,0,0,1
../kbl_data/2021-2022,S39G01N53,창원 LG,Away,윤원상,0,0,0,0.0,0,1,0.0,0,1,0.0,0,0,0.0,0,0,0,0,0,0,0,0,0,2
../kbl_data/2021-2022,S39G01N53,창원 LG,Away,압둘 말릭 아부,6,2,3,66.7,0,0,0.0,2,3,66.7,2,2,100.0,0,0,0,1,1,0,0,1,1,0
../kbl_data/2021-2022,S39G01N53,창원 LG,Away,아셈 마레이,15,6,13,46.2,0,0,0.0,6,13,46.2,3,5,60.0,5,9,14,1,4,0,1,1,2,3
../kbl_data/2021-2022,S39G01N53,창원 LG,Away,이승우,0,0,0,0.0,0,0,0.0,0,0,0.0,0,0,0.0,0,0,0,0,0,0,0,0,0,0
../kbl_data/2021-2022,S39G01N54,원주 DB,Home,윤호영,2,1,1,100.0,0,1,0.0,1,2,50.0,0,0,0.0,1,1,2,3,3,0,0,0,1,4
../kbl_data/2021-2022,S39G01N54,원주 DB,Home,박찬희,11,3,6,50.0,1,7,14.3,4,13,30.8,2,4,50.0,0,2,2,4,0,0,0,0,0,2
../kbl_data/2021-2022,S39G01N54,원주 DB,Home,김종규,15,6,6,100.0,1,3,33.3,7,9,77.8,0,0,0.0,2,2,4,2,1,3,1,0,1,3
../kbl_data/2021-2022,S39G01N54,원주 DB,Home,허웅,11,3,4,75.0,1,8,12.5,4,12,33.3,2,2,100.0,2,3,5,6,2,0,0,0,2,1
../kbl_data/2021-2022,S39G01N54,원주 DB,Home,김영훈,11,0,1,0.0,3,5,60.0,3,6,50.0,2,3,66.7,2,1,3,0,0,0,0,0,0,3
../kbl_data/2021-2022,S39G01N54,원주 DB,Home,김철욱,0,0,0,0.0,0,1,0.0,0,1,0.0,0,0,0.0,0,0,0,0,0,0,0,0,0,2
../kbl_data/2021-2022,S39G01N54,원주 DB,Home,나카무라 타이치,0,0,1,0.0,0,1,0.0,0,2,0.0,0,0,0.0,0,1,1,0,1,0,0,0,1,0
../kbl_data/2021-2022,S39G01N54,원주 DB,Home,이용우,3,0,2,0.0,1,3,33.3,1,5,20.0,0,0,0.0,1,1,2,1,0,0,0,0,0,2
../kbl_data/2021-2022,S39G01N54,원주 DB,Home,이준희,0,0,0,0.0,0,0,0.0,0,0,0.0,0,0,0.0,0,0,0,0,0,0,0,0,0,0
../kbl_data/2021-2022,S39G01N54,원주 DB,Home,얀테 메이튼,17,7,8,87.5,0,1,0.0,7,9,77.8,3,6,50.0,2,7,9,2,0,0,0,1,2,4
../kbl_data/2021-2022,S39G01N54,원주 DB,Home,레나드 프리먼,5,2,5,40.0,0,0,0.0,2,5,40.0,1,1,100.0,1,2,3,0,1,1,0,0,0,2
../kbl_data/2021-2022,S39G01N54,원주 DB,Home,정호영,5,1,4,25.0,1,6,16.7,2,10,20.0,0,0,0.0,0,2,2,3,0,1,0,0,0,2
../kbl_data/2021-2022,S39G01N54,대구 한국가스공사,Away,정영삼,0,0,0,0.0,0,2,0.0,0,2,0.0,0,0,0.0,0,0,0,0,0,0,0,0,0,0
../kbl_data/2021-2022,S39G01N54,대구 한국가스공사,Away,홍경기,6,1,2,50.0,1,3,33.3,2,5,40.0,1,2,50.0,1,1,2,1,0,0,0,0,0,4
../kbl_data/2021-2022,S39G01N54,대구 한국가스공사,Away,차바위,5,0,1,0.0,1,4,25.0,1,5,20.0,2,2,100.0,1,3,4,3,0,0,0,0,1,4
../kbl_data/2021-2022,S39G01N54,대구 한국가스공사,Away,조상열,0,0,1,0.0,0,1,0.0,0,2,0.0,0,0,0.0,0,1,1,0,0,0,0,0,2,3
../kbl_data/2021-2022,S39G01N54,대구 한국가스공사,Away,이대헌,11,3,8,37.5,1,2,50.0,4,10,40.0,2,2,100.0,1,3,4,3,1,0,0,0,0,0
../kbl_data/2021-2022,S39G01N54,대구 한국가스공사,Away,임준수,0,0,0,0.0,0,0,0.0,0,0,0.0,0,0,0.0,0,0,0,0,0,0,0,0,0,0
../kbl_data/2021-2022,S39G01N54,대구 한국가스공사,Away,김낙현,23,3,4,75.0,5,6,83.3,8,10,80.0,2,5,40.0,1,4,5,12,1,0,1,0,3,2
../kbl_data/2021-2022,S39G01N54,대구 한국가스공사,Away,전현우,7,1,1,100.0,1,4,25.0,2,5,40.0,2,2,100.0,0,2,2,0,1,0,0,0,0,2
../kbl_data/2021-2022,S39G01N54,대구 한국가스공사,Away,양준우,0,0,1,0.0,0,1,0.0,0,2,0.0,0,0,0.0,0,0,0,1,0,0,0,0,0,1
../kbl_data/2021-2022,S39G01N54,대구 한국가스공사,Away,클리프 알렉산더,2,0,3,0.0,0,0,0.0,0,3,0.0,2,2,100.0,0,7,7,0,0,0,0,0,2,1
../kbl_data/2021-2022,S39G01N54,대구 한국가스공사,Away,앤드류 니콜슨,30,10,11,90.9,1,6,16.7,11,17,64.7,7,8,87.5,1,11,12,2,1,0,0,0,2,4
../kbl_data/2021-2022,S39G01N54,대구 한국가스공사,Away,신승민,0,0,1,0.0,0,0,0.0,0,1,0.0,0,0,0.0,1,0,1,1,0,0,0,0,1,0
../kbl_data/2021-2022,S39G01N55,수원 KT,Home,김동욱,8,0,1,0.0,2,7,28.6,2,8,25.0,2,3,66.7,2,4,6,5,0,0,0,0,2,0
../kbl_data/2021-2022,S39G01N55,수원 KT,Home,김영환,10,2,7,28.6,2,3,66.7,4,10,40.0,0,0,0.0,1,2,3,3,2,0,1,0,2,1
../kbl_data/2021-2022,S39G01N55,수원 KT,Home,김현민,0,0,0,0.0,0,0,0.0,0,0,0.0,0,0,0.0,0,0,0,0,0,0,0,0,0,0
../kbl_data/2021-2022,S39G01N55,수원 KT,Home,최창진,4,2,3,66.7,0,1,0.0,2,4,50.0,0,0,0.0,2,1,3,1,0,0,0,0,0,2
../kbl_data/2021-2022,S39G01N55,수원 KT,Home,정성우,16,2,4,50.0,3,5,60.0,5,9,55.6,3,4,75.0,0,1,1,1,3,0,0,0,1,4
../kbl_data/2021-2022,S39G01N55,수원 KT,Home,양홍석,7,2,3,66.7,1,4,25.0,3,7,42.9,0,0,0.0,0,4,4,3,0,1,0,0,2,1
../kbl_data/2021-2022,S39G01N55,수원 KT,Home,박준영,0,0,0,0.0,0,0,0.0,0,0,0.0,0,0,0.0,0,0,0,0,0,0,0,0,0,0
../kbl_data/2021-2022,S39G01N55,수원 KT,Home,캐디 라렌,29,12,17,70.6,1,3,33.3,13,20,65.0,2,6,33.3,5,8,13,1,2,1,0,2,2,4
../kbl_data/2021-2022,S39G01N55,수원 KT,Home,문상옥,0,0,0,0.0,0,0,0.0,0,0,0.0,0,0,0.0,0,0,0,0,0,0,0,0,0,0
../kbl_data/2021-2022,S39G01N55,수원 KT,Home,박지원,4,2,2,100.0,0,1,0.0,2,3,66.7,0,0,0.0,0,0,0,2,0,0,0,0,0,2
../kbl_data/2021-2022,S39G01N55,수원 KT,Home,마이크 마이어스,0,0,1,0.0,0,0,0.0,0,1,0.0,0,0,0.0,0,1,1,0,0,0,0,0,0,1
../kbl_data/2021-2022,S39G01N55,수원 KT,Home,하윤기,2,0,3,0.0,0,0,0.0,0,3,0.0,2,2,100.0,1,1,2,0,0,0,0,0,1,1
../kbl_data/2021-2022,S39G01N55,전주 KCC,Away,송창용,3,0,2,0.0,1,3,33.3,1,5,20.0,0,0,0.0,0,2,2,0,1,0,1,0,1,0
../kbl_data/2021-2022,S39G01N55,전주 KCC,Away,이정현,18,5,10,50.0,2,6,33.3,7,16,43.8,2,2,100.0,0,6,6,3,0,0,0,0,2,1
../kbl_data/2021-2022,S39G01N55,전주 KCC,Away,라건아,24,6,8,75.0,3,4,75.0,9,12,75.0,3,3,100.0,6,4,10,2,0,1,0,0,2,4
../kbl_data/2021-2022,S39G01N55,전주 KCC,Away,김지완,4,2,7,28.6,0,4,0.0,2,11,18.2,0,0,0.0,0,0,0,4,0,0,0,0,0,1
../kbl_data/2021-2022,S39G01N55,전주 KCC,Away,김상규,2,1,1,100.0,0,1,0.0,1,2,50.0,0,0,0.0,2,2,4,0,0,0,0,0,0,2
../kbl_data/2021-2022,S39G01N55,전주 KCC,Away,유병훈,0,0,0,0.0,0,0,0.0,0,0,0.0,0,0,0.0,0,0,0,0,0,0,0,0,0,0
../kbl_data/2021-2022,S39G01N55,전주 KCC,Away,전준범,4,1,1,100.0,0,1,0.0,1,2,50.0,2,2,100.0,1,0,1,0,1,0,1,0,0,3
../kbl_data/2021-2022,S39G01N55,전주 KCC,Away,박재현,0,0,3,0.0,0,0,0.0,0,3,0.0,0,0,0.0,0,0,0,1,0,0,0,0,0,1
../kbl_data/2021-2022,S39G01N55,전주 KCC,Away,이진욱,0,0,0,0.0,0,0,0.0,0,0,0.0,0,0,0.0,0,1,1,4,1,0,0,0,0,1
../kbl_data/2021-2022,S39G01N55,전주 KCC,Away,유현준,18,3,6,50.0,4,5,80.0,7,11,63.6,0,0,0.0,0,1,1,3,1,0,0,0,3,3
../kbl_data/2021-2022,S39G01N55,전주 KCC,Away,라타비우스 윌리엄스,6,3,3,100.0,0,0,0.0,3,3,100.0,0,2,0.0,1,5,6,1,0,0,0,0,0,2
../kbl_data/2021-2022,S39G01N55,전주 KCC,Away,곽정훈,0,0,0,0.0,0,0,0.0,0,0,0.0,0,0,0.0,0,0,0,0,0,0,0,0,0,0
../kbl_data/2021-2022,S39G01N56,서울 SK,Home,양우섭,0,0,1,0.0,0,0,0.0,0,1,0.0,0,0,0.0,2,2,4,0,0,0,0,0,0,2
../kbl_data/2021-2022,S39G01N56,서울 SK,Home,허일영,10,2,5,40.0,1,2,50.0,3,7,42.9,3,4,75.0,1,1,2,0,0,0,0,0,0,1
../kbl_data/2021-2022,S39G01N56,서울 SK,Home,김선형,15,5,10,50.0,1,4,25.0,6,14,42.9,2,3,66.7,0,2,2,3,3,0,0,0,2,0
../kbl_data/2021-2022,S39G01N56,서울 SK,Home,최부경,2,1,2,50.0,0,0,0.0,1,2,50.0,0,0,0.0,0,3,3,1,2,0,0,0,0,2
../kbl_data/2021-2022,S39G01N56,서울 SK,Home,리온 윌리엄스,4,2,2,100.0,0,0,0.0,2,2,100.0,0,0,0.0,0,0,0,0,0,0,0,0,0,0
../kbl_data/2021-2022,S39G01N56,서울 SK,Home,이현석,0,0,0,0.0,0,0,0.0,0,0,0.0,0,0,0.0,0,0,0,0,0,0,0,0,0,0
../kbl_data/2021-2022,S39G01N56,서울 SK,Home,최원혁,0,0,0,0.0,0,0,0.0,0,0,0.0,0,0,0.0,0,0,0,0,0,0,0,0,0,2
../kbl_data/2021-2022,S39G01N56,서울 SK,Home,최준용,12,2,4,50.0,2,10,20.0,4,14,28.6,2,4,50.0,1,5,6,1,0,0,0,0,3,4
../kbl_data/2021-2022,S39G01N56,서울 SK,Home,안영준,8,1,6,16.7,1,3,33.3,2,9,22.2,3,5,60.0,2,3,5,4,1,0,0,0,4,2
../kbl_data/2021-2022,S39G01N56,서울 SK,Home,자밀 워니,22,10,15,66.7,0,1,0.0,10,16,62.5,2,2,100.0,5,8,13,3,3,0,0,4,1,3
../kbl_data/2021-2022,S39G01N56,서울 SK,Home,김형빈,0,0,0,0.0,0,0,0.0,0,0,0.0,0,0,0.0,0,0,0,0,0,0,0,0,0,0
../kbl_data/2021-2022,S39G01N56,서울 SK,Home,오재현,4,0,0,0.0,0,0,0.0,0,0,0.0,4,4,100.0,0,0,0,2,0,0,0,0,0,3
../kbl_data/2021-2022,S39G01N56,안양 KGC,Away,함준후,0,0,0,0.0,0,0,0.0,0,0,0.0,0,0,0.0,0,1,1,0,0,0,0,0,0,2
../kbl_data/2021-2022,S39G01N56,안양 KGC,Away,오세근,12,4,7,57.1,0,0,0.0,4,7,57.1,4,6,66.7,4,1,5,1,3,2,0,0,0,2
../kbl_data/2021-2022,S39G01N56,안양 KGC,Away,문성곤,14,1,1,100.0,4,7,57.1,5,8,62.5,0,0,0.0,4,5,9,1,2,0,0,0,1,4
../kbl_data/2021-2022,S39G01N56,안양 KGC,Away,전성현,10,1,2,50.0,2,7,28.6,3,9,33.3,2,2,100.0,0,2,2,0,0,0,0,0,0,1
../kbl_data/2021-2022,S39G01N56,안양 KGC,Away,정강호,0,0,0,0.0,0,0,0.0,0,0,0.0,0,0,0.0,0,0,0,0,0,0,0,0,0,0
../kbl_data/2021-2022,S39G01N56,안양 KGC,Away,이우정,3,0,0,0.0,1,3,33.3,1,3,33.3,0,0,0.0,1,1,2,1,0,0,0,0,2,3
../kbl_data/2021-2022,S39G01N56,안양 KGC,Away,대릴 먼로,2,1,3,33.3,0,0,0.0,1,3,33.3,0,0,0.0,0,2,2,1,0,0,0,0,0,2
../kbl_data/2021-2022,S39G01N56,안양 KGC,Away,우동현,0,0,0,0.0,0,0,0.0,0,0,0.0,0,0,0.0,0,0,0,0,0,0,0,0,0,0
../kbl_data/2021-2022,S39G01N56,안양 KGC,Away,변준형,12,4,4,100.0,1,1,100.0,5,5,100.0,1,1,100.0,0,1,1,3,0,0,0,0,4,4
../kbl_data/2021-2022,S39G01N56,안양 KGC,Away,한승희,0,0,0,0.0,0,1,0.0,0,1,0.0,0,0,0.0,0,0,0,2,0,0,0,0,0,0
../kbl_data/2021-2022,S39G01N56,안양 KGC,Away,양승면,0,0,2,0.0,0,0,0.0,0,2,0.0,0,0,0.0,0,0,0,0,1,0,0,0,0,2
../kbl_data/2021-2022,S39G01N56,안양 KGC,Away,오마리 스펠맨,26,6,16,37.5,3,8,37.5,9,24,37.5,5,12,41.7,2,12,14,4,2,1,0,0,5,0
../kbl_data/2021-2022,S39G01N57,고양 오리온,Home,오용준,9,0,0,0.0,3,4,75.0,3,4,75.0,0,0,0.0,0,0,0,0,2,1,0,0,0,2
../kbl_data/2021-2022,S39G01N57,고양 오리온,Home,김강선,0,0,2,0.0,0,1,0.0,0,3,0.0,0,0,0.0,0,1,1,1,0,0,0,0,0,0
../kbl_data/2021-2022,S39G01N57,고양 오리온,Home,최현민,0,0,1,0.0,0,1,0.0,0,2,0.0,0,0,0.0,0,1,1,0,0,0,0,0,0,0
../kbl_data/2021-2022,S39G01N57,고양 오리온,Home,임종일,6,0,0,0.0,1,1,100.0,1,1,100.0,3,4,75.0,0,1,1,2,0,0,0,0,0,2
../kbl_data/2021-2022,S39G01N57,고양 오리온,Home,한호빈,8,2,3,66.7,1,3,33.3,3,6,50.0,1,2,50.0,1,6,7,7,0,0,0,0,2,1
../kbl_data/2021-2022,S39G01N57,고양 오리온,Home,최승욱,0,0,0,0.0,0,0,0.0,0,0,0.0,0,0,0.0,0,0,0,0,0,0,0,0,0,1
../kbl_data/2021-2022,S39G01N57,고양 오리온,Home,이승현,19,6,9,66.7,1,2,50.0,7,11,63.6,4,4,100.0,1,8,9,7,1,0,0,0,0,0
../kbl_data/2021-2022,S39G01N57,고양 오리온,Home,이종현,4,1,6,16.7,0,0,0.0,1,6,16.7,2,2,100.0,0,4,4,2,2,2,0,0,1,0
../kbl_data/2021-2022,S39G01N57,고양 오리온,Home,김세창,5,1,2,50.0,1,1,100.0,2,3,66.7,0,0,0.0,0,0,0,2,0,0,0,0,0,3
../kbl_data/2021-2022,S39G01N57,고양 오리온,Home,박진철,0,0,0,0.0,0,0,0.0,0,0,0.0,0,0,0.0,0,0,0,0,0,0,0,0,0,1
../kbl_data/2021-2022,S39G01N57,고양 오리온,Home,미로슬라브 라둘리차,24,5,8,62.5,3,3,100.0,8,11,72.7,5,7,71.4,1,5,6,0,2,0,0,0,4,3
../kbl_data/2021-2022,S39G01N57,고양 오리온,Home,이정현,18,3,8,37.5,4,8,50.0,7,16,43.8,0,0,0.0,1,1,2,8,2,0,0,0,2,3
../kbl_data/2021-2022,S39G01N57,원주 DB,Away,윤호영,3,0,2,0.0,1,2,50.0,1,4,25.0,0,2,0.0,0,1,1,0,1,0,0,0,1,1
../kbl_data/2021-2022,S39G01N57,원주 DB,Away,정준원,5,1,3,33.3,1,1,100.0,2,4,50.0,0,0,0.0,1,2,3,0,1,0,0,0,1,2
../kbl_data/2021-2022,S39G01N57,원주 DB,Away,김종규,21,7,11,63.6,1,2,50.0,8,13,61.5,4,4,100.0,1,6,7,1,0,2,0,0,1,3
../kbl_data/2021-2022,S39G01N57,원주 DB,Away,허웅,10,2,4,50.0,2,5,40.0,4,9,44.4,0,0,0.0,0,2,2,9,0,0,0,0,2,2
../kbl_data/2021-2022,S39G01N57,원주 DB,Away,김영훈,0,0,1,0.0,0,1,0.0,0,2,0.0,0,0,0.0,0,0,0,0,1,0,1,0,1,1
../kbl_data/2021-2022,S39G01N57,원주 DB,Away,김철욱,4,2,2,100.0,0,3,0.0,2,5,40.0,0,0,0.0,1,1,2,1,0,0,0,0,0,1
../kbl_data/2021-2022,S39G01N57,원주 DB,Away,나카무라 타이치,6,0,2,0.0,1,3,33.3,1,5,20.0,3,3,100.0,0,3,3,2,0,0,0,0,1,1
../kbl_data/2021-2022,S39G01N57,원주 DB,Away,이용우,0,0,0,0.0,0,0,0.0,0,0,0.0,0,0,0.0,0,0,0,0,0,0,0,0,1,0
../kbl_data/2021-2022,S39G01N57,원주 DB,Away,이준희,3,1,2,50.0,0,1,0.0,1,3,33.3,1,2,50.0,1,2,3,0,0,0,0,0,1,0
../kbl_data/2021-2022,S39G01N57,원주 DB,Away,얀테 메이튼,8,2,4,50.0,1,1,100.0,3,5,60.0,1,2,50.0,0,1,1,1,0,0,0,1,1,2
../kbl_data/2021-2022,S39G01N57,원주 DB,Away,레나드 프리먼,12,6,9,66.7,0,0,0.0,6,9,66.7,0,0,0.0,3,9,12,2,1,1,0,1,0,1
../kbl_data/2021-2022,S39G01N57,원주 DB,Away,정호영,13,5,9,55.6,1,2,50.0,6,11,54.5,0,0,0.0,1,2,3,5,0,0,0,0,2,2
../kbl_data/2021-2022,S39G01N58,울산 현대모비스,Home,이현민,2,1,1,100.0,0,0,0.0,1,1,100.0,0,0,0.0,0,1,1,10,0,0,0,0,1,3
../kbl_data/2021-2022,S39G01N58,울산 현대모비스,Home,함지훈,4,2,4,50.0,0,1,0.0,2,5,40.0,0,0,0.0,1,1,2,2,0,0,0,0,0,0
../kbl_data/2021-2022,S39G01N58,울산 현대모비스,Home,최진수,0,0,1,0.0,0,2,0.0,0,3,0.0,0,0,0.0,0,1,1,0,1,1,0,0,0,2
../kbl_data/2021-2022,S39G01N58,울산 현대모비스,Home,장재석,21,8,14,57.1,0,0,0.0,8,14,57.1,5,8,62.5,5,2,7,1,2,1,0,0,0,4
../kbl_data/2021-2022,S39G01N58,울산 현대모비스,Home,정성호,3,0,1,0.0,1,2,50.0,1,3,33.3,0,0,0.0,0,3,3,0,0,0,0,0,0,1
../kbl_data/2021-2022,S39G01N58,울산 현대모비스,Home,김영현,0,0,0,0.0,0,0,0.0,0,0,0.0,0,0,0.0,0,0,0,0,0,0,0,0,0,0
../kbl_data/2021-2022,S39G01N58,울산 현대모비스,Home,김수찬,0,0,0,0.0,0,0,0.0,0,0,0.0,0,0,0.0,0,0,0,0,0,0,0,0,0,0
../kbl_data/2021-2022,S39G01N58,울산 현대모비스,Home,서명진,2,1,3,33.3,0,4,0.0,1,7,14.3,0,0,0.0,0,3,3,7,0,0,0,0,0,1
../kbl_data/2021-2022,S39G01N58,울산 현대모비스,Home,얼 클락,21,9,12,75.0,1,3,33.3,10,15,66.7,0,1,0.0,1,11,12,3,0,3,0,1,3,3
../kbl_data/2021-2022,S39G01N58,울산 현대모비스,Home,이우석,20,5,5,100.0,1,3,33.3,6,8,75.0,7,9,77.8,1,6,7,2,2,0,0,0,3,0
../kbl_data/2021-2022,S39G01N58,울산 현대모비스,Home,라숀 토마스,2,1,4,25.0,0,0,0.0,1,4,25.0,0,0,0.0,0,2,2,1,3,1,0,0,2,1
../kbl_data/2021-2022,S39G01N58,울산 현대모비스,Home,신민석,3,1,1,100.0,0,1,0.0,1,2,50.0,1,2,50.0,0,0,0,1,1,0,0,0,0,3
../kbl_data/2021-2022,S39G01N58,서울 삼성,Away,장민국,2,1,1,100.0,0,5,0.0,1,6,16.7,0,0,0.0,0,4,4,1,0,0,0,0,1,2
../kbl_data/2021-2022,S39G01N58,서울 삼성,Away,김시래,6,3,6,50.0,0,5,0.0,3,11,27.3,0,0,0.0,1,0,1,7,1,0,0,0,1,2
../kbl_data/2021-2022,S39G01N58,서울 삼성,Away,김현수,12,3,4,75.0,2,7,28.6,5,11,45.5,0,0,0.0,0,1,1,0,0,0,0,0,1,4
../kbl_data/2021-2022,S39G01N58,서울 삼성,Away,임동섭,9,3,6,50.0,1,2,50.0,4,8,50.0,0,0,0.0,2,3,5,2,0,0,0,0,0,4
../kbl_data/2021-2022,S39G01N58,서울 삼성,Away,이동엽,2,1,2,50.0,0,1,0.0,1,3,33.3,0,0,0.0,0,4,4,2,1,0,0,0,3,2
../kbl_data/2021-2022,S39G01N58,서울 삼성,Away,배수용,2,1,1,100.0,0,0,0.0,1,1,100.0,0,0,0.0,1,0,1,0,0,0,0,0,0,1
../kbl_data/2021-2022,S39G01N58,서울 삼성,Away,아이제아 힉스,24,7,13,53.8,1,3,33.3,8,16,50.0,7,9,77.8,4,7,11,0,0,1,0,2,3,1
../kbl_data/2021-2022,S39G01N58,서울 삼성,Away,박민우,0,0,0,0.0,0,1,0.0,0,1,0.0,0,0,0.0,1,0,1,0,0,0,0,0,0,1
../kbl_data/2021-2022,S39G01N58,서울 삼성,Away,차민석,0,0,2,0.0,0,1,0.0,0,3,0.0,0,0,0.0,0,0,0,0,0,0,0,0,1,0
../kbl_data/2021-2022,S39G01N58,서울 삼성,Away,전형준,0,0,0,0.0,0,0,0.0,0,0,0.0,0,0,0.0,0,0,0,1,1,0,0,0,0,0
../kbl_data/2021-2022,S39G01N58,서울 삼성,Away,다니엘 오셰푸,4,2,3,66.7,0,0,0.0,2,3,66.7,0,1,0.0,0,4,4,0,1,0,0,0,1,0
../kbl_data/2021-2022,S39G01N58,서울 삼성,Away,이원석,6,3,5,60.0,0,2,0.0,3,7,42.9,0,2,0.0,1,2,3,0,0,1,0,0,0,5
../kbl_data/2021-2022,S39G01N59,창원 LG,Home,강병현,3,0,1,0.0,1,1,100.0,1,2,50.0,0,0,0.0,0,0,0,0,0,0,0,0,0,1
../kbl_data/2021-2022,S39G01N59,창원 LG,Home,변기훈,2,0,0,0.0,0,3,0.0,0,3,0.0,2,2,100.0,2,1,3,0,1,0,0,0,2,3
../kbl_data/2021-2022,S39G01N59,창원 LG,Home,이관희,2,1,9,11.1,0,0,0.0,1,9,11.1,0,0,0.0,0,5,5,3,1,0,0,0,1,1
../kbl_data/2021-2022,S39G01N59,창원 LG,Home,정희재,6,2,3,66.7,0,1,0.0,2,4,50.0,2,2,100.0,0,1,1,1,0,0,0,0,1,2
../kbl_data/2021-2022,S39G01N59,창원 LG,Home,서민수,1,0,4,0.0,0,1,0.0,0,5,0.0,1,2,50.0,1,3,4,0,0,0,0,0,0,3
../kbl_data/2021-2022,S39G01N59,창원 LG,Home,이재도,13,4,8,50.0,1,3,33.3,5,11,45.5,2,3,66.7,1,3,4,3,2,0,0,0,1,1
../kbl_data/2021-2022,S39G01N59,창원 LG,Home,박정현,4,2,3,66.7,0,1,0.0,2,4,50.0,0,0,0.0,3,4,7,1,1,1,0,0,2,2
../kbl_data/2021-2022,S39G01N59,창원 LG,Home,이광진,15,0,0,0.0,5,7,71.4,5,7,71.4,0,0,0.0,1,1,2,0,0,0,0,0,0,3
../kbl_data/2021-2022,S39G01N59,창원 LG,Home,윤원상,7,0,0,0.0,2,6,33.3,2,6,33.3,1,2,50.0,0,1,1,2,0,0,0,0,0,1
../kbl_data/2021-2022,S39G01N59,창원 LG,Home,압둘 말릭 아부,7,2,2,100.0,1,2,50.0,3,4,75.0,0,2,0.0,1,1,2,0,0,1,0,2,1,1
../kbl_data/2021-2022,S39G01N59,창원 LG,Home,아셈 마레이,21,10,12,83.3,0,0,0.0,10,12,83.3,1,4,25.0,9,5,14,5,0,1,0,1,1,0
../kbl_data/2021-2022,S39G01N59,창원 LG,Home,이승우,0,0,1,0.0,0,0,0.0,0,1,0.0,0,0,0.0,0,1,1,0,0,0,0,0,1,0
../kbl_data/2021-2022,S39G01N59,대구 한국가스공사,Away,정영삼,5,0,2,0.0,1,1,100.0,1,3,33.3,2,2,100.0,0,1,1,0,1,0,0,0,1,4
../kbl_data/2021-2022,S39G01N59,대구 한국가스공사,Away,홍경기,0,0,2,0.0,0,4,0.0,0,6,0.0,0,0,0.0,1,1,2,0,0,0,2,0,1,3
../kbl_data/2021-2022,S39G01N59,대구 한국가스공사,Away,차바위,2,1,1,100.0,0,0,0.0,1,1,100.0,0,0,0.0,0,1,1,1,0,0,0,0,0,0
../kbl_data/2021-2022,S39G01N59,대구 한국가스공사,Away,조상열,0,0,0,0.0,0,2,0.0,0,2,0.0,0,0,0.0,0,0,0,2,1,0,0,0,0,0
../kbl_data/2021-2022,S39G01N59,대구 한국가스공사,Away,이대헌,15,6,10,60.0,1,2,50.0,7,12,58.3,0,0,0.0,1,1,2,3,0,0,0,0,1,4
../kbl_data/2021-2022,S39G01N59,대구 한국가스공사,Away,임준수,0,0,0,0.0,0,0,0.0,0,0,0.0,0,0,0.0,0,0,0,0,0,0,0,0,0,0
../kbl_data/2021-2022,S39G01N59,대구 한국가스공사,Away,김낙현,7,2,5,40.0,1,6,16.7,3,11,27.3,0,0,0.0,2,2,4,10,3,0,0,0,2,0
../kbl_data/2021-2022,S39G01N59,대구 한국가스공사,Away,전현우,5,0,2,0.0,1,3,33.3,1,5,20.0,2,2,100.0,1,2,3,1,1,0,0,0,0,1
../kbl_data/2021-2022,S39G01N59,대구 한국가스공사,Away,양준우,1,0,0,0.0,0,1,0.0,0,1,0.0,1,2,50.0,1,0,1,0,0,0,0,0,1,1
../kbl_data/2021-2022,S39G01N59,대구 한국가스공사,Away,클리프 알렉산더,8,3,5,60.0,0,0,0.0,3,5,60.0,2,2,100.0,2,4,6,0,0,1,0,1,1,1
../kbl_data/2021-2022,S39G01N59,대구 한국가스공사,Away,앤드류 니콜슨,23,5,9,55.6,3,9,33.3,8,18,44.4,4,5,80.0,1,6,7,0,0,0,0,2,1,3
../kbl_data/2021-2022,S39G01N59,대구 한국가스공사,Away,신승민,0,0,0,0.0,0,0,0.0,0,0,0.0,0,0,0.0,0,0,0,0,0,0,0,0,0,4
../kbl_data/2021-2022,S39G01N60,울산 현대모비스,Home,이현민,3,0,0,0.0,0,2,0.0,0,2,0.0,3,3,100.0,1,1,2,3,1,0,0,0,0,2
../kbl_data/2021-2022,S39G01N60,울산 현대모비스,Home,함지훈,9,3,5,60.0,0,2,0.0,3,7,42.9,3,4,75.0,0,1,1,1,0,0,0,0,0,0
../kbl_data/2021-2022,S39G01N60,울산 현대모비스,Home,최진수,0,0,1,0.0,0,0,0.0,0,1,0.0,0,0,0.0,1,0,1,0,2,0,0,0,1,0
../kbl_data/2021-2022,S39G01N60,울산 현대모비스,Home,장재석,15,5,7,71.4,0,0,0.0,5,7,71.4,5,5,100.0,1,3,4,0,1,2,0,0,1,4
../kbl_data/2021-2022,S39G01N60,울산 현대모비스,Home,정성호,0,0,0,0.0,0,1,0.0,0,1,0.0,0,0,0.0,0,0,0,0,0,0,0,0,0,0
../kbl_data/2021-2022,S39G01N60,울산 현대모비스,Home,김영현,3,1,1,100.0,0,2,0.0,1,3,33.3,1,2,50.0,1,0,1,0,0,0,0,0,0,0
../kbl_data/2021-2022,S39G01N60,울산 현대모비스,Home,김수찬,4,2,2,100.0,0,2,0.0,2,4,50.0,0,0,0.0,1,0,1,1,1,0,0,0,1,1
../kbl_data/2021-2022,S39G01N60,울산 현대모비스,Home,서명진,6,1,3,33.3,1,3,33.3,2,6,33.3,1,2,50.0,0,1,1,3,0,0,0,0,1,4
../kbl_data/2021-2022,S39G01N60,울산 현대모비스,Home,얼 클락,14,7,12,58.3,0,1,0.0,7,13,53.8,0,0,0.0,1,3,4,0,0,0,0,1,3,0
../kbl_data/2021-2022,S39G01N60,울산 현대모비스,Home,이우석,21,6,9,66.7,1,4,25.0,7,13,53.8,6,6,100.0,1,4,5,6,1,0,0,0,2,3
../kbl_data/2021-2022,S39G01N60,울산 현대모비스,Home,라숀 토마스,5,2,3,66.7,0,0,0.0,2,3,66.7,1,4,25.0,3,1,4,4,1,0,0,1,0,2
../kbl_data/2021-2022,S39G01N60,울산 현대모비스,Home,신민석,0,0,0,0.0,0,1,0.0,0,1,0.0,0,0,0.0,0,1,1,0,0,0,0,0,1,0
../kbl_data/2021-2022,S39G01N60,안양 KGC,Away,함준후,0,0,0,0.0,0,0,0.0,0,0,0.0,0,0,0.0,0,0,0,0,0,0,0,0,0,0
../kbl_data/2021-2022,S39G01N60,안양 KGC,Away,오세근,20,10,14,71.4,0,0,0.0,10,14,71.4,0,0,0.0,0,3,3,1,0,0,0,0,1,3
../kbl_data/2021-2022,S39G01N60,안양 KGC,Away,문성곤,8,1,1,100.0,2,6,33.3,3,7,42.9,0,0,0.0,4,6,10,4,2,1,1,0,0,5
../kbl_data/2021-2022,S39G01N60,안양 KGC,Away,전성현,11,3,4,75.0,1,6,16.7,4,10,40.0,2,2,100.0,2,3,5,0,0,0,0,0,4,2
../kbl_data/2021-2022,S39G01N60,안양 KGC,Away,박재한,0,0,0,0.0,0,0,0.0,0,0,0.0,0,0,0.0,0,0,0,0,0,0,0,0,0,0
../kbl_data/2021-2022,S39G01N60,안양 KGC,Away,정강호,0,0,0,0.0,0,1,0.0,0,1,0.0,0,0,0.0,1,1,2,0,0,0,0,0,0,2
../kbl_data/2021-2022,S39G01N60,안양 KGC,Away,이우정,2,1,1,100.0,0,0,0.0,1,1,100.0,0,0,0.0,0,0,0,0,1,0,0,0,0,1
../kbl_data/2021-2022,S39G01N60,안양 KGC,Away,대릴 먼로,8,3,5,60.0,0,1,0.0,3,6,50.0,2,2,100.0,2,3,5,2,0,0,0,0,0,2
../kbl_data/2021-2022,S39G01N60,안양 KGC,Away,우동현,0,0,0,0.0,0,0,0.0,0,0,0.0,0,0,0.0,0,0,0,0,0,0,0,0,0,0
../kbl_data/2021-2022,S39G01N60,안양 KGC,Away,변준형,19,3,7,42.9,2,5,40.0,5,12,41.7,7,7,100.0,2,1,3,13,2,0,0,0,6,2
../kbl_data/2021-2022,S39G01N60,안양 KGC,Away,한승희,4,2,3,66.7,0,0,0.0,2,3,66.7,0,0,0.0,2,1,3,1,0,0,1,0,0,5
../kbl_data/2021-2022,S39G01N60,안양 KGC,Away,오마리 스펠맨,24,5,10,50.0,4,9,44.4,9,19,47.4,2,2,100.0,3,4,7,3,0,0,0,1,1,2
../kbl_data/2021-2022,S39G01N61,원주 DB,Home,윤호영,9,3,3,100.0,1,3,33.3,4,6,66.7,0,0,0.0,1,7,8,2,2,1,0,0,3,3
../kbl_data/2021-2022,S39G01N61,원주 DB,Home,정준원,6,2,4,50.0,0,1,0.0,2,5,40.0,2,3,66.7,0,2,2,1,1,0,0,0,0,4
../kbl_data/2021-2022,S39G01N61,원주 DB,Home,김종규,6,3,10,30.0,0,1,0.0,3,11,27.3,0,0,0.0,1,5,6,1,0,4,1,0,2,3
../kbl_data/2021-2022,S39G01N61,원주 DB,Home,허웅,16,4,5,80.0,2,5,40.0,6,10,60.0,2,3,66.7,0,1,1,4,0,1,0,0,4,1
../kbl_data/2021-2022,S39G01N61,원주 DB,Home,김영훈,2,1,1,100.0,0,1,0.0,1,2,50.0,0,2,0.0,0,0,0,0,0,0,0,0,1,1
../kbl_data/2021-2022,S39G01N61,원주 DB,Home,배강률,0,0,0,0.0,0,0,0.0,0,0,0.0,0,0,0.0,0,1,1,0,0,0,0,0,0,0
../kbl_data/2021-2022,S39G01N61,원주 DB,Home,김철욱,5,2,4,50.0,0,0,0.0,2,4,50.0,1,1,100.0,0,0,0,0,0,0,0,0,0,0
../kbl_data/2021-2022,S39G01N61,원주 DB,Home,박상권,0,0,0,0.0,0,0,0.0,0,0,0.0,0,0,0.0,0,0,0,0,0,0,0,0,0,0
../kbl_data/2021-2022,S39G01N61,원주 DB,Home,나카무라 타이치,5,1,6,16.7,1,1,100.0,2,7,28.6,0,0,0.0,1,2,3,2,1,0,0,0,2,1
../kbl_data/2021-2022,S39G01N61,원주 DB,Home,이준희,0,0,0,0.0,0,0,0.0,0,0,0.0,0,0,0.0,0,0,0,0,0,0,0,0,0,0
../kbl_data/2021-2022,S39G01N61,원주 DB,Home,레나드 프리먼,13,5,10,50.0,0,0,0.0,5,10,50.0,3,4,75.0,4,10,14,0,1,3,0,1,0,3
../kbl_data/2021-2022,S39G01N61,원주 DB,Home,정호영,5,2,4,50.0,0,1,0.0,2,5,40.0,1,1,100.0,0,2,2,4,2,1,0,0,5,1
../kbl_data/2021-2022,S39G01N61,수원 KT,Away,김동욱,16,2,4,50.0,4,13,30.8,6,17,35.3,0,0,0.0,1,0,1,1,0,0,0,0,2,1
../kbl_data/2021-2022,S39G01N61,수원 KT,Away,김영환,3,1,1,100.0,0,5,0.0,1,6,16.7,1,2,50.0,0,0,0,1,1,0,0,0,2,2
../kbl_data/2021-2022,S39G01N61,수원 KT,Away,김현민,2,1,2,50.0,0,1,0.0,1,3,33.3,0,0,0.0,0,1,1,0,0,0,0,0,0,0
../kbl_data/2021-2022,S39G01N61,수원 KT,Away,김민욱,0,0,0,0.0,0,0,0.0,0,0,0.0,0,0,0.0,0,0,0,0,0,0,0,0,0,0
../kbl_data/2021-2022,S39G01N61,수원 KT,Away,최창진,3,0,4,0.0,1,3,33.3,1,7,14.3,0,0,0.0,2,3,5,1,1,0,0,0,0,1
../kbl_data/2021-2022,S39G01N61,수원 KT,Away,정성우,3,0,6,0.0,1,6,16.7,1,12,8.3,0,0,0.0,2,1,3,3,1,0,3,0,3,3
../kbl_data/2021-2022,S39G01N61,수원 KT,Away,양홍석,3,0,4,0.0,1,8,12.5,1,12,8.3,0,0,0.0,4,4,8,5,1,0,0,0,2,4
../kbl_data/2021-2022,S39G01N61,수원 KT,Away,캐디 라렌,19,8,13,61.5,0,1,0.0,8,14,57.1,3,3,100.0,3,6,9,2,2,1,0,0,2,2
../kbl_data/2021-2022,S39G01N61,수원 KT,Away,문상옥,0,0,0,0.0,0,0,0.0,0,0,0.0,0,0,0.0,0,0,0,0,0,0,0,0,0,0
../kbl_data/2021-2022,S39G01N61,수원 KT,Away,박지원,2,1,1,100.0,0,1,0.0,1,2,50.0,0,0,0.0,1,0,1,1,1,0,0,0,1,1
../kbl_data/2021-2022,S39G01N61,수원 KT,Away,마이크 마이어스,2,0,2,0.0,0,0,0.0,0,2,0.0,2,2,100.0,5,6,11,0,2,0,0,0,2,2
../kbl_data/2021-2022,S39G01N61,수원 KT,Away,하윤기,0,0,2,0.0,0,0,0.0,0,2,0.0,0,2,0.0,3,3,6,0,1,1,0,0,1,1
../kbl_data/2021-2022,S39G01N62,서울 삼성,Home,장민국,12,0,1,0.0,4,6,66.7,4,7,57.1,0,0,0.0,0,1,1,0,0,0,0,0,0,5
../kbl_data/2021-2022,S39G01N62,서울 삼성,Home,김시래,4,1,4,25.0,0,2,0.0,1,6,16.7,2,2,100.0,0,3,3,11,3,0,1,0,1,2
../kbl_data/2021-2022,S39G01N62,서울 삼성,Home,김현수,9,0,2,0.0,3,7,42.9,3,9,33.3,0,0,0.0,0,1,1,1,0,0,0,0,1,0
../kbl_data/2021-2022,S39G01N62,서울 삼성,Home,임동섭,8,4,5,80.0,0,4,0.0,4,9,44.4,0,1,0.0,2,2,4,0,1,0,0,0,1,4
../kbl_data/2021-2022,S39G01N62,서울 삼성,Home,이동엽,11,1,2,50.0,2,4,50.0,3,6,50.0,3,3,100.0,1,3,4,3,1,0,0,0,2,4
../kbl_data/2021-2022,S39G01N62,서울 삼성,Home,배수용,0,0,1,0.0,0,1,0.0,0,2,0.0,0,0,0.0,0,0,0,2,0,0,0,0,0,0
../kbl_data/2021-2022,S39G01N62,서울 삼성,Home,이호현,0,0,0,0.0,0,0,0.0,0,0,0.0,0,0,0.0,0,0,0,0,0,0,0,0,0,0
../kbl_data/2021-2022,S39G01N62,서울 삼성,Home,아이제아 힉스,22,10,17,58.8,0,1,0.0,10,18,55.6,2,2,100.0,2,12,14,2,0,0,0,0,4,3
../kbl_data/2021-2022,S39G01N62,서울 삼성,Home,차민석,0,0,0,0.0,0,0,0.0,0,0,0.0,0,0,0.0,0,0,0,0,0,0,0,0,0,0
../kbl_data/2021-2022,S39G01N62,서울 삼성,Home,전형준,2,1,1,100.0,0,1,0.0,1,2,50.0,0,0,0.0,0,0,0,0,0,0,0,0,0,3
../kbl_data/2021-2022,S39G01N62,서울 삼성,Home,다니엘 오셰푸,5,2,2,100.0,0,0,0.0,2,2,100.0,1,2,50.0,0,4,4,0,1,0,0,0,1,3
../kbl_data/2021-2022,S39G01N62,서울 삼성,Home,이원석,2,1,3,33.3,0,0,0.0,1,3,33.3,0,0,0.0,0,0,0,0,0,0,0,0,1,3
../kbl_data/2021-2022,S39G01N62,서울 SK,Away,양우섭,4,2,3,66.7,0,2,0.0,2,5,40.0,0,0,0.0,0,0,0,0,1,0,0,0,0,2
../kbl_data/2021-2022,S39G01N62,서울 SK,Away,허일영,16,2,2,100.0,2,5,40.0,4,7,57.1,6,7,85.7,0,0,0,0,1,0,0,0,1,4
../kbl_data/2021-2022,S39G01N62,서울 SK,Away,김선형,6,1,4,25.0,0,2,0.0,1,6,16.7,4,4,100.0,1,3,4,2,2,0,0,0,2,0
../kbl_data/2021-2022,S39G01N62,서울 SK,Away,최부경,0,0,2,0.0,0,0,0.0,0,2,0.0,0,0,0.0,0,3,3,1,0,0,0,0,0,4
../kbl_data/2021-2022,S39G01N62,서울 SK,Away,리온 윌리엄스,2,1,2,50.0,0,0,0.0,1,2,50.0,0,0,0.0,1,2,3,0,0,2,0,0,1,1
../kbl_data/2021-2022,S39G01N62,서울 SK,Away,이현석,0,0,0,0.0,0,0,0.0,0,0,0.0,0,0,0.0,0,0,0,0,0,0,0,0,0,1
../kbl_data/2021-2022,S39G01N62,서울 SK,Away,최원혁,0,0,2,0.0,0,0,0.0,0,2,0.0,0,0,0.0,7,6,13,5,1,0,1,0,1,3
../kbl_data/2021-2022,S39G01N62,서울 SK,Away,최준용,13,6,14,42.9,0,6,0.0,6,20,30.0,1,2,50.0,1,4,5,0,0,0,0,0,2,1
../kbl_data/2021-2022,S39G01N62,서울 SK,Away,안영준,6,1,5,20.0,1,3,33.3,2,8,25.0,1,4,25.0,1,4,5,0,0,1,0,0,2,0
../kbl_data/2021-2022,S39G01N62,서울 SK,Away,자밀 워니,27,11,16,68.8,0,0,0.0,11,16,68.8,5,9,55.6,7,6,13,1,0,0,0,0,0,2
../kbl_data/2021-2022,S39G01N62,서울 SK,Away,김형빈,0,0,0,0.0,0,0,0.0,0,0,0.0,0,0,0.0,0,0,0,0,0,0,0,0,0,0
../kbl_data/2021-2022,S39G01N62,서울 SK,Away,오재현,0,0,2,0.0,0,0,0.0,0,2,0.0,0,0,0.0,0,0,0,0,0,0,0,0,0,0
../kbl_data/2021-2022,S39G01N63,창원 LG,Home,강병현,5,0,0,0.0,1,1,100.0,1,1,100.0,2,2,100.0,0,0,0,0,0,0,0,0,2,1
../kbl_data/2021-2022,S39G01N63,창원 LG,Home,변기훈,0,0,0,0.0,0,0,0.0,0,0,0.0,0,0,0.0,0,1,1,1,0,0,0,0,0,0
../kbl_data/2021-2022,S39G01N63,창원 LG,Home,이관희,12,3,9,33.3,0,2,0.0,3,11,27.3,6,7,85.7,0,3,3,6,0,0,0,0,2,0
../kbl_data/2021-2022,S39G01N63,창원 LG,Home,정희재,1,0,0,0.0,0,1,0.0,0,1,0.0,1,2,50.0,0,0,0,0,0,0,0,0,0,1
../kbl_data/2021-2022,S39G01N63,창원 LG,Home,서민수,0,0,0,0.0,0,2,0.0,0,2,0.0,0,0,0.0,1,0,1,0,0,0,0,0,0,1
../kbl_data/2021-2022,S39G01N63,창원 LG,Home,이재도,7,2,8,25.0,1,6,16.7,3,14,21.4,0,2,0.0,0,2,2,4,2,0,0,0,1,1
../kbl_data/2021-2022,S39G01N63,창원 LG,Home,박정현,21,10,13,76.9,0,2,0.0,10,15,66.7,1,2,50.0,6,4,10,0,0,0,0,0,1,4
../kbl_data/2021-2022,S39G01N63,창원 LG,Home,이광진,2,1,1,100.0,0,3,0.0,1,4,25.0,0,0,0.0,3,2,5,0,3,1,0,0,1,2
../kbl_data/2021-2022,S39G01N63,창원 LG,Home,윤원상,2,1,1,100.0,0,3,0.0,1,4,25.0,0,0,0.0,2,1,3,1,1,0,0,0,0,1
../kbl_data/2021-2022,S39G01N63,창원 LG,Home,압둘 말릭 아부,6,3,4,75.0,0,1,0.0,3,5,60.0,0,2,0.0,1,2,3,0,0,2,0,2,1,2
../kbl_data/2021-2022,S39G01N63,창원 LG,Home,아셈 마레이,4,2,7,28.6,0,0,0.0,2,7,28.6,0,6,0.0,5,11,16,2,0,1,0,0,2,5
../kbl_data/2021-2022,S39G01N63,창원 LG,Home,이승우,1,0,1,0.0,0,0,0.0,0,1,0.0,1,2,50.0,0,1,1,0,0,0,0,0,0,0
../kbl_data/2021-2022,S39G01N63,울산 현대모비스,Away,이현민,4,2,3,66.7,0,1,0.0,2,4,50.0,0,0,0.0,2,1,3,4,1,0,0,0,1,4
../kbl_data/2021-2022,S39G01N63,울산 현대모비스,Away,함지훈,4,2,4,50.0,0,0,0.0,2,4,50.0,0,0,0.0,3,1,4,3,2,0,0,0,0,0
../kbl_data/2021-2022,S39G01N63,울산 현대모비스,Away,최진수,8,4,6,66.7,0,4,0.0,4,10,40.0,0,0,0.0,0,3,3,4,0,0,0,1,1,2
../kbl_data/2021-2022,S39G01N63,울산 현대모비스,Away,박지훈,5,1,3,33.3,1,2,50.0,2,5,40.0,0,0,0.0,2,3,5,0,1,0,0,0,0,3
../kbl_data/2021-2022,S39G01N63,울산 현대모비스,Away,장재석,15,7,14,50.0,0,0,0.0,7,14,50.0,1,4,25.0,2,6,8,3,1,2,0,0,0,1
../kbl_data/2021-2022,S39G01N63,울산 현대모비스,Away,정성호,6,0,0,0.0,2,5,40.0,2,5,40.0,0,0,0.0,0,1,1,0,0,0,0,0,0,1
../kbl_data/2021-2022,S39G01N63,울산 현대모비스,Away,김수찬,0,0,0,0.0,0,0,0.0,0,0,0.0,0,0,0.0,0,0,0,1,0,0,0,0,0,0
../kbl_data/2021-2022,S39G01N63,울산 현대모비스,Away,서명진,15,2,5,40.0,3,6,50.0,5,11,45.5,2,3,66.7,1,1,2,3,1,0,0,0,1,4
../kbl_data/2021-2022,S39G01N63,울산 현대모비스,Away,얼 클락,6,3,7,42.9,0,1,0.0,3,8,37.5,0,0,0.0,0,5,5,1,0,2,0,1,0,3
../kbl_data/2021-2022,S39G01N63,울산 현대모비스,Away,이우석,2,1,3,33.3,0,2,0.0,1,5,20.0,0,0,0.0,2,1,3,7,0,0,0,0,4,3
../kbl_data/2021-2022,S39G01N63,울산 현대모비스,Away,라숀 토마스,13,6,10,60.0,0,0,0.0,6,10,60.0,1,5,20.0,4,5,9,1,1,0,0,1,0,3
../kbl_data/2021-2022,S39G01N63,울산 현대모비스,Away,신민석,2,1,1,100.0,0,1,0.0,1,2,50.0,0,0,0.0,1,0,1,0,0,0,0,0,0,0
../kbl_data/2021-2022,S39G01N64,전주 KCC,Home,송창용,2,1,1,100.0,0,1,0.0,1,2,50.0,0,0,0.0,0,0,0,0,0,0,0,0,0,1
../kbl_data/2021-2022,S39G01N64,전주 KCC,Home,이정현,9,1,1,100.0,2,7,28.6,3,8,37.5,1,2,50.0,0,5,5,5,2,0,0,0,3,2
../kbl_data/2021-2022,S39G01N64,전주 KCC,Home,정창영,7,3,6,50.0,0,1,0.0,3,7,42.9,1,2,50.0,1,0,1,3,0,0,0,0,0,2
../kbl_data/2021-2022,S39G01N64,전주 KCC,Home,라건아,21,9,14,64.3,0,3,0.0,9,17,52.9,3,6,50.0,4,6,10,3,1,0,0,0,0,2
../kbl_data/2021-2022,S39G01N64,전주 KCC,Home,김지완,2,0,1,0.0,0,6,0.0,0,7,0.0,2,2,100.0,0,1,1,1,1,0,0,0,2,2
../kbl_data/2021-2022,S39G01N64,전주 KCC,Home,김상규,6,3,4,75.0,0,2,0.0,3,6,50.0,0,0,0.0,2,1,3,3,0,1,0,0,1,1
../kbl_data/2021-2022,S39G01N64,전주 KCC,Home,유병훈,3,0,0,0.0,1,1,100.0,1,1,100.0,0,0,0.0,0,0,0,0,0,0,0,0,0,0
../kbl_data/2021-2022,S39G01N64,전주 KCC,Home,전준범,3,0,0,0.0,1,3,33.3,1,3,33.3,0,0,0.0,0,1,1,0,0,1,0,0,0,0
../kbl_data/2021-2022,S39G01N64,전주 KCC,Home,박재현,2,1,2,50.0,0,0,0.0,1,2,50.0,0,0,0.0,0,0,0,1,0,0,0,0,0,3
../kbl_data/2021-2022,S39G01N64,전주 KCC,Home,이진욱,0,0,0,0.0,0,0,0.0,0,0,0.0,0,0,0.0,0,0,0,0,0,0,0,0,0,0
../kbl_data/2021-2022,S39G01N64,전주 KCC,Home,유현준,11,1,6,16.7,2,5,40.0,3,11,27.3,3,3,100.0,0,1,1,1,1,1,0,0,1,4
../kbl_data/2021-2022,S39G01N64,전주 KCC,Home,라타비우스 윌리엄스,4,2,4,50.0,0,0,0.0,2,4,50.0,0,0,0.0,5,1,6,0,0,0,0,1,0,2
../kbl_data/2021-2022,S39G01N64,대구 한국가스공사,Away,정영삼,3,1,1,100.0,0,3,0.0,1,4,25.0,1,2,50.0,0,0,0,1,1,0,0,0,1,2
../kbl_data/2021-2022,S39G01N64,대구 한국가스공사,Away,홍경기,0,0,1,0.0,0,0,0.0,0,1,0.0,0,0,0.0,0,1,1,0,0,0,0,0,0,2
../kbl_data/2021-2022,S39G01N64,대구 한국가스공사,Away,차바위,5,0,1,0.0,1,1,100.0,1,2,50.0,2,2,100.0,2,2,4,3,0,0,0,0,0,1
../kbl_data/2021-2022,S39G01N64,대구 한국가스공사,Away,조상열,8,1,1,100.0,2,5,40.0,3,6,50.0,0,0,0.0,1,0,1,1,1,0,0,0,0,2
../kbl_data/2021-2022,S39G01N64,대구 한국가스공사,Away,이대헌,12,3,7,42.9,2,2,100.0,5,9,55.6,0,2,0.0,4,8,12,4,1,0,0,0,4,2
../kbl_data/2021-2022,S39G01N64,대구 한국가스공사,Away,임준수,2,1,1,100.0,0,0,0.0,1,1,100.0,0,0,0.0,0,0,0,0,0,0,0,0,0,0
../kbl_data/2021-2022,S39G01N64,대구 한국가스공사,Away,김낙현,16,4,6,66.7,2,6,33.3,6,12,50.0,2,2,100.0,1,0,1,4,0,0,0,0,1,4
../kbl_data/2021-2022,S39G01N64,대구 한국가스공사,Away,전현우,8,3,4,75.0,0,3,0.0,3,7,42.9,2,2,100.0,1,3,4,0,0,0,0,0,2,0
../kbl_data/2021-2022,S39G01N64,대구 한국가스공사,Away,양준우,0,0,0,0.0,0,2,0.0,0,2,0.0,0,0,0.0,0,0,0,0,0,0,0,0,0,0
../kbl_data/2021-2022,S39G01N64,대구 한국가스공사,Away,클리프 알렉산더,6,3,4,75.0,0,0,0.0,3,4,75.0,0,0,0.0,2,0,2,0,0,1,0,2,0,2
../kbl_data/2021-2022,S39G01N64,대구 한국가스공사,Away,앤드류 니콜슨,19,4,6,66.7,3,6,50.0,7,12,58.3,2,4,50.0,1,12,13,5,2,1,0,0,2,1
../kbl_data/2021-2022,S39G01N64,대구 한국가스공사,Away,신승민,0,0,0,0.0,0,0,0.0,0,0,0.0,0,0,0.0,0,0,0,0,0,0,0,0,0,0
../kbl_data/2021-2022,S39G01N65,안양 KGC,Home,함준후,5,1,1,100.0,1,2,50.0,2,3,66.7,0,0,0.0,1,1,2,0,0,0,0,0,0,1
../kbl_data/2021-2022,S39G01N65,안양 KGC,Home,오세근,16,7,12,58.3,0,0,0.0,7,12,58.3,2,2,100.0,2,3,5,1,0,0,0,0,1,4
../kbl_data/2021-2022,S39G01N65,안양 KGC,Home,문성곤,10,1,1,100.0,2,8,25.0,3,9,33.3,2,4,50.0,2,7,9,1,6,0,0,0,0,4
../kbl_data/2021-2022,S39G01N65,안양 KGC,Home,전성현,2,1,1,100.0,0,3,0.0,1,4,25.0,0,2,0.0,0,1,1,1,1,0,0,0,0,2
../kbl_data/2021-2022,S39G01N65,안양 KGC,Home,박재한,0,0,0,0.0,0,0,0.0,0,0,0.0,0,0,0.0,0,0,0,0,0,0,0,0,0,0
../kbl_data/2021-2022,S39G01N65,안양 KGC,Home,정강호,0,0,0,0.0,0,0,0.0,0,0,0.0,0,0,0.0,0,0,0,0,0,0,0,0,0,0
../kbl_data/2021-2022,S39G01N65,안양 KGC,Home,이우정,0,0,0,0.0,0,0,0.0,0,0,0.0,0,0,0.0,0,0,0,2,1,0,0,0,1,2
../kbl_data/2021-2022,S39G01N65,안양 KGC,Home,대릴 먼로,10,4,4,100.0,0,0,0.0,4,4,100.0,2,2,100.0,1,5,6,0,0,1,0,0,1,0
../kbl_data/2021-2022,S39G01N65,안양 KGC,Home,우동현,0,0,0,0.0,0,4,0.0,0,4,0.0,0,0,0.0,0,0,0,0,0,0,0,0,0,1
../kbl_data/2021-2022,S39G01N65,안양 KGC,Home,변준형,18,3,5,60.0,3,4,75.0,6,9,66.7,3,4,75.0,0,2,2,11,2,0,0,0,5,2
../kbl_data/2021-2022,S39G01N65,안양 KGC,Home,한승희,5,1,2,50.0,1,1,100.0,2,3,66.7,0,0,0.0,1,0,1,0,0,0,0,0,0,1
../kbl_data/2021-2022,S39G01N65,안양 KGC,Home,오마리 스펠맨,30,10,16,62.5,2,4,50.0,12,20,60.0,4,7,57.1,3,6,9,2,2,1,0,2,1,2
../kbl_data/2021-2022,S39G01N65,고양 오리온,Away,오용준,0,0,0,0.0,0,1,0.0,0,1,0.0,0,0,0.0,0,0,0,0,0,0,0,0,1,0
../kbl_data/2021-2022,S39G01N65,고양 오리온,Away,김강선,5,0,1,0.0,1,3,33.3,1,4,25.0,2,2,100.0,1,1,2,1,1,0,0,0,0,0
../kbl_data/2021-2022,S39G01N65,고양 오리온,Away,최현민,12,4,4,100.0,1,2,50.0,5,6,83.3,1,1,100.0,1,1,2,1,0,0,0,0,1,2
../kbl_data/2021-2022,S39G01N65,고양 오리온,Away,이대성,28,5,8,62.5,4,6,66.7,9,14,64.3,6,6,100.0,0,5,5,5,0,0,0,0,3,2
../kbl_data/2021-2022,S39G01N65,고양 오리온,Away,한호빈,7,2,3,66.7,1,3,33.3,3,6,50.0,0,1,0.0,0,0,0,2,1,0,0,0,2,3
../kbl_data/2021-2022,S39G01N65,고양 오리온,Away,최승욱,0,0,0,0.0,0,0,0.0,0,0,0.0,0,0,0.0,0,0,0,0,0,0,0,0,0,0
../kbl_data/2021-2022,S39G01N65,고양 오리온,Away,이승현,17,7,13,53.8,1,3,33.3,8,16,50.0,0,0,0.0,0,3,3,2,2,1,0,0,3,3
../kbl_data/2021-2022,S39G01N65,고양 오리온,Away,이종현,2,1,3,33.3,0,0,0.0,1,3,33.3,0,0,0.0,1,2,3,1,0,0,0,0,1,1
../kbl_data/2021-2022,S39G01N65,고양 오리온,Away,김세창,2,0,0,0.0,0,1,0.0,0,1,0.0,2,2,100.0,0,0,0,0,1,0,0,0,0,1
../kbl_data/2021-2022,S39G01N65,고양 오리온,Away,박진철,0,0,0,0.0,0,0,0.0,0,0,0.0,0,2,0.0,1,0,1,0,0,1,0,0,0,1
../kbl_data/2021-2022,S39G01N65,고양 오리온,Away,미로슬라브 라둘리차,6,3,7,42.9,0,1,0.0,3,8,37.5,0,0,0.0,2,6,8,4,0,0,0,1,1,3
../kbl_data/2021-2022,S39G01N65,고양 오리온,Away,이정현,5,1,3,33.3,1,2,50.0,2,5,40.0,0,1,0.0,0,4,4,3,1,0,0,0,2,2
../kbl_data/2021-2022,S39G01N66,원주 DB,Home,윤호영,1,0,1,0.0,0,0,0.0,0,1,0.0,1,2,50.0,1,4,5,1,1,0,0,0,2,0
../kbl_data/2021-2022,S39G01N66,원주 DB,Home,박찬희,2,1,6,16.7,0,0,0.0,1,6,16.7,0,0,0.0,0,0,0,6,0,0,0,0,0,2
../kbl_data/2021-2022,S39G01N66,원주 DB,Home,정준원,7,2,4,50.0,1,2,50.0,3,6,50.0,0,0,0.0,0,2,2,2,2,1,0,0,2,1
../kbl_data/2021-2022,S39G01N66,원주 DB,Home,김종규,8,4,11,36.4,0,1,0.0,4,12,33.3,0,2,0.0,2,3,5,2,0,1,0,0,1,3
../kbl_data/2021-2022,S39G01N66,원주 DB,Home,허웅,14,2,6,33.3,3,6,50.0,5,12,41.7,1,3,33.3,0,0,0,4,0,0,0,0,1,2
../kbl_data/2021-2022,S39G01N66,원주 DB,Home,김영훈,5,1,1,100.0,1,3,33.3,2,4,50.0,0,0,0.0,0,1,1,2,0,0,0,0,0,0
../kbl_data/2021-2022,S39G01N66,원주 DB,Home,배강률,0,0,0,0.0,0,0,0.0,0,0,0.0,0,0,0.0,0,0,0,0,0,0,0,0,0,0
../kbl_data/2021-2022,S39G01N66,원주 DB,Home,김철욱,2,0,2,0.0,0,0,0.0,0,2,0.0,2,2,100.0,1,2,3,0,0,0,0,0,0,3
../kbl_data/2021-2022,S39G01N66,원주 DB,Home,박상권,0,0,0,0.0,0,0,0.0,0,0,0.0,0,0,0.0,0,0,0,0,0,0,0,0,0,2
../kbl_data/2021-2022,S39G01N66,원주 DB,Home,나카무라 타이치,0,0,1,0.0,0,1,0.0,0,2,0.0,0,0,0.0,1,0,1,1,0,0,0,0,0,2
../kbl_data/2021-2022,S39G01N66,원주 DB,Home,레나드 프리먼,17,8,14,57.1,0,1,0.0,8,15,53.3,1,2,50.0,2,11,13,1,2,0,0,0,2,1
../kbl_data/2021-2022,S39G01N66,원주 DB,Home,정호영,11,4,8,50.0,1,2,50.0,5,10,50.0,0,0,0.0,2,2,4,0,0,1,0,0,1,2
../kbl_data/2021-2022,S39G01N66,서울 SK,Away,양우섭,9,1,1,100.0,2,4,50.0,3,5,60.0,1,2,50.0,0,2,2,1,1,0,0,0,1,2
../kbl_data/2021-2022,S39G01N66,서울 SK,Away,허일영,5,1,3,33.3,0,4,0.0,1,7,14.3,3,3,100.0,1,0,1,2,1,0,1,0,0,3
../kbl_data/2021-2022,S39G01N66,서울 SK,Away,김선형,10,5,6,83.3,0,4,0.0,5,10,50.0,0,0,0.0,0,1,1,4,1,0,0,0,1,0
../kbl_data/2021-2022,S39G01N66,서울 SK,Away,최부경,0,0,1,0.0,0,0,0.0,0,1,0.0,0,0,0.0,0,0,0,0,0,0,0,0,1,1
../kbl_data/2021-2022,S39G01N66,서울 SK,Away,리온 윌리엄스,0,0,0,0.0,0,0,0.0,0,0,0.0,0,0,0.0,1,1,2,0,0,0,0,0,0,0
../kbl_data/2021-2022,S39G01N66,서울 SK,Away,이현석,0,0,2,0.0,0,1,0.0,0,3,0.0,0,0,0.0,0,4,4,1,1,0,0,0,0,3
../kbl_data/2021-2022,S39G01N66,서울 SK,Away,최원혁,5,1,3,33.3,1,3,33.3,2,6,33.3,0,0,0.0,3,1,4,3,2,0,0,0,0,3
../kbl_data/2021-2022,S39G01N66,서울 SK,Away,최준용,18,4,8,50.0,2,3,66.7,6,11,54.5,4,5,80.0,0,6,6,3,0,3,0,0,1,2
../kbl_data/2021-2022,S39G01N66,서울 SK,Away,안영준,5,1,7,14.3,1,6,16.7,2,13,15.4,0,0,0.0,2,4,6,0,2,1,0,0,2,2
../kbl_data/2021-2022,S39G01N66,서울 SK,Away,자밀 워니,25,11,17,64.7,0,1,0.0,11,18,61.1,3,3,100.0,5,13,18,0,0,0,0,0,3,0
../kbl_data/2021-2022,S39G01N66,서울 SK,Away,김형빈,0,0,0,0.0,0,0,0.0,0,0,0.0,0,0,0.0,0,0,0,0,0,0,0,0,0,0
../kbl_data/2021-2022,S39G01N66,서울 SK,Away,오재현,0,0,0,0.0,0,0,0.0,0,0,0.0,0,0,0.0,0,0,0,0,0,0,0,0,0,0
../kbl_data/2021-2022,S39G01N67,서울 삼성,Home,장민국,6,2,3,66.7,0,0,0.0,2,3,66.7,2,2,100.0,1,4,5,1,0,0,0,0,1,4
../kbl_data/2021-2022,S39G01N67,서울 삼성,Home,김시래,16,6,9,66.7,0,3,0.0,6,12,50.0,4,4,100.0,5,7,12,6,0,0,0,0,2,4
../kbl_data/2021-2022,S39G01N67,서울 삼성,Home,김현수,0,0,4,0.0,0,2,0.0,0,6,0.0,0,0,0.0,0,0,0,1,0,0,0,0,0,0
../kbl_data/2021-2022,S39G01N67,서울 삼성,Home,임동섭,15,3,5,60.0,3,6,50.0,6,11,54.5,0,0,0.0,3,1,4,0,0,0,0,0,2,3
../kbl_data/2021-2022,S39G01N67,서울 삼성,Home,이동엽,13,2,6,33.3,3,8,37.5,5,14,35.7,0,0,0.0,4,2,6,1,1,0,0,0,1,2
../kbl_data/2021-2022,S39G01N67,서울 삼성,Home,배수용,0,0,0,0.0,0,0,0.0,0,0,0.0,0,0,0.0,0,0,0,0,0,0,0,0,0,0
../kbl_data/2021-2022,S39G01N67,서울 삼성,Home,이호현,0,0,0,0.0,0,0,0.0,0,0,0.0,0,0,0.0,0,0,0,0,0,0,0,0,0,0
../kbl_data/2021-2022,S39G01N67,서울 삼성,Home,아이제아 힉스,10,4,6,66.7,0,1,0.0,4,7,57.1,2,6,33.3,0,4,4,3,0,1,0,0,5,4
../kbl_data/2021-2022,S39G01N67,서울 삼성,Home,차민석,0,0,0,0.0,0,0,0.0,0,0,0.0,0,0,0.0,0,0,0,0,0,0,0,0,0,0
../kbl_data/2021-2022,S39G01N67,서울 삼성,Home,전형준,0,0,1,0.0,0,0,0.0,0,1,0.0,0,0,0.0,0,0,0,0,0,0,0,0,0,0
../kbl_data/2021-2022,S39G01N67,서울 삼성,Home,다니엘 오셰푸,0,0,1,0.0,0,0,0.0,0,1,0.0,0,2,0.0,2,2,4,0,1,0,0,0,0,1
../kbl_data/2021-2022,S39G01N67,서울 삼성,Home,이원석,4,2,4,50.0,0,3,0.0,2,7,28.6,0,0,0.0,0,2,2,1,3,1,0,0,1,2
../kbl_data/2021-2022,S39G01N67,전주 KCC,Away,송창용,0,0,0,0.0,0,3,0.0,0,3,0.0,0,0,0.0,0,1,1,0,0,0,0,0,0,1
../kbl_data/2021-2022,S39G01N67,전주 KCC,Away,이정현,7,1,3,33.3,1,4,25.0,2,7,28.6,2,4,50.0,0,3,3,4,4,0,0,0,4,2
../kbl_data/2021-2022,S39G01N67,전주 KCC,Away,정창영,3,1,1,100.0,0,1,0.0,1,2,50.0,1,1,100.0,0,0,0,1,0,0,0,0,1,0
../kbl_data/2021-2022,S39G01N67,전주 KCC,Away,라건아,21,7,14,50.0,1,1,100.0,8,15,53.3,4,5,80.0,6,7,13,3,3,1,0,0,1,2
../kbl_data/2021-2022,S39G01N67,전주 KCC,Away,김지완,10,4,8,50.0,0,5,0.0,4,13,30.8,2,2,100.0,0,1,1,1,2,0,0,0,0,2
../kbl_data/2021-2022,S39G01N67,전주 KCC,Away,김상규,10,1,2,50.0,2,5,40.0,3,7,42.9,2,2,100.0,3,4,7,3,0,2,0,0,1,2
../kbl_data/2021-2022,S39G01N67,전주 KCC,Away,유병훈,0,0,0,0.0,0,0,0.0,0,0,0.0,0,0,0.0,0,0,0,0,0,0,0,0,0,0
../kbl_data/2021-2022,S39G01N67,전주 KCC,Away,전준범,6,0,1,0.0,2,4,50.0,2,5,40.0,0,0,0.0,2,2,4,0,0,0,0,0,0,0
../kbl_data/2021-2022,S39G01N67,전주 KCC,Away,박재현,9,3,4,75.0,1,4,25.0,4,8,50.0,0,0,0.0,0,0,0,1,0,0,0,0,0,5
../kbl_data/2021-2022,S39G01N67,전주 KCC,Away,이진욱,0,0,0,0.0,0,0,0.0,0,0,0.0,0,0,0.0,0,0,0,0,0,0,0,0,0,0
../kbl_data/2021-2022,S39G01N67,전주 KCC,Away,유현준,4,2,5,40.0,0,0,0.0,2,5,40.0,0,0,0.0,0,2,2,2,0,1,0,0,1,0
../kbl_data/2021-2022,S39G01N67,전주 KCC,Away,라타비우스 윌리엄스,1,0,1,0.0,0,0,0.0,0,1,0.0,1,2,50.0,2,3,5,0,0,0,0,0,0,0
../kbl_data/2021-2022,S39G01N68,수원 KT,Home,김동욱,15,3,3,100.0,3,5,60.0,6,8,75.0,0,0,0.0,0,4,4,4,0,0,0,0,2,3
../kbl_data/2021-2022,S39G01N68,수원 KT,Home,김영환,2,1,2,50.0,0,0,0.0,1,2,50.0,0,0,0.0,0,0,0,1,0,0,0,0,0,1
../kbl_data/2021-2022,S39G01N68,수원 KT,Home,김현민,4,1,1,100.0,0,1,0.0,1,2,50.0,2,2,100.0,1,0,1,1,1,0,0,0,0,2
../kbl_data/2021-2022,S39G01N68,수원 KT,Home,최창진,4,2,2,100.0,0,0,0.0,2,2,100.0,0,0,0.0,1,2,3,2,0,0,0,0,0,3
../kbl_data/2021-2022,S39G01N68,수원 KT,Home,정성우,1,0,2,0.0,0,2,0.0,0,4,0.0,1,2,50.0,0,0,0,3,1,0,0,0,2,2
../kbl_data/2021-2022,S39G01N68,수원 KT,Home,허훈,20,3,5,60.0,2,4,50.0,5,9,55.6,8,8,100.0,2,3,5,3,0,0,0,0,0,1
../kbl_data/2021-2022,S39G01N68,수원 KT,Home,양홍석,19,6,10,60.0,2,4,50.0,8,14,57.1,1,2,50.0,3,2,5,1,0,0,0,0,2,1
../kbl_data/2021-2022,S39G01N68,수원 KT,Home,캐디 라렌,12,4,8,50.0,1,2,50.0,5,10,50.0,1,3,33.3,1,6,7,1,0,1,0,0,1,3
../kbl_data/2021-2022,S39G01N68,수원 KT,Home,문상옥,0,0,0,0.0,0,0,0.0,0,0,0.0,0,0,0.0,0,0,0,0,0,0,0,0,0,0
../kbl_data/2021-2022,S39G01N68,수원 KT,Home,박지원,0,0,0,0.0,0,0,0.0,0,0,0.0,0,0,0.0,0,0,0,0,0,0,0,0,0,0
../kbl_data/2021-2022,S39G01N68,수원 KT,Home,마이크 마이어스,10,4,5,80.0,0,0,0.0,4,5,80.0,2,6,33.3,0,2,2,2,0,0,0,0,2,3
../kbl_data/2021-2022,S39G01N68,수원 KT,Home,하윤기,2,1,2,50.0,0,0,0.0,1,2,50.0,0,1,0.0,0,4,4,0,1,1,0,0,2,3
../kbl_data/2021-2022,S39G01N68,창원 LG,Away,강병현,0,0,0,0.0,0,0,0.0,0,0,0.0,0,0,0.0,0,2,2,0,0,0,0,0,0,1
../kbl_data/2021-2022,S39G01N68,창원 LG,Away,변기훈,0,0,0,0.0,0,1,0.0,0,1,0.0,0,0,0.0,0,0,0,0,0,0,1,0,0,0
../kbl_data/2021-2022,S39G01N68,창원 LG,Away,이관희,7,2,4,50.0,1,4,25.0,3,8,37.5,0,0,0.0,0,0,0,2,1,0,0,0,3,1
../kbl_data/2021-2022,S39G01N68,창원 LG,Away,정희재,24,2,2,100.0,5,7,71.4,7,9,77.8,5,6,83.3,1,5,6,1,0,0,0,0,0,4
../kbl_data/2021-2022,S39G01N68,창원 LG,Away,서민수,4,2,3,66.7,0,8,0.0,2,11,18.2,0,0,0.0,1,2,3,2,0,0,0,0,0,1
../kbl_data/2021-2022,S39G01N68,창원 LG,Away,이재도,17,7,9,77.8,1,6,16.7,8,15,53.3,0,0,0.0,3,0,3,4,3,0,0,0,0,1
../kbl_data/2021-2022,S39G01N68,창원 LG,Away,박정현,2,1,2,50.0,0,0,0.0,1,2,50.0,0,0,0.0,1,1,2,1,2,0,0,0,0,5
../kbl_data/2021-2022,S39G01N68,창원 LG,Away,이광진,0,0,1,0.0,0,0,0.0,0,1,0.0,0,0,0.0,1,1,2,0,0,0,0,0,0,2
../kbl_data/2021-2022,S39G01N68,창원 LG,Away,윤원상,2,1,1,100.0,0,0,0.0,1,1,100.0,0,0,0.0,0,0,0,0,0,0,0,0,0,0
../kbl_data/2021-2022,S39G01N68,창원 LG,Away,압둘 말릭 아부,1,0,2,0.0,0,0,0.0,0,2,0.0,1,2,50.0,1,2,3,0,0,0,0,0,1,3
../kbl_data/2021-2022,S39G01N68,창원 LG,Away,아셈 마레이,23,6,14,42.9,1,1,100.0,7,15,46.7,8,11,72.7,6,5,11,2,0,2,0,0,3,3
../kbl_data/2021-2022,S39G01N68,창원 LG,Away,이승우,0,0,0,0.0,0,0,0.0,0,0,0.0,0,0,0.0,0,0,0,0,0,0,0,0,0,0
../kbl_data/2021-2022,S39G01N69,울산 현대모비스,Home,함지훈,21,8,10,80.0,1,3,33.3,9,13,69.2,2,3,66.7,0,4,4,2,2,1,0,0,1,1
../kbl_data/2021-2022,S39G01N69,울산 현대모비스,Home,최진수,0,0,2,0.0,0,0,0.0,0,2,0.0,0,0,0.0,0,0,0,1,0,0,0,0,0,0
../kbl_data/2021-2022,S39G01N69,울산 현대모비스,Home,박지훈,0,0,1,0.0,0,2,0.0,0,3,0.0,0,0,0.0,0,0,0,0,1,0,0,0,0,3
../kbl_data/2021-2022,S39G01N69,울산 현대모비스,Home,장재석,2,1,3,33.3,0,0,0.0,1,3,33.3,0,1,0.0,0,1,1,1,0,0,0,0,2,2
../kbl_data/2021-2022,S39G01N69,울산 현대모비스,Home,정성호,0,0,0,0.0,0,0,0.0,0,0,0.0,0,0,0.0,0,0,0,0,0,0,0,0,0,0
../kbl_data/2021-2022,S39G01N69,울산 현대모비스,Home,서명진,15,0,2,0.0,5,6,83.3,5,8,62.5,0,0,0.0,0,3,3,12,0,0,0,0,1,1
../kbl_data/2021-2022,S39G01N69,울산 현대모비스,Home,얼 클락,16,7,10,70.0,0,0,0.0,7,10,70.0,2,2,100.0,1,7,8,1,0,0,0,0,4,0
../kbl_data/2021-2022,S39G01N69,울산 현대모비스,Home,이우석,4,2,3,66.7,0,1,0.0,2,4,50.0,0,0,0.0,1,1,2,2,0,1,0,0,3,1
../kbl_data/2021-2022,S39G01N69,울산 현대모비스,Home,라숀 토마스,6,3,5,60.0,0,0,0.0,3,5,60.0,0,2,0.0,5,5,10,1,1,2,0,0,3,2
../kbl_data/2021-2022,S39G01N69,울산 현대모비스,Home,신민석,13,1,1,100.0,3,5,60.0,4,6,66.7,2,2,100.0,2,2,4,0,1,0,0,0,3,3
../kbl_data/2021-2022,S39G01N69,울산 현대모비스,Home,김동준,15,6,7,85.7,1,4,25.0,7,11,63.6,0,0,0.0,0,0,0,4,4,0,0,0,1,2
../kbl_data/2021-2022,S39G01N69,울산 현대모비스,Home,윤성준,0,0,0,0.0,0,1,0.0,0,1,0.0,0,0,0.0,0,1,1,0,0,0,0,0,1,2
../kbl_data/2021-2022,S39G01N69,원주 DB,Away,윤호영,0,0,0,0.0,0,1,0.0,0,1,0.0,0,0,0.0,0,0,0,0,0,0,0,0,1,1
../kbl_data/2021-2022,S39G01N69,원주 DB,Away,박찬희,0,0,1,0.0,0,2,0.0,0,3,0.0,0,0,0.0,0,1,1,3,0,0,0,0,0,0
../kbl_data/2021-2022,S39G01N69,원주 DB,Away,정준원,4,1,2,50.0,0,0,0.0,1,2,50.0,2,2,100.0,0,0,0,0,0,0,0,0,1,0
../kbl_data/2021-2022,S39G01N69,원주 DB,Away,김종규,4,2,6,33.3,0,0,0.0,2,6,33.3,0,0,0.0,1,2,3,0,0,0,0,0,2,4
../kbl_data/2021-2022,S39G01N69,원주 DB,Away,허웅,18,3,7,42.9,3,10,30.0,6,17,35.3,3,3,100.0,2,0,2,6,5,0,0,0,4,1
../kbl_data/2021-2022,S39G01N69,원주 DB,Away,김영훈,3,0,0,0.0,1,2,50.0,1,2,50.0,0,0,0.0,1,1,2,0,0,0,0,0,0,0
../kbl_data/2021-2022,S39G01N69,원주 DB,Away,배강률,2,1,1,100.0,0,0,0.0,1,1,100.0,0,0,0.0,0,0,0,0,1,0,0,0,0,1
../kbl_data/2021-2022,S39G01N69,원주 DB,Away,김철욱,9,1,1,100.0,2,3,66.7,3,4,75.0,1,2,50.0,0,0,0,2,1,1,0,0,3,2
../kbl_data/2021-2022,S39G01N69,원주 DB,Away,나카무라 타이치,0,0,1,0.0,0,2,0.0,0,3,0.0,0,0,0.0,0,2,2,0,0,0,0,0,0,1
../kbl_data/2021-2022,S39G01N69,원주 DB,Away,이준희,16,8,11,72.7,0,0,0.0,8,11,72.7,0,1,0.0,2,2,4,2,3,0,0,0,0,3
../kbl_data/2021-2022,S39G01N69,원주 DB,Away,레나드 프리먼,24,10,11,90.9,1,2,50.0,11,13,84.6,1,2,50.0,5,8,13,4,1,0,0,2,2,2
../kbl_data/2021-2022,S39G01N69,원주 DB,Away,정호영,6,2,6,33.3,0,2,0.0,2,8,25.0,2,2,100.0,0,2,2,2,2,0,0,0,2,0
../kbl_data/2021-2022,S39G01N70,서울 SK,Home,양우섭,2,1,2,50.0,0,0,0.0,1,2,50.0,0,0,0.0,0,0,0,1,0,0,0,0,0,1
../kbl_data/2021-2022,S39G01N70,서울 SK,Home,허일영,12,3,5,60.0,2,2,100.0,5,7,71.4,0,0,0.0,2,0,2,1,2,1,0,0,0,2
../kbl_data/2021-2022,S39G01N70,서울 SK,Home,김선형,18,6,7,85.7,2,2,100.0,8,9,88.9,0,0,0.0,0,1,1,5,0,0,0,0,1,0
../kbl_data/2021-2022,S39G01N70,서울 SK,Home,최부경,4,2,5,40.0,0,0,0.0,2,5,40.0,0,0,0.0,1,2,3,1,1,0,1,0,0,2
../kbl_data/2021-2022,S39G01N70,서울 SK,Home,리온 윌리엄스,8,4,5,80.0,0,0,0.0,4,5,80.0,0,0,0.0,0,1,1,0,1,0,0,0,2,1
../kbl_data/2021-2022,S39G01N70,서울 SK,Home,배병준,2,1,1,100.0,0,0,0.0,1,1,100.0,0,0,0.0,0,0,0,0,0,0,0,0,0,0
../kbl_data/2021-2022,S39G01N70,서울 SK,Home,이현석,0,0,1,0.0,0,0,0.0,0,1,0.0,0,0,0.0,0,0,0,1,0,0,1,0,0,1
../kbl_data/2021-2022,S39G01N70,서울 SK,Home,최원혁,0,0,0,0.0,0,2,0.0,0,2,0.0,0,0,0.0,1,3,4,5,0,0,0,0,0,4
../kbl_data/2021-2022,S39G01N70,서울 SK,Home,최준용,4,1,2,50.0,0,2,0.0,1,4,25.0,2,2,100.0,0,5,5,5,0,0,0,0,0,0
../kbl_data/2021-2022,S39G01N70,서울 SK,Home,안영준,10,3,8,37.5,1,2,50.0,4,10,40.0,1,2,50.0,1,0,1,2,1,1,0,0,2,1
../kbl_data/2021-2022,S39G01N70,서울 SK,Home,자밀 워니,27,12,18,66.7,0,1,0.0,12,19,63.2,3,4,75.0,0,7,7,3,4,0,0,0,1,3
../kbl_data/2021-2022,S39G01N70,서울 SK,Home,오재현,2,1,1,100.0,0,0,0.0,1,1,100.0,0,0,0.0,0,0,0,1,0,1,0,0,0,1
../kbl_data/2021-2022,S39G01N70,고양 오리온,Away,오용준,2,1,1,100.0,0,0,0.0,1,1,100.0,0,0,0.0,0,0,0,0,0,0,0,0,0,3
../kbl_data/2021-2022,S39G01N70,고양 오리온,Away,김강선,2,1,2,50.0,0,3,0.0,1,5,20.0,0,0,0.0,0,1,1,1,0,1,0,0,0,1
../kbl_data/2021-2022,S39G01N70,고양 오리온,Away,최현민,1,0,0,0.0,0,2,0.0,0,2,0.0,1,2,50.0,0,2,2,0,0,0,0,0,1,0
../kbl_data/2021-2022,S39G01N70,고양 오리온,Away,임종일,2,1,1,100.0,0,0,0.0,1,1,100.0,0,0,0.0,0,0,0,0,0,0,0,0,0,0
../kbl_data/2021-2022,S39G01N70,고양 오리온,Away,이대성,17,5,9,55.6,1,2,50.0,6,11,54.5,4,4,100.0,2,2,4,3,0,0,0,0,2,3
../kbl_data/2021-2022,S39G01N70,고양 오리온,Away,한호빈,7,2,2,100.0,1,2,50.0,3,4,75.0,0,0,0.0,0,2,2,2,0,0,0,0,2,1
../kbl_data/2021-2022,S39G01N70,고양 오리온,Away,최승욱,3,0,0,0.0,1,1,100.0,1,1,100.0,0,0,0.0,0,0,0,0,1,0,0,0,1,0
../kbl_data/2021-2022,S39G01N70,고양 오리온,Away,이승현,17,3,7,42.9,3,3,100.0,6,10,60.0,2,2,100.0,0,3,3,1,0,3,0,0,2,1
../kbl_data/2021-2022,S39G01N70,고양 오리온,Away,이종현,0,0,0,0.0,0,0,0.0,0,0,0.0,0,0,0.0,0,0,0,0,0,0,0,0,0,0
../kbl_data/2021-2022,S39G01N70,고양 오리온,Away,머피 할로웨이,15,6,9,66.7,0,2,0.0,6,11,54.5,3,3,100.0,1,7,8,1,1,0,0,2,4,4
../kbl_data/2021-2022,S39G01N70,고양 오리온,Away,미로슬라브 라둘리차,2,1,2,50.0,0,1,0.0,1,3,33.3,0,0,0.0,1,4,5,1,0,1,0,0,1,2
../kbl_data/2021-2022,S39G01N70,고양 오리온,Away,이정현,15,4,5,80.0,2,4,50.0,6,9,66.7,1,2,50.0,0,2,2,2,3,0,0,0,3,3
../kbl_data/2021-2022,S39G01N71,울산 현대모비스,Home,이현민,0,0,0,0.0,0,0,0.0,0,0,0.0,0,0,0.0,0,1,1,3,1,0,0,0,0,1
../kbl_data/2021-2022,S39G01N71,울산 현대모비스,Home,함지훈,6,2,2,100.0,0,3,0.0,2,5,40.0,2,4,50.0,2,3,5,2,1,1,0,0,1,0
../kbl_data/2021-2022,S39G01N71,울산 현대모비스,Home,최진수,0,0,1,0.0,0,1,0.0,0,2,0.0,0,0,0.0,0,3,3,3,1,0,0,0,0,0
../kbl_data/2021-2022,S39G01N71,울산 현대모비스,Home,박지훈,3,0,2,0.0,1,1,100.0,1,3,33.3,0,0,0.0,1,0,1,1,0,0,0,0,0,1
../kbl_data/2021-2022,S39G01N71,울산 현대모비스,Home,장재석,9,3,8,37.5,0,0,0.0,3,8,37.5,3,6,50.0,0,2,2,2,0,0,0,0,0,2
../kbl_data/2021-2022,S39G01N71,울산 현대모비스,Home,정성호,0,0,0,0.0,0,0,0.0,0,0,0.0,0,0,0.0,0,0,0,0,0,0,0,0,0,0
../kbl_data/2021-2022,S39G01N71,울산 현대모비스,Home,서명진,11,4,5,80.0,1,2,50.0,5,7,71.4,0,0,0.0,0,0,0,0,0,0,0,0,5,4
../kbl_data/2021-2022,S39G01N71,울산 현대모비스,Home,얼 클락,14,3,8,37.5,2,4,50.0,5,12,41.7,2,2,100.0,1,9,10,1,1,2,0,1,0,2
../kbl_data/2021-2022,S39G01N71,울산 현대모비스,Home,이우석,16,6,13,46.2,1,1,100.0,7,14,50.0,1,1,100.0,1,1,2,4,2,0,0,0,1,3
../kbl_data/2021-2022,S39G01N71,울산 현대모비스,Home,라숀 토마스,4,0,5,0.0,0,0,0.0,0,5,0.0,4,4,100.0,0,1,1,0,0,1,0,0,0,2
../kbl_data/2021-2022,S39G01N71,울산 현대모비스,Home,신민석,5,1,2,50.0,1,7,14.3,2,9,22.2,0,0,0.0,2,0,2,0,0,0,1,0,2,2
../kbl_data/2021-2022,S39G01N71,울산 현대모비스,Home,김동준,2,1,2,50.0,0,1,0.0,1,3,33.3,0,0,0.0,0,0,0,1,2,0,0,0,1,0
../kbl_data/2021-2022,S39G01N71,수원 KT,Away,김동욱,5,1,3,33.3,1,2,50.0,2,5,40.0,0,0,0.0,0,0,0,3,1,1,0,0,0,0
../kbl_data/2021-2022,S39G01N71,수원 KT,Away,김영환,6,3,4,75.0,0,0,0.0,3,4,75.0,0,0,0.0,0,0,0,2,0,1,0,0,0,0
../kbl_data/2021-2022,S39G01N71,수원 KT,Away,김현민,8,4,6,66.7,0,3,0.0,4,9,44.4,0,0,0.0,0,2,2,0,2,0,0,0,1,3
../kbl_data/2021-2022,S39G01N71,수원 KT,Away,최창진,0,0,0,0.0,0,0,0.0,0,0,0.0,0,0,0.0,0,0,0,0,0,0,0,0,0,1
../kbl_data/2021-2022,S39G01N71,수원 KT,Away,정성우,7,2,3,66.7,1,2,50.0,3,5,60.0,0,0,0.0,0,5,5,3,1,0,1,0,1,3
../kbl_data/2021-2022,S39G01N71,수원 KT,Away,허훈,7,3,7,42.9,0,4,0.0,3,11,27.3,1,4,25.0,0,2,2,5,0,0,0,0,2,1
../kbl_data/2021-2022,S39G01N71,수원 KT,Away,양홍석,16,3,7,42.9,3,5,60.0,6,12,50.0,1,1,100.0,2,5,7,6,0,0,0,0,3,0
../kbl_data/2021-2022,S39G01N71,수원 KT,Away,캐디 라렌,18,6,15,40.0,1,2,50.0,7,17,41.2,3,3,100.0,6,6,12,0,1,3,0,0,3,2
../kbl_data/2021-2022,S39G01N71,수원 KT,Away,문상옥,0,0,0,0.0,0,0,0.0,0,0,0.0,0,0,0.0,0,0,0,0,0,0,0,0,0,0
../kbl_data/2021-2022,S39G01N71,수원 KT,Away,박지원,0,0,0,0.0,0,0,0.0,0,0,0.0,0,0,0.0,0,0,0,0,0,0,0,0,0,0
../kbl_data/2021-2022,S39G01N71,수원 KT,Away,마이크 마이어스,9,4,6,66.7,0,0,0.0,4,6,66.7,1,2,50.0,5,5,10,1,0,1,0,1,2,3
../kbl_data/2021-2022,S39G01N71,수원 KT,Away,하윤기,9,3,3,100.0,0,0,0.0,3,3,100.0,3,4,75.0,2,4,6,0,0,0,0,0,1,5
../kbl_data/2021-2022,S39G01N72,대구 한국가스공사,Home,정영삼,0,0,2,0.0,0,0,0.0,0,2,0.0,0,0,0.0,0,2,2,0,0,0,0,0,0,0
../kbl_data/2021-2022,S39G01N72,대구 한국가스공사,Home,민성주,0,0,0,0.0,0,0,0.0,0,0,0.0,0,0,0.0,0,0,0,1,0,0,0,0,0,2
../kbl_data/2021-2022,S39G01N72,대구 한국가스공사,Home,홍경기,0,0,0,0.0,0,0,0.0,0,0,0.0,0,0,0.0,0,0,0,0,0,0,0,0,0,0
../kbl_data/2021-2022,S39G01N72,대구 한국가스공사,Home,차바위,2,1,1,100.0,0,1,0.0,1,2,50.0,0,0,0.0,0,2,2,2,0,0,1,0,1,4
../kbl_data/2021-2022,S39G01N72,대구 한국가스공사,Home,조상열,5,1,1,100.0,1,3,33.3,2,4,50.0,0,0,0.0,4,0,4,1,1,0,0,0,0,1
../kbl_data/2021-2022,S39G01N72,대구 한국가스공사,Home,임준수,0,0,1,0.0,0,0,0.0,0,1,0.0,0,0,0.0,0,1,1,0,0,0,0,0,1,2
../kbl_data/2021-2022,S39G01N72,대구 한국가스공사,Home,김낙현,23,5,9,55.6,4,8,50.0,9,17,52.9,1,4,25.0,1,2,3,7,0,0,0,0,3,2
../kbl_data/2021-2022,S39G01N72,대구 한국가스공사,Home,전현우,12,3,5,60.0,2,4,50.0,5,9,55.6,0,0,0.0,1,1,2,1,1,0,1,0,0,3
../kbl_data/2021-2022,S39G01N72,대구 한국가스공사,Home,양준우,0,0,0,0.0,0,1,0.0,0,1,0.0,0,0,0.0,0,0,0,0,0,0,0,0,0,1
../kbl_data/2021-2022,S39G01N72,대구 한국가스공사,Home,클리프 알렉산더,2,1,3,33.3,0,0,0.0,1,3,33.3,0,1,0.0,2,1,3,0,0,0,0,0,1,0
../kbl_data/2021-2022,S39G01N72,대구 한국가스공사,Home,앤드류 니콜슨,37,9,16,56.2,5,9,55.6,14,25,56.0,4,5,80.0,1,20,21,1,1,0,0,3,4,0
../kbl_data/2021-2022,S39G01N72,대구 한국가스공사,Home,신승민,7,2,4,50.0,1,2,50.0,3,6,50.0,0,0,0.0,2,0,2,5,0,0,1,0,0,3
../kbl_data/2021-2022,S39G01N72,고양 오리온,Away,오용준,0,0,0,0.0,0,0,0.0,0,0,0.0,0,0,0.0,0,0,0,0,0,0,0,0,0,0
../kbl_data/2021-2022,S39G01N72,고양 오리온,Away,김강선,8,1,2,50.0,2,4,50.0,3,6,50.0,0,1,0.0,1,1,2,1,1,0,0,0,0,3
../kbl_data/2021-2022,S39G01N72,고양 오리온,Away,최현민,3,0,1,0.0,1,2,50.0,1,3,33.3,0,0,0.0,0,0,0,1,1,0,0,0,1,2
../kbl_data/2021-2022,S39G01N72,고양 오리온,Away,임종일,0,0,0,0.0,0,0,0.0,0,0,0.0,0,0,0.0,0,0,0,0,0,0,0,0,0,0
../kbl_data/2021-2022,S39G01N72,고양 오리온,Away,이대성,20,6,8,75.0,1,2,50.0,7,10,70.0,5,7,71.4,0,3,3,1,2,0,0,0,4,2
../kbl_data/2021-2022,S39G01N72,고양 오리온,Away,한호빈,7,1,3,33.3,1,4,25.0,2,7,28.6,2,4,50.0,1,3,4,2,3,0,0,0,2,2
../kbl_data/2021-2022,S39G01N72,고양 오리온,Away,이승현,11,3,7,42.9,0,4,0.0,3,11,27.3,5,6,83.3,2,5,7,3,0,0,0,0,0,2
../kbl_data/2021-2022,S39G01N72,고양 오리온,Away,이종현,0,0,0,0.0,0,0,0.0,0,0,0.0,0,0,0.0,0,0,0,0,0,0,0,0,0,0
../kbl_data/2021-2022,S39G01N72,고양 오리온,Away,머피 할로웨이,10,5,9,55.6,0,1,0.0,5,10,50.0,0,0,0.0,2,7,9,5,1,2,0,2,0,2
../kbl_data/2021-2022,S39G01N72,고양 오리온,Away,김세창,0,0,0,0.0,0,0,0.0,0,0,0.0,0,0,0.0,0,0,0,0,0,0,0,0,0,0
../kbl_data/2021-2022,S39G01N72,고양 오리온,Away,미로슬라브 라둘리차,3,0,3,0.0,1,2,50.0,1,5,20.0,0,2,0.0,0,4,4,2,0,0,0,0,1,2
../kbl_data/2021-2022,S39G01N72,고양 오리온,Away,이정현,17,1,3,33.3,5,6,83.3,6,9,66.7,0,0,0.0,0,1,1,3,0,0,0,0,1,3
../kbl_data/2021-2022,S39G01N73,안양 KGC,Home,함준후,4,2,3,66.7,0,2,0.0,2,5,40.0,0,0,0.0,0,2,2,0,0,1,0,0,0,3
../kbl_data/2021-2022,S39G01N73,안양 KGC,Home,오세근,17,6,10,60.0,0,2,0.0,6,12,50.0,5,5,100.0,2,6,8,4,0,0,0,0,0,0
../kbl_data/2021-2022,S39G01N73,안양 KGC,Home,문성곤,15,1,1,100.0,4,7,57.1,5,8,62.5,1,2,50.0,3,3,6,3,3,0,0,0,1,2
../kbl_data/2021-2022,S39G01N73,안양 KGC,Home,전성현,19,2,3,66.7,5,6,83.3,7,9,77.8,0,0,0.0,0,1,1,0,0,0,0,0,1,1
../kbl_data/2021-2022,S39G01N73,안양 KGC,Home,박재한,0,0,0,0.0,0,0,0.0,0,0,0.0,0,0,0.0,0,0,0,0,0,0,0,0,1,0
../kbl_data/2021-2022,S39G01N73,안양 KGC,Home,정강호,0,0,0,0.0,0,1,0.0,0,1,0.0,0,0,0.0,0,1,1,0,0,0,0,0,1,1
../kbl_data/2021-2022,S39G01N73,안양 KGC,Home,이우정,4,2,4,50.0,0,0,0.0,2,4,50.0,0,0,0.0,0,0,0,1,1,0,0,0,0,1
../kbl_data/2021-2022,S39G01N73,안양 KGC,Home,대릴 먼로,4,2,5,40.0,0,1,0.0,2,6,33.3,0,0,0.0,1,0,1,2,0,0,0,0,0,1
../kbl_data/2021-2022,S39G01N73,안양 KGC,Home,우동현,3,0,1,0.0,1,3,33.3,1,4,25.0,0,0,0.0,1,0,1,1,1,0,0,0,0,0
../kbl_data/2021-2022,S39G01N73,안양 KGC,Home,변준형,16,2,3,66.7,3,5,60.0,5,8,62.5,3,4,75.0,0,1,1,9,1,0,0,0,0,3
../kbl_data/2021-2022,S39G01N73,안양 KGC,Home,한승희,5,1,1,100.0,1,1,100.0,2,2,100.0,0,0,0.0,0,1,1,1,0,0,0,0,0,2
../kbl_data/2021-2022,S39G01N73,안양 KGC,Home,오마리 스펠맨,21,8,11,72.7,1,5,20.0,9,16,56.2,2,2,100.0,1,7,8,1,5,6,0,4,1,2
../kbl_data/2021-2022,S39G01N73,전주 KCC,Away,송창용,14,6,7,85.7,0,2,0.0,6,9,66.7,2,2,100.0,1,3,4,3,0,0,0,0,0,0
../kbl_data/2021-2022,S39G01N73,전주 KCC,Away,이정현,12,3,5,60.0,2,5,40.0,5,10,50.0,0,1,0.0,0,1,1,2,0,0,0,0,3,1
../kbl_data/2021-2022,S39G01N73,전주 KCC,Away,정창영,9,2,7,28.6,1,1,100.0,3,8,37.5,2,2,100.0,0,5,5,3,1,0,0,0,0,1
../kbl_data/2021-2022,S39G01N73,전주 KCC,Away,라건아,20,10,13,76.9,0,2,0.0,10,15,66.7,0,0,0.0,5,2,7,2,0,1,0,0,1,1
../kbl_data/2021-2022,S39G01N73,전주 KCC,Away,김지완,0,0,1,0.0,0,3,0.0,0,4,0.0,0,0,0.0,0,0,0,2,1,0,0,0,1,2
../kbl_data/2021-2022,S39G01N73,전주 KCC,Away,김상규,3,0,1,0.0,1,3,33.3,1,4,25.0,0,0,0.0,3,2,5,1,0,0,0,0,1,3
../kbl_data/2021-2022,S39G01N73,전주 KCC,Away,유병훈,0,0,0,0.0,0,0,0.0,0,0,0.0,0,0,0.0,0,1,1,1,1,1,0,0,0,0
../kbl_data/2021-2022,S39G01N73,전주 KCC,Away,전준범,10,0,0,0.0,3,6,50.0,3,6,50.0,1,2,50.0,0,5,5,1,0,0,0,0,1,1
../kbl_data/2021-2022,S39G01N73,전주 KCC,Away,박재현,3,0,1,0.0,1,2,50.0,1,3,33.3,0,0,0.0,0,1,1,3,0,0,0,0,1,3
../kbl_data/2021-2022,S39G01N73,전주 KCC,Away,이진욱,2,1,2,50.0,0,0,0.0,1,2,50.0,0,0,0.0,0,0,0,1,0,0,0,0,1,1
../kbl_data/2021-2022,S39G01N73,전주 KCC,Away,유현준,5,0,3,0.0,1,2,50.0,1,5,20.0,2,2,100.0,0,2,2,1,0,0,0,0,2,1
../kbl_data/2021-2022,S39G01N73,전주 KCC,Away,라타비우스 윌리엄스,14,6,8,75.0,0,0,0.0,6,8,75.0,2,2,100.0,4,4,8,0,0,1,0,1,1,2
../kbl_data/2021-2022,S39G01N74,창원 LG,Home,강병현,0,0,0,0.0,0,0,0.0,0,0,0.0,0,0,0.0,0,0,0,0,0,0,0,0,0,1
../kbl_data/2021-2022,S39G01N74,창원 LG,Home,변기훈,5,1,1,100.0,1,3,33.3,2,4,50.0,0,0,0.0,0,0,0,1,0,0,0,0,0,0
../kbl_data/2021-2022,S39G01N74,창원 LG,Home,이관희,10,2,6,33.3,2,8,25.0,4,14,28.6,0,0,0.0,1,2,3,3,2,0,0,0,3,2
../kbl_data/2021-2022,S39G01N74,창원 LG,Home,정희재,5,0,1,0.0,1,3,33.3,1,4,25.0,2,2,100.0,0,0,0,0,0,0,0,0,0,4
../kbl_data/2021-2022,S39G01N74,창원 LG,Home,서민수,3,0,0,0.0,1,2,50.0,1,2,50.0,0,0,0.0,0,1,1,0,0,1,0,0,0,1
../kbl_data/2021-2022,S39G01N74,창원 LG,Home,이재도,16,2,5,40.0,3,6,50.0,5,11,45.5,3,4,75.0,0,0,0,4,4,0,0,0,0,1
../kbl_data/2021-2022,S39G01N74,창원 LG,Home,박정현,13,4,11,36.4,1,1,100.0,5,12,41.7,2,2,100.0,8,2,10,2,0,1,0,0,2,5
../kbl_data/2021-2022,S39G01N74,창원 LG,Home,이광진,3,0,1,0.0,1,3,33.3,1,4,25.0,0,0,0.0,1,0,1,1,0,0,0,0,0,1
../kbl_data/2021-2022,S39G01N74,창원 LG,Home,윤원상,6,1,3,33.3,1,2,50.0,2,5,40.0,1,2,50.0,0,1,1,0,0,0,0,0,0,3
../kbl_data/2021-2022,S39G01N74,창원 LG,Home,압둘 말릭 아부,4,2,2,100.0,0,0,0.0,2,2,100.0,0,0,0.0,0,3,3,1,0,0,0,0,0,2
../kbl_data/2021-2022,S39G01N74,창원 LG,Home,아셈 마레이,15,7,14,50.0,0,1,0.0,7,15,46.7,1,2,50.0,4,10,14,3,3,0,0,0,0,3
../kbl_data/2021-2022,S39G01N74,창원 LG,Home,이승우,5,1,3,33.3,1,1,100.0,2,4,50.0,0,0,0.0,0,2,2,1,1,0,0,0,0,1
../kbl_data/2021-2022,S39G01N74,서울 SK,Away,양우섭,0,0,1,0.0,0,0,0.0,0,1,0.0,0,0,0.0,0,1,1,0,0,0,0,0,1,0
../kbl_data/2021-2022,S39G01N74,서울 SK,Away,허일영,1,0,0,0.0,0,2,0.0,0,2,0.0,1,2,50.0,1,3,4,0,0,0,0,0,0,2
../kbl_data/2021-2022,S39G01N74,서울 SK,Away,김선형,5,2,4,50.0,0,2,0.0,2,6,33.3,1,4,25.0,0,1,1,5,0,0,0,0,3,1
../kbl_data/2021-2022,S39G01N74,서울 SK,Away,최부경,4,2,5,40.0,0,0,0.0,2,5,40.0,0,0,0.0,0,4,4,0,0,0,0,0,0,2
../kbl_data/2021-2022,S39G01N74,서울 SK,Away,리온 윌리엄스,0,0,1,0.0,0,0,0.0,0,1,0.0,0,0,0.0,1,0,1,0,0,0,0,0,1,0
../kbl_data/2021-2022,S39G01N74,서울 SK,Away,이원대,0,0,1,0.0,0,0,0.0,0,1,0.0,0,0,0.0,0,0,0,0,0,0,0,0,1,0
../kbl_data/2021-2022,S39G01N74,서울 SK,Away,이현석,5,1,1,100.0,1,2,50.0,2,3,66.7,0,0,0.0,0,2,2,0,0,0,0,0,0,2
../kbl_data/2021-2022,S39G01N74,서울 SK,Away,최원혁,8,1,1,100.0,1,1,100.0,2,2,100.0,3,4,75.0,2,1,3,1,1,0,1,0,1,2
../kbl_data/2021-2022,S39G01N74,서울 SK,Away,최준용,17,5,7,71.4,1,3,33.3,6,10,60.0,4,8,50.0,1,4,5,2,0,3,0,0,3,2
../kbl_data/2021-2022,S39G01N74,서울 SK,Away,안영준,19,4,9,44.4,2,3,66.7,6,12,50.0,5,8,62.5,0,5,5,0,1,1,0,0,1,4
../kbl_data/2021-2022,S39G01N74,서울 SK,Away,자밀 워니,14,6,14,42.9,0,1,0.0,6,15,40.0,2,2,100.0,5,10,15,7,0,1,0,0,4,1
../kbl_data/2021-2022,S39G01N74,서울 SK,Away,오재현,0,0,0,0.0,0,0,0.0,0,0,0.0,0,0,0.0,0,0,0,0,0,0,0,0,1,2
../kbl_data/2021-2022,S39G01N75,서울 삼성,Home,장민국,10,2,3,66.7,2,5,40.0,4,8,50.0,0,0,0.0,1,0,1,0,0,0,0,0,1,5
../kbl_data/2021-2022,S39G01N75,서울 삼성,Home,김시래,5,1,2,50.0,1,3,33.3,2,5,40.0,0,0,0.0,1,2,3,6,1,0,1,0,4,3
../kbl_data/2021-2022,S39G01N75,서울 삼성,Home,김현수,2,1,1,100.0,0,0,0.0,1,1,100.0,0,0,0.0,0,0,0,0,1,0,0,0,0,1
../kbl_data/2021-2022,S39G01N75,서울 삼성,Home,임동섭,0,0,5,0.0,0,5,0.0,0,10,0.0,0,0,0.0,1,1,2,0,0,0,0,0,1,2
../kbl_data/2021-2022,S39G01N75,서울 삼성,Home,이동엽,12,5,8,62.5,0,4,0.0,5,12,41.7,2,4,50.0,3,7,10,2,4,0,0,0,3,2
../kbl_data/2021-2022,S39G01N75,서울 삼성,Home,배수용,0,0,0,0.0,0,0,0.0,0,0,0.0,0,0,0.0,0,0,0,0,0,0,0,0,0,0
../kbl_data/2021-2022,S39G01N75,서울 삼성,Home,이호현,0,0,0,0.0,0,0,0.0,0,0,0.0,0,0,0.0,0,0,0,0,0,0,0,0,0,0
../kbl_data/2021-2022,S39G01N75,서울 삼성,Home,아이제아 힉스,2,1,1,100.0,0,0,0.0,1,1,100.0,0,0,0.0,0,0,0,0,0,0,0,0,0,0
../kbl_data/2021-2022,S39G01N75,서울 삼성,Home,차민석,3,1,4,25.0,0,0,0.0,1,4,25.0,1,1,100.0,2,3,5,0,0,0,0,0,0,2
../kbl_data/2021-2022,S39G01N75,서울 삼성,Home,전형준,3,0,0,0.0,0,1,0.0,0,1,0.0,3,4,75.0,1,0,1,0,0,0,0,0,0,0
../kbl_data/2021-2022,S39G01N75,서울 삼성,Home,다니엘 오셰푸,17,7,17,41.2,0,1,0.0,7,18,38.9,3,4,75.0,3,5,8,2,2,4,0,1,5,2
../kbl_data/2021-2022,S39G01N75,서울 삼성,Home,이원석,4,0,4,0.0,0,0,0.0,0,4,0.0,4,4,100.0,1,0,1,0,1,0,1,0,0,2
../kbl_data/2021-2022,S39G01N75,수원 KT,Away,김동욱,13,2,5,40.0,3,5,60.0,5,10,50.0,0,0,0.0,0,3,3,1,1,0,0,0,2,1
../kbl_data/2021-2022,S39G01N75,수원 KT,Away,김영환,14,4,9,44.4,1,2,50.0,5,11,45.5,3,3,100.0,2,7,9,2,0,0,1,0,1,2
../kbl_data/2021-2022,S39G01N75,수원 KT,Away,김현민,1,0,0,0.0,0,0,0.0,0,0,0.0,1,2,50.0,0,0,0,0,0,0,0,0,0,2
../kbl_data/2021-2022,S39G01N75,수원 KT,Away,최창진,0,0,0,0.0,0,0,0.0,0,0,0.0,0,0,0.0,0,0,0,0,0,0,0,0,0,3
../kbl_data/2021-2022,S39G01N75,수원 KT,Away,정성우,0,0,0,0.0,0,0,0.0,0,0,0.0,0,0,0.0,0,0,0,2,0,0,0,0,1,0
../kbl_data/2021-2022,S39G01N75,수원 KT,Away,허훈,12,6,7,85.7,0,3,0.0,6,10,60.0,0,2,0.0,0,0,0,1,0,0,0,0,6,3
../kbl_data/2021-2022,S39G01N75,수원 KT,Away,양홍석,10,3,7,42.9,0,3,0.0,3,10,30.0,4,4,100.0,1,5,6,4,3,0,0,0,2,2
../kbl_data/2021-2022,S39G01N75,수원 KT,Away,캐디 라렌,5,1,4,25.0,1,3,33.3,2,7,28.6,0,0,0.0,2,3,5,1,0,2,0,1,0,1
../kbl_data/2021-2022,S39G01N75,수원 KT,Away,문상옥,0,0,0,0.0,0,0,0.0,0,0,0.0,0,0,0.0,0,0,0,0,0,0,0,0,0,0
../kbl_data/2021-2022,S39G01N75,수원 KT,Away,박지원,0,0,0,0.0,0,0,0.0,0,0,0.0,0,0,0.0,0,0,0,0,0,0,0,0,0,0
../kbl_data/2021-2022,S39G01N75,수원 KT,Away,마이크 마이어스,8,3,4,75.0,0,0,0.0,3,4,75.0,2,3,66.7,1,8,9,1,5,1,0,2,3,4
../kbl_data/2021-2022,S39G01N75,수원 KT,Away,하윤기,4,2,3,66.7,0,0,0.0,2,3,66.7,0,0,0.0,1,2,3,0,0,2,0,0,3,1
../kbl_data/2021-2022,S39G01N76,대구 한국가스공사,Home,정영삼,0,0,0,0.0,0,0,0.0,0,0,0.0,0,0,0.0,0,0,0,0,0,0,0,0,0,0
../kbl_data/2021-2022,S39G01N76,대구 한국가스공사,Home,민성주,4,2,2,100.0,0,0,0.0,2,2,100.0,0,2,0.0,1,1,2,0,1,1,0,0,1,4
../kbl_data/2021-2022,S39G01N76,대구 한국가스공사,Home,홍경기,0,0,0,0.0,0,0,0.0,0,0,0.0,0,0,0.0,0,0,0,0,0,0,0,0,0,0
../kbl_data/2021-2022,S39G01N76,대구 한국가스공사,Home,차바위,5,1,2,50.0,1,3,33.3,2,5,40.0,0,0,0.0,2,5,7,1,0,0,0,0,1,2
../kbl_data/2021-2022,S39G01N76,대구 한국가스공사,Home,조상열,3,0,0,0.0,1,3,33.3,1,3,33.3,0,0,0.0,0,1,1,0,1,0,0,0,0,3
../kbl_data/2021-2022,S39G01N76,대구 한국가스공사,Home,두경민,18,4,6,66.7,3,11,27.3,7,17,41.2,1,2,50.0,0,0,0,6,2,0,1,0,2,4
../kbl_data/2021-2022,S39G01N76,대구 한국가스공사,Home,임준수,0,0,0,0.0,0,0,0.0,0,0,0.0,0,0,0.0,0,0,0,0,0,0,0,0,0,0
../kbl_data/2021-2022,S39G01N76,대구 한국가스공사,Home,김낙현,7,2,8,25.0,1,7,14.3,3,15,20.0,0,0,0.0,3,2,5,7,1,0,0,0,1,2
../kbl_data/2021-2022,S39G01N76,대구 한국가스공사,Home,전현우,8,0,0,0.0,2,7,28.6,2,7,28.6,2,2,100.0,0,1,1,1,1,0,0,0,0,0
../kbl_data/2021-2022,S39G01N76,대구 한국가스공사,Home,클리프 알렉산더,2,1,1,100.0,0,0,0.0,1,1,100.0,0,0,0.0,0,2,2,0,0,0,0,1,0,0
../kbl_data/2021-2022,S39G01N76,대구 한국가스공사,Home,앤드류 니콜슨,20,9,12,75.0,0,4,0.0,9,16,56.2,2,2,100.0,3,14,17,1,1,0,0,1,4,0
../kbl_data/2021-2022,S39G01N76,대구 한국가스공사,Home,신승민,6,3,6,50.0,0,1,0.0,3,7,42.9,0,0,0.0,2,1,3,1,0,0,0,0,2,4
../kbl_data/2021-2022,S39G01N76,안양 KGC,Away,함준후,0,0,0,0.0,0,1,0.0,0,1,0.0,0,0,0.0,0,0,0,1,1,0,0,0,0,0
../kbl_data/2021-2022,S39G01N76,안양 KGC,Away,오세근,15,6,12,50.0,0,1,0.0,6,13,46.2,3,8,37.5,5,3,8,1,4,1,0,0,2,0
../kbl_data/2021-2022,S39G01N76,안양 KGC,Away,문성곤,7,2,2,100.0,1,7,14.3,3,9,33.3,0,2,0.0,4,6,10,6,2,1,0,0,2,3
../kbl_data/2021-2022,S39G01N76,안양 KGC,Away,전성현,20,1,3,33.3,5,9,55.6,6,12,50.0,3,6,50.0,0,2,2,4,1,0,0,0,0,2
../kbl_data/2021-2022,S39G01N76,안양 KGC,Away,박재한,0,0,0,0.0,0,0,0.0,0,0,0.0,0,0,0.0,0,0,0,0,0,0,0,0,0,0
../kbl_data/2021-2022,S39G01N76,안양 KGC,Away,정강호,0,0,0,0.0,0,1,0.0,0,1,0.0,0,0,0.0,0,0,0,0,0,0,0,0,0,0
../kbl_data/2021-2022,S39G01N76,안양 KGC,Away,이우정,2,1,1,100.0,0,0,0.0,1,1,100.0,0,0,0.0,1,0,1,0,0,0,0,0,0,0
../kbl_data/2021-2022,S39G01N76,안양 KGC,Away,대릴 먼로,0,0,0,0.0,0,0,0.0,0,0,0.0,0,0,0.0,0,0,0,0,0,0,0,0,0,0
../kbl_data/2021-2022,S39G01N76,안양 KGC,Away,우동현,0,0,0,0.0,0,0,0.0,0,0,0.0,0,0,0.0,0,0,0,0,0,0,0,0,0,0
../kbl_data/2021-2022,S39G01N76,안양 KGC,Away,변준형,23,7,8,87.5,3,6,50.0,10,14,71.4,0,0,0.0,0,4,4,7,0,1,0,0,5,3
../kbl_data/2021-2022,S39G01N76,안양 KGC,Away,한승희,2,1,2,50.0,0,0,0.0,1,2,50.0,0,0,0.0,0,1,1,0,0,0,0,0,0,1
../kbl_data/2021-2022,S39G01N76,안양 KGC,Away,오마리 스펠맨,21,3,10,30.0,5,11,45.5,8,21,38.1,0,0,0.0,2,13,15,6,0,1,0,1,1,0
../kbl_data/2021-2022,S39G01N77,원주 DB,Home,윤호영,4,0,2,0.0,1,3,33.3,1,5,20.0,1,2,50.0,2,3,5,0,0,0,0,0,1,1
../kbl_data/2021-2022,S39G01N77,원주 DB,Home,박찬희,12,4,6,66.7,1,3,33.3,5,9,55.6,1,1,100.0,0,2,2,5,1,0,1,0,2,4
../kbl_data/2021-2022,S39G01N77,원주 DB,Home,김현호,0,0,2,0.0,0,1,0.0,0,3,0.0,0,0,0.0,0,2,2,3,0,0,1,0,0,2
../kbl_data/2021-2022,S39G01N77,원주 DB,Home,정준원,8,4,5,80.0,0,0,0.0,4,5,80.0,0,0,0.0,1,2,3,0,0,1,0,0,0,1
../kbl_data/2021-2022,S39G01N77,원주 DB,Home,김종규,9,4,5,80.0,0,0,0.0,4,5,80.0,1,2,50.0,1,5,6,1,2,1,0,0,1,5
../kbl_data/2021-2022,S39G01N77,원주 DB,Home,허웅,26,4,4,100.0,6,11,54.5,10,15,66.7,0,0,0.0,2,1,3,5,1,0,0,0,2,2
../kbl_data/2021-2022,S39G01N77,원주 DB,Home,김영훈,0,0,0,0.0,0,0,0.0,0,0,0.0,0,0,0.0,0,0,0,0,0,0,0,0,0,0
../kbl_data/2021-2022,S39G01N77,원주 DB,Home,배강률,0,0,0,0.0,0,0,0.0,0,0,0.0,0,0,0.0,1,0,1,0,0,0,0,0,0,0
../kbl_data/2021-2022,S39G01N77,원주 DB,Home,나카무라 타이치,0,0,0,0.0,0,1,0.0,0,1,0.0,0,0,0.0,0,0,0,0,0,0,0,0,0,0
../kbl_data/2021-2022,S39G01N77,원주 DB,Home,레나드 프리먼,5,2,5,40.0,0,0,0.0,2,5,40.0,1,3,33.3,0,8,8,1,1,0,0,0,1,5
../kbl_data/2021-2022,S39G01N77,원주 DB,Home,정호영,7,2,5,40.0,1,2,50.0,3,7,42.9,0,0,0.0,0,4,4,2,0,0,0,0,0,1
../kbl_data/2021-2022,S39G01N77,원주 DB,Home,조니 오브라이언트,6,3,10,30.0,0,4,0.0,3,14,21.4,0,0,0.0,0,3,3,2,1,0,0,1,1,1
../kbl_data/2021-2022,S39G01N77,서울 삼성,Away,김동량,4,2,3,66.7,0,0,0.0,2,3,66.7,0,0,0.0,1,0,1,1,0,0,0,0,0,2
../kbl_data/2021-2022,S39G01N77,서울 삼성,Away,장민국,10,2,4,50.0,2,5,40.0,4,9,44.4,0,0,0.0,0,0,0,0,0,0,0,0,2,5
../kbl_data/2021-2022,S39G01N77,서울 삼성,Away,김시래,11,1,4,25.0,2,5,40.0,3,9,33.3,3,4,75.0,1,4,5,7,0,0,1,0,3,0
../kbl_data/2021-2022,S39G01N77,서울 삼성,Away,김현수,3,0,3,0.0,1,5,20.0,1,8,12.5,0,0,0.0,0,2,2,0,1,0,0,0,1,0
../kbl_data/2021-2022,S39G01N77,서울 삼성,Away,임동섭,3,0,1,0.0,1,1,100.0,1,2,50.0,0,2,0.0,1,1,2,1,1,0,0,0,0,0
../kbl_data/2021-2022,S39G01N77,서울 삼성,Away,이동엽,2,1,3,33.3,0,3,0.0,1,6,16.7,0,0,0.0,0,1,1,2,2,0,0,0,0,2
../kbl_data/2021-2022,S39G01N77,서울 삼성,Away,배수용,0,0,0,0.0,0,0,0.0,0,0,0.0,0,0,0.0,0,1,1,0,0,0,0,0,0,0
../kbl_data/2021-2022,S39G01N77,서울 삼성,Away,이호현,0,0,1,0.0,0,0,0.0,0,1,0.0,0,0,0.0,0,1,1,0,0,0,0,0,0,0
../kbl_data/2021-2022,S39G01N77,서울 삼성,Away,차민석,2,0,3,0.0,0,0,0.0,0,3,0.0,2,2,100.0,1,3,4,0,0,1,0,0,1,0
../kbl_data/2021-2022,S39G01N77,서울 삼성,Away,전형준,3,0,2,0.0,1,2,50.0,1,4,25.0,0,0,0.0,0,0,0,1,1,0,0,0,1,3
../kbl_data/2021-2022,S39G01N77,서울 삼성,Away,다니엘 오셰푸,19,6,13,46.2,0,2,0.0,6,15,40.0,7,9,77.8,6,14,20,3,0,2,0,0,3,3
../kbl_data/2021-2022,S39G01N77,서울 삼성,Away,이원석,10,2,2,100.0,0,0,0.0,2,2,100.0,6,7,85.7,1,1,2,0,1,2,0,0,1,4
../kbl_data/2021-2022,S39G01N78,서울 SK,Home,양우섭,2,1,1,100.0,0,0,0.0,1,1,100.0,0,0,0.0,0,0,0,3,0,0,0,0,1,0
../kbl_data/2021-2022,S39G01N78,서울 SK,Home,허일영,8,1,2,50.0,2,4,50.0,3,6,50.0,0,0,0.0,1,1,2,0,2,0,0,0,0,2
../kbl_data/2021-2022,S39G01N78,서울 SK,Home,김선형,17,4,6,66.7,3,8,37.5,7,14,50.0,0,0,0.0,0,1,1,6,2,0,0,0,2,1
../kbl_data/2021-2022,S39G01N78,서울 SK,Home,최부경,7,3,4,75.0,0,0,0.0,3,4,75.0,1,4,25.0,1,4,5,0,1,0,0,0,1,1
../kbl_data/2021-2022,S39G01N78,서울 SK,Home,리온 윌리엄스,0,0,1,0.0,0,0,0.0,0,1,0.0,0,0,0.0,0,0,0,0,1,0,0,0,1,2
../kbl_data/2021-2022,S39G01N78,서울 SK,Home,배병준,0,0,0,0.0,0,0,0.0,0,0,0.0,0,0,0.0,0,0,0,0,0,0,0,0,0,0
../kbl_data/2021-2022,S39G01N78,서울 SK,Home,이현석,2,1,2,50.0,0,2,0.0,1,4,25.0,0,0,0.0,0,1,1,1,1,0,0,0,1,3
../kbl_data/2021-2022,S39G01N78,서울 SK,Home,최원혁,0,0,0,0.0,0,0,0.0,0,0,0.0,0,0,0.0,0,2,2,3,0,0,0,0,1,3
../kbl_data/2021-2022,S39G01N78,서울 SK,Home,최준용,10,3,7,42.9,1,4,25.0,4,11,36.4,1,2,50.0,1,6,7,6,1,1,0,0,1,4
../kbl_data/2021-2022,S39G01N78,서울 SK,Home,안영준,8,1,5,20.0,0,4,0.0,1,9,11.1,6,6,100.0,2,3,5,4,1,2,0,0,0,3
../kbl_data/2021-2022,S39G01N78,서울 SK,Home,자밀 워니,42,16,21,76.2,1,1,100.0,17,22,77.3,7,7,100.0,5,10,15,2,1,0,0,1,0,0
../kbl_data/2021-2022,S39G01N78,서울 SK,Home,오재현,0,0,0,0.0,0,0,0.0,0,0,0.0,0,0,0.0,0,0,0,0,0,0,0,0,0,0
../kbl_data/2021-2022,S39G01N78,전주 KCC,Away,송창용,6,0,1,0.0,1,2,50.0,1,3,33.3,3,3,100.0,1,3,4,1,1,0,0,0,0,2
../kbl_data/2021-2022,S39G01N78,전주 KCC,Away,이정현,4,2,4,50.0,0,3,0.0,2,7,28.6,0,0,0.0,0,2,2,4,1,1,0,0,3,3
../kbl_data/2021-2022,S39G01N78,전주 KCC,Away,정창영,8,1,2,50.0,1,2,50.0,2,4,50.0,3,6,50.0,0,4,4,0,0,0,0,0,0,5
../kbl_data/2021-2022,S39G01N78,전주 KCC,Away,라건아,29,13,20,65.0,0,1,0.0,13,21,61.9,3,3,100.0,4,7,11,2,1,0,0,0,1,3
../kbl_data/2021-2022,S39G01N78,전주 KCC,Away,김지완,13,2,6,33.3,3,5,60.0,5,11,45.5,0,0,0.0,1,2,3,3,0,0,0,0,1,2
../kbl_data/2021-2022,S39G01N78,전주 KCC,Away,김상규,11,4,5,80.0,1,3,33.3,5,8,62.5,0,0,0.0,0,1,1,2,1,0,0,0,1,0
../kbl_data/2021-2022,S39G01N78,전주 KCC,Away,유병훈,0,0,0,0.0,0,0,0.0,0,0,0.0,0,0,0.0,0,0,0,0,0,0,0,0,0,0
../kbl_data/2021-2022,S39G01N78,전주 KCC,Away,전준범,14,2,4,50.0,3,6,50.0,5,10,50.0,1,1,100.0,0,1,1,1,0,0,0,0,2,2
../kbl_data/2021-2022,S39G01N78,전주 KCC,Away,박재현,0,0,0,0.0,0,0,0.0,0,0,0.0,0,0,0.0,0,0,0,1,0,0,0,0,1,1
../kbl_data/2021-2022,S39G01N78,전주 KCC,Away,이진욱,0,0,0,0.0,0,0,0.0,0,0,0.0,0,0,0.0,0,0,0,0,0,0,0,0,0,0
../kbl_data/2021-2022,S39G01N78,전주 KCC,Away,유현준,4,1,1,100.0,0,1,0.0,1,2,50.0,2,2,100.0,0,4,4,7,2,0,1,0,2,1
../kbl_data/2021-2022,S39G01N78,전주 KCC,Away,라타비우스 윌리엄스,2,1,3,33.3,0,0,0.0,1,3,33.3,0,0,0.0,0,0,0,0,0,0,0,0,0,2
../kbl_data/2021-2022,S39G01N79,수원 KT,Home,김동욱,6,0,1,0.0,2,5,40.0,2,6,33.3,0,0,0.0,0,1,1,3,1,0,0,0,0,3
../kbl_data/2021-2022,S39G01N79,수원 KT,Home,김영환,6,3,3,100.0,0,3,0.0,3,6,50.0,0,0,0.0,1,1,2,0,1,0,0,0,0,0
../kbl_data/2021-2022,S39G01N79,수원 KT,Home,김현민,0,0,0,0.0,0,1,0.0,0,1,0.0,0,0,0.0,0,3,3,0,3,0,0,0,0,1
../kbl_data/2021-2022,S39G01N79,수원 KT,Home,최창진,0,0,0,0.0,0,0,0.0,0,0,0.0,0,0,0.0,0,0,0,0,0,0,0,0,0,0
../kbl_data/2021-2022,S39G01N79,수원 KT,Home,정성우,13,5,7,71.4,1,7,14.3,6,14,42.9,0,0,0.0,1,1,2,6,1,0,0,0,2,0
../kbl_data/2021-2022,S39G01N79,수원 KT,Home,허훈,28,5,7,71.4,4,6,66.7,9,13,69.2,6,6,100.0,1,1,2,3,0,0,0,0,3,2
../kbl_data/2021-2022,S39G01N79,수원 KT,Home,양홍석,18,5,7,71.4,2,4,50.0,7,11,63.6,2,2,100.0,3,6,9,1,0,0,0,0,2,0
../kbl_data/2021-2022,S39G01N79,수원 KT,Home,캐디 라렌,19,7,9,77.8,0,2,0.0,7,11,63.6,5,6,83.3,2,10,12,0,0,2,0,1,3,3
../kbl_data/2021-2022,S39G01N79,수원 KT,Home,문상옥,0,0,0,0.0,0,0,0.0,0,0,0.0,0,0,0.0,0,0,0,0,0,0,0,0,0,0
../kbl_data/2021-2022,S39G01N79,수원 KT,Home,박지원,0,0,0,0.0,0,0,0.0,0,0,0.0,0,0,0.0,0,0,0,0,0,0,0,0,0,0
../kbl_data/2021-2022,S39G01N79,수원 KT,Home,마이크 마이어스,6,3,5,60.0,0,0,0.0,3,5,60.0,0,0,0.0,2,2,4,2,0,0,0,0,1,2
../kbl_data/2021-2022,S39G01N79,수원 KT,Home,하윤기,0,0,1,0.0,0,0,0.0,0,1,0.0,0,0,0.0,0,3,3,0,0,0,0,0,0,2
../kbl_data/2021-2022,S39G01N79,안양 KGC,Away,박형철,0,0,0,0.0,0,0,0.0,0,0,0.0,0,0,0.0,0,0,0,0,0,0,0,0,0,0
../kbl_data/2021-2022,S39G01N79,안양 KGC,Away,함준후,0,0,0,0.0,0,0,0.0,0,0,0.0,0,0,0.0,1,0,1,0,0,0,0,0,1,1
../kbl_data/2021-2022,S39G01N79,안양 KGC,Away,오세근,14,6,12,50.0,0,1,0.0,6,13,46.2,2,3,66.7,1,2,3,3,0,1,1,0,0,2
../kbl_data/2021-2022,S39G01N79,안양 KGC,Away,문성곤,10,3,4,75.0,1,1,100.0,4,5,80.0,1,2,50.0,1,7,8,6,2,0,0,0,0,2
../kbl_data/2021-2022,S39G01N79,안양 KGC,Away,전성현,10,2,3,66.7,2,5,40.0,4,8,50.0,0,0,0.0,0,0,0,0,1,0,0,0,1,1
../kbl_data/2021-2022,S39G01N79,안양 KGC,Away,정강호,0,0,0,0.0,0,1,0.0,0,1,0.0,0,0,0.0,1,0,1,0,0,0,0,0,1,0
../kbl_data/2021-2022,S39G01N79,안양 KGC,Away,이우정,0,0,0,0.0,0,3,0.0,0,3,0.0,0,0,0.0,0,0,0,0,0,0,0,0,0,2
../kbl_data/2021-2022,S39G01N79,안양 KGC,Away,대릴 먼로,4,2,3,66.7,0,0,0.0,2,3,66.7,0,0,0.0,0,2,2,0,0,1,0,0,1,2
../kbl_data/2021-2022,S39G01N79,안양 KGC,Away,우동현,4,2,2,100.0,0,1,0.0,2,3,66.7,0,0,0.0,1,0,1,1,1,0,0,0,0,0
../kbl_data/2021-2022,S39G01N79,안양 KGC,Away,변준형,19,6,9,66.7,2,8,25.0,8,17,47.1,1,1,100.0,0,1,1,2,0,0,0,0,3,5
../kbl_data/2021-2022,S39G01N79,안양 KGC,Away,한승희,4,2,4,50.0,0,2,0.0,2,6,33.3,0,0,0.0,2,0,2,1,1,0,0,0,0,1
../kbl_data/2021-2022,S39G01N79,안양 KGC,Away,오마리 스펠맨,15,5,8,62.5,0,5,0.0,5,13,38.5,5,8,62.5,2,7,9,5,3,1,0,2,2,3
../kbl_data/2021-2022,S39G01N80,원주 DB,Home,윤호영,0,0,0,0.0,0,0,0.0,0,0,0.0,0,0,0.0,1,4,5,1,1,1,0,0,0,2
../kbl_data/2021-2022,S39G01N80,원주 DB,Home,박찬희,5,1,4,25.0,1,3,33.3,2,7,28.6,0,0,0.0,2,2,4,7,3,0,1,0,3,4
../kbl_data/2021-2022,S39G01N80,원주 DB,Home,김현호,0,0,2,0.0,0,0,0.0,0,2,0.0,0,0,0.0,1,1,2,0,0,0,0,0,2,3
../kbl_data/2021-2022,S39G01N80,원주 DB,Home,정준원,3,0,1,0.0,1,1,100.0,1,2,50.0,0,0,0.0,2,0,2,1,2,0,0,0,1,3
../kbl_data/2021-2022,S39G01N80,원주 DB,Home,김종규,9,4,11,36.4,0,0,0.0,4,11,36.4,1,2,50.0,1,3,4,1,0,1,0,0,0,1
../kbl_data/2021-2022,S39G01N80,원주 DB,Home,허웅,39,10,15,66.7,3,8,37.5,13,23,56.5,10,11,90.9,0,6,6,4,0,0,0,0,1,2
../kbl_data/2021-2022,S39G01N80,원주 DB,Home,김영훈,0,0,0,0.0,0,1,0.0,0,1,0.0,0,0,0.0,1,1,2,0,0,0,0,0,0,0
../kbl_data/2021-2022,S39G01N80,원주 DB,Home,배강률,0,0,0,0.0,0,0,0.0,0,0,0.0,0,0,0.0,0,0,0,0,0,0,0,0,0,0
../kbl_data/2021-2022,S39G01N80,원주 DB,Home,나카무라 타이치,6,0,0,0.0,2,4,50.0,2,4,50.0,0,0,0.0,0,0,0,0,0,0,0,0,1,1
../kbl_data/2021-2022,S39G01N80,원주 DB,Home,레나드 프리먼,10,5,8,62.5,0,1,0.0,5,9,55.6,0,2,0.0,1,4,5,2,1,0,0,2,1,4
../kbl_data/2021-2022,S39G01N80,원주 DB,Home,정호영,3,0,1,0.0,1,1,100.0,1,2,50.0,0,0,0.0,0,1,1,0,0,0,0,0,1,1
../kbl_data/2021-2022,S39G01N80,원주 DB,Home,조니 오브라이언트,7,1,3,33.3,1,4,25.0,2,7,28.6,2,2,100.0,2,3,5,4,0,0,0,0,3,3
../kbl_data/2021-2022,S39G01N80,창원 LG,Away,강병현,0,0,0,0.0,0,0,0.0,0,0,0.0,0,0,0.0,0,0,0,0,0,0,0,0,0,0
../kbl_data/2021-2022,S39G01N80,창원 LG,Away,변기훈,3,0,0,0.0,1,4,25.0,1,4,25.0,0,2,0.0,1,0,1,1,3,0,0,0,0,2
../kbl_data/2021-2022,S39G01N80,창원 LG,Away,이관희,13,4,10,40.0,1,4,25.0,5,14,35.7,2,2,100.0,1,6,7,5,1,0,0,0,2,1
../kbl_data/2021-2022,S39G01N80,창원 LG,Away,정희재,5,1,2,50.0,0,1,0.0,1,3,33.3,3,5,60.0,1,1,2,0,2,0,0,0,1,4
../kbl_data/2021-2022,S39G01N80,창원 LG,Away,서민수,13,3,7,42.9,2,4,50.0,5,11,45.5,1,2,50.0,2,0,2,2,0,0,0,0,1,3
../kbl_data/2021-2022,S39G01N80,창원 LG,Away,한상혁,3,0,1,0.0,1,3,33.3,1,4,25.0,0,0,0.0,0,2,2,1,0,0,0,0,3,0
../kbl_data/2021-2022,S39G01N80,창원 LG,Away,이재도,21,5,12,41.7,2,3,66.7,7,15,46.7,5,7,71.4,1,4,5,2,1,0,0,0,3,0
../kbl_data/2021-2022,S39G01N80,창원 LG,Away,박정현,0,0,1,0.0,0,0,0.0,0,1,0.0,0,0,0.0,0,0,0,0,1,0,0,0,0,1
../kbl_data/2021-2022,S39G01N80,창원 LG,Away,이광진,0,0,0,0.0,0,0,0.0,0,0,0.0,0,0,0.0,0,1,1,0,0,1,0,0,1,1
../kbl_data/2021-2022,S39G01N80,창원 LG,Away,압둘 말릭 아부,6,3,6,50.0,0,0,0.0,3,6,50.0,0,1,0.0,0,5,5,0,0,0,0,1,0,3
../kbl_data/2021-2022,S39G01N80,창원 LG,Away,아셈 마레이,19,7,10,70.0,0,0,0.0,7,10,70.0,5,7,71.4,8,7,15,3,1,0,0,0,2,2
../kbl_data/2021-2022,S39G01N80,창원 LG,Away,이승우,0,0,0,0.0,0,0,0.0,0,0,0.0,0,2,0.0,1,0,1,0,0,0,0,0,0,1
../kbl_data/2021-2022,S39G01N81,고양 오리온,Home,오용준,0,0,0,0.0,0,0,0.0,0,0,0.0,0,0,0.0,0,0,0,0,0,0,0,0,0,0
../kbl_data/2021-2022,S39G01N81,고양 오리온,Home,김강선,6,0,0,0.0,2,3,66.7,2,3,66.7,0,0,0.0,0,1,1,0,0,0,0,0,1,2
../kbl_data/2021-2022,S39G01N81,고양 오리온,Home,최현민,0,0,0,0.0,0,1,0.0,0,1,0.0,0,0,0.0,1,0,1,1,1,0,0,0,2,2
../kbl_data/2021-2022,S39G01N81,고양 오리온,Home,이대성,24,6,11,54.5,1,3,33.3,7,14,50.0,9,10,90.0,0,1,1,3,0,0,0,0,2,3
../kbl_data/2021-2022,S39G01N81,고양 오리온,Home,한호빈,10,2,5,40.0,2,7,28.6,4,12,33.3,0,0,0.0,0,2,2,2,1,0,1,0,2,2
../kbl_data/2021-2022,S39G01N81,고양 오리온,Home,이정제,0,0,0,0.0,0,0,0.0,0,0,0.0,0,0,0.0,0,0,0,0,0,0,0,0,0,0
../kbl_data/2021-2022,S39G01N81,고양 오리온,Home,이승현,8,4,8,50.0,0,1,0.0,4,9,44.4,0,0,0.0,2,5,7,3,2,0,0,0,1,1
../kbl_data/2021-2022,S39G01N81,고양 오리온,Home,김진유,2,0,3,0.0,0,0,0.0,0,3,0.0,2,2,100.0,2,5,7,3,0,0,0,0,0,0
../kbl_data/2021-2022,S39G01N81,고양 오리온,Home,머피 할로웨이,12,5,9,55.6,0,1,0.0,5,10,50.0,2,4,50.0,2,3,5,1,3,3,0,2,1,2
../kbl_data/2021-2022,S39G01N81,고양 오리온,Home,박진철,0,0,0,0.0,0,0,0.0,0,0,0.0,0,0,0.0,0,0,0,0,0,0,0,0,0,0
../kbl_data/2021-2022,S39G01N81,고양 오리온,Home,미로슬라브 라둘리차,16,6,6,100.0,1,2,50.0,7,8,87.5,1,2,50.0,0,3,3,1,0,0,0,0,1,3
../kbl_data/2021-2022,S39G01N81,고양 오리온,Home,이정현,8,2,2,100.0,0,1,0.0,2,3,66.7,4,5,80.0,0,1,1,2,0,0,0,0,2,1
../kbl_data/2021-2022,S39G01N81,울산 현대모비스,Away,이현민,4,2,2,100.0,0,2,0.0,2,4,50.0,0,0,0.0,2,0,2,4,0,0,0,0,2,1
../kbl_data/2021-2022,S39G01N81,울산 현대모비스,Away,함지훈,16,7,10,70.0,0,2,0.0,7,12,58.3,2,2,100.0,1,1,2,6,2,0,0,0,0,3
../kbl_data/2021-2022,S39G01N81,울산 현대모비스,Away,최진수,2,1,1,100.0,0,3,0.0,1,4,25.0,0,0,0.0,0,0,0,0,1,0,0,0,0,2
../kbl_data/2021-2022,S39G01N81,울산 현대모비스,Away,박지훈,0,0,0,0.0,0,2,0.0,0,2,0.0,0,0,0.0,0,2,2,0,0,0,1,0,1,4
../kbl_data/2021-2022,S39G01N81,울산 현대모비스,Away,장재석,2,1,2,50.0,0,0,0.0,1,2,50.0,0,0,0.0,0,1,1,0,1,0,0,0,0,1
../kbl_data/2021-2022,S39G01N81,울산 현대모비스,Away,김국찬,11,2,2,100.0,2,7,28.6,4,9,44.4,1,2,50.0,1,1,2,1,0,0,0,0,2,2
../kbl_data/2021-2022,S39G01N81,울산 현대모비스,Away,서명진,12,5,7,71.4,0,1,0.0,5,8,62.5,2,2,100.0,1,0,1,5,0,0,0,0,1,3
../kbl_data/2021-2022,S39G01N81,울산 현대모비스,Away,얼 클락,15,6,10,60.0,1,2,50.0,7,12,58.3,0,0,0.0,1,4,5,0,1,0,0,0,0,2
../kbl_data/2021-2022,S39G01N81,울산 현대모비스,Away,이우석,13,6,7,85.7,0,1,0.0,6,8,75.0,1,2,50.0,2,6,8,8,1,0,1,0,4,1
../kbl_data/2021-2022,S39G01N81,울산 현대모비스,Away,라숀 토마스,16,7,15,46.7,0,0,0.0,7,15,46.7,2,2,100.0,2,6,8,0,1,1,0,1,1,3
../kbl_data/2021-2022,S39G01N81,울산 현대모비스,Away,신민석,2,1,1,100.0,0,1,0.0,1,2,50.0,0,0,0.0,1,0,1,0,1,0,0,0,0,1
../kbl_data/2021-2022,S39G01N81,울산 현대모비스,Away,김동준,0,0,0,0.0,0,0,0.0,0,0,0.0,0,0,0.0,0,0,0,0,0,0,0,0,0,0
../kbl_data/2021-2022,S39G01N82,안양 KGC,Home,양희종,1,0,1,0.0,0,2,0.0,0,3,0.0,1,2,50.0,0,2,2,0,0,0,0,0,1,1
../kbl_data/2021-2022,S39G01N82,안양 KGC,Home,함준후,0,0,0,0.0,0,0,0.0,0,0,0.0,0,0,0.0,0,0,0,0,0,0,0,0,0,0
../kbl_data/2021-2022,S39G01N82,안양 KGC,Home,오세근,4,2,5,40.0,0,0,0.0,2,5,40.0,0,0,0.0,0,2,2,2,0,1,0,0,1,1
../kbl_data/2021-2022,S39G01N82,안양 KGC,Home,문성곤,3,0,0,0.0,1,6,16.7,1,6,16.7,0,0,0.0,1,1,2,3,1,0,0,0,1,4
../kbl_data/2021-2022,S39G01N82,안양 KGC,Home,전성현,6,0,2,0.0,2,5,40.0,2,7,28.6,0,0,0.0,3,3,6,1,0,0,0,0,2,0
../kbl_data/2021-2022,S39G01N82,안양 KGC,Home,박지훈,7,2,6,33.3,1,3,33.3,3,9,33.3,0,0,0.0,2,1,3,5,1,0,0,0,2,4
../kbl_data/2021-2022,S39G01N82,안양 KGC,Home,이우정,0,0,0,0.0,0,0,0.0,0,0,0.0,0,0,0.0,0,0,0,0,0,0,0,0,0,0
../kbl_data/2021-2022,S39G01N82,안양 KGC,Home,대릴 먼로,2,0,0,0.0,0,0,0.0,0,0,0.0,2,2,100.0,0,1,1,0,0,1,0,0,0,1
../kbl_data/2021-2022,S39G01N82,안양 KGC,Home,우동현,0,0,1,0.0,0,1,0.0,0,2,0.0,0,0,0.0,0,0,0,0,0,0,0,0,0,0
../kbl_data/2021-2022,S39G01N82,안양 KGC,Home,변준형,5,2,5,40.0,0,5,0.0,2,10,20.0,1,1,100.0,1,2,3,6,2,0,1,0,2,2
../kbl_data/2021-2022,S39G01N82,안양 KGC,Home,한승희,0,0,0,0.0,0,0,0.0,0,0,0.0,0,0,0.0,0,0,0,0,0,0,0,0,0,0
../kbl_data/2021-2022,S39G01N82,안양 KGC,Home,오마리 스펠맨,41,11,15,73.3,4,11,36.4,15,26,57.7,7,12,58.3,2,9,11,1,0,1,0,3,1,4
../kbl_data/2021-2022,S39G01N82,창원 LG,Away,강병현,3,0,1,0.0,1,2,50.0,1,3,33.3,0,0,0.0,1,0,1,1,0,0,0,0,0,2
../kbl_data/2021-2022,S39G01N82,창원 LG,Away,변기훈,4,2,3,66.7,0,0,0.0,2,3,66.7,0,0,0.0,1,0,1,0,1,0,0,0,1,0
../kbl_data/2021-2022,S39G01N82,창원 LG,Away,이관희,23,1,6,16.7,7,12,58.3,8,18,44.4,0,0,0.0,0,2,2,2,0,0,0,0,2,1
../kbl_data/2021-2022,S39G01N82,창원 LG,Away,정희재,11,2,3,66.7,2,7,28.6,4,10,40.0,1,1,100.0,1,7,8,4,2,0,1,0,1,4
../kbl_data/2021-2022,S39G01N82,창원 LG,Away,서민수,7,3,3,100.0,0,1,0.0,3,4,75.0,1,2,50.0,7,0,7,0,0,0,0,0,0,4
../kbl_data/2021-2022,S39G01N82,창원 LG,Away,한상혁,8,0,1,0.0,2,3,66.7,2,4,50.0,2,2,100.0,0,1,1,3,0,0,0,0,0,4
../kbl_data/2021-2022,S39G01N82,창원 LG,Away,이재도,13,3,4,75.0,2,6,33.3,5,10,50.0,1,2,50.0,0,4,4,6,1,0,1,0,0,0
../kbl_data/2021-2022,S39G01N82,창원 LG,Away,박인태,0,0,1,0.0,0,0,0.0,0,1,0.0,0,0,0.0,0,2,2,0,0,1,0,0,0,0
../kbl_data/2021-2022,S39G01N82,창원 LG,Away,정해원,0,0,0,0.0,0,0,0.0,0,0,0.0,0,0,0.0,0,0,0,0,0,0,0,0,0,0
../kbl_data/2021-2022,S39G01N82,창원 LG,Away,박정현,2,1,2,50.0,0,1,0.0,1,3,33.3,0,0,0.0,1,3,4,0,0,0,0,0,0,2
../kbl_data/2021-2022,S39G01N82,창원 LG,Away,압둘 말릭 아부,1,0,1,0.0,0,0,0.0,0,1,0.0,1,2,50.0,0,3,3,0,0,0,0,0,2,2
../kbl_data/2021-2022,S39G01N82,창원 LG,Away,아셈 마레이,12,5,11,45.5,0,0,0.0,5,11,45.5,2,4,50.0,4,9,13,6,1,1,0,0,6,1
../kbl_data/2021-2022,S39G01N83,전주 KCC,Home,송창용,11,1,1,100.0,2,4,50.0,3,5,60.0,3,3,100.0,0,1,1,3,1,0,0,0,1,2
../kbl_data/2021-2022,S39G01N83,전주 KCC,Home,이정현,24,3,7,42.9,3,5,60.0,6,12,50.0,9,10,90.0,0,5,5,4,3,0,0,0,2,2
../kbl_data/2021-2022,S39G01N83,전주 KCC,Home,정창영,7,1,4,25.0,1,3,33.3,2,7,28.6,2,2,100.0,1,1,2,1,0,0,0,0,0,2
../kbl_data/2021-2022,S39G01N83,전주 KCC,Home,라건아,30,9,14,64.3,3,4,75.0,12,18,66.7,3,4,75.0,3,7,10,3,1,5,0,1,5,2
../kbl_data/2021-2022,S39G01N83,전주 KCC,Home,김지완,0,0,2,0.0,0,2,0.0,0,4,0.0,0,0,0.0,0,3,3,4,0,0,0,0,0,4
../kbl_data/2021-2022,S39G01N83,전주 KCC,Home,김상규,6,3,3,100.0,0,2,0.0,3,5,60.0,0,2,0.0,4,1,5,2,1,0,0,0,0,4
../kbl_data/2021-2022,S39G01N83,전주 KCC,Home,유병훈,0,0,0,0.0,0,0,0.0,0,0,0.0,0,0,0.0,0,0,0,0,0,0,0,0,0,0
../kbl_data/2021-2022,S39G01N83,전주 KCC,Home,전준범,0,0,0,0.0,0,0,0.0,0,0,0.0,0,0,0.0,0,2,2,1,1,0,0,0,1,0
../kbl_data/2021-2022,S39G01N83,전주 KCC,Home,박재현,3,0,1,0.0,1,1,100.0,1,2,50.0,0,0,0.0,0,0,0,1,0,0,0,0,1,1
../kbl_data/2021-2022,S39G01N83,전주 KCC,Home,이진욱,0,0,0,0.0,0,0,0.0,0,0,0.0,0,0,0.0,0,0,0,0,0,0,0,0,0,0
../kbl_data/2021-2022,S39G01N83,전주 KCC,Home,유현준,5,2,4,50.0,0,4,0.0,2,8,25.0,1,2,50.0,1,3,4,7,2,0,0,0,4,1
../kbl_data/2021-2022,S39G01N83,전주 KCC,Home,라타비우스 윌리엄스,4,2,2,100.0,0,0,0.0,2,2,100.0,0,0,0.0,0,1,1,0,0,0,0,1,0,0
../kbl_data/2021-2022,S39G01N83,원주 DB,Away,윤호영,0,0,0,0.0,0,0,0.0,0,0,0.0,0,0,0.0,0,0,0,0,0,0,0,0,0,0
../kbl_data/2021-2022,S39G01N83,원주 DB,Away,박찬희,0,0,0,0.0,0,2,0.0,0,2,0.0,0,0,0.0,0,1,1,6,0,0,0,0,2,4
../kbl_data/2021-2022,S39G01N83,원주 DB,Away,김현호,5,0,1,0.0,1,4,25.0,1,5,20.0,2,2,100.0,0,0,0,1,0,0,0,0,0,3
../kbl_data/2021-2022,S39G01N83,원주 DB,Away,정준원,0,0,0,0.0,0,0,0.0,0,0,0.0,0,0,0.0,0,0,0,0,0,1,0,0,0,0
../kbl_data/2021-2022,S39G01N83,원주 DB,Away,김종규,10,5,6,83.3,0,0,0.0,5,6,83.3,0,0,0.0,4,2,6,1,0,0,0,0,0,5
../kbl_data/2021-2022,S39G01N83,원주 DB,Away,허웅,8,1,3,33.3,1,7,14.3,2,10,20.0,3,3,100.0,0,2,2,3,1,0,1,0,1,3
../kbl_data/2021-2022,S39G01N83,원주 DB,Away,김영훈,0,0,0,0.0,0,2,0.0,0,2,0.0,0,0,0.0,0,0,0,1,0,0,0,0,1,0
../kbl_data/2021-2022,S39G01N83,원주 DB,Away,강상재,13,6,10,60.0,0,1,0.0,6,11,54.5,1,2,50.0,4,9,13,2,3,0,0,0,2,1
../kbl_data/2021-2022,S39G01N83,원주 DB,Away,이준희,4,1,1,100.0,0,2,0.0,1,3,33.3,2,2,100.0,0,0,0,0,1,0,0,0,0,1
../kbl_data/2021-2022,S39G01N83,원주 DB,Away,레나드 프리먼,6,2,7,28.6,0,0,0.0,2,7,28.6,2,2,100.0,1,4,5,1,2,0,0,0,0,0
../kbl_data/2021-2022,S39G01N83,원주 DB,Away,정호영,22,2,3,66.7,6,11,54.5,8,14,57.1,0,0,0.0,0,1,1,4,0,0,1,1,2,3
../kbl_data/2021-2022,S39G01N83,원주 DB,Away,조니 오브라이언트,17,3,7,42.9,3,7,42.9,6,14,42.9,2,2,100.0,1,6,7,1,1,0,0,0,4,1
../kbl_data/2021-2022,S39G01N84,서울 삼성,Home,김동량,6,3,5,60.0,0,1,0.0,3,6,50.0,0,0,0.0,2,2,4,2,1,0,0,0,0,3
../kbl_data/2021-2022,S39G01N84,서울 삼성,Home,장민국,9,3,5,60.0,1,5,20.0,4,10,40.0,0,0,0.0,0,4,4,0,0,0,0,0,0,4
../kbl_data/2021-2022,S39G01N84,서울 삼성,Home,김시래,12,2,5,40.0,1,4,25.0,3,9,33.3,5,7,71.4,0,3,3,5,1,0,0,0,4,3
../kbl_data/2021-2022,S39G01N84,서울 삼성,Home,김현수,13,1,2,50.0,3,9,33.3,4,11,36.4,2,2,100.0,0,0,0,0,0,0,0,0,0,2
../kbl_data/2021-2022,S39G01N84,서울 삼성,Home,배수용,5,1,1,100.0,1,1,100.0,2,2,100.0,0,0,0.0,0,1,1,1,0,0,0,0,1,1
../kbl_data/2021-2022,S39G01N84,서울 삼성,Home,천기범,4,2,2,100.0,0,2,0.0,2,4,50.0,0,0,0.0,1,1,2,1,2,1,0,0,3,3
../kbl_data/2021-2022,S39G01N84,서울 삼성,Home,강바일,0,0,2,0.0,0,0,0.0,0,2,0.0,0,0,0.0,0,0,0,0,0,0,0,0,0,0
../kbl_data/2021-2022,S39G01N84,서울 삼성,Home,차민석,0,0,0,0.0,0,0,0.0,0,0,0.0,0,0,0.0,0,0,0,0,0,0,1,0,0,2
../kbl_data/2021-2022,S39G01N84,서울 삼성,Home,전형준,0,0,0,0.0,0,0,0.0,0,0,0.0,0,0,0.0,0,0,0,0,0,0,0,0,0,0
../kbl_data/2021-2022,S39G01N84,서울 삼성,Home,다니엘 오셰푸,21,8,20,40.0,0,0,0.0,8,20,40.0,5,5,100.0,5,9,14,7,2,1,0,2,3,2
../kbl_data/2021-2022,S39G01N84,서울 삼성,Home,조우성,0,0,0,0.0,0,0,0.0,0,0,0.0,0,0,0.0,0,0,0,0,0,0,0,0,0,0
../kbl_data/2021-2022,S39G01N84,서울 삼성,Home,이원석,4,1,1,100.0,0,1,0.0,1,2,50.0,2,2,100.0,1,1,2,1,0,1,0,0,1,2
../kbl_data/2021-2022,S39G01N84,고양 오리온,Away,김강선,3,0,0,0.0,1,2,50.0,1,2,50.0,0,0,0.0,0,0,0,1,1,0,0,0,1,1
../kbl_data/2021-2022,S39G01N84,고양 오리온,Away,최현민,5,0,0,0.0,1,2,50.0,1,2,50.0,2,3,66.7,1,1,2,0,0,1,0,0,0,1
../kbl_data/2021-2022,S39G01N84,고양 오리온,Away,이대성,15,3,5,60.0,1,3,33.3,4,8,50.0,6,8,75.0,0,2,2,9,1,0,1,0,2,1
../kbl_data/2021-2022,S39G01N84,고양 오리온,Away,이정제,0,0,0,0.0,0,0,0.0,0,0,0.0,0,0,0.0,1,1,2,1,0,0,0,0,1,0
../kbl_data/2021-2022,S39G01N84,고양 오리온,Away,최승욱,0,0,0,0.0,0,0,0.0,0,0,0.0,0,0,0.0,0,0,0,0,0,0,0,0,0,0
../kbl_data/2021-2022,S39G01N84,고양 오리온,Away,이승현,18,7,15,46.7,0,0,0.0,7,15,46.7,4,4,100.0,4,6,10,3,0,0,0,0,2,0
../kbl_data/2021-2022,S39G01N84,고양 오리온,Away,김진유,3,0,0,0.0,1,2,50.0,1,2,50.0,0,0,0.0,0,3,3,1,1,0,0,0,0,4
../kbl_data/2021-2022,S39G01N84,고양 오리온,Away,머피 할로웨이,10,5,8,62.5,0,0,0.0,5,8,62.5,0,1,0.0,1,9,10,1,3,2,0,2,2,3
../kbl_data/2021-2022,S39G01N84,고양 오리온,Away,조한진,0,0,0,0.0,0,0,0.0,0,0,0.0,0,0,0.0,0,0,0,0,1,0,0,0,0,1
../kbl_data/2021-2022,S39G01N84,고양 오리온,Away,조석호,2,1,2,50.0,0,0,0.0,1,2,50.0,0,0,0.0,0,1,1,1,0,0,0,0,1,1
../kbl_data/2021-2022,S39G01N84,고양 오리온,Away,미로슬라브 라둘리차,15,5,8,62.5,1,1,100.0,6,9,66.7,2,2,100.0,1,4,5,1,2,0,0,1,2,2
../kbl_data/2021-2022,S39G01N84,고양 오리온,Away,이정현,7,2,6,33.3,1,4,25.0,3,10,30.0,0,0,0.0,0,0,0,1,1,0,0,0,2,5
../kbl_data/2021-2022,S39G01N85,울산 현대모비스,Home,이현민,8,2,2,100.0,1,1,100.0,3,3,100.0,1,2,50.0,0,4,4,3,2,0,0,0,2,3
../kbl_data/2021-2022,S39G01N85,울산 현대모비스,Home,함지훈,13,5,8,62.5,1,1,100.0,6,9,66.7,0,0,0.0,2,2,4,3,1,0,0,0,0,1
../kbl_data/2021-2022,S39G01N85,울산 현대모비스,Home,최진수,5,1,6,16.7,1,3,33.3,2,9,22.2,0,0,0.0,1,2,3,2,2,0,0,1,0,1
../kbl_data/2021-2022,S39G01N85,울산 현대모비스,Home,박지훈,0,0,1,0.0,0,1,0.0,0,2,0.0,0,0,0.0,2,1,3,0,0,0,0,0,0,2
../kbl_data/2021-2022,S39G01N85,울산 현대모비스,Home,장재석,0,0,0,0.0,0,0,0.0,0,0,0.0,0,0,0.0,0,0,0,0,0,0,0,0,0,0
../kbl_data/2021-2022,S39G01N85,울산 현대모비스,Home,김국찬,8,1,3,33.3,2,8,25.0,3,11,27.3,0,0,0.0,0,3,3,3,2,0,0,0,1,1
../kbl_data/2021-2022,S39G01N85,울산 현대모비스,Home,서명진,4,1,2,50.0,0,2,0.0,1,4,25.0,2,2,100.0,1,0,1,4,0,0,0,0,3,1
../kbl_data/2021-2022,S39G01N85,울산 현대모비스,Home,얼 클락,18,3,5,60.0,3,5,60.0,6,10,60.0,3,4,75.0,0,4,4,2,0,1,0,1,3,2
../kbl_data/2021-2022,S39G01N85,울산 현대모비스,Home,이우석,8,3,6,50.0,0,0,0.0,3,6,50.0,2,2,100.0,3,1,4,2,0,0,0,1,2,1
../kbl_data/2021-2022,S39G01N85,울산 현대모비스,Home,라숀 토마스,14,7,16,43.8,0,0,0.0,7,16,43.8,0,0,0.0,5,8,13,0,2,1,0,1,3,4
../kbl_data/2021-2022,S39G01N85,울산 현대모비스,Home,신민석,3,0,1,0.0,1,2,50.0,1,3,33.3,0,0,0.0,0,0,0,3,1,0,0,0,0,2
../kbl_data/2021-2022,S39G01N85,울산 현대모비스,Home,김동준,0,0,0,0.0,0,0,0.0,0,0,0.0,0,0,0.0,0,0,0,0,0,0,0,0,0,0
../kbl_data/2021-2022,S39G01N85,서울 SK,Away,양우섭,2,1,1,100.0,0,0,0.0,1,1,100.0,0,0,0.0,0,0,0,1,0,0,0,0,1,2
../kbl_data/2021-2022,S39G01N85,서울 SK,Away,허일영,7,2,3,66.7,1,4,25.0,3,7,42.9,0,0,0.0,1,1,2,0,1,0,1,0,0,1
../kbl_data/2021-2022,S39G01N85,서울 SK,Away,김선형,16,5,9,55.6,1,3,33.3,6,12,50.0,3,4,75.0,1,2,3,5,2,0,0,0,3,3
../kbl_data/2021-2022,S39G01N85,서울 SK,Away,최부경,2,1,4,25.0,0,0,0.0,1,4,25.0,0,0,0.0,0,0,0,0,0,1,0,0,2,0
../kbl_data/2021-2022,S39G01N85,서울 SK,Away,리온 윌리엄스,0,0,0,0.0,0,1,0.0,0,1,0.0,0,0,0.0,0,0,0,0,0,0,0,0,0,1
../kbl_data/2021-2022,S39G01N85,서울 SK,Away,배병준,0,0,0,0.0,0,0,0.0,0,0,0.0,0,0,0.0,0,0,0,0,0,0,0,0,0,0
../kbl_data/2021-2022,S39G01N85,서울 SK,Away,이현석,8,1,1,100.0,2,2,100.0,3,3,100.0,0,0,0.0,2,1,3,1,0,0,1,0,1,2
../kbl_data/2021-2022,S39G01N85,서울 SK,Away,최원혁,0,0,0,0.0,0,0,0.0,0,0,0.0,0,0,0.0,0,1,1,0,0,0,0,0,0,0
../kbl_data/2021-2022,S39G01N85,서울 SK,Away,최준용,13,2,7,28.6,3,9,33.3,5,16,31.2,0,0,0.0,1,4,5,3,1,3,0,0,3,4
../kbl_data/2021-2022,S39G01N85,서울 SK,Away,안영준,6,3,4,75.0,0,1,0.0,3,5,60.0,0,2,0.0,0,2,2,0,3,0,0,0,2,4
../kbl_data/2021-2022,S39G01N85,서울 SK,Away,자밀 워니,21,8,13,61.5,0,2,0.0,8,15,53.3,5,6,83.3,4,12,16,5,2,0,0,2,1,2
../kbl_data/2021-2022,S39G01N85,서울 SK,Away,오재현,2,0,0,0.0,0,0,0.0,0,0,0.0,2,2,100.0,0,1,1,1,0,0,0,0,0,1
../kbl_data/2021-2022,S39G01N86,대구 한국가스공사,Home,정영삼,0,0,0,0.0,0,0,0.0,0,0,0.0,0,0,0.0,0,1,1,0,0,0,0,0,0,0
../kbl_data/2021-2022,S39G01N86,대구 한국가스공사,Home,차바위,4,1,1,100.0,0,2,0.0,1,3,33.3,2,2,100.0,0,3,3,6,2,0,1,0,0,1
../kbl_data/2021-2022,S39G01N86,대구 한국가스공사,Home,조상열,0,0,0,0.0,0,0,0.0,0,0,0.0,0,0,0.0,0,0,0,0,0,0,0,0,0,0
../kbl_data/2021-2022,S39G01N86,대구 한국가스공사,Home,이대헌,8,3,11,27.3,0,1,0.0,3,12,25.0,2,2,100.0,2,1,3,0,0,0,0,0,2,3
../kbl_data/2021-2022,S39G01N86,대구 한국가스공사,Home,두경민,26,4,8,50.0,6,14,42.9,10,22,45.5,0,0,0.0,1,1,2,5,0,0,0,0,3,3
../kbl_data/2021-2022,S39G01N86,대구 한국가스공사,Home,박봉진,1,0,0,0.0,0,1,0.0,0,1,0.0,1,2,50.0,0,0,0,1,0,0,0,0,0,0
../kbl_data/2021-2022,S39G01N86,대구 한국가스공사,Home,김낙현,6,0,4,0.0,2,8,25.0,2,12,16.7,0,0,0.0,0,3,3,6,2,0,0,0,1,2
../kbl_data/2021-2022,S39G01N86,대구 한국가스공사,Home,전현우,6,0,0,0.0,2,5,40.0,2,5,40.0,0,2,0.0,1,3,4,0,0,0,0,0,0,1
../kbl_data/2021-2022,S39G01N86,대구 한국가스공사,Home,이윤기,3,0,0,0.0,1,2,50.0,1,2,50.0,0,0,0.0,0,0,0,1,0,0,1,0,1,3
../kbl_data/2021-2022,S39G01N86,대구 한국가스공사,Home,양준우,0,0,0,0.0,0,0,0.0,0,0,0.0,0,0,0.0,0,0,0,0,0,0,0,0,0,0
../kbl_data/2021-2022,S39G01N86,대구 한국가스공사,Home,클리프 알렉산더,22,8,11,72.7,0,1,0.0,8,12,66.7,6,8,75.0,5,16,21,0,0,1,0,4,1,5
../kbl_data/2021-2022,S39G01N86,대구 한국가스공사,Home,신승민,0,0,1,0.0,0,0,0.0,0,1,0.0,0,0,0.0,0,0,0,0,0,0,0,0,0,1
../kbl_data/2021-2022,S39G01N86,수원 KT,Away,김동욱,0,0,0,0.0,0,4,0.0,0,4,0.0,0,0,0.0,0,2,2,1,0,0,0,0,1,0
../kbl_data/2021-2022,S39G01N86,수원 KT,Away,김영환,8,1,2,50.0,2,3,66.7,3,5,60.0,0,0,0.0,0,0,0,0,0,0,0,0,0,1
../kbl_data/2021-2022,S39G01N86,수원 KT,Away,김현민,0,0,0,0.0,0,0,0.0,0,0,0.0,0,0,0.0,0,0,0,0,0,0,0,0,0,0
../kbl_data/2021-2022,S39G01N86,수원 KT,Away,최창진,2,1,1,100.0,0,0,0.0,1,1,100.0,0,0,0.0,0,0,0,0,0,0,0,0,0,3
../kbl_data/2021-2022,S39G01N86,수원 KT,Away,정성우,19,2,4,50.0,4,9,44.4,6,13,46.2,3,4,75.0,0,4,4,5,1,0,0,0,0,4
../kbl_data/2021-2022,S39G01N86,수원 KT,Away,허훈,6,0,8,0.0,1,3,33.3,1,11,9.1,3,5,60.0,1,2,3,7,1,0,0,0,2,3
../kbl_data/2021-2022,S39G01N86,수원 KT,Away,양홍석,22,4,8,50.0,4,8,50.0,8,16,50.0,2,5,40.0,5,8,13,5,0,0,0,0,1,4
../kbl_data/2021-2022,S39G01N86,수원 KT,Away,캐디 라렌,8,4,9,44.4,0,1,0.0,4,10,40.0,0,0,0.0,3,4,7,1,0,6,0,0,2,2
../kbl_data/2021-2022,S39G01N86,수원 KT,Away,문상옥,0,0,0,0.0,0,0,0.0,0,0,0.0,0,0,0.0,0,0,0,0,0,0,0,0,0,0
../kbl_data/2021-2022,S39G01N86,수원 KT,Away,박지원,0,0,0,0.0,0,0,0.0,0,0,0.0,0,0,0.0,0,0,0,0,0,0,0,0,0,0
../kbl_data/2021-2022,S39G01N86,수원 KT,Away,마이크 마이어스,10,4,6,66.7,0,0,0.0,4,6,66.7,2,2,100.0,1,7,8,1,1,0,0,1,1,4
../kbl_data/2021-2022,S39G01N86,수원 KT,Away,하윤기,8,4,5,80.0,0,0,0.0,4,5,80.0,0,0,0.0,2,5,7,0,0,0,0,0,2,1
../kbl_data/2021-2022,S39G01N87,서울 삼성,Home,김동량,4,0,1,0.0,1,4,25.0,1,5,20.0,1,2,50.0,3,6,9,2,0,2,0,0,0,1
../kbl_data/2021-2022,S39G01N87,서울 삼성,Home,장민국,19,2,3,66.7,5,10,50.0,7,13,53.8,0,2,0.0,0,3,3,0,0,1,0,0,1,2
../kbl_data/2021-2022,S39G01N87,서울 삼성,Home,김시래,3,0,4,0.0,0,0,0.0,0,4,0.0,3,4,75.0,1,1,2,5,0,0,0,0,3,5
../kbl_data/2021-2022,S39G01N87,서울 삼성,Home,김현수,12,2,2,100.0,2,6,33.3,4,8,50.0,2,2,100.0,1,3,4,3,0,0,0,0,0,2
../kbl_data/2021-2022,S39G01N87,서울 삼성,Home,배수용,0,0,0,0.0,0,0,0.0,0,0,0.0,0,0,0.0,0,0,0,0,0,0,0,0,0,1
../kbl_data/2021-2022,S39G01N87,서울 삼성,Home,천기범,9,2,5,40.0,1,2,50.0,3,7,42.9,2,4,50.0,2,2,4,1,1,1,0,0,2,4
../kbl_data/2021-2022,S39G01N87,서울 삼성,Home,강바일,0,0,0,0.0,0,0,0.0,0,0,0.0,0,0,0.0,0,0,0,0,0,0,0,0,0,0
../kbl_data/2021-2022,S39G01N87,서울 삼성,Home,차민석,2,1,1,100.0,0,1,0.0,1,2,50.0,0,0,0.0,1,0,1,0,0,0,0,0,0,1
../kbl_data/2021-2022,S39G01N87,서울 삼성,Home,전형준,0,0,0,0.0,0,0,0.0,0,0,0.0,0,0,0.0,0,0,0,0,0,0,0,0,0,0
../kbl_data/2021-2022,S39G01N87,서울 삼성,Home,다니엘 오셰푸,16,7,11,63.6,0,2,0.0,7,13,53.8,2,6,33.3,2,9,11,5,0,1,0,2,3,3
../kbl_data/2021-2022,S39G01N87,서울 삼성,Home,조우성,0,0,0,0.0,0,0,0.0,0,0,0.0,0,0,0.0,0,0,0,0,0,0,0,0,0,0
../kbl_data/2021-2022,S39G01N87,서울 삼성,Home,이원석,2,1,1,100.0,0,0,0.0,1,1,100.0,0,0,0.0,0,0,0,0,0,0,0,0,0,3
../kbl_data/2021-2022,S39G01N87,창원 LG,Away,강병현,0,0,0,0.0,0,0,0.0,0,0,0.0,0,0,0.0,0,0,0,0,0,0,0,0,0,1
../kbl_data/2021-2022,S39G01N87,창원 LG,Away,변기훈,0,0,0,0.0,0,1,0.0,0,1,0.0,0,0,0.0,0,1,1,0,0,0,0,0,0,2
../kbl_data/2021-2022,S39G01N87,창원 LG,Away,이관희,11,1,5,20.0,2,6,33.3,3,11,27.3,3,3,100.0,1,5,6,4,0,0,0,0,0,1
../kbl_data/2021-2022,S39G01N87,창원 LG,Away,정희재,9,3,3,100.0,0,4,0.0,3,7,42.9,3,4,75.0,1,3,4,2,2,0,0,0,0,4
../kbl_data/2021-2022,S39G01N87,창원 LG,Away,서민수,16,6,8,75.0,1,2,50.0,7,10,70.0,1,2,50.0,1,2,3,2,0,0,0,0,0,3
../kbl_data/2021-2022,S39G01N87,창원 LG,Away,한상혁,3,0,0,0.0,1,2,50.0,1,2,50.0,0,0,0.0,0,0,0,1,0,0,0,0,1,1
../kbl_data/2021-2022,S39G01N87,창원 LG,Away,이재도,5,1,6,16.7,1,5,20.0,2,11,18.2,0,0,0.0,2,2,4,5,4,0,0,0,0,1
../kbl_data/2021-2022,S39G01N87,창원 LG,Away,박인태,2,1,1,100.0,0,0,0.0,1,1,100.0,0,0,0.0,1,0,1,0,0,0,0,0,0,0
../kbl_data/2021-2022,S39G01N87,창원 LG,Away,정해원,0,0,0,0.0,0,0,0.0,0,0,0.0,0,0,0.0,0,0,0,0,0,0,0,0,0,0
../kbl_data/2021-2022,S39G01N87,창원 LG,Away,박정현,0,0,0,0.0,0,0,0.0,0,0,0.0,0,0,0.0,0,0,0,0,0,0,0,0,0,0
../kbl_data/2021-2022,S39G01N87,창원 LG,Away,압둘 말릭 아부,4,2,3,66.7,0,0,0.0,2,3,66.7,0,1,0.0,2,2,4,2,1,0,0,2,1,2
../kbl_data/2021-2022,S39G01N87,창원 LG,Away,아셈 마레이,15,6,15,40.0,0,0,0.0,6,15,40.0,3,10,30.0,6,6,12,2,0,0,1,0,2,4
../kbl_data/2021-2022,S39G01N88,안양 KGC,Home,양희종,0,0,0,0.0,0,1,0.0,0,1,0.0,0,0,0.0,0,0,0,1,0,0,1,0,0,1
../kbl_data/2021-2022,S39G01N88,안양 KGC,Home,함준후,0,0,0,0.0,0,0,0.0,0,0,0.0,0,0,0.0,0,0,0,0,0,0,0,0,0,0
../kbl_data/2021-2022,S39G01N88,안양 KGC,Home,오세근,16,6,13,46.2,0,0,0.0,6,13,46.2,4,4,100.0,2,7,9,0,1,2,0,0,4,5
../kbl_data/2021-2022,S39G01N88,안양 KGC,Home,문성곤,9,0,0,0.0,3,4,75.0,3,4,75.0,0,0,0.0,1,6,7,4,2,0,1,0,3,2
../kbl_data/2021-2022,S39G01N88,안양 KGC,Home,전성현,24,5,8,62.5,4,10,40.0,9,18,50.0,2,2,100.0,2,3,5,1,1,0,0,0,1,1
../kbl_data/2021-2022,S39G01N88,안양 KGC,Home,박지훈,7,2,4,50.0,1,3,33.3,3,7,42.9,0,2,0.0,0,2,2,1,3,0,0,0,1,0
../kbl_data/2021-2022,S39G01N88,안양 KGC,Home,이우정,0,0,0,0.0,0,0,0.0,0,0,0.0,0,0,0.0,0,0,0,0,0,0,0,0,0,0
../kbl_data/2021-2022,S39G01N88,안양 KGC,Home,대릴 먼로,0,0,0,0.0,0,0,0.0,0,0,0.0,0,0,0.0,1,2,3,2,0,0,0,0,2,1
../kbl_data/2021-2022,S39G01N88,안양 KGC,Home,우동현,0,0,0,0.0,0,0,0.0,0,0,0.0,0,0,0.0,0,0,0,0,0,0,0,0,0,0
../kbl_data/2021-2022,S39G01N88,안양 KGC,Home,변준형,20,3,6,50.0,4,11,36.4,7,17,41.2,2,3,66.7,2,2,4,7,2,0,1,0,3,3
../kbl_data/2021-2022,S39G01N88,안양 KGC,Home,한승희,0,0,0,0.0,0,1,0.0,0,1,0.0,0,0,0.0,0,0,0,0,0,0,0,0,0,1
../kbl_data/2021-2022,S39G01N88,안양 KGC,Home,오마리 스펠맨,14,6,15,40.0,0,8,0.0,6,23,26.1,2,6,33.3,1,8,9,5,1,2,0,1,3,1
../kbl_data/2021-2022,S39G01N88,원주 DB,Away,윤호영,5,1,4,25.0,1,1,100.0,2,5,40.0,0,0,0.0,3,3,6,2,2,1,0,0,0,0
../kbl_data/2021-2022,S39G01N88,원주 DB,Away,박찬희,7,2,3,66.7,1,4,25.0,3,7,42.9,0,2,0.0,0,4,4,1,0,0,1,0,3,1
../kbl_data/2021-2022,S39G01N88,원주 DB,Away,정준원,2,1,4,25.0,0,1,0.0,1,5,20.0,0,0,0.0,2,2,4,1,0,0,0,0,1,2
../kbl_data/2021-2022,S39G01N88,원주 DB,Away,김종규,4,1,2,50.0,0,2,0.0,1,4,25.0,2,2,100.0,2,4,6,1,1,0,0,0,4,4
../kbl_data/2021-2022,S39G01N88,원주 DB,Away,허웅,29,6,7,85.7,3,7,42.9,9,14,64.3,8,9,88.9,0,3,3,1,2,0,0,0,5,5
../kbl_data/2021-2022,S39G01N88,원주 DB,Away,김영훈,2,1,1,100.0,0,4,0.0,1,5,20.0,0,0,0.0,0,0,0,0,0,0,0,0,0,0
../kbl_data/2021-2022,S39G01N88,원주 DB,Away,강상재,9,1,6,16.7,2,3,66.7,3,9,33.3,1,2,50.0,0,7,7,1,1,1,0,0,0,2
../kbl_data/2021-2022,S39G01N88,원주 DB,Away,나카무라 타이치,0,0,2,0.0,0,0,0.0,0,2,0.0,0,0,0.0,0,0,0,1,0,0,0,0,0,1
../kbl_data/2021-2022,S39G01N88,원주 DB,Away,이준희,0,0,0,0.0,0,0,0.0,0,0,0.0,0,0,0.0,0,0,0,0,0,0,0,0,0,0
../kbl_data/2021-2022,S39G01N88,원주 DB,Away,레나드 프리먼,10,5,7,71.4,0,0,0.0,5,7,71.4,0,0,0.0,5,3,8,2,1,0,0,1,1,0
../kbl_data/2021-2022,S39G01N88,원주 DB,Away,정호영,13,2,5,40.0,3,4,75.0,5,9,55.6,0,0,0.0,0,4,4,5,2,1,0,0,2,2
../kbl_data/2021-2022,S39G01N88,원주 DB,Away,조니 오브라이언트,15,6,12,50.0,1,6,16.7,7,18,38.9,0,0,0.0,1,9,10,1,0,1,0,0,3,1
../kbl_data/2021-2022,S39G01N89,대구 한국가스공사,Home,정영삼,1,0,0,0.0,0,0,0.0,0,0,0.0,1,2,50.0,0,1,1,0,2,0,0,0,0,0
../kbl_data/2021-2022,S39G01N89,대구 한국가스공사,Home,차바위,3,0,0,0.0,1,2,50.0,1,2,50.0,0,0,0.0,1,5,6,1,0,1,0,0,1,2
../kbl_data/2021-2022,S39G01N89,대구 한국가스공사,Home,조상열,0,0,0,0.0,0,0,0.0,0,0,0.0,0,0,0.0,0,0,0,0,0,0,0,0,0,0
../kbl_data/2021-2022,S39G01N89,대구 한국가스공사,Home,이대헌,18,6,15,40.0,1,2,50.0,7,17,41.2,3,4,75.0,4,4,8,2,0,0,0,0,3,3
../kbl_data/2021-2022,S39G01N89,대구 한국가스공사,Home,두경민,19,3,6,50.0,3,9,33.3,6,15,40.0,4,5,80.0,0,0,0,1,0,0,0,0,4,4
../kbl_data/2021-2022,S39G01N89,대구 한국가스공사,Home,박봉진,0,0,0,0.0,0,0,0.0,0,0,0.0,0,0,0.0,0,0,0,0,0,0,0,0,0,1
../kbl_data/2021-2022,S39G01N89,대구 한국가스공사,Home,김낙현,18,2,5,40.0,4,7,57.1,6,12,50.0,2,5,40.0,1,0,1,4,0,0,0,0,5,5
../kbl_data/2021-2022,S39G01N89,대구 한국가스공사,Home,전현우,0,0,0,0.0,0,1,0.0,0,1,0.0,0,0,0.0,0,1,1,0,0,0,0,0,0,1
../kbl_data/2021-2022,S39G01N89,대구 한국가스공사,Home,이윤기,0,0,0,0.0,0,1,0.0,0,1,0.0,0,0,0.0,0,0,0,1,0,0,0,0,2,1
../kbl_data/2021-2022,S39G01N89,대구 한국가스공사,Home,양준우,0,0,0,0.0,0,0,0.0,0,0,0.0,0,0,0.0,0,0,0,0,0,0,0,0,0,0
../kbl_data/2021-2022,S39G01N89,대구 한국가스공사,Home,클리프 알렉산더,14,6,12,50.0,0,1,0.0,6,13,46.2,2,2,100.0,5,18,23,7,1,1,0,3,2,1
../kbl_data/2021-2022,S39G01N89,대구 한국가스공사,Home,신승민,0,0,0,0.0,0,0,0.0,0,0,0.0,0,0,0.0,0,0,0,0,0,0,0,0,0,2
../kbl_data/2021-2022,S39G01N89,서울 SK,Away,양우섭,0,0,0,0.0,0,0,0.0,0,0,0.0,0,0,0.0,0,0,0,0,0,0,0,0,0,0
../kbl_data/2021-2022,S39G01N89,서울 SK,Away,허일영,8,1,1,100.0,2,2,100.0,3,3,100.0,0,0,0.0,0,2,2,0,2,0,0,0,0,4
../kbl_data/2021-2022,S39G01N89,서울 SK,Away,김선형,13,4,5,80.0,1,3,33.3,5,8,62.5,2,2,100.0,2,2,4,3,1,0,0,0,4,0
../kbl_data/2021-2022,S39G01N89,서울 SK,Away,최부경,3,1,2,50.0,0,0,0.0,1,2,50.0,1,4,25.0,0,0,0,1,0,1,0,0,0,1
../kbl_data/2021-2022,S39G01N89,서울 SK,Away,리온 윌리엄스,0,0,2,0.0,0,1,0.0,0,3,0.0,0,0,0.0,2,1,3,1,0,0,0,0,0,1
../kbl_data/2021-2022,S39G01N89,서울 SK,Away,배병준,0,0,0,0.0,0,0,0.0,0,0,0.0,0,0,0.0,0,0,0,0,0,0,0,0,0,0
../kbl_data/2021-2022,S39G01N89,서울 SK,Away,이현석,0,0,0,0.0,0,0,0.0,0,0,0.0,0,0,0.0,0,1,1,0,0,0,0,0,1,0
../kbl_data/2021-2022,S39G01N89,서울 SK,Away,최원혁,0,0,0,0.0,0,1,0.0,0,1,0.0,0,0,0.0,1,2,3,4,3,0,0,0,0,4
../kbl_data/2021-2022,S39G01N89,서울 SK,Away,최준용,16,4,8,50.0,2,7,28.6,6,15,40.0,2,4,50.0,4,4,8,3,2,1,0,0,2,3
../kbl_data/2021-2022,S39G01N89,서울 SK,Away,안영준,19,7,15,46.7,1,3,33.3,8,18,44.4,2,4,50.0,2,4,6,0,3,0,0,0,1,1
../kbl_data/2021-2022,S39G01N89,서울 SK,Away,자밀 워니,14,7,19,36.8,0,1,0.0,7,20,35.0,0,0,0.0,2,7,9,4,1,2,0,0,0,1
../kbl_data/2021-2022,S39G01N89,서울 SK,Away,오재현,2,0,2,0.0,0,1,0.0,0,3,0.0,2,2,100.0,0,0,0,1,0,0,1,0,0,1
../kbl_data/2021-2022,S39G01N90,고양 오리온,Home,김강선,15,2,3,66.7,3,7,42.9,5,10,50.0,2,2,100.0,0,2,2,0,1,0,0,0,1,1
../kbl_data/2021-2022,S39G01N90,고양 오리온,Home,최현민,8,1,1,100.0,2,5,40.0,3,6,50.0,0,2,0.0,2,0,2,1,0,0,0,0,0,1
../kbl_data/2021-2022,S39G01N90,고양 오리온,Home,이대성,17,5,13,38.5,1,4,25.0,6,17,35.3,4,4,100.0,0,1,1,7,3,0,0,0,3,2
../kbl_data/2021-2022,S39G01N90,고양 오리온,Home,이정제,0,0,0,0.0,0,0,0.0,0,0,0.0,0,0,0.0,0,0,0,0,0,0,0,0,0,0
../kbl_data/2021-2022,S39G01N90,고양 오리온,Home,최승욱,0,0,0,0.0,0,0,0.0,0,0,0.0,0,0,0.0,2,0,2,0,0,0,0,0,0,0
../kbl_data/2021-2022,S39G01N90,고양 오리온,Home,이승현,18,7,9,77.8,0,0,0.0,7,9,77.8,4,4,100.0,4,3,7,1,3,1,0,0,1,0
../kbl_data/2021-2022,S39G01N90,고양 오리온,Home,김진유,0,0,2,0.0,0,0,0.0,0,2,0.0,0,0,0.0,2,0,2,0,0,0,0,0,0,1
../kbl_data/2021-2022,S39G01N90,고양 오리온,Home,머피 할로웨이,6,2,6,33.3,0,0,0.0,2,6,33.3,2,2,100.0,1,4,5,2,2,3,0,0,0,3
../kbl_data/2021-2022,S39G01N90,고양 오리온,Home,조한진,0,0,0,0.0,0,0,0.0,0,0,0.0,0,0,0.0,0,0,0,0,0,0,0,0,0,0
../kbl_data/2021-2022,S39G01N90,고양 오리온,Home,조석호,5,1,2,50.0,1,4,25.0,2,6,33.3,0,0,0.0,0,1,1,2,0,0,0,0,0,0
../kbl_data/2021-2022,S39G01N90,고양 오리온,Home,미로슬라브 라둘리차,2,0,1,0.0,0,1,0.0,0,2,0.0,2,2,100.0,0,4,4,1,0,0,0,0,1,3
../kbl_data/2021-2022,S39G01N90,고양 오리온,Home,이정현,70,18,34,52.9,10,22,45.5,28,56,50.0,4,4,100.0,2,10,12,18,10,0,0,0,12,12
../kbl_data/2021-2022,S39G01N90,전주 KCC,Away,송창용,0,0,1,0.0,0,0,0.0,0,1,0.0,0,0,0.0,0,0,0,0,0,0,0,0,0,0
../kbl_data/2021-2022,S39G01N90,전주 KCC,Away,이정현,70,18,34,52.9,10,22,45.5,28,56,50.0,4,4,100.0,2,10,12,18,10,0,0,0,12,12
../kbl_data/2021-2022,S39G01N90,전주 KCC,Away,라건아,15,6,10,60.0,1,3,33.3,7,13,53.8,0,0,0.0,4,11,15,1,0,3,0,0,0,0
../kbl_data/2021-2022,S39G01N90,전주 KCC,Away,김지완,14,2,5,40.0,2,4,50.0,4,9,44.4,4,7,57.1,1,1,2,4,0,0,0,0,5,3
../kbl_data/2021-2022,S39G01N90,전주 KCC,Away,김상규,12,4,6,66.7,1,2,50.0,5,8,62.5,1,1,100.0,7,5,12,2,1,0,0,0,0,3
../kbl_data/2021-2022,S39G01N90,전주 KCC,Away,유병훈,0,0,0,0.0,0,0,0.0,0,0,0.0,0,0,0.0,0,0,0,0,0,0,0,0,1,1
../kbl_data/2021-2022,S39G01N90,전주 KCC,Away,전준범,2,1,1,100.0,0,0,0.0,1,1,100.0,0,0,0.0,0,2,2,0,0,0,0,0,0,1
../kbl_data/2021-2022,S39G01N90,전주 KCC,Away,박재현,2,1,2,50.0,0,1,0.0,1,3,33.3,0,0,0.0,0,0,0,2,0,0,0,0,1,1
../kbl_data/2021-2022,S39G01N90,전주 KCC,Away,이진욱,0,0,0,0.0,0,0,0.0,0,0,0.0,0,0,0.0,0,0,0,0,0,0,0,0,0,0
../kbl_data/2021-2022,S39G01N90,전주 KCC,Away,유현준,8,3,3,100.0,0,1,0.0,3,4,75.0,2,3,66.7,0,1,1,5,2,1,0,0,5,1
../kbl_data/2021-2022,S39G01N90,전주 KCC,Away,라타비우스 윌리엄스,12,6,10,60.0,0,0,0.0,6,10,60.0,0,1,0.0,2,3,5,0,1,0,0,0,0,2
../kbl_data/2021-2022,S39G01N90,전주 KCC,Away,곽정훈,2,1,1,100.0,0,1,0.0,1,2,50.0,0,0,0.0,0,0,0,0,0,0,0,0,0,2
../kbl_data/2021-2022,S39G01N91,울산 현대모비스,Home,이현민,0,0,1,0.0,0,0,0.0,0,1,0.0,0,0,0.0,0,1,1,0,0,0,0,0,1,1
../kbl_data/2021-2022,S39G01N91,울산 현대모비스,Home,함지훈,12,4,7,57.1,0,2,0.0,4,9,44.4,4,4,100.0,2,3,5,1,4,1,0,0,2,3
../kbl_data/2021-2022,S39G01N91,울산 현대모비스,Home,최진수,5,1,3,33.3,1,3,33.3,2,6,33.3,0,0,0.0,2,1,3,1,1,2,0,0,1,2
../kbl_data/2021-2022,S39G01N91,울산 현대모비스,Home,박지훈,0,0,1,0.0,0,1,0.0,0,2,0.0,0,0,0.0,1,0,1,0,0,0,0,0,0,1
../kbl_data/2021-2022,S39G01N91,울산 현대모비스,Home,장재석,2,1,1,100.0,0,0,0.0,1,1,100.0,0,0,0.0,0,0,0,0,0,0,0,0,0,1
../kbl_data/2021-2022,S39G01N91,울산 현대모비스,Home,김국찬,11,2,3,66.7,2,5,40.0,4,8,50.0,1,2,50.0,2,2,4,3,1,0,0,0,0,3
../kbl_data/2021-2022,S39G01N91,울산 현대모비스,Home,서명진,7,0,7,0.0,2,5,40.0,2,12,16.7,1,2,50.0,0,2,2,7,0,0,0,0,2,5
../kbl_data/2021-2022,S39G01N91,울산 현대모비스,Home,얼 클락,2,1,3,33.3,0,0,0.0,1,3,33.3,0,0,0.0,0,4,4,0,0,0,0,0,2,1
../kbl_data/2021-2022,S39G01N91,울산 현대모비스,Home,이우석,6,2,3,66.7,0,0,0.0,2,3,66.7,2,2,100.0,1,6,7,2,1,0,0,0,3,2
../kbl_data/2021-2022,S39G01N91,울산 현대모비스,Home,라숀 토마스,27,10,21,47.6,0,0,0.0,10,21,47.6,7,10,70.0,9,7,16,1,2,1,0,1,1,4
../kbl_data/2021-2022,S39G01N91,울산 현대모비스,Home,신민석,0,0,0,0.0,0,0,0.0,0,0,0.0,0,0,0.0,0,0,0,0,0,0,0,0,0,0
../kbl_data/2021-2022,S39G01N91,울산 현대모비스,Home,김동준,0,0,0,0.0,0,0,0.0,0,0,0.0,0,0,0.0,0,0,0,0,0,0,0,0,0,0
../kbl_data/2021-2022,S39G01N91,수원 KT,Away,김동욱,16,2,6,33.3,4,12,33.3,6,18,33.3,0,1,0.0,1,5,6,2,0,1,0,0,3,2
../kbl_data/2021-2022,S39G01N91,수원 KT,Away,김영환,0,0,0,0.0,0,1,0.0,0,1,0.0,0,0,0.0,0,0,0,0,0,0,0,0,0,0
../kbl_data/2021-2022,S39G01N91,수원 KT,Away,김현민,2,1,2,50.0,0,1,0.0,1,3,33.3,0,0,0.0,2,0,2,0,0,0,0,0,0,5
../kbl_data/2021-2022,S39G01N91,수원 KT,Away,최창진,0,0,0,0.0,0,0,0.0,0,0,0.0,0,0,0.0,0,0,0,0,0,0,1,0,0,0
../kbl_data/2021-2022,S39G01N91,수원 KT,Away,정성우,2,0,3,0.0,0,1,0.0,0,4,0.0,2,2,100.0,0,1,1,2,3,0,0,0,2,3
../kbl_data/2021-2022,S39G01N91,수원 KT,Away,허훈,18,3,9,33.3,3,7,42.9,6,16,37.5,3,4,75.0,3,2,5,7,1,0,0,0,3,3
../kbl_data/2021-2022,S39G01N91,수원 KT,Away,양홍석,7,2,3,66.7,0,1,0.0,2,4,50.0,3,4,75.0,4,1,5,1,0,0,0,0,3,1
../kbl_data/2021-2022,S39G01N91,수원 KT,Away,캐디 라렌,23,8,14,57.1,1,3,33.3,9,17,52.9,4,6,66.7,5,8,13,2,1,5,0,3,2,3
../kbl_data/2021-2022,S39G01N91,수원 KT,Away,문상옥,0,0,0,0.0,0,0,0.0,0,0,0.0,0,0,0.0,0,0,0,0,0,0,0,0,0,0
../kbl_data/2021-2022,S39G01N91,수원 KT,Away,박지원,0,0,0,0.0,0,0,0.0,0,0,0.0,0,0,0.0,0,0,0,0,0,0,0,0,0,0
../kbl_data/2021-2022,S39G01N91,수원 KT,Away,마이크 마이어스,3,1,1,100.0,0,0,0.0,1,1,100.0,1,2,50.0,0,2,2,0,0,0,0,0,0,1
../kbl_data/2021-2022,S39G01N91,수원 KT,Away,하윤기,4,1,4,25.0,0,0,0.0,1,4,25.0,2,2,100.0,4,3,7,0,0,0,0,0,1,5
../kbl_data/2021-2022,S39G01N92,서울 삼성,Home,김동량,10,4,4,100.0,0,2,0.0,4,6,66.7,2,2,100.0,1,0,1,0,0,0,0,0,0,3
../kbl_data/2021-2022,S39G01N92,서울 삼성,Home,장민국,3,0,2,0.0,1,3,33.3,1,5,20.0,0,0,0.0,2,4,6,0,0,1,0,0,1,2
../kbl_data/2021-2022,S39G01N92,서울 삼성,Home,김시래,15,5,8,62.5,1,7,14.3,6,15,40.0,2,2,100.0,0,1,1,7,0,0,0,0,3,3
../kbl_data/2021-2022,S39G01N92,서울 삼성,Home,김현수,5,0,4,0.0,1,5,20.0,1,9,11.1,2,2,100.0,1,2,3,3,1,0,0,0,1,4
../kbl_data/2021-2022,S39G01N92,서울 삼성,Home,임동섭,8,0,1,0.0,2,6,33.3,2,7,28.6,2,2,100.0,0,4,4,0,0,0,0,0,0,2
../kbl_data/2021-2022,S39G01N92,서울 삼성,Home,배수용,0,0,0,0.0,0,0,0.0,0,0,0.0,0,0,0.0,0,0,0,0,0,0,0,0,0,0
../kbl_data/2021-2022,S39G01N92,서울 삼성,Home,천기범,1,0,1,0.0,0,0,0.0,0,1,0.0,1,2,50.0,1,1,2,0,0,0,0,0,0,0
../kbl_data/2021-2022,S39G01N92,서울 삼성,Home,차민석,4,2,2,100.0,0,1,0.0,2,3,66.7,0,0,0.0,3,2,5,0,1,0,0,0,0,1
../kbl_data/2021-2022,S39G01N92,서울 삼성,Home,전형준,5,0,2,0.0,1,2,50.0,1,4,25.0,2,2,100.0,0,0,0,0,0,0,0,0,1,0
../kbl_data/2021-2022,S39G01N92,서울 삼성,Home,다니엘 오셰푸,12,4,8,50.0,1,2,50.0,5,10,50.0,1,1,100.0,4,6,10,3,1,3,0,0,3,0
../kbl_data/2021-2022,S39G01N92,서울 삼성,Home,조우성,0,0,2,0.0,0,0,0.0,0,2,0.0,0,0,0.0,2,1,3,0,0,0,0,0,1,0
../kbl_data/2021-2022,S39G01N92,서울 삼성,Home,이원석,10,3,7,42.9,0,1,0.0,3,8,37.5,4,5,80.0,3,3,6,1,0,0,0,0,2,3
../kbl_data/2021-2022,S39G01N92,원주 DB,Away,윤호영,0,0,0,0.0,0,0,0.0,0,0,0.0,0,0,0.0,0,1,1,1,0,0,0,0,2,3
../kbl_data/2021-2022,S39G01N92,원주 DB,Away,박찬희,9,2,2,100.0,1,3,33.3,3,5,60.0,2,2,100.0,0,2,2,3,1,0,0,0,1,3
../kbl_data/2021-2022,S39G01N92,원주 DB,Away,김현호,6,0,2,0.0,2,2,100.0,2,4,50.0,0,0,0.0,0,1,1,1,1,0,0,0,0,1
../kbl_data/2021-2022,S39G01N92,원주 DB,Away,정준원,10,2,2,100.0,2,3,66.7,4,5,80.0,0,0,0.0,0,2,2,1,0,0,0,0,1,1
../kbl_data/2021-2022,S39G01N92,원주 DB,Away,김종규,9,3,6,50.0,0,1,0.0,3,7,42.9,3,3,100.0,0,5,5,2,0,0,0,1,0,2
../kbl_data/2021-2022,S39G01N92,원주 DB,Away,허웅,20,1,2,50.0,5,7,71.4,6,9,66.7,3,3,100.0,0,3,3,3,1,0,0,0,1,1
../kbl_data/2021-2022,S39G01N92,원주 DB,Away,김영훈,0,0,0,0.0,0,0,0.0,0,0,0.0,0,0,0.0,0,0,0,0,0,0,0,0,0,0
../kbl_data/2021-2022,S39G01N92,원주 DB,Away,강상재,14,7,10,70.0,0,1,0.0,7,11,63.6,0,0,0.0,2,5,7,6,1,3,0,0,0,0
../kbl_data/2021-2022,S39G01N92,원주 DB,Away,나카무라 타이치,0,0,0,0.0,0,0,0.0,0,0,0.0,0,0,0.0,0,0,0,0,1,0,0,0,0,1
../kbl_data/2021-2022,S39G01N92,원주 DB,Away,레나드 프리먼,12,5,9,55.6,0,1,0.0,5,10,50.0,2,3,66.7,2,2,4,3,2,1,0,0,1,0
../kbl_data/2021-2022,S39G01N92,원주 DB,Away,정호영,7,2,5,40.0,0,2,0.0,2,7,28.6,3,4,75.0,0,1,1,2,0,1,0,0,0,3
../kbl_data/2021-2022,S39G01N92,원주 DB,Away,조니 오브라이언트,7,2,5,40.0,1,2,50.0,3,7,42.9,0,0,0.0,0,3,3,4,0,0,0,0,1,3
../kbl_data/2021-2022,S39G01N93,고양 오리온,Home,김강선,11,1,1,100.0,3,4,75.0,4,5,80.0,0,0,0.0,1,2,3,2,0,0,0,0,0,2
../kbl_data/2021-2022,S39G01N93,고양 오리온,Home,최현민,0,0,1,0.0,0,1,0.0,0,2,0.0,0,0,0.0,1,0,1,1,0,0,0,0,1,3
../kbl_data/2021-2022,S39G01N93,고양 오리온,Home,이대성,12,4,8,50.0,1,1,100.0,5,9,55.6,1,2,50.0,1,2,3,6,2,0,0,0,1,4
../kbl_data/2021-2022,S39G01N93,고양 오리온,Home,이정제,0,0,0,0.0,0,0,0.0,0,0,0.0,0,0,0.0,0,0,0,0,0,0,0,0,0,0
../kbl_data/2021-2022,S39G01N93,고양 오리온,Home,최승욱,2,1,1,100.0,0,0,0.0,1,1,100.0,0,0,0.0,0,1,1,0,1,1,0,0,0,0
../kbl_data/2021-2022,S39G01N93,고양 오리온,Home,이승현,20,7,8,87.5,2,5,40.0,9,13,69.2,0,0,0.0,2,4,6,2,0,0,0,0,2,2
../kbl_data/2021-2022,S39G01N93,고양 오리온,Home,김진유,2,1,1,100.0,0,2,0.0,1,3,33.3,0,0,0.0,1,5,6,2,0,0,0,0,0,4
../kbl_data/2021-2022,S39G01N93,고양 오리온,Home,머피 할로웨이,18,8,10,80.0,0,0,0.0,8,10,80.0,2,2,100.0,2,5,7,2,3,1,0,1,2,1
../kbl_data/2021-2022,S39G01N93,고양 오리온,Home,조한진,6,0,1,0.0,2,4,50.0,2,5,40.0,0,0,0.0,0,1,1,0,0,0,0,0,0,0
../kbl_data/2021-2022,S39G01N93,고양 오리온,Home,조석호,2,1,3,33.3,0,0,0.0,1,3,33.3,0,0,0.0,0,0,0,0,0,0,0,0,1,1
../kbl_data/2021-2022,S39G01N93,고양 오리온,Home,미로슬라브 라둘리차,12,3,4,75.0,1,3,33.3,4,7,57.1,3,3,100.0,1,8,9,5,1,1,1,0,3,3
../kbl_data/2021-2022,S39G01N93,고양 오리온,Home,이정현,4,2,5,40.0,0,3,0.0,2,8,25.0,0,0,0.0,0,7,7,4,1,0,0,0,3,2
../kbl_data/2021-2022,S39G01N93,창원 LG,Away,강병현,2,1,1,100.0,0,1,0.0,1,2,50.0,0,0,0.0,0,0,0,0,1,0,0,0,0,1
../kbl_data/2021-2022,S39G01N93,창원 LG,Away,변기훈,3,1,1,100.0,0,2,0.0,1,3,33.3,1,2,50.0,0,1,1,0,0,0,0,0,0,3
../kbl_data/2021-2022,S39G01N93,창원 LG,Away,이관희,8,2,4,50.0,1,8,12.5,3,12,25.0,1,2,50.0,0,2,2,1,3,1,0,0,1,0
../kbl_data/2021-2022,S39G01N93,창원 LG,Away,정희재,5,0,2,0.0,1,5,20.0,1,7,14.3,2,2,100.0,3,0,3,1,0,0,0,0,3,4
../kbl_data/2021-2022,S39G01N93,창원 LG,Away,서민수,6,0,1,0.0,2,5,40.0,2,6,33.3,0,2,0.0,1,1,2,0,0,0,0,0,1,3
../kbl_data/2021-2022,S39G01N93,창원 LG,Away,한상혁,0,0,1,0.0,0,1,0.0,0,2,0.0,0,0,0.0,0,0,0,1,0,0,0,0,1,0
../kbl_data/2021-2022,S39G01N93,창원 LG,Away,이재도,15,2,8,25.0,3,8,37.5,5,16,31.2,2,2,100.0,2,3,5,7,1,0,0,0,1,1
../kbl_data/2021-2022,S39G01N93,창원 LG,Away,정해원,0,0,0,0.0,0,0,0.0,0,0,0.0,0,0,0.0,0,0,0,0,0,0,0,0,0,0
../kbl_data/2021-2022,S39G01N93,창원 LG,Away,박정현,4,2,4,50.0,0,0,0.0,2,4,50.0,0,0,0.0,0,4,4,0,0,0,0,0,5,0
../kbl_data/2021-2022,S39G01N93,창원 LG,Away,압둘 말릭 아부,6,2,3,66.7,0,1,0.0,2,4,50.0,2,5,40.0,1,2,3,0,0,1,0,1,0,1
../kbl_data/2021-2022,S39G01N93,창원 LG,Away,아셈 마레이,15,6,14,42.9,0,0,0.0,6,14,42.9,3,4,75.0,9,5,14,2,1,1,1,0,1,1
../kbl_data/2021-2022,S39G01N93,창원 LG,Away,이승우,2,1,1,100.0,0,0,0.0,1,1,100.0,0,0,0.0,0,0,0,2,1,0,0,0,0,2
../kbl_data/2021-2022,S39G01N94,전주 KCC,Home,송창용,11,3,4,75.0,1,1,100.0,4,5,80.0,2,2,100.0,1,5,6,1,0,0,0,0,1,1
../kbl_data/2021-2022,S39G01N94,전주 KCC,Home,이정현,33,7,9,77.8,3,11,27.3,10,20,50.0,10,11,90.9,2,3,5,6,0,0,0,0,3,2
../kbl_data/2021-2022,S39G01N94,전주 KCC,Home,라건아,17,7,9,77.8,1,2,50.0,8,11,72.7,0,0,0.0,3,8,11,3,0,0,0,1,0,3
../kbl_data/2021-2022,S39G01N94,전주 KCC,Home,김지완,0,0,0,0.0,0,1,0.0,0,1,0.0,0,0,0.0,1,0,1,0,0,0,0,0,0,2
../kbl_data/2021-2022,S39G01N94,전주 KCC,Home,김상규,8,2,2,100.0,0,2,0.0,2,4,50.0,4,4,100.0,2,1,3,3,0,1,0,0,2,3
../kbl_data/2021-2022,S39G01N94,전주 KCC,Home,유병훈,0,0,0,0.0,0,0,0.0,0,0,0.0,0,0,0.0,0,0,0,0,0,0,1,0,0,1
../kbl_data/2021-2022,S39G01N94,전주 KCC,Home,박재현,2,1,3,33.3,0,1,0.0,1,4,25.0,0,0,0.0,0,1,1,1,0,0,0,0,3,3
../kbl_data/2021-2022,S39G01N94,전주 KCC,Home,이진욱,5,1,1,100.0,1,3,33.3,2,4,50.0,0,0,0.0,1,1,2,3,0,0,0,0,0,1
../kbl_data/2021-2022,S39G01N94,전주 KCC,Home,유현준,11,1,3,33.3,3,7,42.9,4,10,40.0,0,0,0.0,1,1,2,2,0,0,1,0,2,2
../kbl_data/2021-2022,S39G01N94,전주 KCC,Home,라타비우스 윌리엄스,6,3,5,60.0,0,0,0.0,3,5,60.0,0,0,0.0,3,0,3,0,1,0,0,2,0,1
../kbl_data/2021-2022,S39G01N94,전주 KCC,Home,곽정훈,0,0,0,0.0,0,0,0.0,0,0,0.0,0,0,0.0,0,0,0,0,0,0,0,0,0,0
../kbl_data/2021-2022,S39G01N94,전주 KCC,Home,이근휘,5,1,1,100.0,1,3,33.3,2,4,50.0,0,0,0.0,1,0,1,0,1,0,0,0,0,1
../kbl_data/2021-2022,S39G01N94,대구 한국가스공사,Away,정영삼,0,0,0,0.0,0,1,0.0,0,1,0.0,0,0,0.0,0,0,0,0,0,0,0,0,0,1
../kbl_data/2021-2022,S39G01N94,대구 한국가스공사,Away,차바위,0,0,1,0.0,0,0,0.0,0,1,0.0,0,0,0.0,0,0,0,0,0,0,0,0,0,3
../kbl_data/2021-2022,S39G01N94,대구 한국가스공사,Away,조상열,5,0,0,0.0,1,3,33.3,1,3,33.3,2,2,100.0,1,0,1,2,0,0,0,0,0,1
../kbl_data/2021-2022,S39G01N94,대구 한국가스공사,Away,이대헌,15,3,8,37.5,2,2,100.0,5,10,50.0,3,4,75.0,0,2,2,0,0,0,0,0,1,4
../kbl_data/2021-2022,S39G01N94,대구 한국가스공사,Away,두경민,26,3,5,60.0,6,12,50.0,9,17,52.9,2,4,50.0,1,1,2,4,2,0,0,0,1,4
../kbl_data/2021-2022,S39G01N94,대구 한국가스공사,Away,박봉진,0,0,0,0.0,0,0,0.0,0,0,0.0,0,0,0.0,0,0,0,0,0,0,0,0,0,0
../kbl_data/2021-2022,S39G01N94,대구 한국가스공사,Away,김낙현,22,3,3,100.0,3,4,75.0,6,7,85.7,7,7,100.0,1,4,5,7,4,0,0,0,2,1
../kbl_data/2021-2022,S39G01N94,대구 한국가스공사,Away,전현우,6,0,0,0.0,2,5,40.0,2,5,40.0,0,0,0.0,1,1,2,2,1,0,0,0,0,0
../kbl_data/2021-2022,S39G01N94,대구 한국가스공사,Away,이윤기,0,0,1,0.0,0,0,0.0,0,1,0.0,0,0,0.0,0,0,0,0,0,0,0,0,0,1
../kbl_data/2021-2022,S39G01N94,대구 한국가스공사,Away,클리프 알렉산더,2,1,4,25.0,0,0,0.0,1,4,25.0,0,0,0.0,1,3,4,2,1,0,0,1,1,1
../kbl_data/2021-2022,S39G01N94,대구 한국가스공사,Away,앤드류 니콜슨,27,9,10,90.0,1,4,25.0,10,14,71.4,6,6,100.0,1,5,6,1,3,1,0,1,2,4
../kbl_data/2021-2022,S39G01N94,대구 한국가스공사,Away,신승민,0,0,0,0.0,0,0,0.0,0,0,0.0,0,0,0.0,0,0,0,0,0,0,0,0,0,0
../kbl_data/2021-2022,S39G01N95,고양 오리온,Home,김강선,3,0,0,0.0,1,3,33.3,1,3,33.3,0,0,0.0,0,0,0,2,0,0,0,0,1,3
../kbl_data/2021-2022,S39G01N95,고양 오리온,Home,최현민,6,0,2,0.0,2,4,50.0,2,6,33.3,0,0,0.0,1,1,2,1,1,0,0,0,0,1
../kbl_data/2021-2022,S39G01N95,고양 오리온,Home,이대성,15,1,3,33.3,3,5,60.0,4,8,50.0,4,4,100.0,0,2,2,5,2,1,0,0,4,1
../kbl_data/2021-2022,S39G01N95,고양 오리온,Home,이정제,0,0,0,0.0,0,0,0.0,0,0,0.0,0,0,0.0,0,0,0,0,0,0,0,0,0,0
../kbl_data/2021-2022,S39G01N95,고양 오리온,Home,최승욱,0,0,1,0.0,0,0,0.0,0,1,0.0,0,0,0.0,0,0,0,0,0,0,0,0,1,0
../kbl_data/2021-2022,S39G01N95,고양 오리온,Home,이승현,19,8,11,72.7,1,1,100.0,9,12,75.0,0,0,0.0,1,4,5,3,0,0,0,0,3,2
../kbl_data/2021-2022,S39G01N95,고양 오리온,Home,김진유,2,1,1,100.0,0,3,0.0,1,4,25.0,0,0,0.0,1,0,1,0,2,0,0,0,0,1
../kbl_data/2021-2022,S39G01N95,고양 오리온,Home,머피 할로웨이,14,7,12,58.3,0,0,0.0,7,12,58.3,0,3,0.0,3,9,12,1,1,0,0,1,2,3
../kbl_data/2021-2022,S39G01N95,고양 오리온,Home,조한진,2,0,0,0.0,0,1,0.0,0,1,0.0,2,2,100.0,0,1,1,0,0,1,0,0,0,1
../kbl_data/2021-2022,S39G01N95,고양 오리온,Home,조석호,0,0,1,0.0,0,0,0.0,0,1,0.0,0,0,0.0,0,0,0,1,0,0,0,0,0,2
../kbl_data/2021-2022,S39G01N95,고양 오리온,Home,미로슬라브 라둘리차,8,3,4,75.0,0,2,0.0,3,6,50.0,2,2,100.0,1,3,4,1,0,0,0,1,1,3
../kbl_data/2021-2022,S39G01N95,고양 오리온,Home,이정현,2,1,4,25.0,0,1,0.0,1,5,20.0,0,0,0.0,0,0,0,4,1,1,0,0,0,1
../kbl_data/2021-2022,S39G01N95,서울 SK,Away,양우섭,0,0,0,0.0,0,0,0.0,0,0,0.0,0,0,0.0,0,0,0,0,0,0,0,0,0,0
../kbl_data/2021-2022,S39G01N95,서울 SK,Away,허일영,11,4,5,80.0,1,5,20.0,5,10,50.0,0,0,0.0,2,4,6,0,0,0,0,0,0,3
../kbl_data/2021-2022,S39G01N95,서울 SK,Away,김선형,9,3,6,50.0,0,2,0.0,3,8,37.5,3,4,75.0,0,0,0,12,1,0,0,0,3,1
../kbl_data/2021-2022,S39G01N95,서울 SK,Away,최부경,8,4,6,66.7,0,0,0.0,4,6,66.7,0,1,0.0,1,2,3,0,0,1,0,0,1,2
../kbl_data/2021-2022,S39G01N95,서울 SK,Away,리온 윌리엄스,4,1,4,25.0,0,0,0.0,1,4,25.0,2,2,100.0,2,4,6,0,0,0,0,0,1,2
../kbl_data/2021-2022,S39G01N95,서울 SK,Away,배병준,8,0,1,0.0,2,2,100.0,2,3,66.7,2,2,100.0,0,1,1,1,0,0,1,0,0,1
../kbl_data/2021-2022,S39G01N95,서울 SK,Away,이현석,0,0,0,0.0,0,0,0.0,0,0,0.0,0,0,0.0,0,0,0,0,0,0,0,0,0,0
../kbl_data/2021-2022,S39G01N95,서울 SK,Away,최원혁,3,0,0,0.0,1,1,100.0,1,1,100.0,0,0,0.0,0,2,2,1,0,0,0,0,1,3
../kbl_data/2021-2022,S39G01N95,서울 SK,Away,최준용,5,1,1,100.0,1,3,33.3,2,4,50.0,0,1,0.0,2,4,6,2,1,1,0,0,2,2
../kbl_data/2021-2022,S39G01N95,서울 SK,Away,안영준,8,3,6,50.0,0,4,0.0,3,10,30.0,2,2,100.0,0,2,2,5,1,0,0,0,0,2
../kbl_data/2021-2022,S39G01N95,서울 SK,Away,자밀 워니,25,12,17,70.6,0,2,0.0,12,19,63.2,1,2,50.0,3,6,9,2,2,0,0,0,1,1
../kbl_data/2021-2022,S39G01N95,서울 SK,Away,오재현,0,0,0,0.0,0,0,0.0,0,0,0.0,0,0,0.0,0,0,0,0,0,0,0,0,0,0
../kbl_data/2021-2022,S39G01N96,울산 현대모비스,Home,이현민,11,3,4,75.0,0,1,0.0,3,5,60.0,5,6,83.3,0,2,2,5,2,0,0,0,0,3
../kbl_data/2021-2022,S39G01N96,울산 현대모비스,Home,함지훈,14,5,7,71.4,0,1,0.0,5,8,62.5,4,4,100.0,3,2,5,4,0,0,0,0,1,0
../kbl_data/2021-2022,S39G01N96,울산 현대모비스,Home,박지훈,16,4,6,66.7,2,4,50.0,6,10,60.0,2,4,50.0,6,10,16,8,2,0,0,0,0,10
../kbl_data/2021-2022,S39G01N96,울산 현대모비스,Home,장재석,11,4,9,44.4,0,0,0.0,4,9,44.4,3,4,75.0,2,1,3,0,0,0,0,0,0,1
../kbl_data/2021-2022,S39G01N96,울산 현대모비스,Home,김영현,0,0,0,0.0,0,0,0.0,0,0,0.0,0,0,0.0,0,1,1,0,0,0,1,0,0,2
../kbl_data/2021-2022,S39G01N96,울산 현대모비스,Home,김국찬,9,0,0,0.0,3,7,42.9,3,7,42.9,0,0,0.0,0,2,2,0,1,0,0,0,0,3
../kbl_data/2021-2022,S39G01N96,울산 현대모비스,Home,서명진,8,4,5,80.0,0,3,0.0,4,8,50.0,0,0,0.0,0,1,1,4,0,0,1,0,2,2
../kbl_data/2021-2022,S39G01N96,울산 현대모비스,Home,얼 클락,11,5,7,71.4,0,2,0.0,5,9,55.6,1,2,50.0,2,9,11,3,1,4,0,2,4,2
../kbl_data/2021-2022,S39G01N96,울산 현대모비스,Home,이우석,3,1,4,25.0,0,1,0.0,1,5,20.0,1,2,50.0,1,1,2,3,1,0,0,0,1,1
../kbl_data/2021-2022,S39G01N96,울산 현대모비스,Home,라숀 토마스,12,5,7,71.4,0,0,0.0,5,7,71.4,2,2,100.0,0,5,5,1,1,0,0,2,1,3
../kbl_data/2021-2022,S39G01N96,울산 현대모비스,Home,신민석,0,0,0,0.0,0,2,0.0,0,2,0.0,0,0,0.0,1,1,2,2,1,0,0,0,0,2
../kbl_data/2021-2022,S39G01N96,울산 현대모비스,Home,김동준,4,2,4,50.0,0,1,0.0,2,5,40.0,0,0,0.0,0,1,1,1,1,0,1,0,1,0
../kbl_data/2021-2022,S39G01N96,안양 KGC,Away,양희종,0,0,1,0.0,0,1,0.0,0,2,0.0,0,2,0.0,1,2,3,0,0,2,1,0,0,3
../kbl_data/2021-2022,S39G01N96,안양 KGC,Away,함준후,0,0,1,0.0,0,1,0.0,0,2,0.0,0,0,0.0,1,1,2,0,0,0,0,0,0,0
../kbl_data/2021-2022,S39G01N96,안양 KGC,Away,오세근,10,3,9,33.3,0,0,0.0,3,9,33.3,4,5,80.0,0,6,6,1,0,0,0,0,2,4
../kbl_data/2021-2022,S39G01N96,안양 KGC,Away,문성곤,0,0,2,0.0,0,2,0.0,0,4,0.0,0,0,0.0,1,1,2,3,2,1,0,0,0,2
../kbl_data/2021-2022,S39G01N96,안양 KGC,Away,전성현,8,1,3,33.3,2,8,25.0,3,11,27.3,0,0,0.0,0,1,1,2,0,0,0,0,1,1
../kbl_data/2021-2022,S39G01N96,안양 KGC,Away,박지훈,16,4,6,66.7,2,4,50.0,6,10,60.0,2,4,50.0,6,10,16,8,2,0,0,0,0,10
../kbl_data/2021-2022,S39G01N96,안양 KGC,Away,이우정,0,0,0,0.0,0,0,0.0,0,0,0.0,0,0,0.0,0,0,0,0,0,0,0,0,0,1
../kbl_data/2021-2022,S39G01N96,안양 KGC,Away,대릴 먼로,12,4,4,100.0,0,0,0.0,4,4,100.0,4,7,57.1,1,5,6,1,0,0,0,0,4,2
../kbl_data/2021-2022,S39G01N96,안양 KGC,Away,우동현,0,0,0,0.0,0,2,0.0,0,2,0.0,0,0,0.0,0,0,0,0,0,0,0,0,1,0
../kbl_data/2021-2022,S39G01N96,안양 KGC,Away,변준형,8,4,7,57.1,0,5,0.0,4,12,33.3,0,0,0.0,0,1,1,2,0,0,0,0,2,2
../kbl_data/2021-2022,S39G01N96,안양 KGC,Away,한승희,0,0,2,0.0,0,0,0.0,0,2,0.0,0,0,0.0,0,0,0,0,0,0,0,0,0,1
../kbl_data/2021-2022,S39G01N96,안양 KGC,Away,오마리 스펠맨,15,4,8,50.0,2,3,66.7,6,11,54.5,1,4,25.0,2,6,8,2,1,0,0,0,5,4
../kbl_data/2021-2022,S39G01N97,전주 KCC,Home,송창용,0,0,0,0.0,0,0,0.0,0,0,0.0,0,0,0.0,0,0,0,0,0,0,0,0,0,0
../kbl_data/2021-2022,S39G01N97,전주 KCC,Home,이정현,14,1,7,14.3,4,10,40.0,5,17,29.4,0,0,0.0,1,4,5,2,1,0,0,0,1,2
../kbl_data/2021-2022,S39G01N97,전주 KCC,Home,라건아,17,7,16,43.8,0,2,0.0,7,18,38.9,3,4,75.0,2,7,9,3,1,1,0,0,1,1
../kbl_data/2021-2022,S39G01N97,전주 KCC,Home,김상규,19,4,5,80.0,3,4,75.0,7,9,77.8,2,3,66.7,2,4,6,1,2,1,0,0,0,0
../kbl_data/2021-2022,S39G01N97,전주 KCC,Home,유병훈,5,0,1,0.0,1,2,50.0,1,3,33.3,2,2,100.0,0,3,3,1,2,0,0,0,0,3
../kbl_data/2021-2022,S39G01N97,전주 KCC,Home,박재현,6,2,2,100.0,0,1,0.0,2,3,66.7,2,2,100.0,0,1,1,2,0,0,1,0,0,1
../kbl_data/2021-2022,S39G01N97,전주 KCC,Home,이진욱,3,1,1,100.0,0,0,0.0,1,1,100.0,1,2,50.0,0,0,0,2,2,0,1,0,1,2
../kbl_data/2021-2022,S39G01N97,전주 KCC,Home,김진용,0,0,0,0.0,0,0,0.0,0,0,0.0,0,0,0.0,0,0,0,0,0,0,0,0,0,0
../kbl_data/2021-2022,S39G01N97,전주 KCC,Home,유현준,6,2,3,66.7,0,1,0.0,2,4,50.0,2,2,100.0,0,2,2,4,0,0,0,0,1,1
../kbl_data/2021-2022,S39G01N97,전주 KCC,Home,라타비우스 윌리엄스,4,2,3,66.7,0,0,0.0,2,3,66.7,0,0,0.0,1,1,2,1,0,0,0,0,0,3
../kbl_data/2021-2022,S39G01N97,전주 KCC,Home,곽정훈,2,1,2,50.0,0,0,0.0,1,2,50.0,0,0,0.0,0,1,1,0,0,0,0,0,0,2
../kbl_data/2021-2022,S39G01N97,전주 KCC,Home,이근휘,11,1,1,100.0,3,6,50.0,4,7,57.1,0,0,0.0,2,1,3,1,2,0,0,0,0,1
../kbl_data/2021-2022,S39G01N97,서울 삼성,Away,김동량,6,3,4,75.0,0,2,0.0,3,6,50.0,0,0,0.0,5,4,9,2,0,0,0,0,2,2
../kbl_data/2021-2022,S39G01N97,서울 삼성,Away,장민국,3,0,4,0.0,1,4,25.0,1,8,12.5,0,0,0.0,0,1,1,0,0,0,0,0,1,0
../kbl_data/2021-2022,S39G01N97,서울 삼성,Away,김시래,22,4,7,57.1,4,7,57.1,8,14,57.1,2,2,100.0,0,4,4,5,1,0,0,0,2,4
../kbl_data/2021-2022,S39G01N97,서울 삼성,Away,김현수,7,2,5,40.0,1,5,20.0,3,10,30.0,0,0,0.0,1,3,4,3,0,1,0,0,1,2
../kbl_data/2021-2022,S39G01N97,서울 삼성,Away,임동섭,12,0,2,0.0,4,8,50.0,4,10,40.0,0,0,0.0,1,4,5,4,0,0,0,0,1,3
../kbl_data/2021-2022,S39G01N97,서울 삼성,Away,배수용,0,0,0,0.0,0,0,0.0,0,0,0.0,0,0,0.0,1,0,1,0,0,0,0,0,0,0
../kbl_data/2021-2022,S39G01N97,서울 삼성,Away,이호현,2,1,2,50.0,0,0,0.0,1,2,50.0,0,0,0.0,0,0,0,0,0,0,0,0,2,0
../kbl_data/2021-2022,S39G01N97,서울 삼성,Away,차민석,0,0,1,0.0,0,0,0.0,0,1,0.0,0,0,0.0,1,1,2,0,0,0,0,0,0,0
../kbl_data/2021-2022,S39G01N97,서울 삼성,Away,전형준,0,0,0,0.0,0,1,0.0,0,1,0.0,0,0,0.0,0,1,1,0,0,0,0,0,1,1
../kbl_data/2021-2022,S39G01N97,서울 삼성,Away,다니엘 오셰푸,12,5,7,71.4,0,0,0.0,5,7,71.4,2,8,25.0,1,8,9,4,2,3,0,0,2,2
../kbl_data/2021-2022,S39G01N97,서울 삼성,Away,조우성,0,0,1,0.0,0,0,0.0,0,1,0.0,0,0,0.0,0,1,1,0,0,0,0,0,0,2
../kbl_data/2021-2022,S39G01N97,서울 삼성,Away,이원석,6,3,6,50.0,0,0,0.0,3,6,50.0,0,1,0.0,3,1,4,0,1,0,1,0,1,3
../kbl_data/2021-2022,S39G01N98,창원 LG,Home,강병현,8,1,2,50.0,2,3,66.7,3,5,60.0,0,0,0.0,0,2,2,0,0,0,0,0,0,1
../kbl_data/2021-2022,S39G01N98,창원 LG,Home,변기훈,5,1,2,50.0,1,4,25.0,2,6,33.3,0,0,0.0,1,1,2,2,1,0,0,0,0,2
../kbl_data/2021-2022,S39G01N98,창원 LG,Home,이관희,12,3,4,75.0,2,7,28.6,5,11,45.5,0,0,0.0,2,2,4,3,1,1,0,0,2,2
../kbl_data/2021-2022,S39G01N98,창원 LG,Home,정희재,10,3,6,50.0,1,2,50.0,4,8,50.0,1,1,100.0,0,3,3,0,1,0,0,0,2,3
../kbl_data/2021-2022,S39G01N98,창원 LG,Home,서민수,9,0,2,0.0,3,6,50.0,3,8,37.5,0,0,0.0,3,2,5,2,1,0,1,0,0,3
../kbl_data/2021-2022,S39G01N98,창원 LG,Home,이재도,18,7,9,77.8,1,7,14.3,8,16,50.0,1,1,100.0,1,0,1,8,0,0,0,0,1,2
../kbl_data/2021-2022,S39G01N98,창원 LG,Home,정해원,0,0,0,0.0,0,0,0.0,0,0,0.0,0,0,0.0,0,0,0,0,0,0,0,0,1,0
../kbl_data/2021-2022,S39G01N98,창원 LG,Home,박정현,0,0,0,0.0,0,0,0.0,0,0,0.0,0,0,0.0,0,0,0,0,0,0,0,0,1,2
../kbl_data/2021-2022,S39G01N98,창원 LG,Home,이광진,0,0,0,0.0,0,1,0.0,0,1,0.0,0,0,0.0,0,0,0,0,0,0,0,0,0,0
../kbl_data/2021-2022,S39G01N98,창원 LG,Home,압둘 말릭 아부,10,5,10,50.0,0,0,0.0,5,10,50.0,0,2,0.0,5,3,8,1,0,1,0,4,0,1
../kbl_data/2021-2022,S39G01N98,창원 LG,Home,아셈 마레이,11,4,6,66.7,0,0,0.0,4,6,66.7,3,4,75.0,3,7,10,2,1,0,0,0,3,0
../kbl_data/2021-2022,S39G01N98,창원 LG,Home,이승우,0,0,0,0.0,0,0,0.0,0,0,0.0,0,0,0.0,0,0,0,0,0,0,0,0,2,0
../kbl_data/2021-2022,S39G01N98,대구 한국가스공사,Away,정영삼,0,0,0,0.0,0,0,0.0,0,0,0.0,0,0,0.0,1,0,1,1,1,0,0,0,0,2
../kbl_data/2021-2022,S39G01N98,대구 한국가스공사,Away,차바위,4,2,2,100.0,0,1,0.0,2,3,66.7,0,0,0.0,1,0,1,4,0,0,0,0,0,3
../kbl_data/2021-2022,S39G01N98,대구 한국가스공사,Away,조상열,3,0,0,0.0,1,3,33.3,1,3,33.3,0,0,0.0,1,1,2,0,1,0,0,0,0,0
../kbl_data/2021-2022,S39G01N98,대구 한국가스공사,Away,이대헌,16,5,8,62.5,0,1,0.0,5,9,55.6,6,7,85.7,2,3,5,2,0,0,0,0,3,2
../kbl_data/2021-2022,S39G01N98,대구 한국가스공사,Away,두경민,13,5,8,62.5,0,5,0.0,5,13,38.5,3,4,75.0,1,3,4,4,1,0,0,0,1,4
../kbl_data/2021-2022,S39G01N98,대구 한국가스공사,Away,박봉진,0,0,0,0.0,0,0,0.0,0,0,0.0,0,0,0.0,0,0,0,0,0,0,0,0,0,0
../kbl_data/2021-2022,S39G01N98,대구 한국가스공사,Away,김낙현,5,1,2,50.0,1,3,33.3,2,5,40.0,0,0,0.0,0,1,1,1,0,0,0,0,0,1
../kbl_data/2021-2022,S39G01N98,대구 한국가스공사,Away,전현우,0,0,0,0.0,0,3,0.0,0,3,0.0,0,0,0.0,0,2,2,0,2,1,0,0,0,0
../kbl_data/2021-2022,S39G01N98,대구 한국가스공사,Away,이윤기,0,0,0,0.0,0,0,0.0,0,0,0.0,0,0,0.0,0,0,0,0,0,0,0,0,0,0
../kbl_data/2021-2022,S39G01N98,대구 한국가스공사,Away,클리프 알렉산더,2,1,1,100.0,0,0,0.0,1,1,100.0,0,0,0.0,0,5,5,0,0,0,0,1,1,2
../kbl_data/2021-2022,S39G01N98,대구 한국가스공사,Away,앤드류 니콜슨,39,12,16,75.0,4,11,36.4,16,27,59.3,3,4,75.0,1,5,6,1,0,2,0,0,4,3
../kbl_data/2021-2022,S39G01N98,대구 한국가스공사,Away,신승민,0,0,0,0.0,0,0,0.0,0,0,0.0,0,0,0.0,0,0,0,0,0,0,0,0,0,0
../kbl_data/2021-2022,S39G01N99,원주 DB,Home,윤호영,1,0,1,0.0,0,0,0.0,0,1,0.0,1,2,50.0,1,0,1,2,1,0,0,0,2,0
../kbl_data/2021-2022,S39G01N99,원주 DB,Home,박찬희,2,1,2,50.0,0,1,0.0,1,3,33.3,0,0,0.0,1,2,3,1,0,0,0,0,0,1
../kbl_data/2021-2022,S39G01N99,원주 DB,Home,김현호,9,2,4,50.0,1,2,50.0,3,6,50.0,2,2,100.0,0,1,1,2,1,0,0,0,0,0
../kbl_data/2021-2022,S39G01N99,원주 DB,Home,정준원,7,2,3,66.7,1,3,33.3,3,6,50.0,0,0,0.0,0,1,1,1,1,0,1,0,1,1
../kbl_data/2021-2022,S39G01N99,원주 DB,Home,박경상,12,0,0,0.0,3,4,75.0,3,4,75.0,3,4,75.0,1,1,2,2,0,0,0,0,1,2
../kbl_data/2021-2022,S39G01N99,원주 DB,Home,김종규,7,2,6,33.3,1,2,50.0,3,8,37.5,0,0,0.0,0,1,1,2,0,3,0,0,1,3
../kbl_data/2021-2022,S39G01N99,원주 DB,Home,허웅,4,2,6,33.3,0,5,0.0,2,11,18.2,0,2,0.0,1,1,2,3,0,0,0,0,2,1
../kbl_data/2021-2022,S39G01N99,원주 DB,Home,강상재,9,3,4,75.0,1,1,100.0,4,5,80.0,0,0,0.0,2,3,5,0,0,0,0,0,0,0
../kbl_data/2021-2022,S39G01N99,원주 DB,Home,박상권,0,0,0,0.0,0,0,0.0,0,0,0.0,0,0,0.0,0,1,1,0,0,0,0,0,0,0
../kbl_data/2021-2022,S39G01N99,원주 DB,Home,레나드 프리먼,13,4,8,50.0,0,0,0.0,4,8,50.0,5,7,71.4,4,9,13,0,2,0,0,1,2,2
../kbl_data/2021-2022,S39G01N99,원주 DB,Home,정호영,2,1,1,100.0,0,1,0.0,1,2,50.0,0,0,0.0,0,1,1,0,0,0,0,0,3,1
../kbl_data/2021-2022,S39G01N99,원주 DB,Home,조니 오브라이언트,9,1,8,12.5,1,5,20.0,2,13,15.4,4,4,100.0,3,4,7,2,1,1,0,1,4,0
../kbl_data/2021-2022,S39G01N99,수원 KT,Away,김동욱,9,3,3,100.0,1,2,50.0,4,5,80.0,0,0,0.0,0,2,2,4,1,0,0,0,0,1
../kbl_data/2021-2022,S39G01N99,수원 KT,Away,김영환,0,0,1,0.0,0,1,0.0,0,2,0.0,0,0,0.0,0,1,1,0,0,0,0,0,0,1
../kbl_data/2021-2022,S39G01N99,수원 KT,Away,김현민,5,1,2,50.0,1,1,100.0,2,3,66.7,0,0,0.0,1,1,2,0,2,0,0,0,0,3
../kbl_data/2021-2022,S39G01N99,수원 KT,Away,한희원,4,2,2,100.0,0,1,0.0,2,3,66.7,0,1,0.0,0,0,0,0,0,0,0,0,0,1
../kbl_data/2021-2022,S39G01N99,수원 KT,Away,정성우,9,0,1,0.0,3,7,42.9,3,8,37.5,0,0,0.0,4,4,8,5,1,0,1,0,0,4
../kbl_data/2021-2022,S39G01N99,수원 KT,Away,허훈,7,1,4,25.0,1,6,16.7,2,10,20.0,2,2,100.0,0,2,2,8,3,0,0,0,5,1
../kbl_data/2021-2022,S39G01N99,수원 KT,Away,양홍석,17,4,8,50.0,3,6,50.0,7,14,50.0,0,0,0.0,1,6,7,4,2,0,0,0,1,1
../kbl_data/2021-2022,S39G01N99,수원 KT,Away,캐디 라렌,20,10,16,62.5,0,1,0.0,10,17,58.8,0,0,0.0,3,7,10,1,0,2,0,1,1,3
../kbl_data/2021-2022,S39G01N99,수원 KT,Away,문상옥,0,0,1,0.0,0,0,0.0,0,1,0.0,0,0,0.0,0,1,1,0,0,0,0,0,0,1
../kbl_data/2021-2022,S39G01N99,수원 KT,Away,박지원,3,0,1,0.0,1,1,100.0,1,2,50.0,0,0,0.0,0,0,0,1,0,0,0,0,0,1
../kbl_data/2021-2022,S39G01N99,수원 KT,Away,마이크 마이어스,8,4,5,80.0,0,0,0.0,4,5,80.0,0,3,0.0,1,1,2,1,1,0,0,3,2,4
../kbl_data/2021-2022,S39G01N99,수원 KT,Away,하윤기,12,6,11,54.5,0,0,0.0,6,11,54.5,0,0,0.0,2,2,4,1,1,4,0,1,0,1
../kbl_data/2021-2022,S39G01N100,안양 KGC,Home,양희종,5,1,1,100.0,1,2,50.0,2,3,66.7,0,0,0.0,0,0,0,2,1,0,0,0,0,2
../kbl_data/2021-2022,S39G01N100,안양 KGC,Home,박형철,0,0,0,0.0,0,0,0.0,0,0,0.0,0,0,0.0,0,0,0,0,0,0,0,0,0,0
../kbl_data/2021-2022,S39G01N100,안양 KGC,Home,함준후,3,0,2,0.0,1,4,25.0,1,6,16.7,0,0,0.0,4,2,6,0,1,0,0,0,1,4
../kbl_data/2021-2022,S39G01N100,안양 KGC,Home,오세근,11,4,6,66.7,1,2,50.0,5,8,62.5,0,0,0.0,2,2,4,2,1,0,0,0,3,2
../kbl_data/2021-2022,S39G01N100,안양 KGC,Home,문성곤,14,4,6,66.7,2,3,66.7,6,9,66.7,0,1,0.0,0,0,0,3,0,0,0,0,0,4
../kbl_data/2021-2022,S39G01N100,안양 KGC,Home,전성현,17,4,5,80.0,3,6,50.0,7,11,63.6,0,0,0.0,1,3,4,4,3,0,0,0,0,1
../kbl_data/2021-2022,S39G01N100,안양 KGC,Home,박지훈,3,0,0,0.0,1,2,50.0,1,2,50.0,0,0,0.0,0,0,0,2,0,0,0,0,1,1
../kbl_data/2021-2022,S39G01N100,안양 KGC,Home,이우정,0,0,2,0.0,0,0,0.0,0,2,0.0,0,0,0.0,1,0,1,0,0,0,0,0,0,0
../kbl_data/2021-2022,S39G01N100,안양 KGC,Home,대릴 먼로,0,0,2,0.0,0,0,0.0,0,2,0.0,0,0,0.0,1,0,1,0,0,0,0,0,0,1
../kbl_data/2021-2022,S39G01N100,안양 KGC,Home,변준형,22,4,7,57.1,4,7,57.1,8,14,57.1,2,2,100.0,0,1,1,7,0,0,1,0,1,2
../kbl_data/2021-2022,S39G01N100,안양 KGC,Home,한승희,5,2,3,66.7,0,0,0.0,2,3,66.7,1,1,100.0,1,0,1,1,0,0,0,0,0,0
../kbl_data/2021-2022,S39G01N100,안양 KGC,Home,오마리 스펠맨,23,3,4,75.0,4,8,50.0,7,12,58.3,5,6,83.3,2,7,9,3,2,3,0,1,1,0
../kbl_data/2021-2022,S39G01N100,서울 삼성,Away,김동량,5,1,2,50.0,1,2,50.0,2,4,50.0,0,0,0.0,3,0,3,1,0,0,0,0,0,0
../kbl_data/2021-2022,S39G01N100,서울 삼성,Away,장민국,13,2,2,100.0,3,4,75.0,5,6,83.3,0,0,0.0,0,2,2,2,0,0,0,0,1,1
../kbl_data/2021-2022,S39G01N100,서울 삼성,Away,김시래,8,3,5,60.0,0,1,0.0,3,6,50.0,2,2,100.0,1,2,3,6,2,0,0,0,4,4
../kbl_data/2021-2022,S39G01N100,서울 삼성,Away,김현수,0,0,1,0.0,0,1,0.0,0,2,0.0,0,0,0.0,0,0,0,1,1,0,0,0,0,0
../kbl_data/2021-2022,S39G01N100,서울 삼성,Away,임동섭,9,2,4,50.0,1,5,20.0,3,9,33.3,2,2,100.0,0,0,0,2,1,0,0,0,1,2
../kbl_data/2021-2022,S39G01N100,서울 삼성,Away,배수용,0,0,0,0.0,0,1,0.0,0,1,0.0,0,0,0.0,0,2,2,2,0,0,0,0,0,0
../kbl_data/2021-2022,S39G01N100,서울 삼성,Away,이호현,2,1,2,50.0,0,0,0.0,1,2,50.0,0,0,0.0,0,1,1,0,0,0,0,0,2,2
../kbl_data/2021-2022,S39G01N100,서울 삼성,Away,강바일,5,1,2,50.0,1,1,100.0,2,3,66.7,0,0,0.0,0,0,0,0,0,0,0,0,1,2
../kbl_data/2021-2022,S39G01N100,서울 삼성,Away,차민석,11,4,5,80.0,0,0,0.0,4,5,80.0,3,3,100.0,2,1,3,1,0,0,1,0,1,1
../kbl_data/2021-2022,S39G01N100,서울 삼성,Away,전형준,0,0,0,0.0,0,1,0.0,0,1,0.0,0,0,0.0,0,0,0,0,0,0,0,0,0,2
../kbl_data/2021-2022,S39G01N100,서울 삼성,Away,다니엘 오셰푸,14,7,16,43.8,0,0,0.0,7,16,43.8,0,0,0.0,5,8,13,3,0,2,0,1,3,1
../kbl_data/2021-2022,S39G01N100,서울 삼성,Away,이원석,13,6,12,50.0,0,1,0.0,6,13,46.2,1,1,100.0,5,4,9,0,0,1,0,0,2,3
../kbl_data/2021-2022,S39G01N101,서울 SK,Home,양우섭,0,0,0,0.0,0,0,0.0,0,0,0.0,0,0,0.0,0,0,0,0,0,0,0,0,0,0
../kbl_data/2021-2022,S39G01N101,서울 SK,Home,허일영,3,0,3,0.0,0,1,0.0,0,4,0.0,3,4,75.0,0,0,0,0,2,1,0,0,0,3
../kbl_data/2021-2022,S39G01N101,서울 SK,Home,김선형,13,1,3,33.3,3,4,75.0,4,7,57.1,2,2,100.0,1,1,2,9,4,1,1,0,1,3
../kbl_data/2021-2022,S39G01N101,서울 SK,Home,최부경,14,5,8,62.5,0,0,0.0,5,8,62.5,4,4,100.0,1,2,3,1,0,0,0,0,0,1
../kbl_data/2021-2022,S39G01N101,서울 SK,Home,리온 윌리엄스,0,0,0,0.0,0,0,0.0,0,0,0.0,0,0,0.0,0,2,2,0,0,0,0,0,0,2
../kbl_data/2021-2022,S39G01N101,서울 SK,Home,배병준,0,0,0,0.0,0,0,0.0,0,0,0.0,0,0,0.0,0,0,0,0,0,0,0,0,0,0
../kbl_data/2021-2022,S39G01N101,서울 SK,Home,이현석,0,0,1,0.0,0,0,0.0,0,1,0.0,0,0,0.0,0,1,1,0,0,0,0,0,0,0
../kbl_data/2021-2022,S39G01N101,서울 SK,Home,최원혁,0,0,0,0.0,0,1,0.0,0,1,0.0,0,0,0.0,2,2,4,1,0,0,0,0,1,2
../kbl_data/2021-2022,S39G01N101,서울 SK,Home,최준용,7,0,1,0.0,2,8,25.0,2,9,22.2,1,2,50.0,1,0,1,2,2,2,0,0,1,4
../kbl_data/2021-2022,S39G01N101,서울 SK,Home,안영준,20,9,13,69.2,0,1,0.0,9,14,64.3,2,3,66.7,1,4,5,4,3,0,1,0,1,3
../kbl_data/2021-2022,S39G01N101,서울 SK,Home,자밀 워니,29,13,26,50.0,0,2,0.0,13,28,46.4,3,5,60.0,4,8,12,2,1,1,0,2,0,0
../kbl_data/2021-2022,S39G01N101,서울 SK,Home,오재현,2,1,1,100.0,0,0,0.0,1,1,100.0,0,0,0.0,0,0,0,0,0,0,0,0,1,2
../kbl_data/2021-2022,S39G01N101,울산 현대모비스,Away,이현민,7,1,4,25.0,1,1,100.0,2,5,40.0,2,2,100.0,0,3,3,1,0,0,0,0,1,2
../kbl_data/2021-2022,S39G01N101,울산 현대모비스,Away,함지훈,7,2,7,28.6,0,0,0.0,2,7,28.6,3,4,75.0,2,2,4,6,2,0,0,0,0,1
../kbl_data/2021-2022,S39G01N101,울산 현대모비스,Away,최진수,0,0,0,0.0,0,0,0.0,0,0,0.0,0,0,0.0,0,1,1,0,0,0,0,0,1,0
../kbl_data/2021-2022,S39G01N101,울산 현대모비스,Away,박지훈,3,0,0,0.0,1,1,100.0,1,1,100.0,0,0,0.0,0,1,1,0,1,0,1,0,2,0
../kbl_data/2021-2022,S39G01N101,울산 현대모비스,Away,장재석,2,1,3,33.3,0,0,0.0,1,3,33.3,0,0,0.0,1,0,1,1,0,0,0,0,0,2
../kbl_data/2021-2022,S39G01N101,울산 현대모비스,Away,김국찬,12,0,0,0.0,4,8,50.0,4,8,50.0,0,0,0.0,2,2,4,0,0,0,0,0,4,5
../kbl_data/2021-2022,S39G01N101,울산 현대모비스,Away,서명진,13,2,5,40.0,3,4,75.0,5,9,55.6,0,0,0.0,1,2,3,4,0,0,0,0,0,3
../kbl_data/2021-2022,S39G01N101,울산 현대모비스,Away,얼 클락,3,1,2,50.0,0,1,0.0,1,3,33.3,1,2,50.0,1,3,4,0,0,0,0,0,3,3
../kbl_data/2021-2022,S39G01N101,울산 현대모비스,Away,이우석,6,3,4,75.0,0,1,0.0,3,5,60.0,0,0,0.0,2,3,5,2,0,0,0,0,1,2
../kbl_data/2021-2022,S39G01N101,울산 현대모비스,Away,라숀 토마스,17,8,19,42.1,0,0,0.0,8,19,42.1,1,4,25.0,3,9,12,3,0,1,0,1,4,1
../kbl_data/2021-2022,S39G01N101,울산 현대모비스,Away,신민석,5,2,2,100.0,0,1,0.0,2,3,66.7,1,2,50.0,0,2,2,1,0,1,0,0,1,0
../kbl_data/2021-2022,S39G01N101,울산 현대모비스,Away,김동준,2,0,0,0.0,0,0,0.0,0,0,0.0,2,2,100.0,0,0,0,2,0,0,0,0,0,0
../kbl_data/2021-2022,S39G01N102,고양 오리온,Home,김강선,7,1,1,100.0,1,5,20.0,2,6,33.3,2,2,100.0,1,0,1,1,1,0,0,0,3,1
../kbl_data/2021-2022,S39G01N102,고양 오리온,Home,최현민,15,3,5,60.0,3,7,42.9,6,12,50.0,0,1,0.0,4,3,7,4,0,0,0,0,1,2
../kbl_data/2021-2022,S39G01N102,고양 오리온,Home,이대성,26,4,6,66.7,4,9,44.4,8,15,53.3,6,8,75.0,1,2,3,6,2,0,0,0,2,1
../kbl_data/2021-2022,S39G01N102,고양 오리온,Home,이정제,0,0,0,0.0,0,0,0.0,0,0,0.0,0,0,0.0,0,0,0,0,0,0,0,0,0,0
../kbl_data/2021-2022,S39G01N102,고양 오리온,Home,최승욱,2,0,1,0.0,0,0,0.0,0,1,0.0,2,2,100.0,0,2,2,1,0,0,0,0,1,2
../kbl_data/2021-2022,S39G01N102,고양 오리온,Home,이승현,12,6,12,50.0,0,2,0.0,6,14,42.9,0,0,0.0,4,5,9,1,0,0,0,0,3,3
../kbl_data/2021-2022,S39G01N102,고양 오리온,Home,김진유,2,1,1,100.0,0,0,0.0,1,1,100.0,0,0,0.0,1,0,1,0,0,0,0,0,0,0
../kbl_data/2021-2022,S39G01N102,고양 오리온,Home,머피 할로웨이,12,6,11,54.5,0,0,0.0,6,11,54.5,0,0,0.0,3,10,13,5,7,1,0,2,2,1
../kbl_data/2021-2022,S39G01N102,고양 오리온,Home,조한진,0,0,0,0.0,0,0,0.0,0,0,0.0,0,0,0.0,0,0,0,0,0,0,0,0,0,0
../kbl_data/2021-2022,S39G01N102,고양 오리온,Home,김세창,0,0,0,0.0,0,0,0.0,0,0,0.0,0,0,0.0,0,0,0,0,0,0,0,0,2,0
../kbl_data/2021-2022,S39G01N102,고양 오리온,Home,미로슬라브 라둘리차,2,1,3,33.3,0,1,0.0,1,4,25.0,0,0,0.0,0,0,0,2,0,0,0,0,1,3
../kbl_data/2021-2022,S39G01N102,고양 오리온,Home,이정현,54,12,22,54.5,8,32,25.0,20,54,37.0,6,8,75.0,0,16,16,20,0,2,0,0,6,12
../kbl_data/2021-2022,S39G01N102,전주 KCC,Away,송창용,0,0,0,0.0,0,0,0.0,0,0,0.0,0,0,0.0,0,2,2,0,0,0,0,0,0,1
../kbl_data/2021-2022,S39G01N102,전주 KCC,Away,이정현,54,12,22,54.5,8,32,25.0,20,54,37.0,6,8,75.0,0,16,16,20,0,2,0,0,6,12
../kbl_data/2021-2022,S39G01N102,전주 KCC,Away,정창영,5,1,1,100.0,1,2,50.0,2,3,66.7,0,0,0.0,0,3,3,2,1,1,0,0,1,0
../kbl_data/2021-2022,S39G01N102,전주 KCC,Away,라건아,32,14,17,82.4,1,1,100.0,15,18,83.3,1,2,50.0,3,8,11,3,2,1,0,1,1,1
../kbl_data/2021-2022,S39G01N102,전주 KCC,Away,김상규,18,1,4,25.0,4,6,66.7,5,10,50.0,4,6,66.7,1,5,6,1,2,0,0,0,1,3
../kbl_data/2021-2022,S39G01N102,전주 KCC,Away,유병훈,6,3,4,75.0,0,2,0.0,3,6,50.0,0,0,0.0,0,0,0,2,1,0,0,0,1,3
../kbl_data/2021-2022,S39G01N102,전주 KCC,Away,박재현,0,0,0,0.0,0,0,0.0,0,0,0.0,0,0,0.0,0,0,0,3,0,0,0,0,2,2
../kbl_data/2021-2022,S39G01N102,전주 KCC,Away,이진욱,0,0,0,0.0,0,0,0.0,0,0,0.0,0,0,0.0,0,0,0,0,0,0,0,0,0,0
../kbl_data/2021-2022,S39G01N102,전주 KCC,Away,유현준,4,1,6,16.7,0,1,0.0,1,7,14.3,2,2,100.0,0,2,2,3,3,0,1,0,3,3
../kbl_data/2021-2022,S39G01N102,전주 KCC,Away,라타비우스 윌리엄스,3,1,2,50.0,0,0,0.0,1,2,50.0,1,2,50.0,2,2,4,0,0,0,0,1,0,0
../kbl_data/2021-2022,S39G01N102,전주 KCC,Away,곽정훈,0,0,0,0.0,0,0,0.0,0,0,0.0,0,0,0.0,0,0,0,0,0,0,0,0,0,0
../kbl_data/2021-2022,S39G01N102,전주 KCC,Away,이근휘,6,0,0,0.0,2,3,66.7,2,3,66.7,0,0,0.0,0,3,3,2,1,0,0,0,0,2
../kbl_data/2021-2022,S39G01N103,창원 LG,Home,강병현,0,0,0,0.0,0,1,0.0,0,1,0.0,0,0,0.0,0,0,0,0,0,0,0,0,0,2
../kbl_data/2021-2022,S39G01N103,창원 LG,Home,변기훈,7,1,1,100.0,1,3,33.3,2,4,50.0,2,2,100.0,1,0,1,0,1,0,0,0,1,1
../kbl_data/2021-2022,S39G01N103,창원 LG,Home,이관희,19,5,10,50.0,3,8,37.5,8,18,44.4,0,0,0.0,2,1,3,2,0,0,0,0,2,1
../kbl_data/2021-2022,S39G01N103,창원 LG,Home,정희재,4,1,3,33.3,0,1,0.0,1,4,25.0,2,3,66.7,1,3,4,2,0,0,0,0,1,2
../kbl_data/2021-2022,S39G01N103,창원 LG,Home,서민수,3,1,2,50.0,0,3,0.0,1,5,20.0,1,2,50.0,2,0,2,3,0,0,0,0,0,3
../kbl_data/2021-2022,S39G01N103,창원 LG,Home,한상혁,3,0,1,0.0,1,1,100.0,1,2,50.0,0,0,0.0,0,1,1,0,0,0,0,0,0,1
../kbl_data/2021-2022,S39G01N103,창원 LG,Home,이재도,8,1,4,25.0,1,2,50.0,2,6,33.3,3,3,100.0,0,5,5,2,2,0,1,0,2,0
../kbl_data/2021-2022,S39G01N103,창원 LG,Home,정해원,0,0,0,0.0,0,1,0.0,0,1,0.0,0,0,0.0,1,0,1,0,0,0,0,0,0,0
../kbl_data/2021-2022,S39G01N103,창원 LG,Home,박정현,2,1,2,50.0,0,0,0.0,1,2,50.0,0,0,0.0,1,0,1,2,0,0,0,0,1,3
../kbl_data/2021-2022,S39G01N103,창원 LG,Home,이광진,0,0,0,0.0,0,0,0.0,0,0,0.0,0,0,0.0,0,0,0,0,0,0,0,0,0,0
../kbl_data/2021-2022,S39G01N103,창원 LG,Home,압둘 말릭 아부,12,4,7,57.1,1,1,100.0,5,8,62.5,1,3,33.3,2,3,5,0,2,1,0,2,3,2
../kbl_data/2021-2022,S39G01N103,창원 LG,Home,아셈 마레이,15,7,18,38.9,0,0,0.0,7,18,38.9,1,2,50.0,6,3,9,1,1,1,0,0,0,4
../kbl_data/2021-2022,S39G01N103,수원 KT,Away,김동욱,8,1,1,100.0,2,6,33.3,3,7,42.9,0,0,0.0,0,2,2,2,1,0,0,0,1,0
../kbl_data/2021-2022,S39G01N103,수원 KT,Away,김영환,12,3,5,60.0,2,4,50.0,5,9,55.6,0,0,0.0,1,1,2,0,0,0,0,0,0,3
../kbl_data/2021-2022,S39G01N103,수원 KT,Away,김현민,3,1,2,50.0,0,0,0.0,1,2,50.0,1,2,50.0,1,1,2,0,2,0,0,0,1,1
../kbl_data/2021-2022,S39G01N103,수원 KT,Away,한희원,0,0,0,0.0,0,0,0.0,0,0,0.0,0,0,0.0,1,1,2,1,1,0,0,0,0,1
../kbl_data/2021-2022,S39G01N103,수원 KT,Away,정성우,6,2,2,100.0,0,2,0.0,2,4,50.0,2,2,100.0,0,0,0,2,0,0,0,0,2,1
../kbl_data/2021-2022,S39G01N103,수원 KT,Away,허훈,20,6,12,50.0,2,5,40.0,8,17,47.1,2,2,100.0,1,2,3,1,1,0,1,0,4,2
../kbl_data/2021-2022,S39G01N103,수원 KT,Away,양홍석,9,1,3,33.3,2,5,40.0,3,8,37.5,1,2,50.0,1,2,3,3,1,1,0,0,2,2
../kbl_data/2021-2022,S39G01N103,수원 KT,Away,캐디 라렌,13,3,6,50.0,1,1,100.0,4,7,57.1,4,6,66.7,4,10,14,1,1,1,0,0,3,3
../kbl_data/2021-2022,S39G01N103,수원 KT,Away,문상옥,0,0,0,0.0,0,0,0.0,0,0,0.0,0,0,0.0,0,0,0,0,0,0,0,0,0,0
../kbl_data/2021-2022,S39G01N103,수원 KT,Away,박지원,0,0,0,0.0,0,1,0.0,0,1,0.0,0,0,0.0,0,0,0,0,0,0,0,0,0,1
../kbl_data/2021-2022,S39G01N103,수원 KT,Away,마이크 마이어스,4,1,2,50.0,0,0,0.0,1,2,50.0,2,2,100.0,1,7,8,0,1,0,0,0,1,3
../kbl_data/2021-2022,S39G01N103,수원 KT,Away,하윤기,0,0,0,0.0,0,0,0.0,0,0,0.0,0,0,0.0,1,0,1,0,0,0,0,0,0,0
../kbl_data/2021-2022,S39G01N104,대구 한국가스공사,Home,정영삼,0,0,1,0.0,0,0,0.0,0,1,0.0,0,0,0.0,1,0,1,0,0,0,0,0,0,1
../kbl_data/2021-2022,S39G01N104,대구 한국가스공사,Home,차바위,3,0,1,0.0,1,2,50.0,1,3,33.3,0,0,0.0,0,1,1,0,0,0,0,0,0,0
../kbl_data/2021-2022,S39G01N104,대구 한국가스공사,Home,조상열,3,0,2,0.0,1,1,100.0,1,3,33.3,0,0,0.0,0,0,0,1,0,0,0,0,1,5
../kbl_data/2021-2022,S39G01N104,대구 한국가스공사,Home,이대헌,8,4,7,57.1,0,1,0.0,4,8,50.0,0,1,0.0,0,2,2,3,2,0,0,1,3,3
../kbl_data/2021-2022,S39G01N104,대구 한국가스공사,Home,두경민,20,2,4,50.0,4,6,66.7,6,10,60.0,4,6,66.7,0,1,1,3,2,0,0,0,3,3
../kbl_data/2021-2022,S39G01N104,대구 한국가스공사,Home,박봉진,0,0,1,0.0,0,1,0.0,0,2,0.0,0,0,0.0,0,1,1,1,0,0,0,0,0,1
../kbl_data/2021-2022,S39G01N104,대구 한국가스공사,Home,김낙현,15,4,6,66.7,2,6,33.3,6,12,50.0,1,1,100.0,0,0,0,8,1,0,0,0,0,3
../kbl_data/2021-2022,S39G01N104,대구 한국가스공사,Home,전현우,6,0,0,0.0,2,4,50.0,2,4,50.0,0,0,0.0,1,3,4,0,0,0,0,0,1,1
../kbl_data/2021-2022,S39G01N104,대구 한국가스공사,Home,이윤기,0,0,0,0.0,0,0,0.0,0,0,0.0,0,0,0.0,0,1,1,0,0,0,0,0,0,0
../kbl_data/2021-2022,S39G01N104,대구 한국가스공사,Home,클리프 알렉산더,8,3,3,100.0,0,0,0.0,3,3,100.0,2,3,66.7,0,5,5,0,0,0,0,2,0,0
../kbl_data/2021-2022,S39G01N104,대구 한국가스공사,Home,앤드류 니콜슨,29,10,17,58.8,3,4,75.0,13,21,61.9,0,0,0.0,0,10,10,1,1,0,0,1,3,2
../kbl_data/2021-2022,S39G01N104,대구 한국가스공사,Home,신승민,0,0,0,0.0,0,0,0.0,0,0,0.0,0,0,0.0,0,1,1,0,0,0,0,0,1,2
../kbl_data/2021-2022,S39G01N104,원주 DB,Away,윤호영,0,0,0,0.0,0,0,0.0,0,0,0.0,0,0,0.0,0,0,0,0,0,0,0,0,0,1
../kbl_data/2021-2022,S39G01N104,원주 DB,Away,박찬희,0,0,5,0.0,0,2,0.0,0,7,0.0,0,0,0.0,0,0,0,2,0,1,0,0,2,3
../kbl_data/2021-2022,S39G01N104,원주 DB,Away,김현호,14,1,2,50.0,4,6,66.7,5,8,62.5,0,0,0.0,1,0,1,1,0,0,0,0,2,0
../kbl_data/2021-2022,S39G01N104,원주 DB,Away,정준원,2,1,1,100.0,0,0,0.0,1,1,100.0,0,0,0.0,1,0,1,0,0,0,0,0,0,0
../kbl_data/2021-2022,S39G01N104,원주 DB,Away,박경상,0,0,0,0.0,0,2,0.0,0,2,0.0,0,0,0.0,0,1,1,3,1,0,0,0,0,1
../kbl_data/2021-2022,S39G01N104,원주 DB,Away,김종규,8,3,7,42.9,0,0,0.0,3,7,42.9,2,2,100.0,4,5,9,3,2,0,0,0,3,3
../kbl_data/2021-2022,S39G01N104,원주 DB,Away,허웅,19,2,3,66.7,3,8,37.5,5,11,45.5,6,7,85.7,0,4,4,6,0,0,0,0,2,1
../kbl_data/2021-2022,S39G01N104,원주 DB,Away,김영훈,3,0,0,0.0,1,4,25.0,1,4,25.0,0,0,0.0,1,1,2,0,0,0,2,0,0,1
../kbl_data/2021-2022,S39G01N104,원주 DB,Away,강상재,15,5,11,45.5,1,1,100.0,6,12,50.0,2,2,100.0,2,4,6,1,2,0,0,0,1,3
../kbl_data/2021-2022,S39G01N104,원주 DB,Away,레나드 프리먼,12,4,7,57.1,0,0,0.0,4,7,57.1,4,4,100.0,2,4,6,2,1,0,0,1,1,1
../kbl_data/2021-2022,S39G01N104,원주 DB,Away,정호영,0,0,0,0.0,0,1,0.0,0,1,0.0,0,0,0.0,0,0,0,1,1,0,0,0,0,1
../kbl_data/2021-2022,S39G01N104,원주 DB,Away,조니 오브라이언트,7,2,7,28.6,0,4,0.0,2,11,18.2,3,4,75.0,3,7,10,2,0,0,0,0,1,3
../kbl_data/2021-2022,S39G01N105,수원 KT,Home,김동욱,5,1,2,50.0,1,2,50.0,2,4,50.0,0,0,0.0,0,0,0,3,1,0,0,0,0,1
../kbl_data/2021-2022,S39G01N105,수원 KT,Home,김영환,11,1,3,33.3,3,3,100.0,4,6,66.7,0,0,0.0,1,1,2,1,0,0,0,0,1,1
../kbl_data/2021-2022,S39G01N105,수원 KT,Home,김현민,5,1,2,50.0,1,3,33.3,2,5,40.0,0,0,0.0,0,0,0,0,0,0,0,0,1,2
../kbl_data/2021-2022,S39G01N105,수원 KT,Home,한희원,4,0,1,0.0,1,3,33.3,1,4,25.0,1,2,50.0,1,1,2,2,0,0,0,0,0,1
../kbl_data/2021-2022,S39G01N105,수원 KT,Home,정성우,11,1,2,50.0,3,5,60.0,4,7,57.1,0,0,0.0,0,2,2,8,0,0,0,0,0,2
../kbl_data/2021-2022,S39G01N105,수원 KT,Home,허훈,13,2,5,40.0,3,5,60.0,5,10,50.0,0,0,0.0,0,1,1,2,4,0,0,0,2,1
../kbl_data/2021-2022,S39G01N105,수원 KT,Home,양홍석,3,0,2,0.0,1,6,16.7,1,8,12.5,0,0,0.0,1,1,2,2,0,0,0,0,2,1
../kbl_data/2021-2022,S39G01N105,수원 KT,Home,캐디 라렌,10,3,5,60.0,0,0,0.0,3,5,60.0,4,6,66.7,7,8,15,1,0,1,0,0,0,4
../kbl_data/2021-2022,S39G01N105,수원 KT,Home,문상옥,5,1,2,50.0,1,2,50.0,2,4,50.0,0,0,0.0,1,1,2,0,1,0,0,0,0,0
../kbl_data/2021-2022,S39G01N105,수원 KT,Home,박지원,2,1,1,100.0,0,1,0.0,1,2,50.0,0,0,0.0,0,1,1,0,0,0,1,0,0,1
../kbl_data/2021-2022,S39G01N105,수원 KT,Home,마이크 마이어스,2,1,1,100.0,0,0,0.0,1,1,100.0,0,0,0.0,1,5,6,0,1,0,0,1,3,5
../kbl_data/2021-2022,S39G01N105,수원 KT,Home,하윤기,13,5,9,55.6,0,0,0.0,5,9,55.6,3,5,60.0,2,2,4,0,0,0,0,1,3,0
../kbl_data/2021-2022,S39G01N105,서울 삼성,Away,김동량,12,3,5,60.0,2,4,50.0,5,9,55.6,0,0,0.0,1,4,5,0,0,0,0,0,3,3
../kbl_data/2021-2022,S39G01N105,서울 삼성,Away,장민국,4,2,2,100.0,0,4,0.0,2,6,33.3,0,0,0.0,0,5,5,2,1,0,0,0,1,2
../kbl_data/2021-2022,S39G01N105,서울 삼성,Away,김시래,4,1,7,14.3,0,2,0.0,1,9,11.1,2,2,100.0,1,0,1,7,1,0,0,0,4,0
../kbl_data/2021-2022,S39G01N105,서울 삼성,Away,김현수,5,1,2,50.0,1,2,50.0,2,4,50.0,0,0,0.0,1,0,1,3,0,1,0,0,1,2
../kbl_data/2021-2022,S39G01N105,서울 삼성,Away,임동섭,5,1,3,33.3,1,5,20.0,2,8,25.0,0,0,0.0,1,2,3,1,2,0,0,0,1,3
../kbl_data/2021-2022,S39G01N105,서울 삼성,Away,배수용,2,1,1,100.0,0,1,0.0,1,2,50.0,0,0,0.0,0,1,1,0,1,0,0,0,0,1
../kbl_data/2021-2022,S39G01N105,서울 삼성,Away,이호현,0,0,1,0.0,0,1,0.0,0,2,0.0,0,0,0.0,0,1,1,0,0,0,0,0,1,0
../kbl_data/2021-2022,S39G01N105,서울 삼성,Away,강바일,0,0,0,0.0,0,0,0.0,0,0,0.0,0,0,0.0,0,0,0,0,0,0,0,0,0,0
../kbl_data/2021-2022,S39G01N105,서울 삼성,Away,차민석,5,2,5,40.0,0,1,0.0,2,6,33.3,1,2,50.0,0,0,0,1,0,0,0,0,2,1
../kbl_data/2021-2022,S39G01N105,서울 삼성,Away,전형준,1,0,1,0.0,0,1,0.0,0,2,0.0,1,2,50.0,0,0,0,0,0,0,0,0,0,0
../kbl_data/2021-2022,S39G01N105,서울 삼성,Away,조우성,4,1,1,100.0,0,0,0.0,1,1,100.0,2,2,100.0,1,2,3,0,0,1,0,0,0,2
../kbl_data/2021-2022,S39G01N105,서울 삼성,Away,이원석,17,6,10,60.0,0,0,0.0,6,10,60.0,5,9,55.6,6,5,11,1,3,3,0,0,1,4
../kbl_data/2021-2022,S39G01N106,전주 KCC,Home,송창용,0,0,2,0.0,0,1,0.0,0,3,0.0,0,0,0.0,0,0,0,0,0,0,0,0,0,1
../kbl_data/2021-2022,S39G01N106,전주 KCC,Home,이정현,10,2,6,33.3,1,6,16.7,3,12,25.0,3,4,75.0,0,2,2,3,1,0,0,0,4,3
../kbl_data/2021-2022,S39G01N106,전주 KCC,Home,정창영,11,3,7,42.9,1,2,50.0,4,9,44.4,2,2,100.0,1,6,7,3,2,0,0,0,3,3
../kbl_data/2021-2022,S39G01N106,전주 KCC,Home,라건아,15,5,10,50.0,0,2,0.0,5,12,41.7,5,6,83.3,3,10,13,3,1,0,0,1,1,1
../kbl_data/2021-2022,S39G01N106,전주 KCC,Home,김상규,4,1,2,50.0,0,2,0.0,1,4,25.0,2,2,100.0,3,2,5,2,0,0,0,0,2,0
../kbl_data/2021-2022,S39G01N106,전주 KCC,Home,유병훈,0,0,1,0.0,0,0,0.0,0,1,0.0,0,0,0.0,0,0,0,0,0,0,0,0,0,1
../kbl_data/2021-2022,S39G01N106,전주 KCC,Home,박재현,2,1,1,100.0,0,0,0.0,1,1,100.0,0,0,0.0,0,1,1,0,0,0,1,0,1,1
../kbl_data/2021-2022,S39G01N106,전주 KCC,Home,이진욱,3,0,0,0.0,1,3,33.3,1,3,33.3,0,0,0.0,1,1,2,3,1,0,0,0,1,3
../kbl_data/2021-2022,S39G01N106,전주 KCC,Home,유현준,0,0,1,0.0,0,1,0.0,0,2,0.0,0,0,0.0,0,1,1,0,0,0,0,0,1,0
../kbl_data/2021-2022,S39G01N106,전주 KCC,Home,라타비우스 윌리엄스,4,2,4,50.0,0,0,0.0,2,4,50.0,0,0,0.0,3,0,3,0,0,0,0,1,0,1
../kbl_data/2021-2022,S39G01N106,전주 KCC,Home,곽정훈,0,0,0,0.0,0,0,0.0,0,0,0.0,0,0,0.0,0,0,0,0,0,0,0,0,0,0
../kbl_data/2021-2022,S39G01N106,전주 KCC,Home,이근휘,13,2,2,100.0,3,4,75.0,5,6,83.3,0,0,0.0,1,1,2,0,1,0,0,0,1,1
../kbl_data/2021-2022,S39G01N106,창원 LG,Away,강병현,0,0,0,0.0,0,1,0.0,0,1,0.0,0,0,0.0,1,0,1,1,0,0,0,0,0,1
../kbl_data/2021-2022,S39G01N106,창원 LG,Away,변기훈,9,0,0,0.0,3,7,42.9,3,7,42.9,0,0,0.0,0,1,1,0,0,0,0,0,1,4
../kbl_data/2021-2022,S39G01N106,창원 LG,Away,이관희,6,3,5,60.0,0,9,0.0,3,14,21.4,0,0,0.0,0,2,2,4,1,0,0,0,1,0
../kbl_data/2021-2022,S39G01N106,창원 LG,Away,정희재,8,4,4,100.0,0,3,0.0,4,7,57.1,0,0,0.0,0,2,2,0,0,0,0,0,0,4
../kbl_data/2021-2022,S39G01N106,창원 LG,Away,서민수,10,2,5,40.0,2,4,50.0,4,9,44.4,0,0,0.0,3,0,3,1,0,0,0,0,0,2
../kbl_data/2021-2022,S39G01N106,창원 LG,Away,한상혁,0,0,0,0.0,0,1,0.0,0,1,0.0,0,0,0.0,0,0,0,1,1,0,0,0,0,0
../kbl_data/2021-2022,S39G01N106,창원 LG,Away,이재도,14,4,7,57.1,2,3,66.7,6,10,60.0,0,0,0.0,2,4,6,6,2,1,0,0,2,2
../kbl_data/2021-2022,S39G01N106,창원 LG,Away,박인태,0,0,1,0.0,0,0,0.0,0,1,0.0,0,0,0.0,0,1,1,0,0,0,0,0,0,0
../kbl_data/2021-2022,S39G01N106,창원 LG,Away,정해원,0,0,0,0.0,0,0,0.0,0,0,0.0,0,0,0.0,0,0,0,0,0,0,0,0,0,0
../kbl_data/2021-2022,S39G01N106,창원 LG,Away,이광진,3,0,0,0.0,1,1,100.0,1,1,100.0,0,0,0.0,0,2,2,0,0,0,0,0,0,0
../kbl_data/2021-2022,S39G01N106,창원 LG,Away,압둘 말릭 아부,4,2,4,50.0,0,1,0.0,2,5,40.0,0,0,0.0,1,3,4,0,0,1,0,0,0,2
../kbl_data/2021-2022,S39G01N106,창원 LG,Away,아셈 마레이,15,6,11,54.5,0,0,0.0,6,11,54.5,3,5,60.0,5,7,12,2,4,0,0,1,4,4
../kbl_data/2021-2022,S39G01N107,서울 SK,Home,허일영,8,1,2,50.0,1,3,33.3,2,5,40.0,3,3,100.0,1,1,2,0,2,0,0,0,0,2
../kbl_data/2021-2022,S39G01N107,서울 SK,Home,김선형,11,3,7,42.9,1,2,50.0,4,9,44.4,2,2,100.0,0,1,1,5,2,0,0,0,2,2
../kbl_data/2021-2022,S39G01N107,서울 SK,Home,최부경,5,1,3,33.3,0,0,0.0,1,3,33.3,3,4,75.0,0,0,0,0,3,0,0,0,1,2
../kbl_data/2021-2022,S39G01N107,서울 SK,Home,김승원,0,0,0,0.0,0,0,0.0,0,0,0.0,0,0,0.0,0,0,0,0,0,0,0,0,0,0
../kbl_data/2021-2022,S39G01N107,서울 SK,Home,리온 윌리엄스,2,1,1,100.0,0,0,0.0,1,1,100.0,0,0,0.0,0,0,0,0,0,0,0,0,1,2
../kbl_data/2021-2022,S39G01N107,서울 SK,Home,배병준,0,0,0,0.0,0,0,0.0,0,0,0.0,0,0,0.0,0,0,0,0,0,0,0,0,0,0
../kbl_data/2021-2022,S39G01N107,서울 SK,Home,이현석,0,0,0,0.0,0,1,0.0,0,1,0.0,0,0,0.0,0,0,0,0,0,0,0,0,0,1
../kbl_data/2021-2022,S39G01N107,서울 SK,Home,최원혁,0,0,0,0.0,0,0,0.0,0,0,0.0,0,0,0.0,0,2,2,2,1,0,0,0,1,2
../kbl_data/2021-2022,S39G01N107,서울 SK,Home,최준용,23,5,7,71.4,3,7,42.9,8,14,57.1,4,6,66.7,0,4,4,1,1,0,0,1,1,2
../kbl_data/2021-2022,S39G01N107,서울 SK,Home,안영준,21,5,8,62.5,2,5,40.0,7,13,53.8,5,7,71.4,3,4,7,2,0,0,0,0,2,4
../kbl_data/2021-2022,S39G01N107,서울 SK,Home,자밀 워니,29,12,26,46.2,1,2,50.0,13,28,46.4,2,5,40.0,8,6,14,8,2,0,0,0,3,2
../kbl_data/2021-2022,S39G01N107,서울 SK,Home,오재현,0,0,0,0.0,0,0,0.0,0,0,0.0,0,0,0.0,0,0,0,0,0,0,0,0,0,3
../kbl_data/2021-2022,S39G01N107,안양 KGC,Away,양희종,3,0,0,0.0,1,1,100.0,1,1,100.0,0,0,0.0,0,1,1,0,0,1,0,0,0,1
../kbl_data/2021-2022,S39G01N107,안양 KGC,Away,박형철,0,0,0,0.0,0,0,0.0,0,0,0.0,0,0,0.0,0,0,0,0,0,0,0,0,0,0
../kbl_data/2021-2022,S39G01N107,안양 KGC,Away,함준후,0,0,0,0.0,0,0,0.0,0,0,0.0,0,0,0.0,0,0,0,1,0,0,0,0,0,0
../kbl_data/2021-2022,S39G01N107,안양 KGC,Away,오세근,16,6,8,75.0,0,1,0.0,6,9,66.7,4,5,80.0,2,5,7,3,1,2,0,0,3,2
../kbl_data/2021-2022,S39G01N107,안양 KGC,Away,문성곤,12,0,0,0.0,4,8,50.0,4,8,50.0,0,0,0.0,3,1,4,5,2,0,0,0,1,2
../kbl_data/2021-2022,S39G01N107,안양 KGC,Away,전성현,19,1,3,33.3,5,8,62.5,6,11,54.5,2,2,100.0,2,2,4,4,2,0,0,0,1,2
../kbl_data/2021-2022,S39G01N107,안양 KGC,Away,박지훈,3,0,1,0.0,1,2,50.0,1,3,33.3,0,0,0.0,0,0,0,1,0,0,0,0,0,2
../kbl_data/2021-2022,S39G01N107,안양 KGC,Away,이우정,0,0,0,0.0,0,0,0.0,0,0,0.0,0,0,0.0,0,0,0,0,0,0,0,0,0,0
../kbl_data/2021-2022,S39G01N107,안양 KGC,Away,대릴 먼로,9,3,4,75.0,1,1,100.0,4,5,80.0,0,0,0.0,1,5,6,2,2,0,0,1,2,1
../kbl_data/2021-2022,S39G01N107,안양 KGC,Away,변준형,18,3,3,100.0,2,6,33.3,5,9,55.6,6,6,100.0,0,3,3,12,1,1,0,0,2,4
../kbl_data/2021-2022,S39G01N107,안양 KGC,Away,한승희,2,1,2,50.0,0,0,0.0,1,2,50.0,0,0,0.0,1,1,2,1,1,0,1,0,1,1
../kbl_data/2021-2022,S39G01N107,안양 KGC,Away,오마리 스펠맨,30,6,9,66.7,4,11,36.4,10,20,50.0,6,7,85.7,1,5,6,0,1,1,0,3,3,5
../kbl_data/2021-2022,S39G01N108,전주 KCC,Home,송창용,2,0,3,0.0,0,1,0.0,0,4,0.0,2,2,100.0,0,0,0,0,1,0,0,0,0,3
../kbl_data/2021-2022,S39G01N108,전주 KCC,Home,이정현,7,2,6,33.3,1,4,25.0,3,10,30.0,0,0,0.0,1,1,2,2,0,1,1,0,2,2
../kbl_data/2021-2022,S39G01N108,전주 KCC,Home,정창영,2,1,5,20.0,0,1,0.0,1,6,16.7,0,0,0.0,0,2,2,3,1,0,0,0,2,1
../kbl_data/2021-2022,S39G01N108,전주 KCC,Home,라건아,29,10,16,62.5,2,3,66.7,12,19,63.2,3,4,75.0,6,11,17,3,0,2,0,1,4,4
../kbl_data/2021-2022,S39G01N108,전주 KCC,Home,김상규,11,5,7,71.4,0,3,0.0,5,10,50.0,1,2,50.0,0,2,2,0,1,1,0,0,1,3
../kbl_data/2021-2022,S39G01N108,전주 KCC,Home,유병훈,0,0,0,0.0,0,0,0.0,0,0,0.0,0,0,0.0,0,0,0,0,0,0,0,0,0,1
../kbl_data/2021-2022,S39G01N108,전주 KCC,Home,박재현,0,0,1,0.0,0,0,0.0,0,1,0.0,0,0,0.0,0,0,0,3,0,0,0,0,0,1
../kbl_data/2021-2022,S39G01N108,전주 KCC,Home,이진욱,0,0,0,0.0,0,1,0.0,0,1,0.0,0,0,0.0,0,0,0,0,0,0,0,0,1,0
../kbl_data/2021-2022,S39G01N108,전주 KCC,Home,유현준,10,3,4,75.0,1,4,25.0,4,8,50.0,1,2,50.0,0,2,2,2,4,0,1,0,1,4
../kbl_data/2021-2022,S39G01N108,전주 KCC,Home,라타비우스 윌리엄스,2,0,3,0.0,0,0,0.0,0,3,0.0,2,2,100.0,1,1,2,0,0,0,0,0,0,1
../kbl_data/2021-2022,S39G01N108,전주 KCC,Home,곽정훈,4,2,2,100.0,0,0,0.0,2,2,100.0,0,0,0.0,1,1,2,0,1,0,0,0,0,0
../kbl_data/2021-2022,S39G01N108,전주 KCC,Home,이근휘,14,1,1,100.0,4,7,57.1,5,8,62.5,0,2,0.0,0,0,0,2,1,0,0,0,0,0
../kbl_data/2021-2022,S39G01N108,울산 현대모비스,Away,이현민,0,0,0,0.0,0,1,0.0,0,1,0.0,0,0,0.0,0,0,0,2,0,0,0,0,1,1
../kbl_data/2021-2022,S39G01N108,울산 현대모비스,Away,함지훈,13,3,9,33.3,0,1,0.0,3,10,30.0,7,8,87.5,3,3,6,5,1,1,0,0,1,1
../kbl_data/2021-2022,S39G01N108,울산 현대모비스,Away,최진수,11,1,4,25.0,3,6,50.0,4,10,40.0,0,0,0.0,1,2,3,2,0,4,0,0,2,1
../kbl_data/2021-2022,S39G01N108,울산 현대모비스,Away,박지훈,10,2,2,100.0,2,4,50.0,4,6,66.7,0,1,0.0,3,1,4,1,1,0,0,0,0,3
../kbl_data/2021-2022,S39G01N108,울산 현대모비스,Away,장재석,4,2,7,28.6,0,0,0.0,2,7,28.6,0,0,0.0,1,4,5,2,0,0,0,0,1,5
../kbl_data/2021-2022,S39G01N108,울산 현대모비스,Away,김국찬,14,3,4,75.0,2,6,33.3,5,10,50.0,2,2,100.0,0,3,3,2,2,1,0,0,0,1
../kbl_data/2021-2022,S39G01N108,울산 현대모비스,Away,서명진,16,3,5,60.0,3,7,42.9,6,12,50.0,1,1,100.0,2,1,3,6,0,0,0,0,4,1
../kbl_data/2021-2022,S39G01N108,울산 현대모비스,Away,얼 클락,11,3,6,50.0,1,1,100.0,4,7,57.1,2,2,100.0,3,8,11,2,2,2,0,1,2,2
../kbl_data/2021-2022,S39G01N108,울산 현대모비스,Away,이우석,5,1,1,100.0,1,1,100.0,2,2,100.0,0,0,0.0,1,0,1,1,0,0,0,0,1,2
../kbl_data/2021-2022,S39G01N108,울산 현대모비스,Away,라숀 토마스,9,4,9,44.4,0,0,0.0,4,9,44.4,1,2,50.0,4,8,12,2,3,1,0,0,1,2
../kbl_data/2021-2022,S39G01N108,울산 현대모비스,Away,신민석,2,1,1,100.0,0,2,0.0,1,3,33.3,0,0,0.0,1,1,2,0,0,0,0,0,1,0
../kbl_data/2021-2022,S39G01N108,울산 현대모비스,Away,김동준,2,1,1,100.0,0,0,0.0,1,1,100.0,0,0,0.0,0,0,0,0,0,0,0,0,0,0
../kbl_data/2021-2022,S39G01N109,원주 DB,Home,윤호영,3,0,0,0.0,1,2,50.0,1,2,50.0,0,0,0.0,1,1,2,1,0,1,0,0,0,0
../kbl_data/2021-2022,S39G01N109,원주 DB,Home,박찬희,7,2,6,33.3,1,3,33.3,3,9,33.3,0,0,0.0,1,2,3,1,3,0,0,0,1,1
../kbl_data/2021-2022,S39G01N109,원주 DB,Home,김현호,3,0,2,0.0,1,1,100.0,1,3,33.3,0,0,0.0,0,0,0,1,0,0,0,0,0,2
../kbl_data/2021-2022,S39G01N109,원주 DB,Home,정준원,0,0,0,0.0,0,1,0.0,0,1,0.0,0,0,0.0,0,0,0,0,0,0,0,0,1,2
../kbl_data/2021-2022,S39G01N109,원주 DB,Home,김종규,13,5,8,62.5,1,1,100.0,6,9,66.7,0,0,0.0,1,2,3,0,0,2,0,1,1,2
../kbl_data/2021-2022,S39G01N109,원주 DB,Home,허웅,5,1,4,25.0,1,6,16.7,2,10,20.0,0,0,0.0,0,3,3,2,0,1,0,0,1,3
../kbl_data/2021-2022,S39G01N109,원주 DB,Home,김영훈,0,0,0,0.0,0,0,0.0,0,0,0.0,0,0,0.0,0,0,0,0,0,0,0,0,0,0
../kbl_data/2021-2022,S39G01N109,원주 DB,Home,강상재,5,2,7,28.6,0,1,0.0,2,8,25.0,1,2,50.0,2,10,12,3,0,0,0,0,2,2
../kbl_data/2021-2022,S39G01N109,원주 DB,Home,이준희,17,4,5,80.0,3,3,100.0,7,8,87.5,0,0,0.0,1,1,2,1,0,0,0,0,1,2
../kbl_data/2021-2022,S39G01N109,원주 DB,Home,레나드 프리먼,6,3,7,42.9,0,0,0.0,3,7,42.9,0,1,0.0,3,6,9,1,1,0,0,0,1,0
../kbl_data/2021-2022,S39G01N109,원주 DB,Home,정호영,2,0,1,0.0,0,2,0.0,0,3,0.0,2,2,100.0,0,1,1,4,0,0,0,0,1,1
../kbl_data/2021-2022,S39G01N109,원주 DB,Home,조니 오브라이언트,17,8,9,88.9,0,3,0.0,8,12,66.7,1,2,50.0,2,11,13,3,2,0,0,0,2,1
../kbl_data/2021-2022,S39G01N109,고양 오리온,Away,오용준,0,0,0,0.0,0,0,0.0,0,0,0.0,0,0,0.0,0,0,0,0,0,0,0,0,0,1
../kbl_data/2021-2022,S39G01N109,고양 오리온,Away,김강선,8,2,4,50.0,1,4,25.0,3,8,37.5,1,1,100.0,0,0,0,2,2,1,0,0,2,3
../kbl_data/2021-2022,S39G01N109,고양 오리온,Away,최현민,0,0,0,0.0,0,4,0.0,0,4,0.0,0,0,0.0,0,0,0,0,2,0,0,0,1,2
../kbl_data/2021-2022,S39G01N109,고양 오리온,Away,이대성,16,4,10,40.0,1,10,10.0,5,20,25.0,5,6,83.3,1,4,5,4,0,0,0,0,1,1
../kbl_data/2021-2022,S39G01N109,고양 오리온,Away,이정제,3,1,1,100.0,0,0,0.0,1,1,100.0,1,2,50.0,0,0,0,0,0,0,0,0,0,1
../kbl_data/2021-2022,S39G01N109,고양 오리온,Away,이승현,15,6,12,50.0,1,1,100.0,7,13,53.8,0,0,0.0,2,5,7,4,0,0,0,0,1,0
../kbl_data/2021-2022,S39G01N109,고양 오리온,Away,김진유,0,0,0,0.0,0,1,0.0,0,1,0.0,0,0,0.0,1,0,1,0,0,0,0,0,0,2
../kbl_data/2021-2022,S39G01N109,고양 오리온,Away,머피 할로웨이,12,5,10,50.0,0,0,0.0,5,10,50.0,2,3,66.7,3,12,15,2,2,0,0,1,2,1
../kbl_data/2021-2022,S39G01N109,고양 오리온,Away,조한진,0,0,0,0.0,0,1,0.0,0,1,0.0,0,0,0.0,0,2,2,0,1,1,0,0,0,2
../kbl_data/2021-2022,S39G01N109,고양 오리온,Away,김세창,2,1,3,33.3,0,1,0.0,1,4,25.0,0,0,0.0,0,0,0,0,1,0,0,0,0,1
../kbl_data/2021-2022,S39G01N109,고양 오리온,Away,박진철,0,0,0,0.0,0,0,0.0,0,0,0.0,0,0,0.0,0,1,1,0,0,0,0,0,0,0
../kbl_data/2021-2022,S39G01N109,고양 오리온,Away,이정현,2,1,3,33.3,0,2,0.0,1,5,20.0,0,0,0.0,0,1,1,1,0,0,0,0,1,3
../kbl_data/2021-2022,S39G01N110,서울 SK,Home,허일영,0,0,1,0.0,0,0,0.0,0,1,0.0,0,0,0.0,1,0,1,0,0,0,0,0,0,1
../kbl_data/2021-2022,S39G01N110,서울 SK,Home,김선형,7,3,6,50.0,0,2,0.0,3,8,37.5,1,2,50.0,1,0,1,4,1,0,0,0,2,2
../kbl_data/2021-2022,S39G01N110,서울 SK,Home,최부경,9,3,7,42.9,0,0,0.0,3,7,42.9,3,3,100.0,2,2,4,1,1,1,0,0,1,1
../kbl_data/2021-2022,S39G01N110,서울 SK,Home,김승원,0,0,0,0.0,0,0,0.0,0,0,0.0,0,0,0.0,0,0,0,0,0,0,0,0,0,0
../kbl_data/2021-2022,S39G01N110,서울 SK,Home,리온 윌리엄스,2,1,2,50.0,0,0,0.0,1,2,50.0,0,0,0.0,1,2,3,0,0,0,0,0,0,1
../kbl_data/2021-2022,S39G01N110,서울 SK,Home,배병준,3,0,1,0.0,1,1,100.0,1,2,50.0,0,0,0.0,0,1,1,0,0,0,0,0,0,0
../kbl_data/2021-2022,S39G01N110,서울 SK,Home,이현석,2,1,1,100.0,0,2,0.0,1,3,33.3,0,0,0.0,1,1,2,0,1,0,0,0,1,3
../kbl_data/2021-2022,S39G01N110,서울 SK,Home,최원혁,5,2,3,66.7,0,1,0.0,2,4,50.0,1,2,50.0,0,1,1,2,0,0,0,0,1,3
../kbl_data/2021-2022,S39G01N110,서울 SK,Home,최준용,25,6,12,50.0,3,3,100.0,9,15,60.0,4,4,100.0,4,3,7,4,2,2,0,0,4,4
../kbl_data/2021-2022,S39G01N110,서울 SK,Home,안영준,11,4,10,40.0,1,3,33.3,5,13,38.5,0,0,0.0,1,4,5,2,1,1,0,0,1,0
../kbl_data/2021-2022,S39G01N110,서울 SK,Home,자밀 워니,14,7,12,58.3,0,0,0.0,7,12,58.3,0,0,0.0,2,9,11,0,0,2,0,0,0,0
../kbl_data/2021-2022,S39G01N110,서울 SK,Home,오재현,5,1,1,100.0,1,3,33.3,2,4,50.0,0,0,0.0,1,0,1,3,0,0,0,0,0,3
../kbl_data/2021-2022,S39G01N110,창원 LG,Away,강병현,4,1,1,100.0,0,1,0.0,1,2,50.0,2,2,100.0,0,1,1,0,0,0,0,0,0,1
../kbl_data/2021-2022,S39G01N110,창원 LG,Away,변기훈,10,1,1,100.0,2,5,40.0,3,6,50.0,2,4,50.0,3,1,4,3,2,0,0,0,0,3
../kbl_data/2021-2022,S39G01N110,창원 LG,Away,이관희,23,2,5,40.0,6,10,60.0,8,15,53.3,1,2,50.0,0,2,2,0,0,0,0,0,1,1
../kbl_data/2021-2022,S39G01N110,창원 LG,Away,정희재,2,0,2,0.0,0,1,0.0,0,3,0.0,2,2,100.0,1,4,5,3,0,0,0,0,1,2
../kbl_data/2021-2022,S39G01N110,창원 LG,Away,서민수,9,3,6,50.0,1,6,16.7,4,12,33.3,0,0,0.0,0,1,1,1,1,0,0,0,1,4
../kbl_data/2021-2022,S39G01N110,창원 LG,Away,한상혁,3,0,0,0.0,1,1,100.0,1,1,100.0,0,0,0.0,0,0,0,2,0,0,0,0,0,1
../kbl_data/2021-2022,S39G01N110,창원 LG,Away,이재도,7,3,4,75.0,0,2,0.0,3,6,50.0,1,3,33.3,0,3,3,3,2,0,0,0,1,2
../kbl_data/2021-2022,S39G01N110,창원 LG,Away,박인태,0,0,0,0.0,0,0,0.0,0,0,0.0,0,0,0.0,0,1,1,0,0,0,0,0,1,0
../kbl_data/2021-2022,S39G01N110,창원 LG,Away,정해원,0,0,0,0.0,0,0,0.0,0,0,0.0,0,0,0.0,0,0,0,0,0,0,0,0,0,0
../kbl_data/2021-2022,S39G01N110,창원 LG,Away,이광진,0,0,0,0.0,0,0,0.0,0,0,0.0,0,0,0.0,0,0,0,0,0,0,0,0,0,0
../kbl_data/2021-2022,S39G01N110,창원 LG,Away,압둘 말릭 아부,15,7,12,58.3,0,3,0.0,7,15,46.7,1,3,33.3,4,6,10,1,1,2,0,1,3,1
../kbl_data/2021-2022,S39G01N110,창원 LG,Away,아셈 마레이,4,2,9,22.2,0,0,0.0,2,9,22.2,0,0,0.0,4,2,6,2,2,0,0,0,2,2
../kbl_data/2021-2022,S39G01N111,안양 KGC,Home,양희종,5,1,3,33.3,1,3,33.3,2,6,33.3,0,0,0.0,0,1,1,3,1,0,0,0,1,1
../kbl_data/2021-2022,S39G01N111,안양 KGC,Home,함준후,7,2,2,100.0,1,1,100.0,3,3,100.0,0,0,0.0,1,0,1,0,1,1,0,0,0,2
../kbl_data/2021-2022,S39G01N111,안양 KGC,Home,오세근,16,6,10,60.0,1,2,50.0,7,12,58.3,1,1,100.0,1,0,1,2,0,0,0,0,0,2
../kbl_data/2021-2022,S39G01N111,안양 KGC,Home,문성곤,12,3,4,75.0,2,5,40.0,5,9,55.6,0,0,0.0,2,3,5,2,3,0,0,0,0,2
../kbl_data/2021-2022,S39G01N111,안양 KGC,Home,전성현,15,1,2,50.0,4,10,40.0,5,12,41.7,1,2,50.0,1,0,1,1,0,0,0,0,0,0
../kbl_data/2021-2022,S39G01N111,안양 KGC,Home,박지훈,4,2,3,66.7,0,2,0.0,2,5,40.0,0,0,0.0,1,1,2,3,0,0,1,0,0,2
../kbl_data/2021-2022,S39G01N111,안양 KGC,Home,이우정,0,0,0,0.0,0,0,0.0,0,0,0.0,0,0,0.0,0,0,0,0,0,0,0,0,1,0
../kbl_data/2021-2022,S39G01N111,안양 KGC,Home,대릴 먼로,2,1,1,100.0,0,0,0.0,1,1,100.0,0,0,0.0,0,2,2,1,0,0,0,0,0,2
../kbl_data/2021-2022,S39G01N111,안양 KGC,Home,우동현,2,1,2,50.0,0,4,0.0,1,6,16.7,0,0,0.0,0,0,0,0,2,0,0,0,0,3
../kbl_data/2021-2022,S39G01N111,안양 KGC,Home,변준형,11,1,5,20.0,1,3,33.3,2,8,25.0,6,6,100.0,2,1,3,6,3,0,1,0,0,2
../kbl_data/2021-2022,S39G01N111,안양 KGC,Home,한승희,4,2,3,66.7,0,0,0.0,2,3,66.7,0,0,0.0,0,0,0,0,0,0,0,0,0,0
../kbl_data/2021-2022,S39G01N111,안양 KGC,Home,오마리 스펠맨,24,4,6,66.7,4,6,66.7,8,12,66.7,4,6,66.7,3,12,15,3,0,0,0,1,2,0
../kbl_data/2021-2022,S39G01N111,수원 KT,Away,김영환,8,0,1,0.0,2,3,66.7,2,4,50.0,2,2,100.0,1,3,4,2,0,0,0,0,0,0
../kbl_data/2021-2022,S39G01N111,수원 KT,Away,김현민,2,1,3,33.3,0,3,0.0,1,6,16.7,0,0,0.0,1,1,2,1,0,0,0,0,1,4
../kbl_data/2021-2022,S39G01N111,수원 KT,Away,최창진,0,0,0,0.0,0,0,0.0,0,0,0.0,0,0,0.0,0,0,0,1,0,0,0,0,0,1
../kbl_data/2021-2022,S39G01N111,수원 KT,Away,정성우,12,3,4,75.0,2,3,66.7,5,7,71.4,0,0,0.0,0,2,2,2,1,0,0,0,1,4
../kbl_data/2021-2022,S39G01N111,수원 KT,Away,허훈,17,4,8,50.0,2,3,66.7,6,11,54.5,3,3,100.0,1,5,6,4,0,0,0,0,5,3
../kbl_data/2021-2022,S39G01N111,수원 KT,Away,양홍석,9,1,4,25.0,2,5,40.0,3,9,33.3,1,2,50.0,0,4,4,2,0,0,0,0,3,1
../kbl_data/2021-2022,S39G01N111,수원 KT,Away,박준영,0,0,0,0.0,0,0,0.0,0,0,0.0,0,0,0.0,0,0,0,0,0,0,0,0,0,0
../kbl_data/2021-2022,S39G01N111,수원 KT,Away,캐디 라렌,10,5,8,62.5,0,2,0.0,5,10,50.0,0,0,0.0,1,7,8,0,1,0,0,1,0,1
../kbl_data/2021-2022,S39G01N111,수원 KT,Away,문상옥,2,1,1,100.0,0,0,0.0,1,1,100.0,0,0,0.0,0,0,0,0,0,0,0,0,0,0
../kbl_data/2021-2022,S39G01N111,수원 KT,Away,박지원,0,0,0,0.0,0,2,0.0,0,2,0.0,0,0,0.0,1,1,2,3,0,0,0,0,2,1
../kbl_data/2021-2022,S39G01N111,수원 KT,Away,마이크 마이어스,9,4,7,57.1,0,0,0.0,4,7,57.1,1,1,100.0,2,2,4,3,1,0,0,1,1,1
../kbl_data/2021-2022,S39G01N111,수원 KT,Away,하윤기,10,5,7,71.4,0,0,0.0,5,7,71.4,0,0,0.0,1,2,3,0,0,1,0,2,1,0
../kbl_data/2021-2022,S39G01N112,대구 한국가스공사,Home,정영삼,0,0,0,0.0,0,0,0.0,0,0,0.0,0,0,0.0,0,0,0,0,0,0,0,0,0,0
../kbl_data/2021-2022,S39G01N112,대구 한국가스공사,Home,홍경기,13,3,4,75.0,2,3,66.7,5,7,71.4,1,1,100.0,0,0,0,1,0,0,0,0,0,1
../kbl_data/2021-2022,S39G01N112,대구 한국가스공사,Home,조상열,3,0,0,0.0,1,3,33.3,1,3,33.3,0,0,0.0,0,0,0,2,0,0,0,0,0,0
../kbl_data/2021-2022,S39G01N112,대구 한국가스공사,Home,이대헌,12,5,11,45.5,0,1,0.0,5,12,41.7,2,5,40.0,2,8,10,2,1,0,0,0,2,2
../kbl_data/2021-2022,S39G01N112,대구 한국가스공사,Home,두경민,18,3,3,100.0,3,5,60.0,6,8,75.0,3,3,100.0,0,2,2,4,2,0,0,0,3,1
../kbl_data/2021-2022,S39G01N112,대구 한국가스공사,Home,박봉진,0,0,0,0.0,0,1,0.0,0,1,0.0,0,0,0.0,0,0,0,0,0,0,0,0,0,0
../kbl_data/2021-2022,S39G01N112,대구 한국가스공사,Home,김낙현,14,4,4,100.0,1,6,16.7,5,10,50.0,3,3,100.0,0,3,3,9,3,0,0,0,0,0
../kbl_data/2021-2022,S39G01N112,대구 한국가스공사,Home,전현우,8,1,2,50.0,2,5,40.0,3,7,42.9,0,0,0.0,2,3,5,1,0,0,0,0,0,3
../kbl_data/2021-2022,S39G01N112,대구 한국가스공사,Home,이윤기,3,1,1,100.0,0,2,0.0,1,3,33.3,1,2,50.0,1,1,2,0,0,0,0,0,0,4
../kbl_data/2021-2022,S39G01N112,대구 한국가스공사,Home,클리프 알렉산더,15,6,10,60.0,0,0,0.0,6,10,60.0,3,3,100.0,3,10,13,1,2,3,0,1,1,2
../kbl_data/2021-2022,S39G01N112,대구 한국가스공사,Home,앤드류 니콜슨,5,1,3,33.3,1,1,100.0,2,4,50.0,0,0,0.0,0,0,0,0,1,0,0,1,0,0
../kbl_data/2021-2022,S39G01N112,대구 한국가스공사,Home,신승민,5,1,4,25.0,1,2,50.0,2,6,33.3,0,0,0.0,0,3,3,1,1,0,0,0,3,3
../kbl_data/2021-2022,S39G01N112,서울 삼성,Away,김동량,7,3,6,50.0,0,0,0.0,3,6,50.0,1,1,100.0,2,0,2,0,0,0,0,0,1,3
../kbl_data/2021-2022,S39G01N112,서울 삼성,Away,장민국,5,1,2,50.0,1,3,33.3,2,5,40.0,0,0,0.0,0,3,3,1,0,0,0,0,0,2
../kbl_data/2021-2022,S39G01N112,서울 삼성,Away,김시래,5,1,2,50.0,1,3,33.3,2,5,40.0,0,0,0.0,1,0,1,7,1,0,0,0,2,3
../kbl_data/2021-2022,S39G01N112,서울 삼성,Away,김현수,2,1,1,100.0,0,2,0.0,1,3,33.3,0,0,0.0,0,1,1,0,0,0,0,0,1,2
../kbl_data/2021-2022,S39G01N112,서울 삼성,Away,임동섭,0,0,1,0.0,0,3,0.0,0,4,0.0,0,0,0.0,0,1,1,1,0,1,0,0,1,0
../kbl_data/2021-2022,S39G01N112,서울 삼성,Away,배수용,0,0,0,0.0,0,0,0.0,0,0,0.0,0,0,0.0,0,0,0,0,1,0,0,0,0,0
../kbl_data/2021-2022,S39G01N112,서울 삼성,Away,이호현,2,1,2,50.0,0,1,0.0,1,3,33.3,0,0,0.0,0,1,1,1,0,0,0,0,0,0
../kbl_data/2021-2022,S39G01N112,서울 삼성,Away,강바일,5,1,1,100.0,1,5,20.0,2,6,33.3,0,0,0.0,0,1,1,0,0,0,0,0,1,1
../kbl_data/2021-2022,S39G01N112,서울 삼성,Away,차민석,9,3,5,60.0,1,1,100.0,4,6,66.7,0,1,0.0,2,2,4,0,0,0,0,0,0,0
../kbl_data/2021-2022,S39G01N112,서울 삼성,Away,전형준,5,1,2,50.0,1,3,33.3,2,5,40.0,0,0,0.0,0,1,1,4,1,0,0,0,0,4
../kbl_data/2021-2022,S39G01N112,서울 삼성,Away,이원석,4,2,5,40.0,0,0,0.0,2,5,40.0,0,0,0.0,0,6,6,0,1,2,0,0,2,3
../kbl_data/2021-2022,S39G01N112,서울 삼성,Away,토마스 로빈슨,31,12,26,46.2,1,2,50.0,13,28,46.4,4,6,66.7,6,8,14,1,2,0,0,1,4,3
../kbl_data/2021-2022,S39G01N113,원주 DB,Home,윤호영,0,0,1,0.0,0,0,0.0,0,1,0.0,0,0,0.0,1,2,3,0,0,0,0,0,0,3
../kbl_data/2021-2022,S39G01N113,원주 DB,Home,박찬희,4,1,3,33.3,0,2,0.0,1,5,20.0,2,6,33.3,1,1,2,2,0,0,0,0,0,3
../kbl_data/2021-2022,S39G01N113,원주 DB,Home,정준원,7,2,4,50.0,1,2,50.0,3,6,50.0,0,0,0.0,0,0,0,1,0,0,0,0,0,1
../kbl_data/2021-2022,S39G01N113,원주 DB,Home,박경상,6,0,1,0.0,1,5,20.0,1,6,16.7,3,4,75.0,1,1,2,0,0,0,0,0,0,2
../kbl_data/2021-2022,S39G01N113,원주 DB,Home,김종규,12,5,8,62.5,0,0,0.0,5,8,62.5,2,2,100.0,2,5,7,0,1,1,0,0,1,5
../kbl_data/2021-2022,S39G01N113,원주 DB,Home,허웅,21,6,15,40.0,2,3,66.7,8,18,44.4,3,3,100.0,0,2,2,8,3,0,0,0,1,0
../kbl_data/2021-2022,S39G01N113,원주 DB,Home,김영훈,0,0,0,0.0,0,0,0.0,0,0,0.0,0,0,0.0,0,0,0,0,0,0,0,0,0,0
../kbl_data/2021-2022,S39G01N113,원주 DB,Home,강상재,0,0,5,0.0,0,1,0.0,0,6,0.0,0,0,0.0,0,3,3,0,0,0,0,0,0,1
../kbl_data/2021-2022,S39G01N113,원주 DB,Home,이준희,0,0,0,0.0,0,0,0.0,0,0,0.0,0,0,0.0,0,0,0,0,1,1,0,0,2,0
../kbl_data/2021-2022,S39G01N113,원주 DB,Home,레나드 프리먼,14,7,9,77.8,0,0,0.0,7,9,77.8,0,0,0.0,2,9,11,3,0,1,0,2,1,3
../kbl_data/2021-2022,S39G01N113,원주 DB,Home,정호영,0,0,2,0.0,0,0,0.0,0,2,0.0,0,0,0.0,0,0,0,0,0,0,0,0,0,0
../kbl_data/2021-2022,S39G01N113,원주 DB,Home,조니 오브라이언트,14,4,9,44.4,1,2,50.0,5,11,45.5,3,4,75.0,2,6,8,2,0,0,0,0,3,2
../kbl_data/2021-2022,S39G01N113,울산 현대모비스,Away,이현민,1,0,2,0.0,0,3,0.0,0,5,0.0,1,2,50.0,1,1,2,10,0,0,0,0,0,3
../kbl_data/2021-2022,S39G01N113,울산 현대모비스,Away,함지훈,3,0,1,0.0,0,0,0.0,0,1,0.0,3,4,75.0,3,3,6,1,1,0,0,0,0,0
../kbl_data/2021-2022,S39G01N113,울산 현대모비스,Away,최진수,14,3,6,50.0,2,4,50.0,5,10,50.0,2,2,100.0,0,0,0,0,0,1,0,0,0,2
../kbl_data/2021-2022,S39G01N113,울산 현대모비스,Away,박지훈,0,0,0,0.0,0,1,0.0,0,1,0.0,0,0,0.0,0,1,1,0,0,0,0,0,1,1
../kbl_data/2021-2022,S39G01N113,울산 현대모비스,Away,장재석,0,0,6,0.0,0,0,0.0,0,6,0.0,0,2,0.0,1,1,2,0,0,1,0,0,1,1
../kbl_data/2021-2022,S39G01N113,울산 현대모비스,Away,김국찬,6,0,1,0.0,2,4,50.0,2,5,40.0,0,0,0.0,0,2,2,1,0,0,0,0,1,4
../kbl_data/2021-2022,S39G01N113,울산 현대모비스,Away,서명진,6,1,1,100.0,1,5,20.0,2,6,33.3,1,1,100.0,0,1,1,5,0,1,0,0,1,2
../kbl_data/2021-2022,S39G01N113,울산 현대모비스,Away,얼 클락,4,2,5,40.0,0,1,0.0,2,6,33.3,0,0,0.0,1,4,5,0,0,1,0,0,2,0
../kbl_data/2021-2022,S39G01N113,울산 현대모비스,Away,이우석,2,1,6,16.7,0,2,0.0,1,8,12.5,0,0,0.0,1,6,7,1,0,1,0,0,0,3
../kbl_data/2021-2022,S39G01N113,울산 현대모비스,Away,라숀 토마스,30,11,18,61.1,0,1,0.0,11,19,57.9,8,9,88.9,3,8,11,2,3,2,0,0,3,3
../kbl_data/2021-2022,S39G01N113,울산 현대모비스,Away,신민석,6,1,1,100.0,1,5,20.0,2,6,33.3,1,2,50.0,5,1,6,1,0,0,0,0,0,1
../kbl_data/2021-2022,S39G01N113,울산 현대모비스,Away,김동준,0,0,0,0.0,0,0,0.0,0,0,0.0,0,0,0.0,0,0,0,0,0,0,0,0,0,0
../kbl_data/2021-2022,S39G01N114,서울 SK,Home,양우섭,0,0,0,0.0,0,0,0.0,0,0,0.0,0,0,0.0,0,0,0,0,0,0,0,0,0,0
../kbl_data/2021-2022,S39G01N114,서울 SK,Home,허일영,5,1,3,33.3,1,4,25.0,2,7,28.6,0,0,0.0,1,1,2,0,1,0,0,0,1,1
../kbl_data/2021-2022,S39G01N114,서울 SK,Home,김선형,17,6,9,66.7,1,2,50.0,7,11,63.6,2,2,100.0,2,3,5,10,0,0,0,0,3,3
../kbl_data/2021-2022,S39G01N114,서울 SK,Home,최부경,6,3,3,100.0,0,0,0.0,3,3,100.0,0,0,0.0,3,0,3,0,0,0,0,0,0,1
../kbl_data/2021-2022,S39G01N114,서울 SK,Home,리온 윌리엄스,3,1,1,100.0,0,0,0.0,1,1,100.0,1,2,50.0,1,1,2,0,0,0,0,0,0,0
../kbl_data/2021-2022,S39G01N114,서울 SK,Home,배병준,0,0,0,0.0,0,0,0.0,0,0,0.0,0,0,0.0,0,0,0,1,0,0,0,0,0,0
../kbl_data/2021-2022,S39G01N114,서울 SK,Home,이현석,0,0,0,0.0,0,1,0.0,0,1,0.0,0,0,0.0,0,1,1,0,0,0,0,0,0,0
../kbl_data/2021-2022,S39G01N114,서울 SK,Home,최원혁,3,0,0,0.0,1,1,100.0,1,1,100.0,0,0,0.0,0,0,0,0,0,0,1,0,1,2
../kbl_data/2021-2022,S39G01N114,서울 SK,Home,최준용,17,3,7,42.9,3,5,60.0,6,12,50.0,2,2,100.0,1,5,6,4,5,0,0,0,1,3
../kbl_data/2021-2022,S39G01N114,서울 SK,Home,안영준,12,4,7,57.1,0,2,0.0,4,9,44.4,4,4,100.0,0,4,4,3,2,1,0,0,3,2
../kbl_data/2021-2022,S39G01N114,서울 SK,Home,자밀 워니,25,12,25,48.0,0,2,0.0,12,27,44.4,1,1,100.0,6,8,14,4,2,0,0,2,2,1
../kbl_data/2021-2022,S39G01N114,서울 SK,Home,오재현,0,0,1,0.0,0,1,0.0,0,2,0.0,0,0,0.0,0,0,0,1,0,0,0,0,0,1
../kbl_data/2021-2022,S39G01N114,전주 KCC,Away,송창용,0,0,0,0.0,0,0,0.0,0,0,0.0,0,0,0.0,0,0,0,0,0,0,0,0,0,0
../kbl_data/2021-2022,S39G01N114,전주 KCC,Away,이정현,12,5,8,62.5,0,6,0.0,5,14,35.7,2,2,100.0,1,1,2,4,2,0,0,0,2,3
../kbl_data/2021-2022,S39G01N114,전주 KCC,Away,정창영,22,4,6,66.7,4,8,50.0,8,14,57.1,2,2,100.0,0,5,5,1,4,0,0,0,4,2
../kbl_data/2021-2022,S39G01N114,전주 KCC,Away,라건아,14,7,7,100.0,0,3,0.0,7,10,70.0,0,0,0.0,3,5,8,4,0,1,0,1,2,2
../kbl_data/2021-2022,S39G01N114,전주 KCC,Away,김상규,21,6,9,66.7,3,4,75.0,9,13,69.2,0,0,0.0,0,6,6,3,0,1,0,0,2,1
../kbl_data/2021-2022,S39G01N114,전주 KCC,Away,유병훈,0,0,0,0.0,0,0,0.0,0,0,0.0,0,0,0.0,0,0,0,0,0,0,0,0,0,0
../kbl_data/2021-2022,S39G01N114,전주 KCC,Away,박재현,0,0,1,0.0,0,0,0.0,0,1,0.0,0,0,0.0,0,0,0,2,1,0,0,0,0,1
../kbl_data/2021-2022,S39G01N114,전주 KCC,Away,이진욱,4,2,2,100.0,0,2,0.0,2,4,50.0,0,0,0.0,0,1,1,3,0,0,0,0,0,3
../kbl_data/2021-2022,S39G01N114,전주 KCC,Away,유현준,4,2,3,66.7,0,3,0.0,2,6,33.3,0,0,0.0,0,1,1,2,1,0,0,0,1,1
../kbl_data/2021-2022,S39G01N114,전주 KCC,Away,라타비우스 윌리엄스,6,3,6,50.0,0,0,0.0,3,6,50.0,0,2,0.0,3,2,5,0,0,0,0,1,0,0
../kbl_data/2021-2022,S39G01N114,전주 KCC,Away,곽정훈,0,0,0,0.0,0,0,0.0,0,0,0.0,0,0,0.0,0,0,0,0,0,0,0,0,0,1
../kbl_data/2021-2022,S39G01N114,전주 KCC,Away,이근휘,0,0,0,0.0,0,1,0.0,0,1,0.0,0,0,0.0,1,0,1,1,1,0,0,0,1,2
../kbl_data/2021-2022,S39G01N115,대구 한국가스공사,Home,정영삼,0,0,0,0.0,0,0,0.0,0,0,0.0,0,0,0.0,0,0,0,0,0,0,0,0,0,0
../kbl_data/2021-2022,S39G01N115,대구 한국가스공사,Home,민성주,0,0,1,0.0,0,0,0.0,0,1,0.0,0,0,0.0,0,2,2,0,0,0,0,0,0,1
../kbl_data/2021-2022,S39G01N115,대구 한국가스공사,Home,홍경기,2,1,3,33.3,0,0,0.0,1,3,33.3,0,0,0.0,0,1,1,3,0,0,0,0,0,3
../kbl_data/2021-2022,S39G01N115,대구 한국가스공사,Home,조상열,0,0,1,0.0,0,1,0.0,0,2,0.0,0,0,0.0,0,0,0,0,0,0,0,0,0,1
../kbl_data/2021-2022,S39G01N115,대구 한국가스공사,Home,이대헌,5,2,7,28.6,0,2,0.0,2,9,22.2,1,2,50.0,0,2,2,1,2,0,0,0,2,2
../kbl_data/2021-2022,S39G01N115,대구 한국가스공사,Home,두경민,15,2,7,28.6,3,9,33.3,5,16,31.2,2,3,66.7,1,0,1,4,2,0,0,0,1,2
../kbl_data/2021-2022,S39G01N115,대구 한국가스공사,Home,박봉진,0,0,0,0.0,0,0,0.0,0,0,0.0,0,0,0.0,0,0,0,0,0,0,0,0,0,0
../kbl_data/2021-2022,S39G01N115,대구 한국가스공사,Home,김낙현,16,2,6,33.3,4,8,50.0,6,14,42.9,0,0,0.0,0,3,3,2,0,0,0,0,1,3
../kbl_data/2021-2022,S39G01N115,대구 한국가스공사,Home,전현우,3,0,2,0.0,1,2,50.0,1,4,25.0,0,0,0.0,1,1,2,1,0,0,0,0,0,2
../kbl_data/2021-2022,S39G01N115,대구 한국가스공사,Home,이윤기,0,0,0,0.0,0,0,0.0,0,0,0.0,0,0,0.0,0,0,0,0,0,0,0,0,0,0
../kbl_data/2021-2022,S39G01N115,대구 한국가스공사,Home,클리프 알렉산더,25,12,18,66.7,0,3,0.0,12,21,57.1,1,2,50.0,6,15,21,0,1,0,0,5,1,3
../kbl_data/2021-2022,S39G01N115,대구 한국가스공사,Home,신승민,3,0,0,0.0,1,1,100.0,1,1,100.0,0,0,0.0,1,2,3,1,0,0,0,0,0,0
../kbl_data/2021-2022,S39G01N115,수원 KT,Away,김영환,0,0,2,0.0,0,3,0.0,0,5,0.0,0,0,0.0,0,1,1,0,0,0,0,0,0,0
../kbl_data/2021-2022,S39G01N115,수원 KT,Away,김현민,0,0,0,0.0,0,0,0.0,0,0,0.0,0,0,0.0,0,0,0,0,0,0,0,0,0,0
../kbl_data/2021-2022,S39G01N115,수원 KT,Away,최창진,0,0,1,0.0,0,0,0.0,0,1,0.0,0,0,0.0,0,1,1,0,0,0,0,0,0,2
../kbl_data/2021-2022,S39G01N115,수원 KT,Away,정성우,15,2,6,33.3,3,10,30.0,5,16,31.2,2,2,100.0,1,2,3,5,0,0,0,0,1,4
../kbl_data/2021-2022,S39G01N115,수원 KT,Away,허훈,19,3,8,37.5,3,6,50.0,6,14,42.9,4,6,66.7,0,3,3,3,1,0,0,0,3,2
../kbl_data/2021-2022,S39G01N115,수원 KT,Away,양홍석,3,0,2,0.0,1,4,25.0,1,6,16.7,0,0,0.0,3,5,8,3,0,0,0,0,3,2
../kbl_data/2021-2022,S39G01N115,수원 KT,Away,박준영,0,0,0,0.0,0,0,0.0,0,0,0.0,0,0,0.0,0,0,0,0,0,0,0,0,0,0
../kbl_data/2021-2022,S39G01N115,수원 KT,Away,캐디 라렌,24,10,18,55.6,0,1,0.0,10,19,52.6,4,6,66.7,10,13,23,1,0,6,0,2,2,1
../kbl_data/2021-2022,S39G01N115,수원 KT,Away,문상옥,0,0,0,0.0,0,0,0.0,0,0,0.0,0,0,0.0,0,0,0,0,0,0,0,0,0,0
../kbl_data/2021-2022,S39G01N115,수원 KT,Away,박지원,0,0,0,0.0,0,0,0.0,0,0,0.0,0,0,0.0,0,0,0,0,0,0,0,0,0,0
../kbl_data/2021-2022,S39G01N115,수원 KT,Away,마이크 마이어스,0,0,0,0.0,0,0,0.0,0,0,0.0,0,0,0.0,0,1,1,0,0,0,0,0,0,0
../kbl_data/2021-2022,S39G01N115,수원 KT,Away,하윤기,11,3,5,60.0,0,0,0.0,3,5,60.0,5,6,83.3,4,5,9,0,1,0,0,0,0,2
../kbl_data/2021-2022,S39G01N116,고양 오리온,Home,오용준,0,0,0,0.0,0,0,0.0,0,0,0.0,0,0,0.0,0,0,0,0,0,0,0,0,0,0
../kbl_data/2021-2022,S39G01N116,고양 오리온,Home,최현민,9,0,0,0.0,2,5,40.0,2,5,40.0,3,4,75.0,3,0,3,0,0,0,0,0,0,0
../kbl_data/2021-2022,S39G01N116,고양 오리온,Home,이대성,8,3,6,50.0,0,3,0.0,3,9,33.3,2,2,100.0,0,0,0,6,3,0,0,0,2,4
../kbl_data/2021-2022,S39G01N116,고양 오리온,Home,이정제,0,0,1,0.0,0,0,0.0,0,1,0.0,0,0,0.0,0,1,1,0,0,0,1,0,0,1
../kbl_data/2021-2022,S39G01N116,고양 오리온,Home,최승욱,0,0,0,0.0,0,0,0.0,0,0,0.0,0,0,0.0,0,0,0,0,0,0,0,0,0,0
../kbl_data/2021-2022,S39G01N116,고양 오리온,Home,이승현,14,6,9,66.7,0,2,0.0,6,11,54.5,2,2,100.0,1,4,5,3,0,0,0,0,0,3
../kbl_data/2021-2022,S39G01N116,고양 오리온,Home,김진유,5,1,2,50.0,1,1,100.0,2,3,66.7,0,0,0.0,1,1,2,1,0,1,0,0,0,2
../kbl_data/2021-2022,S39G01N116,고양 오리온,Home,머피 할로웨이,27,11,19,57.9,1,2,50.0,12,21,57.1,2,6,33.3,3,10,13,2,5,0,0,3,1,4
../kbl_data/2021-2022,S39G01N116,고양 오리온,Home,조한진,0,0,1,0.0,0,0,0.0,0,1,0.0,0,0,0.0,1,0,1,0,0,0,0,0,0,0
../kbl_data/2021-2022,S39G01N116,고양 오리온,Home,박진철,0,0,0,0.0,0,0,0.0,0,0,0.0,0,0,0.0,0,0,0,0,0,0,0,0,0,0
../kbl_data/2021-2022,S39G01N116,고양 오리온,Home,조석호,0,0,0,0.0,0,0,0.0,0,0,0.0,0,0,0.0,0,0,0,0,0,0,0,0,0,0
../kbl_data/2021-2022,S39G01N116,고양 오리온,Home,이정현,20,3,11,27.3,3,8,37.5,6,19,31.6,5,6,83.3,1,3,4,5,0,0,0,0,3,2
../kbl_data/2021-2022,S39G01N116,안양 KGC,Away,양희종,0,0,0,0.0,0,0,0.0,0,0,0.0,0,0,0.0,0,0,0,0,0,0,0,0,0,0
../kbl_data/2021-2022,S39G01N116,안양 KGC,Away,함준후,5,1,1,100.0,1,1,100.0,2,2,100.0,0,0,0.0,1,0,1,0,1,0,0,0,0,3
../kbl_data/2021-2022,S39G01N116,안양 KGC,Away,오세근,14,5,8,62.5,0,0,0.0,5,8,62.5,4,5,80.0,0,3,3,2,1,0,0,0,0,2
../kbl_data/2021-2022,S39G01N116,안양 KGC,Away,문성곤,6,0,0,0.0,2,5,40.0,2,5,40.0,0,0,0.0,1,3,4,1,1,0,0,0,1,3
../kbl_data/2021-2022,S39G01N116,안양 KGC,Away,전성현,21,2,6,33.3,5,6,83.3,7,12,58.3,2,2,100.0,1,4,5,2,0,0,0,0,1,0
../kbl_data/2021-2022,S39G01N116,안양 KGC,Away,박지훈,7,2,2,100.0,1,1,100.0,3,3,100.0,0,0,0.0,0,0,0,0,1,0,0,0,1,3
../kbl_data/2021-2022,S39G01N116,안양 KGC,Away,이우정,0,0,0,0.0,0,0,0.0,0,0,0.0,0,0,0.0,0,0,0,0,0,0,0,0,0,0
../kbl_data/2021-2022,S39G01N116,안양 KGC,Away,대릴 먼로,0,0,0,0.0,0,0,0.0,0,0,0.0,0,0,0.0,0,0,0,0,0,0,0,0,0,0
../kbl_data/2021-2022,S39G01N116,안양 KGC,Away,우동현,0,0,0,0.0,0,0,0.0,0,0,0.0,0,0,0.0,0,0,0,0,0,0,0,0,0,0
../kbl_data/2021-2022,S39G01N116,안양 KGC,Away,변준형,13,2,4,50.0,2,7,28.6,4,11,36.4,3,4,75.0,0,3,3,9,0,1,0,0,2,3
../kbl_data/2021-2022,S39G01N116,안양 KGC,Away,한승희,0,0,0,0.0,0,0,0.0,0,0,0.0,0,0,0.0,0,0,0,0,0,0,0,0,0,1
../kbl_data/2021-2022,S39G01N116,안양 KGC,Away,오마리 스펠맨,29,6,9,66.7,5,9,55.6,11,18,61.1,2,2,100.0,2,15,17,8,1,3,0,3,6,3
../kbl_data/2021-2022,S39G01N117,창원 LG,Home,강병현,2,1,1,100.0,0,1,0.0,1,2,50.0,0,0,0.0,1,0,1,0,0,0,0,0,0,1
../kbl_data/2021-2022,S39G01N117,창원 LG,Home,변기훈,10,2,3,66.7,2,5,40.0,4,8,50.0,0,0,0.0,1,2,3,1,0,0,0,0,1,3
../kbl_data/2021-2022,S39G01N117,창원 LG,Home,이관희,14,3,3,100.0,2,5,40.0,5,8,62.5,2,4,50.0,0,3,3,2,1,0,0,0,2,4
../kbl_data/2021-2022,S39G01N117,창원 LG,Home,정희재,22,5,7,71.4,2,5,40.0,7,12,58.3,6,8,75.0,1,3,4,0,0,0,1,0,2,2
../kbl_data/2021-2022,S39G01N117,창원 LG,Home,서민수,0,0,3,0.0,0,4,0.0,0,7,0.0,0,0,0.0,1,2,3,2,0,0,0,0,2,2
../kbl_data/2021-2022,S39G01N117,창원 LG,Home,한상혁,4,2,2,100.0,0,1,0.0,2,3,66.7,0,0,0.0,0,2,2,2,0,0,0,0,0,1
../kbl_data/2021-2022,S39G01N117,창원 LG,Home,이재도,8,2,3,66.7,0,3,0.0,2,6,33.3,4,5,80.0,0,4,4,6,4,0,0,0,2,1
../kbl_data/2021-2022,S39G01N117,창원 LG,Home,박인태,4,2,2,100.0,0,0,0.0,2,2,100.0,0,0,0.0,0,1,1,0,1,0,0,0,0,1
../kbl_data/2021-2022,S39G01N117,창원 LG,Home,이광진,0,0,0,0.0,0,1,0.0,0,1,0.0,0,0,0.0,0,0,0,0,1,1,0,0,1,2
../kbl_data/2021-2022,S39G01N117,창원 LG,Home,윤원상,0,0,0,0.0,0,0,0.0,0,0,0.0,0,0,0.0,0,0,0,0,0,0,0,0,0,0
../kbl_data/2021-2022,S39G01N117,창원 LG,Home,압둘 말릭 아부,5,1,2,50.0,0,1,0.0,1,3,33.3,3,4,75.0,1,2,3,0,0,1,0,1,0,3
../kbl_data/2021-2022,S39G01N117,창원 LG,Home,아셈 마레이,12,4,7,57.1,0,0,0.0,4,7,57.1,4,8,50.0,7,4,11,6,1,0,0,0,0,3
../kbl_data/2021-2022,S39G01N117,서울 삼성,Away,김동량,4,2,2,100.0,0,0,0.0,2,2,100.0,0,0,0.0,0,1,1,1,0,0,0,0,0,0
../kbl_data/2021-2022,S39G01N117,서울 삼성,Away,장민국,0,0,2,0.0,0,1,0.0,0,3,0.0,0,0,0.0,0,2,2,1,1,0,0,0,1,2
../kbl_data/2021-2022,S39G01N117,서울 삼성,Away,김시래,13,2,6,33.3,2,5,40.0,4,11,36.4,3,4,75.0,0,2,2,4,1,0,0,0,1,3
../kbl_data/2021-2022,S39G01N117,서울 삼성,Away,김현수,5,2,3,66.7,0,4,0.0,2,7,28.6,1,1,100.0,0,3,3,1,0,0,0,0,0,3
../kbl_data/2021-2022,S39G01N117,서울 삼성,Away,임동섭,4,2,2,100.0,0,3,0.0,2,5,40.0,0,0,0.0,0,0,0,0,0,0,0,0,0,1
../kbl_data/2021-2022,S39G01N117,서울 삼성,Away,배수용,0,0,0,0.0,0,0,0.0,0,0,0.0,0,0,0.0,0,0,0,0,0,0,0,0,0,1
../kbl_data/2021-2022,S39G01N117,서울 삼성,Away,천기범,2,1,1,100.0,0,3,0.0,1,4,25.0,0,0,0.0,2,1,3,4,0,0,0,0,3,4
../kbl_data/2021-2022,S39G01N117,서울 삼성,Away,차민석,4,2,4,50.0,0,0,0.0,2,4,50.0,0,1,0.0,1,0,1,1,0,0,0,0,2,3
../kbl_data/2021-2022,S39G01N117,서울 삼성,Away,전형준,0,0,0,0.0,0,0,0.0,0,0,0.0,0,0,0.0,0,0,0,0,0,0,0,0,0,0
../kbl_data/2021-2022,S39G01N117,서울 삼성,Away,다니엘 오셰푸,12,3,8,37.5,0,1,0.0,3,9,33.3,6,10,60.0,2,5,7,2,2,1,0,0,0,0
../kbl_data/2021-2022,S39G01N117,서울 삼성,Away,이원석,15,5,6,83.3,0,0,0.0,5,6,83.3,5,8,62.5,4,1,5,0,1,2,0,0,0,3
../kbl_data/2021-2022,S39G01N117,서울 삼성,Away,토마스 로빈슨,9,4,7,57.1,0,1,0.0,4,8,50.0,1,1,100.0,1,3,4,1,1,0,0,0,4,5
../kbl_data/2021-2022,S39G01N118,안양 KGC,Home,양희종,0,0,1,0.0,0,2,0.0,0,3,0.0,0,0,0.0,1,1,2,0,1,1,0,0,0,5
../kbl_data/2021-2022,S39G01N118,안양 KGC,Home,함준후,0,0,1,0.0,0,0,0.0,0,1,0.0,0,0,0.0,1,0,1,2,0,0,0,0,0,3
../kbl_data/2021-2022,S39G01N118,안양 KGC,Home,오세근,9,3,7,42.9,0,1,0.0,3,8,37.5,3,3,100.0,1,3,4,3,0,0,0,0,0,4
../kbl_data/2021-2022,S39G01N118,안양 KGC,Home,문성곤,14,1,1,100.0,4,8,50.0,5,9,55.6,0,0,0.0,4,1,5,4,1,1,0,0,1,3
../kbl_data/2021-2022,S39G01N118,안양 KGC,Home,전성현,11,1,3,33.3,3,8,37.5,4,11,36.4,0,0,0.0,0,1,1,2,3,0,0,0,0,2
../kbl_data/2021-2022,S39G01N118,안양 KGC,Home,박지훈,2,1,3,33.3,0,2,0.0,1,5,20.0,0,0,0.0,1,0,1,2,0,0,0,0,0,1
../kbl_data/2021-2022,S39G01N118,안양 KGC,Home,정강호,0,0,0,0.0,0,0,0.0,0,0,0.0,0,0,0.0,0,0,0,0,0,0,0,0,0,0
../kbl_data/2021-2022,S39G01N118,안양 KGC,Home,이우정,0,0,0,0.0,0,0,0.0,0,0,0.0,0,0,0.0,0,0,0,0,0,0,0,0,0,0
../kbl_data/2021-2022,S39G01N118,안양 KGC,Home,대릴 먼로,0,0,0,0.0,0,0,0.0,0,0,0.0,0,0,0.0,0,0,0,0,0,0,0,0,0,0
../kbl_data/2021-2022,S39G01N118,안양 KGC,Home,우동현,3,0,0,0.0,1,3,33.3,1,3,33.3,0,0,0.0,1,0,1,0,1,0,0,0,0,2
../kbl_data/2021-2022,S39G01N118,안양 KGC,Home,변준형,10,2,2,100.0,2,9,22.2,4,11,36.4,0,0,0.0,1,4,5,9,0,0,0,0,1,4
../kbl_data/2021-2022,S39G01N118,안양 KGC,Home,오마리 스펠맨,35,9,14,64.3,5,11,45.5,14,25,56.0,2,4,50.0,1,12,13,3,0,1,0,5,0,0
../kbl_data/2021-2022,S39G01N118,대구 한국가스공사,Away,정영삼,0,0,0,0.0,0,1,0.0,0,1,0.0,0,0,0.0,0,2,2,2,0,0,0,0,0,0
../kbl_data/2021-2022,S39G01N118,대구 한국가스공사,Away,민성주,0,0,1,0.0,0,0,0.0,0,1,0.0,0,0,0.0,1,0,1,0,0,0,0,0,0,1
../kbl_data/2021-2022,S39G01N118,대구 한국가스공사,Away,홍경기,0,0,0,0.0,0,1,0.0,0,1,0.0,0,0,0.0,0,0,0,0,0,0,0,0,0,0
../kbl_data/2021-2022,S39G01N118,대구 한국가스공사,Away,조상열,12,1,1,100.0,2,5,40.0,3,6,50.0,4,5,80.0,0,3,3,2,0,0,0,0,0,2
../kbl_data/2021-2022,S39G01N118,대구 한국가스공사,Away,이대헌,19,4,5,80.0,2,3,66.7,6,8,75.0,5,7,71.4,1,10,11,4,1,0,0,0,3,3
../kbl_data/2021-2022,S39G01N118,대구 한국가스공사,Away,두경민,2,0,4,0.0,0,3,0.0,0,7,0.0,2,2,100.0,1,0,1,8,0,0,0,0,4,0
../kbl_data/2021-2022,S39G01N118,대구 한국가스공사,Away,박봉진,0,0,0,0.0,0,0,0.0,0,0,0.0,0,0,0.0,0,0,0,0,0,0,0,0,0,0
../kbl_data/2021-2022,S39G01N118,대구 한국가스공사,Away,김낙현,19,2,4,50.0,4,11,36.4,6,15,40.0,3,3,100.0,0,1,1,4,1,0,0,0,3,2
../kbl_data/2021-2022,S39G01N118,대구 한국가스공사,Away,전현우,9,1,1,100.0,2,3,66.7,3,4,75.0,1,2,50.0,1,0,1,1,0,0,0,0,0,4
../kbl_data/2021-2022,S39G01N118,대구 한국가스공사,Away,이윤기,0,0,0,0.0,0,0,0.0,0,0,0.0,0,0,0.0,0,0,0,0,0,0,0,0,0,0
../kbl_data/2021-2022,S39G01N118,대구 한국가스공사,Away,클리프 알렉산더,24,10,17,58.8,0,0,0.0,10,17,58.8,4,4,100.0,4,18,22,0,0,1,0,5,0,2
../kbl_data/2021-2022,S39G01N118,대구 한국가스공사,Away,신승민,0,0,0,0.0,0,0,0.0,0,0,0.0,0,0,0.0,0,0,0,0,0,0,0,0,0,4
../kbl_data/2021-2022,S39G01N119,원주 DB,Home,윤호영,3,0,0,0.0,1,2,50.0,1,2,50.0,0,0,0.0,0,1,1,2,0,0,0,0,0,1
../kbl_data/2021-2022,S39G01N119,원주 DB,Home,박찬희,7,3,3,100.0,0,2,0.0,3,5,60.0,1,2,50.0,0,0,0,1,0,0,0,0,0,0
../kbl_data/2021-2022,S39G01N119,원주 DB,Home,정준원,0,0,1,0.0,0,0,0.0,0,1,0.0,0,0,0.0,0,1,1,0,0,0,0,0,0,2
../kbl_data/2021-2022,S39G01N119,원주 DB,Home,박경상,0,0,2,0.0,0,2,0.0,0,4,0.0,0,0,0.0,1,4,5,3,0,0,0,0,3,2
../kbl_data/2021-2022,S39G01N119,원주 DB,Home,김종규,7,2,5,40.0,1,2,50.0,3,7,42.9,0,0,0.0,0,2,2,0,1,0,0,1,1,5
../kbl_data/2021-2022,S39G01N119,원주 DB,Home,허웅,18,3,6,50.0,3,6,50.0,6,12,50.0,3,4,75.0,0,1,1,5,0,0,0,0,4,0
../kbl_data/2021-2022,S39G01N119,원주 DB,Home,강상재,9,1,2,50.0,1,5,20.0,2,7,28.6,4,4,100.0,3,2,5,3,2,0,0,0,0,1
../kbl_data/2021-2022,S39G01N119,원주 DB,Home,김훈,6,0,0,0.0,2,4,50.0,2,4,50.0,0,0,0.0,1,0,1,0,1,1,0,0,1,3
../kbl_data/2021-2022,S39G01N119,원주 DB,Home,이준희,0,0,1,0.0,0,0,0.0,0,1,0.0,0,0,0.0,1,0,1,0,2,0,0,0,0,0
../kbl_data/2021-2022,S39G01N119,원주 DB,Home,레나드 프리먼,12,4,7,57.1,0,0,0.0,4,7,57.1,4,6,66.7,0,5,5,0,2,0,0,0,3,2
../kbl_data/2021-2022,S39G01N119,원주 DB,Home,정호영,4,2,4,50.0,0,2,0.0,2,6,33.3,0,0,0.0,0,3,3,1,0,0,0,0,3,3
../kbl_data/2021-2022,S39G01N119,원주 DB,Home,조니 오브라이언트,6,2,4,50.0,0,5,0.0,2,9,22.2,2,2,100.0,3,4,7,3,1,0,0,0,1,3
../kbl_data/2021-2022,S39G01N119,서울 SK,Away,양우섭,2,0,0,0.0,0,0,0.0,0,0,0.0,2,2,100.0,1,0,1,0,1,0,0,0,1,0
../kbl_data/2021-2022,S39G01N119,서울 SK,Away,허일영,7,3,4,75.0,0,3,0.0,3,7,42.9,1,2,50.0,2,1,3,0,0,0,0,0,0,3
../kbl_data/2021-2022,S39G01N119,서울 SK,Away,김선형,11,1,5,20.0,1,4,25.0,2,9,22.2,6,6,100.0,3,3,6,6,5,0,0,0,2,1
../kbl_data/2021-2022,S39G01N119,서울 SK,Away,최부경,2,1,3,33.3,0,0,0.0,1,3,33.3,0,0,0.0,1,1,2,0,0,0,0,0,0,1
../kbl_data/2021-2022,S39G01N119,서울 SK,Away,리온 윌리엄스,3,1,5,20.0,0,0,0.0,1,5,20.0,1,2,50.0,4,2,6,0,0,0,0,0,1,3
../kbl_data/2021-2022,S39G01N119,서울 SK,Away,배병준,0,0,0,0.0,0,1,0.0,0,1,0.0,0,0,0.0,0,0,0,0,0,0,1,0,0,0
../kbl_data/2021-2022,S39G01N119,서울 SK,Away,이현석,0,0,0,0.0,0,1,0.0,0,1,0.0,0,0,0.0,0,0,0,0,1,0,0,0,0,2
../kbl_data/2021-2022,S39G01N119,서울 SK,Away,최원혁,0,0,1,0.0,0,2,0.0,0,3,0.0,0,0,0.0,1,1,2,1,4,0,0,0,0,2
../kbl_data/2021-2022,S39G01N119,서울 SK,Away,최준용,19,5,9,55.6,1,2,50.0,6,11,54.5,6,8,75.0,1,3,4,0,1,1,0,0,5,1
../kbl_data/2021-2022,S39G01N119,서울 SK,Away,안영준,12,3,6,50.0,1,4,25.0,4,10,40.0,3,4,75.0,0,2,2,0,0,0,0,0,1,1
../kbl_data/2021-2022,S39G01N119,서울 SK,Away,자밀 워니,21,10,18,55.6,0,0,0.0,10,18,55.6,1,1,100.0,3,13,16,5,1,1,0,0,2,1
../kbl_data/2021-2022,S39G01N119,서울 SK,Away,오재현,8,4,4,100.0,0,0,0.0,4,4,100.0,0,0,0.0,0,0,0,1,0,0,0,0,0,4
../kbl_data/2021-2022,S39G01N120,수원 KT,Home,김동욱,7,2,2,100.0,1,2,50.0,3,4,75.0,0,0,0.0,0,2,2,4,1,0,0,0,0,0
../kbl_data/2021-2022,S39G01N120,수원 KT,Home,김영환,11,1,4,25.0,3,3,100.0,4,7,57.1,0,0,0.0,1,0,1,1,1,0,0,0,0,2
../kbl_data/2021-2022,S39G01N120,수원 KT,Home,김현민,0,0,0,0.0,0,0,0.0,0,0,0.0,0,0,0.0,0,0,0,0,0,0,0,0,0,0
../kbl_data/2021-2022,S39G01N120,수원 KT,Home,최창진,1,0,0,0.0,0,1,0.0,0,1,0.0,1,2,50.0,0,2,2,1,2,0,0,0,0,2
../kbl_data/2021-2022,S39G01N120,수원 KT,Home,정성우,5,1,1,100.0,1,4,25.0,2,5,40.0,0,0,0.0,0,0,0,3,0,1,0,0,2,2
../kbl_data/2021-2022,S39G01N120,수원 KT,Home,최성모,6,1,1,100.0,1,1,100.0,2,2,100.0,1,2,50.0,0,1,1,0,0,0,0,0,0,2
../kbl_data/2021-2022,S39G01N120,수원 KT,Home,허훈,3,0,1,0.0,0,5,0.0,0,6,0.0,3,3,100.0,0,0,0,5,0,0,0,0,2,2
../kbl_data/2021-2022,S39G01N120,수원 KT,Home,양홍석,21,5,6,83.3,3,5,60.0,8,11,72.7,2,2,100.0,2,3,5,4,1,0,0,0,3,1
../kbl_data/2021-2022,S39G01N120,수원 KT,Home,박준영,10,5,6,83.3,0,2,0.0,5,8,62.5,0,0,0.0,1,4,5,6,1,0,0,0,0,3
../kbl_data/2021-2022,S39G01N120,수원 KT,Home,캐디 라렌,20,6,11,54.5,1,2,50.0,7,13,53.8,5,6,83.3,2,9,11,1,0,2,0,2,1,2
../kbl_data/2021-2022,S39G01N120,수원 KT,Home,박지원,0,0,1,0.0,0,0,0.0,0,1,0.0,0,0,0.0,0,0,0,3,0,0,0,0,1,2
../kbl_data/2021-2022,S39G01N120,수원 KT,Home,마이크 마이어스,16,8,9,88.9,0,0,0.0,8,9,88.9,0,2,0.0,4,4,8,0,2,1,0,1,1,2
../kbl_data/2021-2022,S39G01N120,전주 KCC,Away,송창용,4,2,3,66.7,0,2,0.0,2,5,40.0,0,0,0.0,1,3,4,3,0,0,2,0,2,0
../kbl_data/2021-2022,S39G01N120,전주 KCC,Away,이정현,11,4,7,57.1,1,2,50.0,5,9,55.6,0,0,0.0,0,1,1,2,0,0,0,0,0,2
../kbl_data/2021-2022,S39G01N120,전주 KCC,Away,정창영,7,1,2,50.0,0,0,0.0,1,2,50.0,5,6,83.3,0,1,1,1,1,0,0,0,1,0
../kbl_data/2021-2022,S39G01N120,전주 KCC,Away,라건아,15,3,5,60.0,3,4,75.0,6,9,66.7,0,0,0.0,0,5,5,0,1,1,0,0,3,2
../kbl_data/2021-2022,S39G01N120,전주 KCC,Away,김상규,7,2,4,50.0,0,2,0.0,2,6,33.3,3,5,60.0,1,0,1,2,0,1,0,0,1,1
../kbl_data/2021-2022,S39G01N120,전주 KCC,Away,유병훈,9,3,4,75.0,1,3,33.3,4,7,57.1,0,0,0.0,0,0,0,3,0,0,0,0,0,3
../kbl_data/2021-2022,S39G01N120,전주 KCC,Away,박재현,2,1,3,33.3,0,0,0.0,1,3,33.3,0,0,0.0,0,0,0,0,1,0,0,0,2,2
../kbl_data/2021-2022,S39G01N120,전주 KCC,Away,이진욱,0,0,0,0.0,0,1,0.0,0,1,0.0,0,0,0.0,0,0,0,3,0,0,0,0,2,1
../kbl_data/2021-2022,S39G01N120,전주 KCC,Away,라타비우스 윌리엄스,17,5,10,50.0,2,2,100.0,7,12,58.3,1,2,50.0,6,4,10,0,3,0,0,1,0,2
../kbl_data/2021-2022,S39G01N120,전주 KCC,Away,곽정훈,1,0,0,0.0,0,0,0.0,0,0,0.0,1,2,50.0,0,0,0,0,0,0,0,0,0,0
../kbl_data/2021-2022,S39G01N120,전주 KCC,Away,이근휘,6,3,4,75.0,0,4,0.0,3,8,37.5,0,0,0.0,0,0,0,0,0,0,0,0,0,3
../kbl_data/2021-2022,S39G01N120,전주 KCC,Away,김동현,1,0,0,0.0,0,0,0.0,0,0,0.0,1,2,50.0,0,0,0,2,0,0,0,0,0,2
../kbl_data/2021-2022,S39G01N121,고양 오리온,Home,오용준,0,0,0,0.0,0,0,0.0,0,0,0.0,0,0,0.0,0,0,0,0,0,0,0,0,0,0
../kbl_data/2021-2022,S39G01N121,고양 오리온,Home,임종일,6,0,0,0.0,2,3,66.7,2,3,66.7,0,0,0.0,1,0,1,1,0,0,0,0,1,4
../kbl_data/2021-2022,S39G01N121,고양 오리온,Home,이대성,36,8,11,72.7,5,10,50.0,13,21,61.9,5,6,83.3,2,1,3,2,1,0,0,0,6,2
../kbl_data/2021-2022,S39G01N121,고양 오리온,Home,이정제,0,0,0,0.0,0,0,0.0,0,0,0.0,0,0,0.0,0,0,0,0,0,0,0,0,0,0
../kbl_data/2021-2022,S39G01N121,고양 오리온,Home,최승욱,0,0,0,0.0,0,0,0.0,0,0,0.0,0,0,0.0,0,0,0,0,0,0,0,0,0,0
../kbl_data/2021-2022,S39G01N121,고양 오리온,Home,이승현,12,6,12,50.0,0,3,0.0,6,15,40.0,0,0,0.0,0,3,3,2,8,1,0,0,1,1
../kbl_data/2021-2022,S39G01N121,고양 오리온,Home,김진유,0,0,1,0.0,0,2,0.0,0,3,0.0,0,0,0.0,0,2,2,1,0,0,0,0,1,3
../kbl_data/2021-2022,S39G01N121,고양 오리온,Home,머피 할로웨이,27,12,19,63.2,0,1,0.0,12,20,60.0,3,4,75.0,7,20,27,7,3,2,0,2,3,2
../kbl_data/2021-2022,S39G01N121,고양 오리온,Home,조한진,2,0,0,0.0,0,0,0.0,0,0,0.0,2,2,100.0,0,3,3,0,0,0,0,0,0,2
../kbl_data/2021-2022,S39G01N121,고양 오리온,Home,김세창,0,0,0,0.0,0,0,0.0,0,0,0.0,0,0,0.0,0,0,0,0,0,0,0,0,0,0
../kbl_data/2021-2022,S39G01N121,고양 오리온,Home,박진철,0,0,0,0.0,0,0,0.0,0,0,0.0,0,0,0.0,0,0,0,0,0,0,0,0,0,0
../kbl_data/2021-2022,S39G01N121,고양 오리온,Home,이정현,15,5,9,55.6,1,7,14.3,6,16,37.5,2,2,100.0,0,0,0,2,2,1,1,0,4,4
../kbl_data/2021-2022,S39G01N121,울산 현대모비스,Away,이현민,1,0,1,0.0,0,2,0.0,0,3,0.0,1,1,100.0,0,0,0,3,1,0,0,0,0,0
../kbl_data/2021-2022,S39G01N121,울산 현대모비스,Away,함지훈,15,5,6,83.3,1,1,100.0,6,7,85.7,2,2,100.0,2,3,5,6,1,0,0,0,3,0
../kbl_data/2021-2022,S39G01N121,울산 현대모비스,Away,최진수,0,0,0,0.0,0,1,0.0,0,1,0.0,0,0,0.0,0,0,0,0,0,0,0,0,0,1
../kbl_data/2021-2022,S39G01N121,울산 현대모비스,Away,박지훈,5,1,3,33.3,1,3,33.3,2,6,33.3,0,0,0.0,1,1,2,0,0,0,0,0,0,4
../kbl_data/2021-2022,S39G01N121,울산 현대모비스,Away,장재석,8,3,5,60.0,0,0,0.0,3,5,60.0,2,4,50.0,0,3,3,4,1,1,0,0,0,3
../kbl_data/2021-2022,S39G01N121,울산 현대모비스,Away,김국찬,10,2,5,40.0,2,5,40.0,4,10,40.0,0,0,0.0,1,1,2,1,1,0,0,0,4,1
../kbl_data/2021-2022,S39G01N121,울산 현대모비스,Away,서명진,13,5,10,50.0,1,7,14.3,6,17,35.3,0,0,0.0,1,4,5,10,0,0,0,0,2,1
../kbl_data/2021-2022,S39G01N121,울산 현대모비스,Away,이우석,16,6,8,75.0,1,2,50.0,7,10,70.0,1,4,25.0,1,2,3,1,0,0,0,0,4,0
../kbl_data/2021-2022,S39G01N121,울산 현대모비스,Away,라숀 토마스,27,12,17,70.6,0,0,0.0,12,17,70.6,3,5,60.0,4,13,17,4,2,3,0,4,5,4
../kbl_data/2021-2022,S39G01N121,울산 현대모비스,Away,신민석,0,0,0,0.0,0,1,0.0,0,1,0.0,0,0,0.0,0,0,0,0,0,0,0,0,0,1
../kbl_data/2021-2022,S39G01N121,울산 현대모비스,Away,김동준,0,0,0,0.0,0,0,0.0,0,0,0.0,0,0,0.0,0,0,0,0,0,0,0,0,0,0
../kbl_data/2021-2022,S39G01N121,울산 현대모비스,Away,에릭 버크너,0,0,0,0.0,0,0,0.0,0,0,0.0,0,0,0.0,0,1,1,1,0,0,0,0,0,0
../kbl_data/2021-2022,S39G01N122,창원 LG,Home,강병현,14,3,3,100.0,2,3,66.7,5,6,83.3,2,3,66.7,0,1,1,0,0,0,0,0,0,2
../kbl_data/2021-2022,S39G01N122,창원 LG,Home,변기훈,0,0,0,0.0,0,3,0.0,0,3,0.0,0,0,0.0,1,0,1,0,1,0,0,0,1,0
../kbl_data/2021-2022,S39G01N122,창원 LG,Home,이관희,12,3,10,30.0,2,4,50.0,5,14,35.7,0,0,0.0,1,1,2,3,0,0,0,0,2,1
../kbl_data/2021-2022,S39G01N122,창원 LG,Home,정희재,13,1,2,50.0,1,3,33.3,2,5,40.0,8,9,88.9,1,1,2,0,0,0,0,0,0,2
../kbl_data/2021-2022,S39G01N122,창원 LG,Home,서민수,5,1,2,50.0,1,1,100.0,2,3,66.7,0,0,0.0,0,4,4,0,0,0,0,0,0,1
../kbl_data/2021-2022,S39G01N122,창원 LG,Home,한상혁,2,1,1,100.0,0,0,0.0,1,1,100.0,0,0,0.0,0,0,0,1,0,0,0,0,0,1
../kbl_data/2021-2022,S39G01N122,창원 LG,Home,이재도,12,2,5,40.0,2,7,28.6,4,12,33.3,2,2,100.0,0,0,0,7,0,0,0,0,0,2
../kbl_data/2021-2022,S39G01N122,창원 LG,Home,박인태,0,0,0,0.0,0,0,0.0,0,0,0.0,0,0,0.0,0,1,1,0,0,0,0,0,0,0
../kbl_data/2021-2022,S39G01N122,창원 LG,Home,정인덕,0,0,1,0.0,0,0,0.0,0,1,0.0,0,0,0.0,0,1,1,0,0,0,0,0,0,0
../kbl_data/2021-2022,S39G01N122,창원 LG,Home,윤원상,8,1,1,100.0,2,3,66.7,3,4,75.0,0,0,0.0,0,1,1,0,0,0,0,0,0,5
../kbl_data/2021-2022,S39G01N122,창원 LG,Home,압둘 말릭 아부,0,0,0,0.0,0,0,0.0,0,0,0.0,0,0,0.0,1,0,1,0,0,0,0,0,1,0
../kbl_data/2021-2022,S39G01N122,창원 LG,Home,아셈 마레이,18,7,11,63.6,0,0,0.0,7,11,63.6,4,8,50.0,8,12,20,7,5,0,0,0,4,2
../kbl_data/2021-2022,S39G01N122,원주 DB,Away,박찬희,6,1,2,50.0,1,1,100.0,2,3,66.7,1,2,50.0,0,1,1,2,0,0,0,0,0,0
../kbl_data/2021-2022,S39G01N122,원주 DB,Away,정준원,0,0,0,0.0,0,1,0.0,0,1,0.0,0,0,0.0,0,0,0,0,0,0,0,0,0,3
../kbl_data/2021-2022,S39G01N122,원주 DB,Away,박경상,0,0,0,0.0,0,1,0.0,0,1,0.0,0,0,0.0,2,1,3,1,0,0,0,0,1,1
../kbl_data/2021-2022,S39G01N122,원주 DB,Away,김종규,4,2,5,40.0,0,1,0.0,2,6,33.3,0,0,0.0,0,2,2,0,0,0,0,0,0,3
../kbl_data/2021-2022,S39G01N122,원주 DB,Away,허웅,12,3,8,37.5,1,5,20.0,4,13,30.8,3,3,100.0,0,1,1,5,2,0,0,0,1,3
../kbl_data/2021-2022,S39G01N122,원주 DB,Away,김영훈,0,0,0,0.0,0,1,0.0,0,1,0.0,0,0,0.0,1,0,1,0,0,0,0,0,0,2
../kbl_data/2021-2022,S39G01N122,원주 DB,Away,맹상훈,0,0,1,0.0,0,3,0.0,0,4,0.0,0,0,0.0,0,0,0,1,0,0,0,0,0,0
../kbl_data/2021-2022,S39G01N122,원주 DB,Away,강상재,9,3,3,100.0,1,3,33.3,4,6,66.7,0,0,0.0,2,4,6,3,0,0,0,0,5,1
../kbl_data/2021-2022,S39G01N122,원주 DB,Away,김훈,9,0,2,0.0,3,5,60.0,3,7,42.9,0,0,0.0,1,0,1,2,0,0,0,0,0,1
../kbl_data/2021-2022,S39G01N122,원주 DB,Away,이준희,16,5,5,100.0,2,4,50.0,7,9,77.8,0,0,0.0,0,2,2,1,0,0,0,0,1,4
../kbl_data/2021-2022,S39G01N122,원주 DB,Away,레나드 프리먼,9,4,4,100.0,0,1,0.0,4,5,80.0,1,2,50.0,1,2,3,1,2,0,0,2,0,3
../kbl_data/2021-2022,S39G01N122,원주 DB,Away,조니 오브라이언트,10,2,4,50.0,2,4,50.0,4,8,50.0,0,0,0.0,1,5,6,1,2,1,0,0,0,2
../kbl_data/2021-2022,S39G01N123,서울 SK,Home,양우섭,4,2,3,66.7,0,0,0.0,2,3,66.7,0,0,0.0,1,2,3,0,1,0,0,0,0,1
../kbl_data/2021-2022,S39G01N123,서울 SK,Home,허일영,7,1,2,50.0,1,1,100.0,2,3,66.7,2,2,100.0,0,1,1,0,0,0,0,0,0,2
../kbl_data/2021-2022,S39G01N123,서울 SK,Home,김선형,10,3,6,50.0,0,1,0.0,3,7,42.9,4,6,66.7,0,2,2,7,0,0,0,0,1,1
../kbl_data/2021-2022,S39G01N123,서울 SK,Home,최부경,2,1,2,50.0,0,1,0.0,1,3,33.3,0,0,0.0,0,2,2,0,0,0,0,0,0,4
../kbl_data/2021-2022,S39G01N123,서울 SK,Home,리온 윌리엄스,8,4,4,100.0,0,0,0.0,4,4,100.0,0,0,0.0,0,2,2,0,0,1,0,0,1,4
../kbl_data/2021-2022,S39G01N123,서울 SK,Home,배병준,0,0,0,0.0,0,0,0.0,0,0,0.0,0,0,0.0,0,0,0,0,0,0,0,0,0,0
../kbl_data/2021-2022,S39G01N123,서울 SK,Home,이현석,0,0,0,0.0,0,0,0.0,0,0,0.0,0,0,0.0,0,0,0,0,0,0,0,0,0,0
../kbl_data/2021-2022,S39G01N123,서울 SK,Home,최원혁,0,0,1,0.0,0,1,0.0,0,2,0.0,0,0,0.0,1,1,2,2,0,0,0,0,1,2
../kbl_data/2021-2022,S39G01N123,서울 SK,Home,최준용,16,4,8,50.0,2,5,40.0,6,13,46.2,2,3,66.7,1,5,6,3,2,3,0,1,3,4
../kbl_data/2021-2022,S39G01N123,서울 SK,Home,안영준,17,6,10,60.0,1,2,50.0,7,12,58.3,2,6,33.3,1,4,5,2,1,0,0,0,0,0
../kbl_data/2021-2022,S39G01N123,서울 SK,Home,자밀 워니,19,9,13,69.2,0,1,0.0,9,14,64.3,1,2,50.0,2,6,8,3,1,1,0,0,2,0
../kbl_data/2021-2022,S39G01N123,서울 SK,Home,오재현,1,0,1,0.0,0,1,0.0,0,2,0.0,1,2,50.0,1,0,1,1,0,1,0,0,0,2
../kbl_data/2021-2022,S39G01N123,서울 삼성,Away,김동량,4,2,3,66.7,0,0,0.0,2,3,66.7,0,0,0.0,0,2,2,1,0,0,0,0,1,1
../kbl_data/2021-2022,S39G01N123,서울 삼성,Away,장민국,11,1,2,50.0,2,9,22.2,3,11,27.3,3,3,100.0,3,0,3,2,1,0,1,0,1,4
../kbl_data/2021-2022,S39G01N123,서울 삼성,Away,김시래,4,0,4,0.0,1,3,33.3,1,7,14.3,1,2,50.0,1,2,3,5,1,0,0,0,2,3
../kbl_data/2021-2022,S39G01N123,서울 삼성,Away,김현수,13,2,3,66.7,3,6,50.0,5,9,55.6,0,0,0.0,0,1,1,1,0,0,0,0,0,0
../kbl_data/2021-2022,S39G01N123,서울 삼성,Away,임동섭,5,1,3,33.3,1,7,14.3,2,10,20.0,0,0,0.0,0,2,2,2,1,0,0,0,0,2
../kbl_data/2021-2022,S39G01N123,서울 삼성,Away,천기범,6,2,3,66.7,0,1,0.0,2,4,50.0,2,2,100.0,0,1,1,4,0,0,1,0,0,4
../kbl_data/2021-2022,S39G01N123,서울 삼성,Away,강바일,0,0,0,0.0,0,0,0.0,0,0,0.0,0,0,0.0,0,0,0,0,0,0,0,0,0,0
../kbl_data/2021-2022,S39G01N123,서울 삼성,Away,차민석,0,0,0,0.0,0,0,0.0,0,0,0.0,0,0,0.0,0,0,0,0,0,0,0,0,0,0
../kbl_data/2021-2022,S39G01N123,서울 삼성,Away,전형준,3,0,0,0.0,1,1,100.0,1,1,100.0,0,0,0.0,0,0,0,0,0,0,0,0,0,1
../kbl_data/2021-2022,S39G01N123,서울 삼성,Away,다니엘 오셰푸,22,9,13,69.2,0,0,0.0,9,13,69.2,4,6,66.7,2,8,10,2,0,0,0,1,1,0
../kbl_data/2021-2022,S39G01N123,서울 삼성,Away,이원석,0,0,0,0.0,0,0,0.0,0,0,0.0,0,0,0.0,1,0,1,0,0,0,0,0,1,0
../kbl_data/2021-2022,S39G01N123,서울 삼성,Away,토마스 로빈슨,10,5,11,45.5,0,0,0.0,5,11,45.5,0,0,0.0,3,7,10,4,0,0,0,0,4,1
../kbl_data/2021-2022,S39G01N124,안양 KGC,Home,양희종,9,0,3,0.0,3,3,100.0,3,6,50.0,0,0,0.0,2,0,2,0,0,1,0,0,1,1
../kbl_data/2021-2022,S39G01N124,안양 KGC,Home,함준후,0,0,0,0.0,0,0,0.0,0,0,0.0,0,0,0.0,0,0,0,0,0,0,0,0,0,1
../kbl_data/2021-2022,S39G01N124,안양 KGC,Home,오세근,16,8,12,66.7,0,0,0.0,8,12,66.7,0,1,0.0,4,4,8,2,0,0,0,0,0,3
../kbl_data/2021-2022,S39G01N124,안양 KGC,Home,문성곤,5,1,1,100.0,1,5,20.0,2,6,33.3,0,0,0.0,3,2,5,1,1,0,1,0,0,4
../kbl_data/2021-2022,S39G01N124,안양 KGC,Home,전성현,14,2,4,50.0,2,10,20.0,4,14,28.6,4,4,100.0,2,2,4,2,0,0,0,0,0,1
../kbl_data/2021-2022,S39G01N124,안양 KGC,Home,박지훈,2,1,1,100.0,0,1,0.0,1,2,50.0,0,2,0.0,0,0,0,4,1,0,0,0,0,3
../kbl_data/2021-2022,S39G01N124,안양 KGC,Home,이우정,0,0,0,0.0,0,0,0.0,0,0,0.0,0,0,0.0,0,0,0,0,0,0,0,0,0,0
../kbl_data/2021-2022,S39G01N124,안양 KGC,Home,대릴 먼로,0,0,0,0.0,0,0,0.0,0,0,0.0,0,0,0.0,0,0,0,0,0,0,0,0,0,0
../kbl_data/2021-2022,S39G01N124,안양 KGC,Home,우동현,0,0,0,0.0,0,0,0.0,0,0,0.0,0,0,0.0,0,0,0,0,0,0,0,0,0,0
../kbl_data/2021-2022,S39G01N124,안양 KGC,Home,변준형,31,9,12,75.0,3,8,37.5,12,20,60.0,4,5,80.0,4,1,5,5,0,0,0,0,3,1
../kbl_data/2021-2022,S39G01N124,안양 KGC,Home,한승희,0,0,0,0.0,0,0,0.0,0,0,0.0,0,0,0.0,0,0,0,0,0,0,0,0,0,0
../kbl_data/2021-2022,S39G01N124,안양 KGC,Home,오마리 스펠맨,19,6,10,60.0,2,7,28.6,8,17,47.1,1,1,100.0,1,12,13,4,0,0,0,3,0,0
../kbl_data/2021-2022,S39G01N124,전주 KCC,Away,송창용,14,3,4,75.0,2,3,66.7,5,7,71.4,2,2,100.0,1,4,5,0,0,0,0,0,0,1
../kbl_data/2021-2022,S39G01N124,전주 KCC,Away,이정현,5,1,2,50.0,1,2,50.0,2,4,50.0,0,0,0.0,0,4,4,3,0,0,0,0,0,1
../kbl_data/2021-2022,S39G01N124,전주 KCC,Away,정창영,3,0,0,0.0,1,2,50.0,1,2,50.0,0,0,0.0,0,1,1,0,0,0,0,0,1,0
../kbl_data/2021-2022,S39G01N124,전주 KCC,Away,라건아,9,3,4,75.0,1,1,100.0,4,5,80.0,0,0,0.0,0,1,1,3,0,1,0,0,0,2
../kbl_data/2021-2022,S39G01N124,전주 KCC,Away,김상규,6,1,2,50.0,0,0,0.0,1,2,50.0,4,4,100.0,0,3,3,2,0,0,0,0,1,2
../kbl_data/2021-2022,S39G01N124,전주 KCC,Away,유병훈,12,2,6,33.3,2,2,100.0,4,8,50.0,2,2,100.0,0,2,2,2,2,0,0,0,0,3
../kbl_data/2021-2022,S39G01N124,전주 KCC,Away,박재현,13,3,6,50.0,1,3,33.3,4,9,44.4,4,5,80.0,0,3,3,4,0,0,0,0,1,4
../kbl_data/2021-2022,S39G01N124,전주 KCC,Away,이진욱,3,1,2,50.0,0,1,0.0,1,3,33.3,1,1,100.0,1,2,3,2,0,0,0,0,2,4
../kbl_data/2021-2022,S39G01N124,전주 KCC,Away,김진용,0,0,0,0.0,0,0,0.0,0,0,0.0,0,0,0.0,0,0,0,0,0,0,0,0,0,0
../kbl_data/2021-2022,S39G01N124,전주 KCC,Away,라타비우스 윌리엄스,12,6,9,66.7,0,0,0.0,6,9,66.7,0,0,0.0,2,2,4,3,0,0,0,3,1,2
../kbl_data/2021-2022,S39G01N124,전주 KCC,Away,곽정훈,0,0,0,0.0,0,0,0.0,0,0,0.0,0,0,0.0,0,0,0,0,0,0,0,0,0,0
../kbl_data/2021-2022,S39G01N124,전주 KCC,Away,이근휘,15,6,7,85.7,1,9,11.1,7,16,43.8,0,0,0.0,1,0,1,1,0,0,0,0,0,2
../kbl_data/2021-2022,S39G01N125,대구 한국가스공사,Home,민성주,6,3,4,75.0,0,0,0.0,3,4,75.0,0,0,0.0,1,1,2,0,0,0,1,0,0,2
../kbl_data/2021-2022,S39G01N125,대구 한국가스공사,Home,홍경기,0,0,0,0.0,0,1,0.0,0,1,0.0,0,0,0.0,0,0,0,0,0,0,0,0,0,2
../kbl_data/2021-2022,S39G01N125,대구 한국가스공사,Home,조상열,2,0,1,0.0,0,1,0.0,0,2,0.0,2,2,100.0,2,0,2,2,0,0,0,0,1,0
../kbl_data/2021-2022,S39G01N125,대구 한국가스공사,Home,이대헌,5,2,9,22.2,0,2,0.0,2,11,18.2,1,3,33.3,1,1,2,4,1,0,0,0,1,2
../kbl_data/2021-2022,S39G01N125,대구 한국가스공사,Home,두경민,2,1,2,50.0,0,1,0.0,1,3,33.3,0,0,0.0,0,1,1,2,1,0,0,0,0,0
../kbl_data/2021-2022,S39G01N125,대구 한국가스공사,Home,박봉진,0,0,0,0.0,0,0,0.0,0,0,0.0,0,0,0.0,0,0,0,0,0,0,0,0,0,0
../kbl_data/2021-2022,S39G01N125,대구 한국가스공사,Home,김낙현,9,0,2,0.0,3,8,37.5,3,10,30.0,0,0,0.0,0,0,0,1,2,0,0,0,1,1
../kbl_data/2021-2022,S39G01N125,대구 한국가스공사,Home,전현우,11,3,4,75.0,1,8,12.5,4,12,33.3,2,2,100.0,0,1,1,0,0,0,0,0,2,2
../kbl_data/2021-2022,S39G01N125,대구 한국가스공사,Home,이윤기,2,1,3,33.3,0,1,0.0,1,4,25.0,0,0,0.0,0,1,1,0,0,1,0,0,1,3
../kbl_data/2021-2022,S39G01N125,대구 한국가스공사,Home,양준우,6,0,1,0.0,2,2,100.0,2,3,66.7,0,0,0.0,1,1,2,0,0,0,0,0,4,2
../kbl_data/2021-2022,S39G01N125,대구 한국가스공사,Home,클리프 알렉산더,20,10,20,50.0,0,0,0.0,10,20,50.0,0,1,0.0,7,12,19,3,1,0,0,5,2,1
../kbl_data/2021-2022,S39G01N125,대구 한국가스공사,Home,신승민,2,1,3,33.3,0,1,0.0,1,4,25.0,0,0,0.0,3,1,4,0,0,0,0,0,1,2
../kbl_data/2021-2022,S39G01N125,울산 현대모비스,Away,이현민,9,3,4,75.0,1,2,50.0,4,6,66.7,0,0,0.0,1,2,3,8,2,0,1,0,1,2
../kbl_data/2021-2022,S39G01N125,울산 현대모비스,Away,함지훈,12,6,9,66.7,0,0,0.0,6,9,66.7,0,0,0.0,4,3,7,8,1,1,0,0,2,0
../kbl_data/2021-2022,S39G01N125,울산 현대모비스,Away,최진수,5,1,2,50.0,1,2,50.0,2,4,50.0,0,0,0.0,0,1,1,2,0,0,0,0,0,1
../kbl_data/2021-2022,S39G01N125,울산 현대모비스,Away,박지훈,0,0,0,0.0,0,2,0.0,0,2,0.0,0,0,0.0,0,0,0,1,0,0,0,0,0,0
../kbl_data/2021-2022,S39G01N125,울산 현대모비스,Away,장재석,0,0,1,0.0,0,0,0.0,0,1,0.0,0,0,0.0,0,0,0,1,0,0,0,0,0,1
../kbl_data/2021-2022,S39G01N125,울산 현대모비스,Away,김국찬,10,1,2,50.0,2,4,50.0,3,6,50.0,2,2,100.0,0,1,1,1,0,1,0,0,1,1
../kbl_data/2021-2022,S39G01N125,울산 현대모비스,Away,이우석,15,4,5,80.0,2,7,28.6,6,12,50.0,1,2,50.0,0,6,6,4,1,0,0,0,3,2
../kbl_data/2021-2022,S39G01N125,울산 현대모비스,Away,라숀 토마스,20,9,13,69.2,0,0,0.0,9,13,69.2,2,3,66.7,1,6,7,1,1,2,0,3,1,3
../kbl_data/2021-2022,S39G01N125,울산 현대모비스,Away,신민석,5,1,1,100.0,1,2,50.0,2,3,66.7,0,0,0.0,0,1,1,0,1,0,0,0,0,0
../kbl_data/2021-2022,S39G01N125,울산 현대모비스,Away,김동준,14,1,3,33.3,4,4,100.0,5,7,71.4,0,0,0.0,0,1,1,6,2,0,1,0,0,1
../kbl_data/2021-2022,S39G01N125,울산 현대모비스,Away,윤성준,3,0,0,0.0,1,1,100.0,1,1,100.0,0,0,0.0,0,0,0,1,1,0,0,0,0,0
../kbl_data/2021-2022,S39G01N125,울산 현대모비스,Away,에릭 버크너,11,5,5,100.0,0,0,0.0,5,5,100.0,1,1,100.0,1,7,8,3,0,0,0,1,1,2
../kbl_data/2021-2022,S39G01N126,수원 KT,Home,김동욱,6,0,2,0.0,2,10,20.0,2,12,16.7,0,0,0.0,0,1,1,2,1,0,0,0,0,1
../kbl_data/2021-2022,S39G01N126,수원 KT,Home,김영환,10,5,5,100.0,0,3,0.0,5,8,62.5,0,0,0.0,2,0,2,2,0,0,0,0,2,2
../kbl_data/2021-2022,S39G01N126,수원 KT,Home,김현민,0,0,0,0.0,0,0,0.0,0,0,0.0,0,0,0.0,0,0,0,0,0,0,0,0,0,0
../kbl_data/2021-2022,S39G01N126,수원 KT,Home,최창진,0,0,0,0.0,0,0,0.0,0,0,0.0,0,0,0.0,0,0,0,0,0,0,0,0,0,0
../kbl_data/2021-2022,S39G01N126,수원 KT,Home,정성우,10,1,2,50.0,2,7,28.6,3,9,33.3,2,2,100.0,2,1,3,0,0,0,0,0,2,3
../kbl_data/2021-2022,S39G01N126,수원 KT,Home,최성모,0,0,0,0.0,0,0,0.0,0,0,0.0,0,0,0.0,0,0,0,0,0,0,0,0,0,0
../kbl_data/2021-2022,S39G01N126,수원 KT,Home,허훈,12,0,2,0.0,3,8,37.5,3,10,30.0,3,5,60.0,0,3,3,7,5,0,0,0,4,2
../kbl_data/2021-2022,S39G01N126,수원 KT,Home,양홍석,15,2,4,50.0,1,6,16.7,3,10,30.0,8,10,80.0,2,6,8,5,2,0,0,0,0,2
../kbl_data/2021-2022,S39G01N126,수원 KT,Home,박준영,2,1,1,100.0,0,0,0.0,1,1,100.0,0,0,0.0,1,0,1,0,0,0,0,0,1,1
../kbl_data/2021-2022,S39G01N126,수원 KT,Home,캐디 라렌,27,11,17,64.7,0,1,0.0,11,18,61.1,5,6,83.3,5,12,17,3,1,4,0,1,2,3
../kbl_data/2021-2022,S39G01N126,수원 KT,Home,마이크 마이어스,0,0,0,0.0,0,0,0.0,0,0,0.0,0,0,0.0,0,0,0,1,0,0,0,0,1,0
../kbl_data/2021-2022,S39G01N126,수원 KT,Home,하윤기,4,2,4,50.0,0,0,0.0,2,4,50.0,0,0,0.0,4,2,6,1,1,0,0,1,1,0
../kbl_data/2021-2022,S39G01N126,서울 SK,Away,양우섭,0,0,0,0.0,0,0,0.0,0,0,0.0,0,0,0.0,0,0,0,0,0,0,0,0,0,0
../kbl_data/2021-2022,S39G01N126,서울 SK,Away,허일영,2,1,3,33.3,0,0,0.0,1,3,33.3,0,0,0.0,1,1,2,0,0,0,0,0,0,1
../kbl_data/2021-2022,S39G01N126,서울 SK,Away,김선형,3,0,3,0.0,1,4,25.0,1,7,14.3,0,0,0.0,1,0,1,6,2,0,0,0,4,0
../kbl_data/2021-2022,S39G01N126,서울 SK,Away,최부경,2,1,2,50.0,0,0,0.0,1,2,50.0,0,0,0.0,0,0,0,1,0,0,0,0,0,3
../kbl_data/2021-2022,S39G01N126,서울 SK,Away,리온 윌리엄스,2,1,1,100.0,0,0,0.0,1,1,100.0,0,0,0.0,1,1,2,0,0,0,0,0,0,1
../kbl_data/2021-2022,S39G01N126,서울 SK,Away,배병준,0,0,0,0.0,0,0,0.0,0,0,0.0,0,0,0.0,0,0,0,0,0,0,0,0,0,0
../kbl_data/2021-2022,S39G01N126,서울 SK,Away,이현석,0,0,0,0.0,0,0,0.0,0,0,0.0,0,0,0.0,0,0,0,0,0,0,0,0,0,1
../kbl_data/2021-2022,S39G01N126,서울 SK,Away,최원혁,5,1,1,100.0,0,1,0.0,1,2,50.0,3,4,75.0,1,4,5,1,0,0,0,0,2,3
../kbl_data/2021-2022,S39G01N126,서울 SK,Away,최준용,15,4,13,30.8,1,3,33.3,5,16,31.2,4,4,100.0,5,3,8,1,0,1,0,0,1,4
../kbl_data/2021-2022,S39G01N126,서울 SK,Away,안영준,21,3,6,50.0,4,5,80.0,7,11,63.6,3,4,75.0,0,3,3,1,4,0,0,0,1,3
../kbl_data/2021-2022,S39G01N126,서울 SK,Away,자밀 워니,30,14,26,53.8,0,0,0.0,14,26,53.8,2,4,50.0,4,12,16,2,0,0,0,0,4,0
../kbl_data/2021-2022,S39G01N126,서울 SK,Away,오재현,2,1,3,33.3,0,0,0.0,1,3,33.3,0,0,0.0,1,1,2,3,3,0,0,0,0,3
../kbl_data/2021-2022,S39G01N127,고양 오리온,Home,오용준,0,0,0,0.0,0,0,0.0,0,0,0.0,0,0,0.0,0,0,0,0,0,0,0,0,0,0
../kbl_data/2021-2022,S39G01N127,고양 오리온,Home,임종일,2,1,2,50.0,0,1,0.0,1,3,33.3,0,0,0.0,1,0,1,1,0,1,0,0,1,3
../kbl_data/2021-2022,S39G01N127,고양 오리온,Home,이대성,22,5,9,55.6,2,5,40.0,7,14,50.0,6,8,75.0,2,3,5,1,1,0,0,0,3,0
../kbl_data/2021-2022,S39G01N127,고양 오리온,Home,이정제,0,0,0,0.0,0,0,0.0,0,0,0.0,0,0,0.0,0,0,0,0,0,0,0,0,0,0
../kbl_data/2021-2022,S39G01N127,고양 오리온,Home,최승욱,2,1,2,50.0,0,2,0.0,1,4,25.0,0,0,0.0,0,1,1,0,0,0,0,0,0,1
../kbl_data/2021-2022,S39G01N127,고양 오리온,Home,이승현,14,4,13,30.8,1,1,100.0,5,14,35.7,3,4,75.0,2,7,9,5,1,1,0,0,1,1
../kbl_data/2021-2022,S39G01N127,고양 오리온,Home,머피 할로웨이,16,7,10,70.0,0,0,0.0,7,10,70.0,2,3,66.7,2,11,13,2,3,1,0,0,4,2
../kbl_data/2021-2022,S39G01N127,고양 오리온,Home,조한진,6,0,4,0.0,2,8,25.0,2,12,16.7,0,0,0.0,1,1,2,0,2,0,1,0,1,1
../kbl_data/2021-2022,S39G01N127,고양 오리온,Home,박진철,0,0,0,0.0,0,0,0.0,0,0,0.0,0,0,0.0,0,0,0,0,0,0,0,0,0,0
../kbl_data/2021-2022,S39G01N127,고양 오리온,Home,조석호,0,0,0,0.0,0,0,0.0,0,0,0.0,0,0,0.0,0,0,0,0,0,0,0,0,0,0
../kbl_data/2021-2022,S39G01N127,고양 오리온,Home,이정현,4,2,4,50.0,0,4,0.0,2,8,25.0,0,2,0.0,2,5,7,3,0,0,0,0,2,4
../kbl_data/2021-2022,S39G01N127,고양 오리온,Home,문시윤,0,0,0,0.0,0,0,0.0,0,0,0.0,0,0,0.0,0,0,0,0,0,0,0,0,0,0
../kbl_data/2021-2022,S39G01N127,서울 삼성,Away,김동량,8,4,5,80.0,0,1,0.0,4,6,66.7,0,2,0.0,3,3,6,2,1,0,0,0,2,3
../kbl_data/2021-2022,S39G01N127,서울 삼성,Away,장민국,5,1,2,50.0,1,3,33.3,2,5,40.0,0,0,0.0,0,1,1,1,1,1,0,0,2,2
../kbl_data/2021-2022,S39G01N127,서울 삼성,Away,김시래,9,3,7,42.9,1,4,25.0,4,11,36.4,0,0,0.0,0,1,1,5,0,0,0,0,2,3
../kbl_data/2021-2022,S39G01N127,서울 삼성,Away,김현수,0,0,1,0.0,0,3,0.0,0,4,0.0,0,0,0.0,0,1,1,0,1,0,0,0,2,2
../kbl_data/2021-2022,S39G01N127,서울 삼성,Away,임동섭,7,1,1,100.0,1,4,25.0,2,5,40.0,2,2,100.0,0,4,4,0,0,0,0,0,0,4
../kbl_data/2021-2022,S39G01N127,서울 삼성,Away,천기범,2,1,3,33.3,0,0,0.0,1,3,33.3,0,0,0.0,0,1,1,5,1,0,0,0,2,5
../kbl_data/2021-2022,S39G01N127,서울 삼성,Away,강바일,3,0,1,0.0,1,1,100.0,1,2,50.0,0,0,0.0,0,0,0,0,0,0,0,0,0,1
../kbl_data/2021-2022,S39G01N127,서울 삼성,Away,차민석,0,0,1,0.0,0,0,0.0,0,1,0.0,0,0,0.0,0,0,0,0,0,0,0,0,0,0
../kbl_data/2021-2022,S39G01N127,서울 삼성,Away,전형준,0,0,0,0.0,0,0,0.0,0,0,0.0,0,0,0.0,0,0,0,0,0,0,0,0,0,1
../kbl_data/2021-2022,S39G01N127,서울 삼성,Away,다니엘 오셰푸,16,8,12,66.7,0,1,0.0,8,13,61.5,0,1,0.0,1,8,9,3,1,1,0,0,2,0
../kbl_data/2021-2022,S39G01N127,서울 삼성,Away,이원석,10,5,7,71.4,0,0,0.0,5,7,71.4,0,0,0.0,0,1,1,0,3,0,0,1,0,1
../kbl_data/2021-2022,S39G01N127,서울 삼성,Away,토마스 로빈슨,4,2,6,33.3,0,0,0.0,2,6,33.3,0,0,0.0,0,8,8,1,1,0,0,1,3,1
../kbl_data/2021-2022,S39G01N128,안양 KGC,Home,양희종,0,0,1,0.0,0,1,0.0,0,2,0.0,0,0,0.0,0,0,0,0,0,1,0,0,0,1
../kbl_data/2021-2022,S39G01N128,안양 KGC,Home,함준후,2,1,1,100.0,0,1,0.0,1,2,50.0,0,0,0.0,0,0,0,0,1,0,0,0,0,1
../kbl_data/2021-2022,S39G01N128,안양 KGC,Home,오세근,8,4,6,66.7,0,0,0.0,4,6,66.7,0,1,0.0,3,4,7,3,2,1,0,0,0,0
../kbl_data/2021-2022,S39G01N128,안양 KGC,Home,문성곤,14,1,2,50.0,4,6,66.7,5,8,62.5,0,0,0.0,1,0,1,0,2,1,0,0,2,4
../kbl_data/2021-2022,S39G01N128,안양 KGC,Home,전성현,9,1,2,50.0,2,6,33.3,3,8,37.5,1,1,100.0,0,2,2,0,1,0,0,0,3,1
../kbl_data/2021-2022,S39G01N128,안양 KGC,Home,박지훈,2,1,1,100.0,0,0,0.0,1,1,100.0,0,0,0.0,1,0,1,0,0,0,0,0,2,0
../kbl_data/2021-2022,S39G01N128,안양 KGC,Home,이우정,0,0,0,0.0,0,0,0.0,0,0,0.0,0,0,0.0,0,0,0,0,0,0,0,0,0,0
../kbl_data/2021-2022,S39G01N128,안양 KGC,Home,대릴 먼로,0,0,1,0.0,0,0,0.0,0,1,0.0,0,0,0.0,0,1,1,1,0,0,0,0,1,0
../kbl_data/2021-2022,S39G01N128,안양 KGC,Home,우동현,0,0,0,0.0,0,1,0.0,0,1,0.0,0,0,0.0,0,0,0,0,0,0,0,0,0,1
../kbl_data/2021-2022,S39G01N128,안양 KGC,Home,변준형,15,3,6,50.0,2,6,33.3,5,12,41.7,3,6,50.0,0,1,1,8,2,1,0,0,3,5
../kbl_data/2021-2022,S39G01N128,안양 KGC,Home,한승희,3,0,0,0.0,1,1,100.0,1,1,100.0,0,0,0.0,0,0,0,0,0,0,0,0,2,1
../kbl_data/2021-2022,S39G01N128,안양 KGC,Home,오마리 스펠맨,27,7,9,77.8,3,5,60.0,10,14,71.4,4,5,80.0,0,16,16,7,2,1,0,2,4,1
../kbl_data/2021-2022,S39G01N128,창원 LG,Away,강병현,2,1,2,50.0,0,1,0.0,1,3,33.3,0,0,0.0,0,1,1,1,2,1,0,0,1,4
../kbl_data/2021-2022,S39G01N128,창원 LG,Away,변기훈,7,2,4,50.0,1,1,100.0,3,5,60.0,0,2,0.0,1,4,5,2,0,0,1,0,0,1
../kbl_data/2021-2022,S39G01N128,창원 LG,Away,이관희,21,6,10,60.0,3,6,50.0,9,16,56.2,0,0,0.0,0,1,1,2,1,0,0,0,2,4
../kbl_data/2021-2022,S39G01N128,창원 LG,Away,정희재,14,1,3,33.3,4,6,66.7,5,9,55.6,0,0,0.0,0,1,1,2,3,0,0,0,1,4
../kbl_data/2021-2022,S39G01N128,창원 LG,Away,서민수,8,1,2,50.0,2,4,50.0,3,6,50.0,0,0,0.0,1,2,3,3,3,0,1,0,0,0
../kbl_data/2021-2022,S39G01N128,창원 LG,Away,한상혁,0,0,1,0.0,0,0,0.0,0,1,0.0,0,0,0.0,0,1,1,0,0,0,0,0,0,0
../kbl_data/2021-2022,S39G01N128,창원 LG,Away,이재도,22,6,9,66.7,2,4,50.0,8,13,61.5,4,5,80.0,0,1,1,6,2,0,0,0,3,2
../kbl_data/2021-2022,S39G01N128,창원 LG,Away,박인태,0,0,0,0.0,0,0,0.0,0,0,0.0,0,0,0.0,0,0,0,0,0,0,0,0,0,0
../kbl_data/2021-2022,S39G01N128,창원 LG,Away,정인덕,0,0,0,0.0,0,0,0.0,0,0,0.0,0,0,0.0,0,0,0,0,0,0,0,0,0,0
../kbl_data/2021-2022,S39G01N128,창원 LG,Away,박정현,2,1,1,100.0,0,0,0.0,1,1,100.0,0,0,0.0,0,0,0,0,0,0,0,0,0,0
../kbl_data/2021-2022,S39G01N128,창원 LG,Away,윤원상,0,0,0,0.0,0,0,0.0,0,0,0.0,0,0,0.0,0,0,0,0,0,0,0,0,0,0
../kbl_data/2021-2022,S39G01N128,창원 LG,Away,아셈 마레이,10,5,12,41.7,0,0,0.0,5,12,41.7,0,0,0.0,5,11,16,7,3,0,0,0,5,4
../kbl_data/2021-2022,S39G01N129,원주 DB,Home,박찬희,4,1,2,50.0,0,0,0.0,1,2,50.0,2,2,100.0,0,2,2,2,1,0,0,0,0,0
../kbl_data/2021-2022,S39G01N129,원주 DB,Home,김현호,0,0,2,0.0,0,2,0.0,0,4,0.0,0,0,0.0,0,1,1,0,1,0,0,0,1,3
../kbl_data/2021-2022,S39G01N129,원주 DB,Home,정준원,0,0,0,0.0,0,0,0.0,0,0,0.0,0,0,0.0,0,0,0,0,0,0,0,0,0,0
../kbl_data/2021-2022,S39G01N129,원주 DB,Home,김종규,7,3,8,37.5,0,1,0.0,3,9,33.3,1,2,50.0,0,0,0,1,2,1,0,1,0,1
../kbl_data/2021-2022,S39G01N129,원주 DB,Home,허웅,20,5,7,71.4,3,5,60.0,8,12,66.7,1,1,100.0,0,1,1,8,1,0,0,0,1,3
../kbl_data/2021-2022,S39G01N129,원주 DB,Home,김영훈,0,0,0,0.0,0,0,0.0,0,0,0.0,0,0,0.0,0,0,0,0,0,0,0,0,0,0
../kbl_data/2021-2022,S39G01N129,원주 DB,Home,강상재,12,6,9,66.7,0,0,0.0,6,9,66.7,0,0,0.0,4,6,10,5,1,2,0,0,1,3
../kbl_data/2021-2022,S39G01N129,원주 DB,Home,김훈,0,0,0,0.0,0,0,0.0,0,0,0.0,0,0,0.0,0,0,0,0,0,0,0,0,0,0
../kbl_data/2021-2022,S39G01N129,원주 DB,Home,이준희,6,3,8,37.5,0,4,0.0,3,12,25.0,0,0,0.0,2,0,2,1,1,1,0,0,1,3
../kbl_data/2021-2022,S39G01N129,원주 DB,Home,레나드 프리먼,15,6,9,66.7,1,1,100.0,7,10,70.0,0,0,0.0,2,11,13,0,3,0,0,3,0,1
../kbl_data/2021-2022,S39G01N129,원주 DB,Home,정호영,23,5,7,71.4,3,7,42.9,8,14,57.1,4,4,100.0,1,1,2,5,0,0,0,0,0,1
../kbl_data/2021-2022,S39G01N129,원주 DB,Home,조니 오브라이언트,5,1,1,100.0,1,1,100.0,2,2,100.0,0,0,0.0,1,3,4,0,0,0,0,0,1,2
../kbl_data/2021-2022,S39G01N129,전주 KCC,Away,송창용,4,1,3,33.3,0,3,0.0,1,6,16.7,2,2,100.0,0,0,0,1,1,0,1,0,0,0
../kbl_data/2021-2022,S39G01N129,전주 KCC,Away,이정현,15,1,3,33.3,3,7,42.9,4,10,40.0,4,7,57.1,0,5,5,4,2,0,0,0,3,3
../kbl_data/2021-2022,S39G01N129,전주 KCC,Away,정창영,6,0,2,0.0,2,2,100.0,2,4,50.0,0,0,0.0,1,4,5,0,0,0,0,0,3,3
../kbl_data/2021-2022,S39G01N129,전주 KCC,Away,라건아,18,6,10,60.0,2,3,66.7,8,13,61.5,0,0,0.0,2,7,9,0,0,1,0,0,1,1
../kbl_data/2021-2022,S39G01N129,전주 KCC,Away,김상규,7,0,3,0.0,2,5,40.0,2,8,25.0,1,2,50.0,0,3,3,3,0,0,1,0,0,0
../kbl_data/2021-2022,S39G01N129,전주 KCC,Away,유병훈,0,0,0,0.0,0,0,0.0,0,0,0.0,0,0,0.0,0,0,0,0,0,0,0,0,0,0
../kbl_data/2021-2022,S39G01N129,전주 KCC,Away,박재현,17,4,5,80.0,1,3,33.3,5,8,62.5,6,8,75.0,0,1,1,8,0,0,0,0,1,4
../kbl_data/2021-2022,S39G01N129,전주 KCC,Away,이진욱,0,0,1,0.0,0,1,0.0,0,2,0.0,0,0,0.0,0,1,1,0,0,0,0,0,0,1
../kbl_data/2021-2022,S39G01N129,전주 KCC,Away,김진용,0,0,0,0.0,0,0,0.0,0,0,0.0,0,0,0.0,0,0,0,0,0,0,0,0,0,0
../kbl_data/2021-2022,S39G01N129,전주 KCC,Away,라타비우스 윌리엄스,2,1,1,100.0,0,0,0.0,1,1,100.0,0,0,0.0,1,3,4,0,0,1,0,0,1,2
../kbl_data/2021-2022,S39G01N129,전주 KCC,Away,곽정훈,2,1,2,50.0,0,0,0.0,1,2,50.0,0,1,0.0,1,0,1,0,0,0,0,0,0,2
../kbl_data/2021-2022,S39G01N129,전주 KCC,Away,이근휘,5,1,1,100.0,1,4,25.0,2,5,40.0,0,0,0.0,0,0,0,1,0,0,0,0,1,2
../kbl_data/2021-2022,S39G01N130,고양 오리온,Home,최현민,2,1,2,50.0,0,3,0.0,1,5,20.0,0,0,0.0,5,0,5,2,2,0,1,0,0,0
../kbl_data/2021-2022,S39G01N130,고양 오리온,Home,임종일,8,1,4,25.0,2,2,100.0,3,6,50.0,0,0,0.0,1,0,1,0,1,0,0,0,2,2
../kbl_data/2021-2022,S39G01N130,고양 오리온,Home,이대성,10,2,8,25.0,2,6,33.3,4,14,28.6,0,0,0.0,2,1,3,1,0,0,0,0,3,3
../kbl_data/2021-2022,S39G01N130,고양 오리온,Home,이정제,2,1,2,50.0,0,0,0.0,1,2,50.0,0,0,0.0,2,1,3,1,0,0,0,0,1,1
../kbl_data/2021-2022,S39G01N130,고양 오리온,Home,최승욱,0,0,1,0.0,0,0,0.0,0,1,0.0,0,0,0.0,0,0,0,0,0,0,0,0,0,0
../kbl_data/2021-2022,S39G01N130,고양 오리온,Home,이승현,14,7,15,46.7,0,2,0.0,7,17,41.2,0,0,0.0,3,1,4,5,1,0,1,0,1,2
../kbl_data/2021-2022,S39G01N130,고양 오리온,Home,머피 할로웨이,16,8,18,44.4,0,0,0.0,8,18,44.4,0,0,0.0,6,7,13,3,3,1,0,2,1,1
../kbl_data/2021-2022,S39G01N130,고양 오리온,Home,조한진,5,1,2,50.0,1,2,50.0,2,4,50.0,0,0,0.0,1,1,2,2,1,0,0,0,0,1
../kbl_data/2021-2022,S39G01N130,고양 오리온,Home,김세창,1,0,0,0.0,0,0,0.0,0,0,0.0,1,2,50.0,0,0,0,1,0,0,0,0,0,0
../kbl_data/2021-2022,S39G01N130,고양 오리온,Home,박진철,0,0,0,0.0,0,0,0.0,0,0,0.0,0,0,0.0,0,0,0,0,0,0,0,0,0,0
../kbl_data/2021-2022,S39G01N130,고양 오리온,Home,이정현,14,4,7,57.1,0,1,0.0,4,8,50.0,6,7,85.7,1,0,1,4,2,0,1,0,1,2
../kbl_data/2021-2022,S39G01N130,고양 오리온,Home,문시윤,2,1,1,100.0,0,0,0.0,1,1,100.0,0,0,0.0,0,0,0,0,0,0,0,1,0,0
../kbl_data/2021-2022,S39G01N130,수원 KT,Away,김동욱,7,2,3,66.7,1,1,100.0,3,4,75.0,0,0,0.0,0,0,0,2,0,0,0,0,0,0
../kbl_data/2021-2022,S39G01N130,수원 KT,Away,김영환,2,1,4,25.0,0,1,0.0,1,5,20.0,0,0,0.0,0,2,2,1,2,0,0,0,0,1
../kbl_data/2021-2022,S39G01N130,수원 KT,Away,김현민,0,0,0,0.0,0,1,0.0,0,1,0.0,0,0,0.0,0,0,0,0,0,0,0,0,0,2
../kbl_data/2021-2022,S39G01N130,수원 KT,Away,정성우,6,2,2,100.0,0,2,0.0,2,4,50.0,2,3,66.7,0,1,1,4,0,0,1,0,3,3
../kbl_data/2021-2022,S39G01N130,수원 KT,Away,최성모,2,1,2,50.0,0,1,0.0,1,3,33.3,0,0,0.0,1,0,1,1,0,0,0,0,0,2
../kbl_data/2021-2022,S39G01N130,수원 KT,Away,허훈,12,2,4,50.0,2,3,66.7,4,7,57.1,2,3,66.7,0,2,2,6,1,0,0,0,2,3
../kbl_data/2021-2022,S39G01N130,수원 KT,Away,양홍석,14,4,6,66.7,2,4,50.0,6,10,60.0,0,0,0.0,1,4,5,5,0,0,0,0,1,0
../kbl_data/2021-2022,S39G01N130,수원 KT,Away,박준영,2,1,1,100.0,0,0,0.0,1,1,100.0,0,0,0.0,0,0,0,1,0,0,0,0,0,0
../kbl_data/2021-2022,S39G01N130,수원 KT,Away,캐디 라렌,23,7,12,58.3,3,3,100.0,10,15,66.7,0,0,0.0,4,4,8,2,0,2,0,1,5,3
../kbl_data/2021-2022,S39G01N130,수원 KT,Away,마이크 마이어스,6,3,3,100.0,0,0,0.0,3,3,100.0,0,2,0.0,1,3,4,0,1,0,0,0,1,2
../kbl_data/2021-2022,S39G01N130,수원 KT,Away,김준환,0,0,1,0.0,0,0,0.0,0,1,0.0,0,0,0.0,1,0,1,0,0,0,0,0,0,1
../kbl_data/2021-2022,S39G01N130,수원 KT,Away,하윤기,14,5,6,83.3,0,0,0.0,5,6,83.3,4,4,100.0,3,2,5,2,2,2,0,0,2,0
../kbl_data/2021-2022,S39G01N131,대구 한국가스공사,Home,민성주,0,0,0,0.0,0,0,0.0,0,0,0.0,0,0,0.0,0,0,0,0,0,0,0,0,0,0
../kbl_data/2021-2022,S39G01N131,대구 한국가스공사,Home,홍경기,0,0,0,0.0,0,0,0.0,0,0,0.0,0,0,0.0,0,0,0,0,0,0,0,0,0,0
../kbl_data/2021-2022,S39G01N131,대구 한국가스공사,Home,조상열,3,0,1,0.0,1,6,16.7,1,7,14.3,0,0,0.0,0,0,0,0,0,0,0,0,1,4
../kbl_data/2021-2022,S39G01N131,대구 한국가스공사,Home,이대헌,8,2,6,33.3,1,1,100.0,3,7,42.9,1,2,50.0,2,5,7,3,2,0,0,1,1,2
../kbl_data/2021-2022,S39G01N131,대구 한국가스공사,Home,두경민,16,5,10,50.0,2,6,33.3,7,16,43.8,0,2,0.0,1,0,1,4,2,0,1,0,2,2
../kbl_data/2021-2022,S39G01N131,대구 한국가스공사,Home,박봉진,0,0,0,0.0,0,0,0.0,0,0,0.0,0,0,0.0,0,0,0,0,0,0,0,0,0,0
../kbl_data/2021-2022,S39G01N131,대구 한국가스공사,Home,김낙현,19,4,8,50.0,3,8,37.5,7,16,43.8,2,2,100.0,0,3,3,3,1,0,0,0,4,1
../kbl_data/2021-2022,S39G01N131,대구 한국가스공사,Home,전현우,14,0,3,0.0,4,8,50.0,4,11,36.4,2,2,100.0,0,2,2,1,0,0,0,0,1,4
../kbl_data/2021-2022,S39G01N131,대구 한국가스공사,Home,이윤기,0,0,0,0.0,0,1,0.0,0,1,0.0,0,0,0.0,1,0,1,0,0,0,0,0,0,1
../kbl_data/2021-2022,S39G01N131,대구 한국가스공사,Home,양준우,0,0,1,0.0,0,0,0.0,0,1,0.0,0,0,0.0,0,0,0,1,0,0,0,0,0,0
../kbl_data/2021-2022,S39G01N131,대구 한국가스공사,Home,클리프 알렉산더,17,7,12,58.3,0,0,0.0,7,12,58.3,3,4,75.0,3,17,20,4,0,0,0,4,3,1
../kbl_data/2021-2022,S39G01N131,대구 한국가스공사,Home,신승민,0,0,1,0.0,0,1,0.0,0,2,0.0,0,0,0.0,2,0,2,0,2,0,0,0,1,3
../kbl_data/2021-2022,S39G01N131,서울 SK,Away,양우섭,0,0,0,0.0,0,0,0.0,0,0,0.0,0,0,0.0,0,0,0,0,0,0,0,0,0,0
../kbl_data/2021-2022,S39G01N131,서울 SK,Away,허일영,3,0,2,0.0,1,2,50.0,1,4,25.0,0,0,0.0,0,0,0,1,2,0,0,0,0,1
../kbl_data/2021-2022,S39G01N131,서울 SK,Away,김선형,9,3,5,60.0,1,4,25.0,4,9,44.4,0,0,0.0,0,3,3,4,0,0,0,0,1,0
../kbl_data/2021-2022,S39G01N131,서울 SK,Away,최부경,6,3,5,60.0,0,0,0.0,3,5,60.0,0,0,0.0,0,3,3,1,1,0,0,0,1,5
../kbl_data/2021-2022,S39G01N131,서울 SK,Away,리온 윌리엄스,2,0,1,0.0,0,0,0.0,0,1,0.0,2,2,100.0,1,6,7,0,0,0,0,0,0,2
../kbl_data/2021-2022,S39G01N131,서울 SK,Away,배병준,0,0,0,0.0,0,0,0.0,0,0,0.0,0,0,0.0,0,0,0,0,0,0,0,0,1,0
../kbl_data/2021-2022,S39G01N131,서울 SK,Away,이현석,3,0,0,0.0,1,3,33.3,1,3,33.3,0,0,0.0,1,0,1,1,0,0,0,0,0,1
../kbl_data/2021-2022,S39G01N131,서울 SK,Away,최원혁,6,0,0,0.0,2,3,66.7,2,3,66.7,0,0,0.0,0,0,0,0,0,0,0,0,0,2
../kbl_data/2021-2022,S39G01N131,서울 SK,Away,최준용,9,3,5,60.0,1,2,50.0,4,7,57.1,0,0,0.0,0,0,0,3,1,0,0,1,2,4
../kbl_data/2021-2022,S39G01N131,서울 SK,Away,안영준,24,5,10,50.0,4,8,50.0,9,18,50.0,2,4,50.0,3,3,6,5,2,1,1,0,2,1
../kbl_data/2021-2022,S39G01N131,서울 SK,Away,자밀 워니,19,8,15,53.3,0,0,0.0,8,15,53.3,3,4,75.0,4,14,18,4,1,1,0,0,3,0
../kbl_data/2021-2022,S39G01N131,서울 SK,Away,오재현,10,2,3,66.7,2,3,66.7,4,6,66.7,0,2,0.0,2,1,3,3,1,0,0,0,2,2
../kbl_data/2021-2022,S39G01N132,울산 현대모비스,Home,이현민,5,1,5,20.0,1,2,50.0,2,7,28.6,0,0,0.0,1,3,4,4,0,0,0,0,3,3
../kbl_data/2021-2022,S39G01N132,울산 현대모비스,Home,함지훈,9,2,5,40.0,0,0,0.0,2,5,40.0,5,6,83.3,2,2,4,6,3,0,0,0,2,0
../kbl_data/2021-2022,S39G01N132,울산 현대모비스,Home,최진수,0,0,0,0.0,0,0,0.0,0,0,0.0,0,0,0.0,0,0,0,0,0,0,0,0,0,0
../kbl_data/2021-2022,S39G01N132,울산 현대모비스,Home,박지훈,2,1,1,100.0,0,2,0.0,1,3,33.3,0,1,0.0,0,0,0,1,1,1,0,0,0,3
../kbl_data/2021-2022,S39G01N132,울산 현대모비스,Home,장재석,12,4,6,66.7,0,0,0.0,4,6,66.7,4,6,66.7,1,0,1,0,0,0,0,0,1,3
../kbl_data/2021-2022,S39G01N132,울산 현대모비스,Home,김국찬,10,2,4,50.0,2,7,28.6,4,11,36.4,0,1,0.0,4,4,8,2,1,0,0,0,1,1
../kbl_data/2021-2022,S39G01N132,울산 현대모비스,Home,이우석,14,4,6,66.7,2,3,66.7,6,9,66.7,0,2,0.0,0,2,2,5,1,0,0,0,3,4
../kbl_data/2021-2022,S39G01N132,울산 현대모비스,Home,라숀 토마스,10,5,9,55.6,0,0,0.0,5,9,55.6,0,0,0.0,4,12,16,1,0,3,0,1,5,3
../kbl_data/2021-2022,S39G01N132,울산 현대모비스,Home,신민석,6,2,2,100.0,0,0,0.0,2,2,100.0,2,2,100.0,1,0,1,1,0,0,0,0,0,1
../kbl_data/2021-2022,S39G01N132,울산 현대모비스,Home,김동준,9,0,2,0.0,3,6,50.0,3,8,37.5,0,0,0.0,0,2,2,2,1,0,1,0,1,1
../kbl_data/2021-2022,S39G01N132,울산 현대모비스,Home,윤성준,0,0,0,0.0,0,0,0.0,0,0,0.0,0,0,0.0,0,0,0,0,0,0,0,0,0,0
../kbl_data/2021-2022,S39G01N132,울산 현대모비스,Home,에릭 버크너,3,0,0,0.0,0,0,0.0,0,0,0.0,3,4,75.0,2,2,4,0,0,0,0,0,1,0
../kbl_data/2021-2022,S39G01N132,서울 삼성,Away,김동량,5,1,2,50.0,1,1,100.0,2,3,66.7,0,0,0.0,1,0,1,0,0,0,0,0,0,2
../kbl_data/2021-2022,S39G01N132,서울 삼성,Away,장민국,16,1,1,100.0,4,6,66.7,5,7,71.4,2,4,50.0,1,1,2,2,2,0,0,0,0,3
../kbl_data/2021-2022,S39G01N132,서울 삼성,Away,김시래,10,3,8,37.5,0,4,0.0,3,12,25.0,4,5,80.0,3,2,5,9,4,0,1,0,2,4
../kbl_data/2021-2022,S39G01N132,서울 삼성,Away,김현수,0,0,2,0.0,0,1,0.0,0,3,0.0,0,0,0.0,0,0,0,0,0,0,0,0,0,0
../kbl_data/2021-2022,S39G01N132,서울 삼성,Away,임동섭,0,0,1,0.0,0,0,0.0,0,1,0.0,0,0,0.0,0,1,1,1,0,0,0,0,1,0
../kbl_data/2021-2022,S39G01N132,서울 삼성,Away,배수용,0,0,0,0.0,0,0,0.0,0,0,0.0,0,0,0.0,0,0,0,0,0,0,0,0,0,0
../kbl_data/2021-2022,S39G01N132,서울 삼성,Away,천기범,1,0,2,0.0,0,3,0.0,0,5,0.0,1,2,50.0,0,1,1,2,0,0,1,0,0,3
../kbl_data/2021-2022,S39G01N132,서울 삼성,Away,차민석,2,1,3,33.3,0,0,0.0,1,3,33.3,0,0,0.0,1,0,1,1,0,0,0,0,0,2
../kbl_data/2021-2022,S39G01N132,서울 삼성,Away,전형준,5,1,1,100.0,1,4,25.0,2,5,40.0,0,0,0.0,0,0,0,1,1,0,0,0,0,3
../kbl_data/2021-2022,S39G01N132,서울 삼성,Away,다니엘 오셰푸,4,2,4,50.0,0,1,0.0,2,5,40.0,0,0,0.0,1,3,4,0,0,0,0,0,0,0
../kbl_data/2021-2022,S39G01N132,서울 삼성,Away,이원석,5,2,5,40.0,0,0,0.0,2,5,40.0,1,3,33.3,2,2,4,1,1,1,0,0,2,2
../kbl_data/2021-2022,S39G01N132,서울 삼성,Away,토마스 로빈슨,22,10,17,58.8,0,2,0.0,10,19,52.6,2,2,100.0,4,7,11,2,2,0,0,1,7,3
../kbl_data/2021-2022,S39G01N133,안양 KGC,Home,양희종,8,1,2,50.0,2,5,40.0,3,7,42.9,0,0,0.0,2,0,2,0,2,0,0,0,0,4
../kbl_data/2021-2022,S39G01N133,안양 KGC,Home,박형철,0,0,0,0.0,0,0,0.0,0,0,0.0,0,0,0.0,0,0,0,0,0,0,0,0,0,0
../kbl_data/2021-2022,S39G01N133,안양 KGC,Home,함준후,0,0,0,0.0,0,2,0.0,0,2,0.0,0,0,0.0,2,0,2,0,0,0,0,0,0,2
../kbl_data/2021-2022,S39G01N133,안양 KGC,Home,오세근,14,5,6,83.3,0,0,0.0,5,6,83.3,4,4,100.0,0,2,2,5,0,1,0,0,2,4
../kbl_data/2021-2022,S39G01N133,안양 KGC,Home,문성곤,18,2,5,40.0,4,5,80.0,6,10,60.0,2,2,100.0,5,4,9,3,2,0,0,0,1,2
../kbl_data/2021-2022,S39G01N133,안양 KGC,Home,전성현,16,2,7,28.6,3,8,37.5,5,15,33.3,3,4,75.0,0,1,1,2,1,0,0,0,0,0
../kbl_data/2021-2022,S39G01N133,안양 KGC,Home,이우정,0,0,0,0.0,0,1,0.0,0,1,0.0,0,0,0.0,0,0,0,0,0,0,0,0,0,1
../kbl_data/2021-2022,S39G01N133,안양 KGC,Home,대릴 먼로,2,1,1,100.0,0,0,0.0,1,1,100.0,0,0,0.0,0,0,0,2,0,0,0,0,0,0
../kbl_data/2021-2022,S39G01N133,안양 KGC,Home,우동현,0,0,0,0.0,0,0,0.0,0,0,0.0,0,0,0.0,0,0,0,0,0,0,0,0,0,0
../kbl_data/2021-2022,S39G01N133,안양 KGC,Home,변준형,13,1,6,16.7,3,5,60.0,4,11,36.4,2,6,33.3,0,1,1,9,1,1,1,0,4,3
../kbl_data/2021-2022,S39G01N133,안양 KGC,Home,한승희,0,0,0,0.0,0,0,0.0,0,0,0.0,0,0,0.0,0,0,0,0,0,0,0,0,0,0
../kbl_data/2021-2022,S39G01N133,안양 KGC,Home,오마리 스펠맨,19,7,14,50.0,1,6,16.7,8,20,40.0,2,4,50.0,1,13,14,0,1,1,0,3,2,2
../kbl_data/2021-2022,S39G01N133,원주 DB,Away,윤호영,2,1,2,50.0,0,1,0.0,1,3,33.3,0,0,0.0,2,2,4,1,0,0,0,0,1,1
../kbl_data/2021-2022,S39G01N133,원주 DB,Away,박찬희,2,1,3,33.3,0,2,0.0,1,5,20.0,0,2,0.0,0,2,2,6,0,0,0,0,0,2
../kbl_data/2021-2022,S39G01N133,원주 DB,Away,정준원,6,3,4,75.0,0,0,0.0,3,4,75.0,0,0,0.0,1,0,1,0,0,0,0,0,1,0
../kbl_data/2021-2022,S39G01N133,원주 DB,Away,김종규,13,5,6,83.3,1,1,100.0,6,7,85.7,0,0,0.0,1,2,3,1,1,0,0,0,1,5
../kbl_data/2021-2022,S39G01N133,원주 DB,Away,허웅,20,6,9,66.7,0,2,0.0,6,11,54.5,8,9,88.9,1,2,3,12,1,0,0,0,2,1
../kbl_data/2021-2022,S39G01N133,원주 DB,Away,김영훈,0,0,0,0.0,0,0,0.0,0,0,0.0,0,0,0.0,0,0,0,0,0,0,0,0,0,0
../kbl_data/2021-2022,S39G01N133,원주 DB,Away,강상재,7,3,6,50.0,0,0,0.0,3,6,50.0,1,2,50.0,2,3,5,1,1,1,0,0,1,1
../kbl_data/2021-2022,S39G01N133,원주 DB,Away,김훈,6,1,1,100.0,1,2,50.0,2,3,66.7,1,2,50.0,1,1,2,0,0,0,0,0,0,1
../kbl_data/2021-2022,S39G01N133,원주 DB,Away,이준희,2,1,3,33.3,0,1,0.0,1,4,25.0,0,0,0.0,1,2,3,1,1,0,0,0,0,4
../kbl_data/2021-2022,S39G01N133,원주 DB,Away,레나드 프리먼,14,6,8,75.0,0,1,0.0,6,9,66.7,2,4,50.0,0,5,5,0,1,0,0,2,0,0
../kbl_data/2021-2022,S39G01N133,원주 DB,Away,정호영,5,2,4,50.0,0,2,0.0,2,6,33.3,1,2,50.0,1,1,2,0,0,0,0,0,3,4
../kbl_data/2021-2022,S39G01N133,원주 DB,Away,조니 오브라이언트,12,2,4,50.0,2,4,50.0,4,8,50.0,2,3,66.7,0,9,9,2,1,0,0,0,2,2
../kbl_data/2021-2022,S39G01N134,울산 현대모비스,Home,이현민,11,1,4,25.0,3,3,100.0,4,7,57.1,0,0,0.0,0,0,0,4,0,0,0,0,3,1
../kbl_data/2021-2022,S39G01N134,울산 현대모비스,Home,함지훈,2,0,0,0.0,0,0,0.0,0,0,0.0,2,2,100.0,3,1,4,7,0,0,0,0,2,1
../kbl_data/2021-2022,S39G01N134,울산 현대모비스,Home,최진수,4,1,3,33.3,0,3,0.0,1,6,16.7,2,2,100.0,0,3,3,0,0,0,0,0,2,2
../kbl_data/2021-2022,S39G01N134,울산 현대모비스,Home,박지훈,2,1,1,100.0,0,3,0.0,1,4,25.0,0,0,0.0,1,2,3,0,0,0,0,0,1,2
../kbl_data/2021-2022,S39G01N134,울산 현대모비스,Home,장재석,2,1,1,100.0,0,0,0.0,1,1,100.0,0,0,0.0,1,1,2,1,1,0,0,0,0,1
../kbl_data/2021-2022,S39G01N134,울산 현대모비스,Home,김국찬,12,3,4,75.0,2,6,33.3,5,10,50.0,0,0,0.0,0,5,5,2,1,0,0,0,2,3
../kbl_data/2021-2022,S39G01N134,울산 현대모비스,Home,이우석,4,2,4,50.0,0,2,0.0,2,6,33.3,0,0,0.0,1,4,5,2,1,0,0,0,2,1
../kbl_data/2021-2022,S39G01N134,울산 현대모비스,Home,라숀 토마스,21,10,15,66.7,0,0,0.0,10,15,66.7,1,1,100.0,3,6,9,1,3,3,0,2,0,3
../kbl_data/2021-2022,S39G01N134,울산 현대모비스,Home,신민석,3,1,1,100.0,0,0,0.0,1,1,100.0,1,2,50.0,2,0,2,1,0,0,0,0,1,0
../kbl_data/2021-2022,S39G01N134,울산 현대모비스,Home,김동준,11,1,3,33.3,3,5,60.0,4,8,50.0,0,0,0.0,0,3,3,2,0,0,0,0,2,0
../kbl_data/2021-2022,S39G01N134,울산 현대모비스,Home,윤성준,0,0,0,0.0,0,0,0.0,0,0,0.0,0,0,0.0,0,0,0,0,0,0,0,0,0,0
../kbl_data/2021-2022,S39G01N134,울산 현대모비스,Home,에릭 버크너,2,1,3,33.3,0,0,0.0,1,3,33.3,0,0,0.0,0,4,4,0,0,1,0,1,2,1
../kbl_data/2021-2022,S39G01N134,창원 LG,Away,강병현,3,1,2,50.0,0,1,0.0,1,3,33.3,1,1,100.0,0,0,0,2,0,0,1,0,1,1
../kbl_data/2021-2022,S39G01N134,창원 LG,Away,변기훈,2,1,3,33.3,0,1,0.0,1,4,25.0,0,0,0.0,1,0,1,0,0,0,0,0,1,2
../kbl_data/2021-2022,S39G01N134,창원 LG,Away,이관희,13,3,10,30.0,1,7,14.3,4,17,23.5,4,4,100.0,2,2,4,1,2,0,0,0,0,2
../kbl_data/2021-2022,S39G01N134,창원 LG,Away,정희재,2,1,4,25.0,0,3,0.0,1,7,14.3,0,0,0.0,2,2,4,0,2,0,0,0,1,3
../kbl_data/2021-2022,S39G01N134,창원 LG,Away,서민수,10,2,4,50.0,2,4,50.0,4,8,50.0,0,0,0.0,1,2,3,1,1,0,0,0,1,3
../kbl_data/2021-2022,S39G01N134,창원 LG,Away,한상혁,0,0,0,0.0,0,0,0.0,0,0,0.0,0,0,0.0,0,0,0,0,0,0,0,0,0,0
../kbl_data/2021-2022,S39G01N134,창원 LG,Away,이재도,11,1,4,25.0,3,7,42.9,4,11,36.4,0,0,0.0,1,1,2,5,2,0,0,0,1,1
../kbl_data/2021-2022,S39G01N134,창원 LG,Away,박인태,0,0,0,0.0,0,0,0.0,0,0,0.0,0,0,0.0,0,0,0,0,0,0,0,0,0,0
../kbl_data/2021-2022,S39G01N134,창원 LG,Away,박정현,0,0,0,0.0,0,0,0.0,0,0,0.0,0,0,0.0,0,0,0,0,0,0,0,0,1,1
../kbl_data/2021-2022,S39G01N134,창원 LG,Away,윤원상,0,0,0,0.0,0,1,0.0,0,1,0.0,0,0,0.0,0,0,0,0,1,0,0,0,0,0
../kbl_data/2021-2022,S39G01N134,창원 LG,Away,압둘 말릭 아부,4,0,1,0.0,1,1,100.0,1,2,50.0,1,2,50.0,1,3,4,0,0,0,0,0,1,1
../kbl_data/2021-2022,S39G01N134,창원 LG,Away,아셈 마레이,20,10,15,66.7,0,0,0.0,10,15,66.7,0,3,0.0,6,5,11,3,3,0,0,1,3,3
../kbl_data/2021-2022,S39G01N135,대구 한국가스공사,Home,민성주,0,0,0,0.0,0,0,0.0,0,0,0.0,0,0,0.0,1,0,1,0,0,0,0,0,0,0
../kbl_data/2021-2022,S39G01N135,대구 한국가스공사,Home,홍경기,11,4,4,100.0,0,3,0.0,4,7,57.1,3,4,75.0,2,1,3,2,0,0,0,0,0,1
../kbl_data/2021-2022,S39G01N135,대구 한국가스공사,Home,조상열,0,0,0,0.0,0,1,0.0,0,1,0.0,0,0,0.0,0,0,0,1,0,0,0,0,1,0
../kbl_data/2021-2022,S39G01N135,대구 한국가스공사,Home,이대헌,10,3,7,42.9,1,2,50.0,4,9,44.4,1,2,50.0,3,4,7,1,0,0,1,0,4,4
../kbl_data/2021-2022,S39G01N135,대구 한국가스공사,Home,두경민,29,6,8,75.0,5,14,35.7,11,22,50.0,2,2,100.0,2,0,2,1,3,0,0,0,4,1
../kbl_data/2021-2022,S39G01N135,대구 한국가스공사,Home,박봉진,0,0,0,0.0,0,0,0.0,0,0,0.0,0,0,0.0,0,0,0,0,0,0,0,0,0,0
../kbl_data/2021-2022,S39G01N135,대구 한국가스공사,Home,김낙현,14,3,4,75.0,2,4,50.0,5,8,62.5,2,2,100.0,0,0,0,1,0,0,0,0,2,2
../kbl_data/2021-2022,S39G01N135,대구 한국가스공사,Home,전현우,5,0,0,0.0,1,2,50.0,1,2,50.0,2,2,100.0,0,0,0,0,0,0,0,0,2,4
../kbl_data/2021-2022,S39G01N135,대구 한국가스공사,Home,이윤기,3,0,1,0.0,1,3,33.3,1,4,25.0,0,0,0.0,1,1,2,1,0,1,0,0,1,5
../kbl_data/2021-2022,S39G01N135,대구 한국가스공사,Home,양준우,0,0,2,0.0,0,0,0.0,0,2,0.0,0,0,0.0,0,1,1,1,0,0,0,0,0,0
../kbl_data/2021-2022,S39G01N135,대구 한국가스공사,Home,클리프 알렉산더,6,2,7,28.6,0,0,0.0,2,7,28.6,2,2,100.0,5,7,12,4,1,0,0,1,2,2
../kbl_data/2021-2022,S39G01N135,대구 한국가스공사,Home,신승민,0,0,0,0.0,0,0,0.0,0,0,0.0,0,0,0.0,2,1,3,0,1,0,0,0,1,2
../kbl_data/2021-2022,S39G01N135,고양 오리온,Away,최현민,0,0,2,0.0,0,0,0.0,0,2,0.0,0,0,0.0,1,0,1,1,1,0,0,0,0,0
../kbl_data/2021-2022,S39G01N135,고양 오리온,Away,임종일,0,0,0,0.0,0,2,0.0,0,2,0.0,0,0,0.0,0,1,1,1,0,0,0,0,0,2
../kbl_data/2021-2022,S39G01N135,고양 오리온,Away,이대성,20,4,9,44.4,3,4,75.0,7,13,53.8,3,5,60.0,1,0,1,2,0,0,0,0,0,0
../kbl_data/2021-2022,S39G01N135,고양 오리온,Away,한호빈,3,1,1,100.0,0,0,0.0,1,1,100.0,1,2,50.0,0,0,0,1,0,0,0,0,1,5
../kbl_data/2021-2022,S39G01N135,고양 오리온,Away,이정제,0,0,0,0.0,0,0,0.0,0,0,0.0,0,0,0.0,0,0,0,0,0,0,0,0,0,0
../kbl_data/2021-2022,S39G01N135,고양 오리온,Away,최승욱,0,0,0,0.0,0,0,0.0,0,0,0.0,0,0,0.0,0,0,0,0,0,0,0,0,0,0
../kbl_data/2021-2022,S39G01N135,고양 오리온,Away,이승현,16,4,6,66.7,1,1,100.0,5,7,71.4,5,6,83.3,4,2,6,4,1,0,0,0,4,2
../kbl_data/2021-2022,S39G01N135,고양 오리온,Away,김진유,0,0,0,0.0,0,0,0.0,0,0,0.0,0,0,0.0,1,0,1,0,0,0,0,0,0,2
../kbl_data/2021-2022,S39G01N135,고양 오리온,Away,머피 할로웨이,14,5,7,71.4,0,1,0.0,5,8,62.5,4,7,57.1,0,11,11,4,3,1,0,0,2,1
../kbl_data/2021-2022,S39G01N135,고양 오리온,Away,조한진,2,1,1,100.0,0,2,0.0,1,3,33.3,0,0,0.0,0,0,0,1,0,0,0,0,1,1
../kbl_data/2021-2022,S39G01N135,고양 오리온,Away,박진철,4,2,2,100.0,0,0,0.0,2,2,100.0,0,0,0.0,1,0,1,0,2,0,0,0,0,2
../kbl_data/2021-2022,S39G01N135,고양 오리온,Away,이정현,28,6,7,85.7,5,7,71.4,11,14,78.6,1,1,100.0,0,1,1,2,3,1,0,0,3,3
../kbl_data/2021-2022,S39G01N136,수원 KT,Home,김동욱,11,3,4,75.0,0,3,0.0,3,7,42.9,5,5,100.0,0,1,1,3,2,0,0,0,1,0
../kbl_data/2021-2022,S39G01N136,수원 KT,Home,김영환,5,1,2,50.0,1,3,33.3,2,5,40.0,0,0,0.0,0,2,2,2,0,0,0,0,1,2
../kbl_data/2021-2022,S39G01N136,수원 KT,Home,김현민,0,0,0,0.0,0,0,0.0,0,0,0.0,0,0,0.0,0,0,0,0,0,0,0,0,0,0
../kbl_data/2021-2022,S39G01N136,수원 KT,Home,정성우,4,2,2,100.0,0,1,0.0,2,3,66.7,0,0,0.0,0,2,2,4,3,0,0,0,2,4
../kbl_data/2021-2022,S39G01N136,수원 KT,Home,최성모,0,0,0,0.0,0,0,0.0,0,0,0.0,0,0,0.0,0,0,0,0,0,0,0,0,0,0
../kbl_data/2021-2022,S39G01N136,수원 KT,Home,허훈,16,4,8,50.0,1,5,20.0,5,13,38.5,5,5,100.0,0,2,2,2,1,0,0,0,1,2
../kbl_data/2021-2022,S39G01N136,수원 KT,Home,양홍석,14,3,6,50.0,2,4,50.0,5,10,50.0,2,2,100.0,0,8,8,5,3,0,0,0,2,2
../kbl_data/2021-2022,S39G01N136,수원 KT,Home,박준영,0,0,1,0.0,0,0,0.0,0,1,0.0,0,0,0.0,1,1,2,0,0,0,0,0,0,1
../kbl_data/2021-2022,S39G01N136,수원 KT,Home,캐디 라렌,25,9,14,64.3,1,2,50.0,10,16,62.5,4,4,100.0,3,5,8,2,0,2,0,1,5,3
../kbl_data/2021-2022,S39G01N136,수원 KT,Home,마이크 마이어스,2,1,1,100.0,0,0,0.0,1,1,100.0,0,2,0.0,1,2,3,3,0,0,0,0,0,3
../kbl_data/2021-2022,S39G01N136,수원 KT,Home,김준환,4,1,1,100.0,0,0,0.0,1,1,100.0,2,2,100.0,0,0,0,0,0,0,0,0,0,0
../kbl_data/2021-2022,S39G01N136,수원 KT,Home,하윤기,4,2,5,40.0,0,0,0.0,2,5,40.0,0,1,0.0,1,1,2,0,0,2,0,0,0,2
../kbl_data/2021-2022,S39G01N136,서울 삼성,Away,김동량,9,3,3,100.0,1,3,33.3,4,6,66.7,0,0,0.0,1,4,5,3,0,0,0,0,0,3
../kbl_data/2021-2022,S39G01N136,서울 삼성,Away,장민국,0,0,1,0.0,0,0,0.0,0,1,0.0,0,0,0.0,0,0,0,0,0,0,0,0,0,0
../kbl_data/2021-2022,S39G01N136,서울 삼성,Away,김시래,20,7,12,58.3,0,2,0.0,7,14,50.0,6,6,100.0,1,2,3,1,2,0,0,0,4,1
../kbl_data/2021-2022,S39G01N136,서울 삼성,Away,김현수,0,0,0,0.0,0,0,0.0,0,0,0.0,0,0,0.0,0,0,0,0,0,0,0,0,0,0
../kbl_data/2021-2022,S39G01N136,서울 삼성,Away,임동섭,0,0,1,0.0,0,3,0.0,0,4,0.0,0,0,0.0,0,1,1,0,0,0,1,0,0,4
../kbl_data/2021-2022,S39G01N136,서울 삼성,Away,배수용,0,0,2,0.0,0,0,0.0,0,2,0.0,0,0,0.0,2,2,4,0,2,0,1,0,0,1
../kbl_data/2021-2022,S39G01N136,서울 삼성,Away,천기범,7,2,2,100.0,1,1,100.0,3,3,100.0,0,0,0.0,0,1,1,3,0,0,0,0,0,1
../kbl_data/2021-2022,S39G01N136,서울 삼성,Away,차민석,2,0,0,0.0,0,0,0.0,0,0,0.0,2,2,100.0,1,0,1,0,0,1,0,0,1,0
../kbl_data/2021-2022,S39G01N136,서울 삼성,Away,전형준,6,0,0,0.0,2,3,66.7,2,3,66.7,0,0,0.0,0,0,0,0,0,0,0,0,0,5
../kbl_data/2021-2022,S39G01N136,서울 삼성,Away,다니엘 오셰푸,10,5,9,55.6,0,0,0.0,5,9,55.6,0,0,0.0,1,3,4,1,1,0,0,0,2,2
../kbl_data/2021-2022,S39G01N136,서울 삼성,Away,이원석,2,1,2,50.0,0,1,0.0,1,3,33.3,0,0,0.0,1,3,4,0,2,0,0,0,2,2
../kbl_data/2021-2022,S39G01N136,서울 삼성,Away,토마스 로빈슨,12,4,23,17.4,0,1,0.0,4,24,16.7,4,6,66.7,10,9,19,3,1,0,0,0,5,1
../kbl_data/2021-2022,S39G01N137,창원 LG,Home,강병현,1,0,0,0.0,0,1,0.0,0,1,0.0,1,2,50.0,0,0,0,0,0,0,0,0,0,3
../kbl_data/2021-2022,S39G01N137,창원 LG,Home,이관희,8,3,8,37.5,0,2,0.0,3,10,30.0,2,2,100.0,1,1,2,2,1,2,0,0,1,1
../kbl_data/2021-2022,S39G01N137,창원 LG,Home,정희재,17,3,6,50.0,3,6,50.0,6,12,50.0,2,2,100.0,2,5,7,3,1,0,0,0,2,2
../kbl_data/2021-2022,S39G01N137,창원 LG,Home,서민수,0,0,2,0.0,0,2,0.0,0,4,0.0,0,0,0.0,1,2,3,1,1,0,0,0,1,5
../kbl_data/2021-2022,S39G01N137,창원 LG,Home,한상혁,0,0,0,0.0,0,0,0.0,0,0,0.0,0,0,0.0,0,0,0,0,0,0,0,0,0,0
../kbl_data/2021-2022,S39G01N137,창원 LG,Home,이재도,13,5,8,62.5,0,1,0.0,5,9,55.6,3,4,75.0,1,3,4,6,1,0,0,0,1,2
../kbl_data/2021-2022,S39G01N137,창원 LG,Home,박인태,0,0,2,0.0,0,1,0.0,0,3,0.0,0,0,0.0,1,1,2,0,0,0,0,0,0,1
../kbl_data/2021-2022,S39G01N137,창원 LG,Home,박정현,0,0,0,0.0,0,0,0.0,0,0,0.0,0,0,0.0,0,0,0,0,0,0,0,0,0,0
../kbl_data/2021-2022,S39G01N137,창원 LG,Home,윤원상,3,0,2,0.0,1,4,25.0,1,6,16.7,0,0,0.0,1,0,1,0,0,0,0,0,0,1
../kbl_data/2021-2022,S39G01N137,창원 LG,Home,압둘 말릭 아부,2,1,1,100.0,0,1,0.0,1,2,50.0,0,0,0.0,0,2,2,0,0,1,0,1,1,1
../kbl_data/2021-2022,S39G01N137,창원 LG,Home,아셈 마레이,25,10,15,66.7,0,2,0.0,10,17,58.8,5,7,71.4,8,6,14,3,3,0,1,0,2,2
../kbl_data/2021-2022,S39G01N137,창원 LG,Home,이승우,0,0,0,0.0,0,0,0.0,0,0,0.0,0,0,0.0,0,0,0,0,0,0,0,0,0,0
../kbl_data/2021-2022,S39G01N137,대구 한국가스공사,Away,민성주,0,0,0,0.0,0,0,0.0,0,0,0.0,0,0,0.0,0,0,0,0,0,0,0,0,0,0
../kbl_data/2021-2022,S39G01N137,대구 한국가스공사,Away,홍경기,3,0,2,0.0,1,4,25.0,1,6,16.7,0,0,0.0,3,0,3,1,1,0,0,0,0,1
../kbl_data/2021-2022,S39G01N137,대구 한국가스공사,Away,조상열,6,0,0,0.0,2,5,40.0,2,5,40.0,0,0,0.0,1,0,1,0,0,0,0,0,0,5
../kbl_data/2021-2022,S39G01N137,대구 한국가스공사,Away,이대헌,20,6,11,54.5,2,4,50.0,8,15,53.3,2,2,100.0,3,4,7,2,0,0,0,0,5,4
../kbl_data/2021-2022,S39G01N137,대구 한국가스공사,Away,두경민,4,0,2,0.0,1,5,20.0,1,7,14.3,1,2,50.0,0,3,3,4,0,0,0,0,3,4
../kbl_data/2021-2022,S39G01N137,대구 한국가스공사,Away,박봉진,0,0,0,0.0,0,0,0.0,0,0,0.0,0,0,0.0,0,0,0,0,0,0,0,0,0,0
../kbl_data/2021-2022,S39G01N137,대구 한국가스공사,Away,김낙현,3,0,2,0.0,1,5,20.0,1,7,14.3,0,0,0.0,0,3,3,7,0,0,0,0,1,0
../kbl_data/2021-2022,S39G01N137,대구 한국가스공사,Away,전현우,5,1,2,50.0,1,3,33.3,2,5,40.0,0,0,0.0,0,0,0,1,1,0,0,0,0,3
../kbl_data/2021-2022,S39G01N137,대구 한국가스공사,Away,이윤기,4,0,0,0.0,1,2,50.0,1,2,50.0,1,2,50.0,0,1,1,0,1,0,0,0,0,1
../kbl_data/2021-2022,S39G01N137,대구 한국가스공사,Away,양준우,0,0,1,0.0,0,1,0.0,0,2,0.0,0,0,0.0,0,4,4,2,0,0,0,0,1,1
../kbl_data/2021-2022,S39G01N137,대구 한국가스공사,Away,클리프 알렉산더,20,8,11,72.7,0,0,0.0,8,11,72.7,4,4,100.0,5,8,13,1,1,0,0,3,1,3
../kbl_data/2021-2022,S39G01N137,대구 한국가스공사,Away,신승민,0,0,2,0.0,0,0,0.0,0,2,0.0,0,0,0.0,0,0,0,0,1,0,0,0,0,0
../kbl_data/2021-2022,S39G01N138,울산 현대모비스,Home,이현민,5,1,4,25.0,1,4,25.0,2,8,25.0,0,0,0.0,2,3,5,3,1,0,0,0,3,2
../kbl_data/2021-2022,S39G01N138,울산 현대모비스,Home,함지훈,14,5,10,50.0,1,2,50.0,6,12,50.0,1,2,50.0,1,1,2,1,1,0,0,0,0,1
../kbl_data/2021-2022,S39G01N138,울산 현대모비스,Home,최진수,6,3,4,75.0,0,1,0.0,3,5,60.0,0,0,0.0,0,1,1,0,1,0,0,0,0,3
../kbl_data/2021-2022,S39G01N138,울산 현대모비스,Home,박지훈,0,0,0,0.0,0,0,0.0,0,0,0.0,0,0,0.0,0,0,0,0,0,0,0,0,0,0
../kbl_data/2021-2022,S39G01N138,울산 현대모비스,Home,장재석,4,2,4,50.0,0,0,0.0,2,4,50.0,0,2,0.0,1,2,3,0,0,1,0,0,1,1
../kbl_data/2021-2022,S39G01N138,울산 현대모비스,Home,김국찬,5,1,2,50.0,1,5,20.0,2,7,28.6,0,0,0.0,0,1,1,1,3,0,0,0,1,5
../kbl_data/2021-2022,S39G01N138,울산 현대모비스,Home,이우석,16,5,12,41.7,1,2,50.0,6,14,42.9,3,3,100.0,1,5,6,4,0,0,0,0,0,1
../kbl_data/2021-2022,S39G01N138,울산 현대모비스,Home,라숀 토마스,13,4,9,44.4,0,0,0.0,4,9,44.4,5,5,100.0,4,5,9,6,2,4,0,0,4,3
../kbl_data/2021-2022,S39G01N138,울산 현대모비스,Home,신민석,2,1,2,50.0,0,0,0.0,1,2,50.0,0,0,0.0,1,1,2,1,0,0,0,0,0,0
../kbl_data/2021-2022,S39G01N138,울산 현대모비스,Home,김동준,7,2,3,66.7,1,1,100.0,3,4,75.0,0,0,0.0,0,3,3,2,0,0,0,0,0,1
../kbl_data/2021-2022,S39G01N138,울산 현대모비스,Home,윤성준,0,0,0,0.0,0,0,0.0,0,0,0.0,0,0,0.0,0,0,0,0,0,0,0,0,0,0
../kbl_data/2021-2022,S39G01N138,울산 현대모비스,Home,에릭 버크너,1,0,0,0.0,0,0,0.0,0,0,0.0,1,2,50.0,1,1,2,0,0,0,0,0,0,0
../kbl_data/2021-2022,S39G01N138,고양 오리온,Away,최현민,2,1,3,33.3,0,0,0.0,1,3,33.3,0,0,0.0,2,0,2,0,1,0,1,0,1,1
../kbl_data/2021-2022,S39G01N138,고양 오리온,Away,임종일,0,0,0,0.0,0,0,0.0,0,0,0.0,0,0,0.0,0,1,1,0,0,0,0,0,0,1
../kbl_data/2021-2022,S39G01N138,고양 오리온,Away,이대성,18,5,8,62.5,2,7,28.6,7,15,46.7,2,2,100.0,2,2,4,2,0,0,0,0,2,1
../kbl_data/2021-2022,S39G01N138,고양 오리온,Away,한호빈,0,0,1,0.0,0,2,0.0,0,3,0.0,0,0,0.0,0,2,2,3,0,0,0,0,1,1
../kbl_data/2021-2022,S39G01N138,고양 오리온,Away,이정제,0,0,0,0.0,0,0,0.0,0,0,0.0,0,0,0.0,0,0,0,0,0,0,0,0,0,0
../kbl_data/2021-2022,S39G01N138,고양 오리온,Away,최승욱,2,0,1,0.0,0,1,0.0,0,2,0.0,2,2,100.0,1,0,1,1,1,0,0,0,0,3
../kbl_data/2021-2022,S39G01N138,고양 오리온,Away,이승현,11,2,7,28.6,1,1,100.0,3,8,37.5,4,5,80.0,0,1,1,1,2,1,0,0,1,3
../kbl_data/2021-2022,S39G01N138,고양 오리온,Away,김진유,3,0,0,0.0,1,1,100.0,1,1,100.0,0,0,0.0,0,1,1,0,0,0,0,0,0,0
../kbl_data/2021-2022,S39G01N138,고양 오리온,Away,머피 할로웨이,24,11,18,61.1,0,1,0.0,11,19,57.9,2,2,100.0,4,13,17,2,2,1,0,0,4,2
../kbl_data/2021-2022,S39G01N138,고양 오리온,Away,조한진,0,0,0,0.0,0,0,0.0,0,0,0.0,0,0,0.0,0,0,0,0,0,0,0,0,0,0
../kbl_data/2021-2022,S39G01N138,고양 오리온,Away,박진철,0,0,0,0.0,0,0,0.0,0,0,0.0,0,0,0.0,0,0,0,0,0,0,0,0,0,0
../kbl_data/2021-2022,S39G01N138,고양 오리온,Away,이정현,9,1,3,33.3,2,5,40.0,3,8,37.5,1,2,50.0,0,5,5,3,1,1,0,0,2,2
../kbl_data/2021-2022,S39G01N139,전주 KCC,Home,송창용,7,2,4,50.0,1,2,50.0,3,6,50.0,0,0,0.0,0,0,0,0,0,0,0,0,0,2
../kbl_data/2021-2022,S39G01N139,전주 KCC,Home,이정현,5,1,4,25.0,1,3,33.3,2,7,28.6,0,0,0.0,0,0,0,5,1,0,0,0,2,2
../kbl_data/2021-2022,S39G01N139,전주 KCC,Home,정창영,19,6,7,85.7,2,4,50.0,8,11,72.7,1,3,33.3,0,4,4,1,2,1,0,0,2,2
../kbl_data/2021-2022,S39G01N139,전주 KCC,Home,라건아,22,10,15,66.7,0,3,0.0,10,18,55.6,2,2,100.0,4,10,14,1,1,1,0,1,5,3
../kbl_data/2021-2022,S39G01N139,전주 KCC,Home,김상규,8,3,3,100.0,0,1,0.0,3,4,75.0,2,2,100.0,2,4,6,3,1,0,0,0,3,1
../kbl_data/2021-2022,S39G01N139,전주 KCC,Home,이진욱,0,0,0,0.0,0,1,0.0,0,1,0.0,0,0,0.0,0,2,2,1,0,0,0,0,0,2
../kbl_data/2021-2022,S39G01N139,전주 KCC,Home,김진용,0,0,0,0.0,0,0,0.0,0,0,0.0,0,0,0.0,0,0,0,0,0,0,0,0,0,0
../kbl_data/2021-2022,S39G01N139,전주 KCC,Home,유현준,0,0,1,0.0,0,4,0.0,0,5,0.0,0,0,0.0,0,2,2,4,1,0,0,0,0,1
../kbl_data/2021-2022,S39G01N139,전주 KCC,Home,라타비우스 윌리엄스,4,0,0,0.0,0,0,0.0,0,0,0.0,4,4,100.0,0,1,1,1,0,0,0,0,0,0
../kbl_data/2021-2022,S39G01N139,전주 KCC,Home,곽정훈,9,1,4,25.0,2,2,100.0,3,6,50.0,1,2,50.0,0,2,2,0,0,0,1,0,1,2
../kbl_data/2021-2022,S39G01N139,전주 KCC,Home,이근휘,3,0,2,0.0,1,7,14.3,1,9,11.1,0,0,0.0,0,0,0,1,2,0,1,0,1,1
../kbl_data/2021-2022,S39G01N139,전주 KCC,Home,김동현,0,0,0,0.0,0,0,0.0,0,0,0.0,0,0,0.0,0,0,0,0,0,0,0,0,0,0
../kbl_data/2021-2022,S39G01N139,서울 SK,Away,양우섭,0,0,0,0.0,0,0,0.0,0,0,0.0,0,0,0.0,0,0,0,0,0,0,0,0,0,0
../kbl_data/2021-2022,S39G01N139,서울 SK,Away,허일영,8,1,5,20.0,2,2,100.0,3,7,42.9,0,0,0.0,0,3,3,0,0,0,0,0,1,4
../kbl_data/2021-2022,S39G01N139,서울 SK,Away,김선형,14,5,8,62.5,1,3,33.3,6,11,54.5,1,2,50.0,0,3,3,7,2,0,0,0,2,3
../kbl_data/2021-2022,S39G01N139,서울 SK,Away,최부경,4,2,3,66.7,0,0,0.0,2,3,66.7,0,0,0.0,1,1,2,1,1,0,0,0,2,1
../kbl_data/2021-2022,S39G01N139,서울 SK,Away,리온 윌리엄스,2,1,1,100.0,0,0,0.0,1,1,100.0,0,0,0.0,1,2,3,1,1,0,0,0,0,1
../kbl_data/2021-2022,S39G01N139,서울 SK,Away,배병준,1,0,0,0.0,0,0,0.0,0,0,0.0,1,2,50.0,0,0,0,0,0,0,0,0,1,0
../kbl_data/2021-2022,S39G01N139,서울 SK,Away,이현석,5,1,1,100.0,1,4,25.0,2,5,40.0,0,0,0.0,2,5,7,2,0,0,0,0,0,3
../kbl_data/2021-2022,S39G01N139,서울 SK,Away,최원혁,0,0,0,0.0,0,0,0.0,0,0,0.0,0,0,0.0,0,0,0,0,0,0,0,0,0,0
../kbl_data/2021-2022,S39G01N139,서울 SK,Away,최준용,31,10,14,71.4,3,4,75.0,13,18,72.2,2,4,50.0,1,4,5,2,2,0,0,2,4,1
../kbl_data/2021-2022,S39G01N139,서울 SK,Away,안영준,3,0,2,0.0,1,5,20.0,1,7,14.3,0,0,0.0,0,4,4,2,0,0,1,0,3,3
../kbl_data/2021-2022,S39G01N139,서울 SK,Away,자밀 워니,17,7,15,46.7,0,2,0.0,7,17,41.2,3,3,100.0,5,5,10,1,2,0,0,1,1,1
../kbl_data/2021-2022,S39G01N139,서울 SK,Away,오재현,0,0,0,0.0,0,0,0.0,0,0,0.0,0,0,0.0,0,0,0,0,0,0,0,0,0,0
../kbl_data/2021-2022,S39G01N140,수원 KT,Home,김동욱,0,0,2,0.0,0,3,0.0,0,5,0.0,0,0,0.0,0,1,1,1,0,0,0,0,1,1
../kbl_data/2021-2022,S39G01N140,수원 KT,Home,김영환,0,0,0,0.0,0,1,0.0,0,1,0.0,0,0,0.0,0,0,0,0,0,0,0,0,0,0
../kbl_data/2021-2022,S39G01N140,수원 KT,Home,김현민,5,1,1,100.0,1,2,50.0,2,3,66.7,0,0,0.0,0,0,0,0,0,0,0,0,0,0
../kbl_data/2021-2022,S39G01N140,수원 KT,Home,정성우,6,3,5,60.0,0,3,0.0,3,8,37.5,0,0,0.0,1,0,1,1,1,0,0,0,0,5
../kbl_data/2021-2022,S39G01N140,수원 KT,Home,최성모,3,1,1,100.0,0,1,0.0,1,2,50.0,1,2,50.0,0,0,0,2,1,0,0,0,0,2
../kbl_data/2021-2022,S39G01N140,수원 KT,Home,허훈,19,4,5,80.0,3,8,37.5,7,13,53.8,2,2,100.0,1,1,2,3,0,0,1,0,4,0
../kbl_data/2021-2022,S39G01N140,수원 KT,Home,양홍석,14,4,8,50.0,2,5,40.0,6,13,46.2,0,2,0.0,1,6,7,2,2,0,0,0,2,1
../kbl_data/2021-2022,S39G01N140,수원 KT,Home,박준영,2,1,2,50.0,0,0,0.0,1,2,50.0,0,0,0.0,0,0,0,0,0,0,0,0,0,1
../kbl_data/2021-2022,S39G01N140,수원 KT,Home,캐디 라렌,6,3,10,30.0,0,0,0.0,3,10,30.0,0,0,0.0,3,7,10,3,0,1,0,0,1,1
../kbl_data/2021-2022,S39G01N140,수원 KT,Home,마이크 마이어스,11,4,5,80.0,0,0,0.0,4,5,80.0,3,8,37.5,1,5,6,3,4,2,0,1,2,3
../kbl_data/2021-2022,S39G01N140,수원 KT,Home,김준환,4,2,3,66.7,0,1,0.0,2,4,50.0,0,0,0.0,0,1,1,2,1,0,0,0,0,1
../kbl_data/2021-2022,S39G01N140,수원 KT,Home,하윤기,6,2,4,50.0,0,0,0.0,2,4,50.0,2,2,100.0,3,3,6,0,0,1,0,0,0,4
../kbl_data/2021-2022,S39G01N140,원주 DB,Away,윤호영,0,0,0,0.0,0,0,0.0,0,0,0.0,0,0,0.0,0,3,3,0,1,0,0,0,0,1
../kbl_data/2021-2022,S39G01N140,원주 DB,Away,박찬희,8,2,5,40.0,1,3,33.3,3,8,37.5,1,2,50.0,1,3,4,8,1,0,0,0,2,3
../kbl_data/2021-2022,S39G01N140,원주 DB,Away,정준원,2,1,4,25.0,0,0,0.0,1,4,25.0,0,0,0.0,1,2,3,0,1,0,0,0,0,0
../kbl_data/2021-2022,S39G01N140,원주 DB,Away,김종규,14,4,6,66.7,0,0,0.0,4,6,66.7,6,8,75.0,7,2,9,1,2,2,0,1,0,3
../kbl_data/2021-2022,S39G01N140,원주 DB,Away,허웅,10,2,7,28.6,2,5,40.0,4,12,33.3,0,0,0.0,1,1,2,2,0,0,1,0,1,1
../kbl_data/2021-2022,S39G01N140,원주 DB,Away,김영훈,0,0,0,0.0,0,0,0.0,0,0,0.0,0,4,0.0,0,2,2,0,0,0,0,0,1,0
../kbl_data/2021-2022,S39G01N140,원주 DB,Away,강상재,13,5,7,71.4,1,2,50.0,6,9,66.7,0,0,0.0,2,1,3,0,0,0,0,0,1,1
../kbl_data/2021-2022,S39G01N140,원주 DB,Away,김철욱,2,1,1,100.0,0,1,0.0,1,2,50.0,0,0,0.0,1,0,1,0,0,0,0,0,0,1
../kbl_data/2021-2022,S39G01N140,원주 DB,Away,이준희,4,2,2,100.0,0,1,0.0,2,3,66.7,0,0,0.0,0,0,0,0,0,0,0,0,0,1
../kbl_data/2021-2022,S39G01N140,원주 DB,Away,레나드 프리먼,13,6,8,75.0,0,1,0.0,6,9,66.7,1,1,100.0,3,4,7,1,1,0,0,0,1,2
../kbl_data/2021-2022,S39G01N140,원주 DB,Away,정호영,7,3,7,42.9,0,3,0.0,3,10,30.0,1,1,100.0,0,0,0,6,1,0,0,0,3,0
../kbl_data/2021-2022,S39G01N140,원주 DB,Away,조니 오브라이언트,14,3,5,60.0,2,8,25.0,5,13,38.5,2,3,66.7,0,8,8,0,0,2,0,0,1,3
../kbl_data/2021-2022,S39G01N141,서울 삼성,Home,김동량,14,7,9,77.8,0,2,0.0,7,11,63.6,0,0,0.0,0,5,5,1,0,0,0,0,0,5
../kbl_data/2021-2022,S39G01N141,서울 삼성,Home,김시래,16,5,9,55.6,1,2,50.0,6,11,54.5,3,4,75.0,1,4,5,6,1,0,1,0,2,4
../kbl_data/2021-2022,S39G01N141,서울 삼성,Home,김현수,3,1,1,100.0,0,5,0.0,1,6,16.7,1,1,100.0,0,3,3,0,0,0,0,0,0,0
../kbl_data/2021-2022,S39G01N141,서울 삼성,Home,임동섭,12,0,2,0.0,4,5,80.0,4,7,57.1,0,0,0.0,2,4,6,1,1,0,0,0,0,3
../kbl_data/2021-2022,S39G01N141,서울 삼성,Home,배수용,0,0,0,0.0,0,2,0.0,0,2,0.0,0,0,0.0,0,0,0,0,0,0,0,0,0,0
../kbl_data/2021-2022,S39G01N141,서울 삼성,Home,정준수,0,0,0,0.0,0,0,0.0,0,0,0.0,0,0,0.0,0,0,0,0,0,0,0,0,0,1
../kbl_data/2021-2022,S39G01N141,서울 삼성,Home,강바일,8,1,3,33.3,2,5,40.0,3,8,37.5,0,0,0.0,1,1,2,0,0,0,0,0,1,3
../kbl_data/2021-2022,S39G01N141,서울 삼성,Home,차민석,0,0,0,0.0,0,0,0.0,0,0,0.0,0,0,0.0,0,0,0,0,0,0,0,0,0,1
../kbl_data/2021-2022,S39G01N141,서울 삼성,Home,전형준,2,1,2,50.0,0,0,0.0,1,2,50.0,0,0,0.0,0,0,0,0,0,0,0,0,0,4
../kbl_data/2021-2022,S39G01N141,서울 삼성,Home,다니엘 오셰푸,8,2,4,50.0,0,0,0.0,2,4,50.0,4,6,66.7,2,2,4,3,1,0,0,0,4,2
../kbl_data/2021-2022,S39G01N141,서울 삼성,Home,이원석,0,0,1,0.0,0,0,0.0,0,1,0.0,0,0,0.0,0,3,3,0,0,0,0,0,2,0
../kbl_data/2021-2022,S39G01N141,서울 삼성,Home,토마스 로빈슨,23,10,21,47.6,0,0,0.0,10,21,47.6,3,3,100.0,6,4,10,6,1,0,0,1,5,1
../kbl_data/2021-2022,S39G01N141,안양 KGC,Away,양희종,8,1,1,100.0,2,4,50.0,3,5,60.0,0,0,0.0,1,0,1,0,0,0,0,0,0,0
../kbl_data/2021-2022,S39G01N141,안양 KGC,Away,박형철,0,0,0,0.0,0,0,0.0,0,0,0.0,0,0,0.0,0,0,0,0,0,0,0,0,1,2
../kbl_data/2021-2022,S39G01N141,안양 KGC,Away,함준후,0,0,0,0.0,0,0,0.0,0,0,0.0,0,0,0.0,0,0,0,0,0,0,0,0,0,1
../kbl_data/2021-2022,S39G01N141,안양 KGC,Away,오세근,18,6,8,75.0,0,1,0.0,6,9,66.7,6,6,100.0,2,6,8,0,2,1,0,0,2,1
../kbl_data/2021-2022,S39G01N141,안양 KGC,Away,문성곤,8,1,1,100.0,2,5,40.0,3,6,50.0,0,0,0.0,1,2,3,2,3,0,0,0,0,2
../kbl_data/2021-2022,S39G01N141,안양 KGC,Away,전성현,12,1,3,33.3,3,10,30.0,4,13,30.8,1,1,100.0,0,2,2,3,2,0,0,0,0,1
../kbl_data/2021-2022,S39G01N141,안양 KGC,Away,박지훈,14,4,5,80.0,0,1,0.0,4,6,66.7,6,10,60.0,1,1,2,3,0,0,0,0,2,4
../kbl_data/2021-2022,S39G01N141,안양 KGC,Away,이우정,0,0,1,0.0,0,0,0.0,0,1,0.0,0,0,0.0,0,0,0,1,1,0,0,0,0,0
../kbl_data/2021-2022,S39G01N141,안양 KGC,Away,대릴 먼로,0,0,0,0.0,0,0,0.0,0,0,0.0,0,0,0.0,0,0,0,0,0,0,0,0,0,0
../kbl_data/2021-2022,S39G01N141,안양 KGC,Away,변준형,0,0,0,0.0,0,3,0.0,0,3,0.0,0,0,0.0,0,1,1,2,1,0,0,0,2,1
../kbl_data/2021-2022,S39G01N141,안양 KGC,Away,한승희,2,1,1,100.0,0,0,0.0,1,1,100.0,0,0,0.0,1,0,1,0,0,0,0,0,1,2
../kbl_data/2021-2022,S39G01N141,안양 KGC,Away,오마리 스펠맨,35,9,13,69.2,3,10,30.0,12,23,52.2,8,8,100.0,1,14,15,9,2,1,0,1,0,3
../kbl_data/2021-2022,S39G01N142,울산 현대모비스,Home,이현민,12,0,0,0.0,4,4,100.0,4,4,100.0,0,0,0.0,1,1,2,9,0,0,0,0,0,3
../kbl_data/2021-2022,S39G01N142,울산 현대모비스,Home,함지훈,8,4,7,57.1,0,1,0.0,4,8,50.0,0,0,0.0,1,5,6,6,1,0,0,0,1,0
../kbl_data/2021-2022,S39G01N142,울산 현대모비스,Home,최진수,0,0,0,0.0,0,2,0.0,0,2,0.0,0,0,0.0,0,0,0,0,0,0,0,0,0,1
../kbl_data/2021-2022,S39G01N142,울산 현대모비스,Home,박지훈,0,0,0,0.0,0,0,0.0,0,0,0.0,0,0,0.0,0,0,0,0,1,0,0,0,0,1
../kbl_data/2021-2022,S39G01N142,울산 현대모비스,Home,장재석,7,3,6,50.0,0,0,0.0,3,6,50.0,1,1,100.0,1,5,6,1,0,0,0,0,3,1
../kbl_data/2021-2022,S39G01N142,울산 현대모비스,Home,김국찬,15,3,4,75.0,3,11,27.3,6,15,40.0,0,0,0.0,0,2,2,5,1,0,0,0,3,4
../kbl_data/2021-2022,S39G01N142,울산 현대모비스,Home,이우석,22,8,12,66.7,1,4,25.0,9,16,56.2,3,4,75.0,1,1,2,2,2,0,0,1,0,2
../kbl_data/2021-2022,S39G01N142,울산 현대모비스,Home,라숀 토마스,29,12,18,66.7,0,0,0.0,12,18,66.7,5,8,62.5,7,7,14,5,4,3,0,1,4,4
../kbl_data/2021-2022,S39G01N142,울산 현대모비스,Home,신민석,0,0,0,0.0,0,1,0.0,0,1,0.0,0,0,0.0,0,0,0,1,0,0,0,0,1,0
../kbl_data/2021-2022,S39G01N142,울산 현대모비스,Home,김동준,0,0,0,0.0,0,0,0.0,0,0,0.0,0,0,0.0,0,1,1,1,0,0,0,0,1,0
../kbl_data/2021-2022,S39G01N142,울산 현대모비스,Home,윤성준,0,0,0,0.0,0,0,0.0,0,0,0.0,0,0,0.0,0,0,0,0,0,0,0,0,0,0
../kbl_data/2021-2022,S39G01N142,울산 현대모비스,Home,에릭 버크너,0,0,0,0.0,0,0,0.0,0,0,0.0,0,0,0.0,0,1,1,0,0,0,0,0,2,0
../kbl_data/2021-2022,S39G01N142,서울 SK,Away,양우섭,0,0,0,0.0,0,0,0.0,0,0,0.0,0,0,0.0,0,0,0,0,0,0,0,0,0,0
../kbl_data/2021-2022,S39G01N142,서울 SK,Away,허일영,4,2,4,50.0,0,3,0.0,2,7,28.6,0,0,0.0,1,0,1,0,0,0,1,0,1,1
../kbl_data/2021-2022,S39G01N142,서울 SK,Away,김선형,29,9,10,90.0,3,4,75.0,12,14,85.7,2,3,66.7,1,4,5,8,1,0,0,0,3,2
../kbl_data/2021-2022,S39G01N142,서울 SK,Away,최부경,4,2,7,28.6,0,0,0.0,2,7,28.6,0,0,0.0,5,0,5,1,0,0,1,0,1,1
../kbl_data/2021-2022,S39G01N142,서울 SK,Away,리온 윌리엄스,0,0,2,0.0,0,0,0.0,0,2,0.0,0,0,0.0,0,0,0,0,0,0,0,0,0,1
../kbl_data/2021-2022,S39G01N142,서울 SK,Away,배병준,0,0,0,0.0,0,0,0.0,0,0,0.0,0,0,0.0,0,0,0,0,0,0,0,0,0,0
../kbl_data/2021-2022,S39G01N142,서울 SK,Away,이현석,0,0,0,0.0,0,1,0.0,0,1,0.0,0,0,0.0,0,1,1,0,0,0,0,0,0,1
../kbl_data/2021-2022,S39G01N142,서울 SK,Away,최원혁,0,0,0,0.0,0,0,0.0,0,0,0.0,0,0,0.0,0,0,0,2,1,0,0,0,0,2
../kbl_data/2021-2022,S39G01N142,서울 SK,Away,최준용,17,8,16,50.0,0,2,0.0,8,18,44.4,1,1,100.0,1,2,3,5,1,1,0,2,3,3
../kbl_data/2021-2022,S39G01N142,서울 SK,Away,안영준,10,2,3,66.7,2,8,25.0,4,11,36.4,0,0,0.0,4,4,8,6,3,1,0,0,1,1
../kbl_data/2021-2022,S39G01N142,서울 SK,Away,자밀 워니,28,11,23,47.8,0,0,0.0,11,23,47.8,6,9,66.7,8,5,13,2,2,1,0,0,1,0
../kbl_data/2021-2022,S39G01N142,서울 SK,Away,오재현,2,1,2,50.0,0,0,0.0,1,2,50.0,0,0,0.0,0,2,2,0,1,0,0,0,0,2
../kbl_data/2021-2022,S39G01N143,수원 KT,Home,김동욱,3,1,4,25.0,0,6,0.0,1,10,10.0,1,1,100.0,1,2,3,4,3,1,0,0,2,3
../kbl_data/2021-2022,S39G01N143,수원 KT,Home,김영환,5,1,1,100.0,1,2,50.0,2,3,66.7,0,0,0.0,1,0,1,3,0,0,0,0,1,2
../kbl_data/2021-2022,S39G01N143,수원 KT,Home,김현민,0,0,0,0.0,0,0,0.0,0,0,0.0,0,0,0.0,0,1,1,0,0,0,0,0,1,0
../kbl_data/2021-2022,S39G01N143,수원 KT,Home,김윤태,0,0,0,0.0,0,0,0.0,0,0,0.0,0,0,0.0,0,0,0,0,0,0,0,0,0,0
../kbl_data/2021-2022,S39G01N143,수원 KT,Home,최성모,0,0,0,0.0,0,0,0.0,0,0,0.0,0,0,0.0,0,0,0,2,1,0,0,0,0,2
../kbl_data/2021-2022,S39G01N143,수원 KT,Home,허훈,20,5,7,71.4,2,8,25.0,7,15,46.7,4,4,100.0,0,1,1,4,3,0,1,0,1,2
../kbl_data/2021-2022,S39G01N143,수원 KT,Home,양홍석,28,6,11,54.5,4,5,80.0,10,16,62.5,4,5,80.0,8,6,14,10,1,0,0,0,6,3
../kbl_data/2021-2022,S39G01N143,수원 KT,Home,박준영,6,2,4,50.0,0,1,0.0,2,5,40.0,2,6,33.3,0,0,0,0,0,0,0,0,0,2
../kbl_data/2021-2022,S39G01N143,수원 KT,Home,캐디 라렌,18,8,11,72.7,0,1,0.0,8,12,66.7,2,3,66.7,2,11,13,0,0,2,0,1,2,3
../kbl_data/2021-2022,S39G01N143,수원 KT,Home,박지원,0,0,0,0.0,0,0,0.0,0,0,0.0,0,0,0.0,0,0,0,0,0,0,0,0,0,0
../kbl_data/2021-2022,S39G01N143,수원 KT,Home,마이크 마이어스,6,3,4,75.0,0,0,0.0,3,4,75.0,0,2,0.0,0,2,2,2,3,1,0,1,2,1
../kbl_data/2021-2022,S39G01N143,수원 KT,Home,김준환,0,0,0,0.0,0,0,0.0,0,0,0.0,0,0,0.0,0,0,0,0,0,0,0,0,1,0
../kbl_data/2021-2022,S39G01N143,대구 한국가스공사,Away,민성주,0,0,1,0.0,0,0,0.0,0,1,0.0,0,0,0.0,0,0,0,0,0,0,0,0,0,0
../kbl_data/2021-2022,S39G01N143,대구 한국가스공사,Away,홍경기,11,3,6,50.0,1,3,33.3,4,9,44.4,2,2,100.0,2,0,2,1,1,0,0,0,1,2
../kbl_data/2021-2022,S39G01N143,대구 한국가스공사,Away,조상열,3,0,0,0.0,1,2,50.0,1,2,50.0,0,0,0.0,0,0,0,1,2,0,0,0,0,3
../kbl_data/2021-2022,S39G01N143,대구 한국가스공사,Away,이대헌,16,4,8,50.0,2,5,40.0,6,13,46.2,2,2,100.0,1,3,4,4,0,0,0,0,3,5
../kbl_data/2021-2022,S39G01N143,대구 한국가스공사,Away,두경민,18,3,4,75.0,2,7,28.6,5,11,45.5,6,7,85.7,0,1,1,6,5,0,0,0,6,0
../kbl_data/2021-2022,S39G01N143,대구 한국가스공사,Away,박봉진,0,0,0,0.0,0,0,0.0,0,0,0.0,0,0,0.0,0,1,1,0,0,0,0,0,0,0
../kbl_data/2021-2022,S39G01N143,대구 한국가스공사,Away,김낙현,22,2,5,40.0,6,8,75.0,8,13,61.5,0,0,0.0,0,2,2,7,1,0,0,0,0,3
../kbl_data/2021-2022,S39G01N143,대구 한국가스공사,Away,전현우,1,0,0,0.0,0,2,0.0,0,2,0.0,1,2,50.0,1,1,2,0,0,0,0,0,1,2
../kbl_data/2021-2022,S39G01N143,대구 한국가스공사,Away,이윤기,0,0,0,0.0,0,0,0.0,0,0,0.0,0,0,0.0,0,1,1,0,0,0,0,0,0,4
../kbl_data/2021-2022,S39G01N143,대구 한국가스공사,Away,양준우,0,0,0,0.0,0,0,0.0,0,0,0.0,0,0,0.0,0,0,0,0,0,0,0,0,0,0
../kbl_data/2021-2022,S39G01N143,대구 한국가스공사,Away,클리프 알렉산더,20,7,14,50.0,0,0,0.0,7,14,50.0,6,6,100.0,1,12,13,0,4,0,0,3,0,3
../kbl_data/2021-2022,S39G01N143,대구 한국가스공사,Away,신승민,3,0,0,0.0,1,2,50.0,1,2,50.0,0,0,0.0,1,1,2,0,0,0,0,0,1,2
../kbl_data/2021-2022,S39G01N144,창원 LG,Home,강병현,7,1,1,100.0,1,3,33.3,2,4,50.0,2,2,100.0,0,1,1,0,0,0,0,0,1,3
../kbl_data/2021-2022,S39G01N144,창원 LG,Home,이관희,8,3,7,42.9,0,6,0.0,3,13,23.1,2,2,100.0,0,3,3,6,1,0,0,0,1,0
../kbl_data/2021-2022,S39G01N144,창원 LG,Home,정희재,6,0,1,0.0,2,4,50.0,2,5,40.0,0,2,0.0,0,2,2,0,3,0,0,0,1,4
../kbl_data/2021-2022,S39G01N144,창원 LG,Home,서민수,11,1,1,100.0,3,5,60.0,4,6,66.7,0,0,0.0,0,2,2,0,0,0,0,0,0,3
../kbl_data/2021-2022,S39G01N144,창원 LG,Home,한상혁,2,0,0,0.0,0,0,0.0,0,0,0.0,2,2,100.0,0,0,0,0,0,0,0,0,0,0
../kbl_data/2021-2022,S39G01N144,창원 LG,Home,이재도,7,2,9,22.2,1,2,50.0,3,11,27.3,0,0,0.0,1,2,3,8,0,0,0,0,1,1
../kbl_data/2021-2022,S39G01N144,창원 LG,Home,정인덕,0,0,0,0.0,0,0,0.0,0,0,0.0,0,0,0.0,0,0,0,0,0,0,0,0,0,0
../kbl_data/2021-2022,S39G01N144,창원 LG,Home,박정현,0,0,0,0.0,0,0,0.0,0,0,0.0,0,0,0.0,0,0,0,0,0,0,0,0,0,0
../kbl_data/2021-2022,S39G01N144,창원 LG,Home,윤원상,0,0,0,0.0,0,0,0.0,0,0,0.0,0,0,0.0,0,0,0,1,0,0,0,0,0,0
../kbl_data/2021-2022,S39G01N144,창원 LG,Home,아셈 마레이,17,7,16,43.8,0,0,0.0,7,16,43.8,3,6,50.0,8,14,22,3,4,0,0,3,1,3
../kbl_data/2021-2022,S39G01N144,창원 LG,Home,이승우,13,6,10,60.0,0,1,0.0,6,11,54.5,1,3,33.3,1,1,2,1,3,0,0,0,1,4
../kbl_data/2021-2022,S39G01N144,창원 LG,Home,사마르도 사무엘스,0,0,0,0.0,0,0,0.0,0,0,0.0,0,0,0.0,0,0,0,0,0,0,0,0,0,0
../kbl_data/2021-2022,S39G01N144,고양 오리온,Away,최현민,0,0,2,0.0,0,0,0.0,0,2,0.0,0,0,0.0,2,1,3,0,0,0,0,0,0,1
../kbl_data/2021-2022,S39G01N144,고양 오리온,Away,임종일,0,0,0,0.0,0,3,0.0,0,3,0.0,0,0,0.0,0,1,1,1,0,0,0,0,0,0
../kbl_data/2021-2022,S39G01N144,고양 오리온,Away,이대성,9,0,3,0.0,2,6,33.3,2,9,22.2,3,4,75.0,0,3,3,2,0,1,0,0,6,3
../kbl_data/2021-2022,S39G01N144,고양 오리온,Away,한호빈,9,1,1,100.0,2,4,50.0,3,5,60.0,1,2,50.0,0,1,1,0,0,0,0,0,0,3
../kbl_data/2021-2022,S39G01N144,고양 오리온,Away,최승욱,4,2,2,100.0,0,0,0.0,2,2,100.0,0,0,0.0,2,1,3,1,0,0,0,0,0,1
../kbl_data/2021-2022,S39G01N144,고양 오리온,Away,이승현,2,1,6,16.7,0,1,0.0,1,7,14.3,0,0,0.0,3,5,8,5,1,0,0,0,1,2
../kbl_data/2021-2022,S39G01N144,고양 오리온,Away,김진유,0,0,0,0.0,0,1,0.0,0,1,0.0,0,0,0.0,0,0,0,0,0,0,0,0,0,1
../kbl_data/2021-2022,S39G01N144,고양 오리온,Away,제임스 메이스,9,2,6,33.3,1,2,50.0,3,8,37.5,2,2,100.0,2,5,7,2,0,0,0,0,0,3
../kbl_data/2021-2022,S39G01N144,고양 오리온,Away,머피 할로웨이,14,6,10,60.0,0,1,0.0,6,11,54.5,2,2,100.0,1,9,10,1,0,0,0,0,4,3
../kbl_data/2021-2022,S39G01N144,고양 오리온,Away,조한진,0,0,0,0.0,0,2,0.0,0,2,0.0,0,0,0.0,0,2,2,0,0,0,0,0,0,1
../kbl_data/2021-2022,S39G01N144,고양 오리온,Away,박진철,0,0,0,0.0,0,0,0.0,0,0,0.0,0,0,0.0,0,0,0,0,0,0,0,0,0,0
../kbl_data/2021-2022,S39G01N144,고양 오리온,Away,이정현,14,5,7,71.4,0,3,0.0,5,10,50.0,4,6,66.7,2,1,3,1,3,0,0,0,1,1
../kbl_data/2021-2022,S39G01N145,서울 삼성,Home,김동량,6,3,8,37.5,0,0,0.0,3,8,37.5,0,0,0.0,4,5,9,8,1,0,0,0,1,3
../kbl_data/2021-2022,S39G01N145,서울 삼성,Home,김시래,12,2,6,33.3,2,2,100.0,4,8,50.0,2,2,100.0,0,3,3,8,3,0,0,0,0,2
../kbl_data/2021-2022,S39G01N145,서울 삼성,Home,김현수,9,3,4,75.0,1,7,14.3,4,11,36.4,0,0,0.0,0,1,1,0,0,0,0,0,1,3
../kbl_data/2021-2022,S39G01N145,서울 삼성,Home,임동섭,16,3,5,60.0,3,10,30.0,6,15,40.0,1,2,50.0,3,4,7,0,0,0,0,0,1,4
../kbl_data/2021-2022,S39G01N145,서울 삼성,Home,배수용,2,1,1,100.0,0,0,0.0,1,1,100.0,0,0,0.0,0,0,0,0,0,1,0,0,0,1
../kbl_data/2021-2022,S39G01N145,서울 삼성,Home,이호현,0,0,0,0.0,0,0,0.0,0,0,0.0,0,0,0.0,0,0,0,0,0,0,0,0,0,0
../kbl_data/2021-2022,S39G01N145,서울 삼성,Home,강바일,0,0,0,0.0,0,0,0.0,0,0,0.0,0,0,0.0,0,0,0,0,0,0,0,0,0,0
../kbl_data/2021-2022,S39G01N145,서울 삼성,Home,차민석,0,0,0,0.0,0,0,0.0,0,0,0.0,0,0,0.0,0,0,0,0,0,0,0,0,0,0
../kbl_data/2021-2022,S39G01N145,서울 삼성,Home,전형준,15,0,1,0.0,5,7,71.4,5,8,62.5,0,0,0.0,1,2,3,0,0,0,0,0,0,1
../kbl_data/2021-2022,S39G01N145,서울 삼성,Home,다니엘 오셰푸,15,7,10,70.0,0,0,0.0,7,10,70.0,1,7,14.3,3,8,11,3,0,0,0,0,3,2
../kbl_data/2021-2022,S39G01N145,서울 삼성,Home,이원석,0,0,0,0.0,0,0,0.0,0,0,0.0,0,0,0.0,0,0,0,0,0,0,0,0,0,0
../kbl_data/2021-2022,S39G01N145,서울 삼성,Home,토마스 로빈슨,10,5,11,45.5,0,0,0.0,5,11,45.5,0,2,0.0,5,5,10,5,2,1,0,1,4,4
../kbl_data/2021-2022,S39G01N145,대구 한국가스공사,Away,민성주,6,3,3,100.0,0,0,0.0,3,3,100.0,0,0,0.0,1,2,3,0,0,0,0,0,0,1
../kbl_data/2021-2022,S39G01N145,대구 한국가스공사,Away,홍경기,15,2,2,100.0,3,7,42.9,5,9,55.6,2,4,50.0,0,0,0,2,1,0,0,0,1,3
../kbl_data/2021-2022,S39G01N145,대구 한국가스공사,Away,조상열,0,0,0,0.0,0,0,0.0,0,0,0.0,0,0,0.0,0,0,0,0,0,0,0,0,0,1
../kbl_data/2021-2022,S39G01N145,대구 한국가스공사,Away,이대헌,10,5,11,45.5,0,3,0.0,5,14,35.7,0,0,0.0,2,1,3,1,0,0,0,0,0,2
../kbl_data/2021-2022,S39G01N145,대구 한국가스공사,Away,두경민,16,5,7,71.4,1,3,33.3,6,10,60.0,3,3,100.0,0,3,3,6,2,0,1,0,0,0
../kbl_data/2021-2022,S39G01N145,대구 한국가스공사,Away,박봉진,0,0,0,0.0,0,0,0.0,0,0,0.0,0,0,0.0,0,0,0,0,0,0,0,0,0,0
../kbl_data/2021-2022,S39G01N145,대구 한국가스공사,Away,김낙현,8,3,3,100.0,0,5,0.0,3,8,37.5,2,2,100.0,0,2,2,2,0,0,0,0,2,3
../kbl_data/2021-2022,S39G01N145,대구 한국가스공사,Away,전현우,3,1,2,50.0,0,0,0.0,1,2,50.0,1,2,50.0,0,0,0,0,0,0,0,0,0,3
../kbl_data/2021-2022,S39G01N145,대구 한국가스공사,Away,이윤기,0,0,1,0.0,0,1,0.0,0,2,0.0,0,0,0.0,0,1,1,1,1,0,0,0,1,1
../kbl_data/2021-2022,S39G01N145,대구 한국가스공사,Away,양준우,2,0,0,0.0,0,0,0.0,0,0,0.0,2,2,100.0,0,3,3,0,0,0,0,0,0,0
../kbl_data/2021-2022,S39G01N145,대구 한국가스공사,Away,클리프 알렉산더,8,3,7,42.9,0,1,0.0,3,8,37.5,2,4,50.0,4,8,12,0,0,1,1,1,5,2
../kbl_data/2021-2022,S39G01N145,대구 한국가스공사,Away,신승민,5,1,2,50.0,1,2,50.0,2,4,50.0,0,0,0.0,0,2,2,3,1,0,0,0,0,1
../kbl_data/2021-2022,S39G01N146,원주 DB,Home,윤호영,0,0,0,0.0,0,0,0.0,0,0,0.0,0,0,0.0,0,0,0,0,0,0,0,0,0,0
../kbl_data/2021-2022,S39G01N146,원주 DB,Home,박찬희,0,0,2,0.0,0,1,0.0,0,3,0.0,0,0,0.0,1,1,2,3,0,0,0,0,0,0
../kbl_data/2021-2022,S39G01N146,원주 DB,Home,정준원,0,0,0,0.0,0,1,0.0,0,1,0.0,0,0,0.0,0,1,1,0,0,0,0,0,0,0
../kbl_data/2021-2022,S39G01N146,원주 DB,Home,김종규,9,2,6,33.3,1,2,50.0,3,8,37.5,2,3,66.7,4,1,5,1,0,0,0,0,2,3
../kbl_data/2021-2022,S39G01N146,원주 DB,Home,허웅,9,0,3,0.0,3,9,33.3,3,12,25.0,0,0,0.0,1,4,5,1,0,0,0,0,2,4
../kbl_data/2021-2022,S39G01N146,원주 DB,Home,김영훈,0,0,0,0.0,0,0,0.0,0,0,0.0,0,0,0.0,0,0,0,0,0,0,0,0,0,0
../kbl_data/2021-2022,S39G01N146,원주 DB,Home,강상재,8,1,4,25.0,2,3,66.7,3,7,42.9,0,0,0.0,2,7,9,3,2,0,1,0,3,1
../kbl_data/2021-2022,S39G01N146,원주 DB,Home,김철욱,4,2,2,100.0,0,2,0.0,2,4,50.0,0,0,0.0,0,2,2,0,0,0,0,0,1,3
../kbl_data/2021-2022,S39G01N146,원주 DB,Home,이준희,8,4,5,80.0,0,2,0.0,4,7,57.1,0,0,0.0,3,2,5,4,2,0,0,0,1,1
../kbl_data/2021-2022,S39G01N146,원주 DB,Home,레나드 프리먼,2,1,1,100.0,0,1,0.0,1,2,50.0,0,0,0.0,1,5,6,0,0,0,0,0,1,1
../kbl_data/2021-2022,S39G01N146,원주 DB,Home,정호영,3,0,1,0.0,1,4,25.0,1,5,20.0,0,0,0.0,1,1,2,0,1,1,0,0,1,4
../kbl_data/2021-2022,S39G01N146,원주 DB,Home,조니 오브라이언트,32,8,13,61.5,3,8,37.5,11,21,52.4,7,9,77.8,2,8,10,3,0,1,0,0,1,1
../kbl_data/2021-2022,S39G01N146,안양 KGC,Away,양희종,4,0,0,0.0,1,3,33.3,1,3,33.3,1,2,50.0,0,3,3,0,0,2,0,0,1,2
../kbl_data/2021-2022,S39G01N146,안양 KGC,Away,박형철,0,0,0,0.0,0,0,0.0,0,0,0.0,0,0,0.0,0,0,0,0,0,0,0,0,0,0
../kbl_data/2021-2022,S39G01N146,안양 KGC,Away,함준후,3,0,0,0.0,1,2,50.0,1,2,50.0,0,0,0.0,1,2,3,2,0,0,0,0,0,2
../kbl_data/2021-2022,S39G01N146,안양 KGC,Away,오세근,10,4,8,50.0,0,0,0.0,4,8,50.0,2,3,66.7,3,6,9,3,0,2,1,0,1,3
../kbl_data/2021-2022,S39G01N146,안양 KGC,Away,문성곤,14,1,1,100.0,4,8,50.0,5,9,55.6,0,0,0.0,2,3,5,0,1,0,0,0,0,2
../kbl_data/2021-2022,S39G01N146,안양 KGC,Away,전성현,17,5,6,83.3,2,8,25.0,7,14,50.0,1,2,50.0,0,0,0,1,1,0,0,0,2,0
../kbl_data/2021-2022,S39G01N146,안양 KGC,Away,박지훈,1,0,1,0.0,0,1,0.0,0,2,0.0,1,2,50.0,0,0,0,1,1,0,0,0,0,3
../kbl_data/2021-2022,S39G01N146,안양 KGC,Away,이우정,0,0,0,0.0,0,0,0.0,0,0,0.0,0,0,0.0,0,0,0,0,0,0,0,0,0,0
../kbl_data/2021-2022,S39G01N146,안양 KGC,Away,대릴 먼로,0,0,0,0.0,0,0,0.0,0,0,0.0,0,0,0.0,0,0,0,0,0,0,0,0,0,0
../kbl_data/2021-2022,S39G01N146,안양 KGC,Away,변준형,8,2,4,50.0,1,6,16.7,3,10,30.0,1,2,50.0,0,1,1,3,2,2,0,0,1,2
../kbl_data/2021-2022,S39G01N146,안양 KGC,Away,한승희,0,0,0,0.0,0,0,0.0,0,0,0.0,0,0,0.0,0,0,0,0,0,0,0,0,0,0
../kbl_data/2021-2022,S39G01N146,안양 KGC,Away,오마리 스펠맨,20,6,11,54.5,2,9,22.2,8,20,40.0,2,7,28.6,4,11,15,5,1,0,0,3,3,4
../kbl_data/2021-2022,S39G01N147,서울 SK,Home,양우섭,2,1,1,100.0,0,0,0.0,1,1,100.0,0,0,0.0,0,0,0,0,0,0,0,0,0,0
../kbl_data/2021-2022,S39G01N147,서울 SK,Home,허일영,5,1,2,50.0,1,5,20.0,2,7,28.6,0,0,0.0,2,4,6,2,1,0,0,0,1,4
../kbl_data/2021-2022,S39G01N147,서울 SK,Home,김선형,6,3,6,50.0,0,1,0.0,3,7,42.9,0,0,0.0,1,2,3,7,0,1,0,0,3,0
../kbl_data/2021-2022,S39G01N147,서울 SK,Home,최부경,15,6,7,85.7,0,1,0.0,6,8,75.0,3,3,100.0,3,3,6,2,4,1,1,1,3,2
../kbl_data/2021-2022,S39G01N147,서울 SK,Home,리온 윌리엄스,12,5,11,45.5,0,2,0.0,5,13,38.5,2,2,100.0,4,3,7,1,3,2,0,1,0,3
../kbl_data/2021-2022,S39G01N147,서울 SK,Home,배병준,3,0,1,0.0,1,1,100.0,1,2,50.0,0,0,0.0,0,1,1,0,1,0,0,0,0,0
../kbl_data/2021-2022,S39G01N147,서울 SK,Home,이현석,0,0,0,0.0,0,0,0.0,0,0,0.0,0,0,0.0,0,0,0,0,0,0,0,0,0,0
../kbl_data/2021-2022,S39G01N147,서울 SK,Home,최원혁,0,0,0,0.0,0,0,0.0,0,0,0.0,0,0,0.0,1,0,1,0,0,0,0,0,1,1
../kbl_data/2021-2022,S39G01N147,서울 SK,Home,최준용,15,3,7,42.9,3,5,60.0,6,12,50.0,0,0,0.0,0,5,5,2,0,0,0,2,2,2
../kbl_data/2021-2022,S39G01N147,서울 SK,Home,안영준,8,4,5,80.0,0,2,0.0,4,7,57.1,0,0,0.0,1,2,3,3,0,0,0,0,2,2
../kbl_data/2021-2022,S39G01N147,서울 SK,Home,자밀 워니,9,3,10,30.0,0,0,0.0,3,10,30.0,3,4,75.0,3,12,15,4,1,1,0,1,0,0
../kbl_data/2021-2022,S39G01N147,서울 SK,Home,오재현,6,3,4,75.0,0,3,0.0,3,7,42.9,0,1,0.0,0,3,3,4,0,1,0,0,1,2
../kbl_data/2021-2022,S39G01N147,고양 오리온,Away,최현민,7,1,3,33.3,0,1,0.0,1,4,25.0,5,6,83.3,0,4,4,0,4,0,0,0,2,1
../kbl_data/2021-2022,S39G01N147,고양 오리온,Away,임종일,2,1,1,100.0,0,1,0.0,1,2,50.0,0,0,0.0,1,2,3,0,1,0,0,0,0,1
../kbl_data/2021-2022,S39G01N147,고양 오리온,Away,이대성,3,0,4,0.0,1,5,20.0,1,9,11.1,0,0,0.0,0,0,0,1,0,0,0,0,0,3
../kbl_data/2021-2022,S39G01N147,고양 오리온,Away,한호빈,16,2,3,66.7,3,6,50.0,5,9,55.6,3,4,75.0,1,2,3,3,0,0,0,0,2,4
../kbl_data/2021-2022,S39G01N147,고양 오리온,Away,이정제,2,1,4,25.0,0,0,0.0,1,4,25.0,0,0,0.0,2,1,3,0,0,0,0,0,1,0
../kbl_data/2021-2022,S39G01N147,고양 오리온,Away,최승욱,4,2,3,66.7,0,0,0.0,2,3,66.7,0,0,0.0,1,0,1,0,0,0,0,0,0,1
../kbl_data/2021-2022,S39G01N147,고양 오리온,Away,이승현,7,1,7,14.3,1,1,100.0,2,8,25.0,2,2,100.0,5,2,7,2,1,1,0,0,4,2
../kbl_data/2021-2022,S39G01N147,고양 오리온,Away,김진유,0,0,0,0.0,0,1,0.0,0,1,0.0,0,0,0.0,0,0,0,0,1,0,1,0,1,1
../kbl_data/2021-2022,S39G01N147,고양 오리온,Away,제임스 메이스,2,1,8,12.5,0,3,0.0,1,11,9.1,0,2,0.0,2,3,5,4,0,1,0,0,0,1
../kbl_data/2021-2022,S39G01N147,고양 오리온,Away,머피 할로웨이,10,5,8,62.5,0,0,0.0,5,8,62.5,0,0,0.0,1,5,6,1,2,1,0,0,4,1
../kbl_data/2021-2022,S39G01N147,고양 오리온,Away,조한진,0,0,0,0.0,0,4,0.0,0,4,0.0,0,0,0.0,0,1,1,0,1,0,0,0,0,0
../kbl_data/2021-2022,S39G01N147,고양 오리온,Away,이정현,6,1,4,25.0,1,4,25.0,2,8,25.0,1,2,50.0,0,2,2,1,0,0,0,0,0,1
../kbl_data/2021-2022,S39G01N148,창원 LG,Home,강병현,0,0,0,0.0,0,1,0.0,0,1,0.0,0,0,0.0,1,0,1,1,0,0,0,0,2,2
../kbl_data/2021-2022,S39G01N148,창원 LG,Home,이관희,11,3,9,33.3,1,4,25.0,4,13,30.8,2,3,66.7,0,2,2,4,1,1,0,0,4,3
../kbl_data/2021-2022,S39G01N148,창원 LG,Home,정희재,15,3,6,50.0,3,4,75.0,6,10,60.0,0,0,0.0,2,5,7,0,1,0,0,0,0,4
../kbl_data/2021-2022,S39G01N148,창원 LG,Home,서민수,3,0,1,0.0,1,3,33.3,1,4,25.0,0,0,0.0,1,1,2,0,0,0,0,0,0,5
../kbl_data/2021-2022,S39G01N148,창원 LG,Home,한상혁,1,0,0,0.0,0,0,0.0,0,0,0.0,1,2,50.0,1,0,1,1,1,0,0,0,0,1
../kbl_data/2021-2022,S39G01N148,창원 LG,Home,이재도,16,4,6,66.7,2,8,25.0,6,14,42.9,2,2,100.0,0,3,3,6,2,0,0,0,0,0
../kbl_data/2021-2022,S39G01N148,창원 LG,Home,정인덕,0,0,0,0.0,0,0,0.0,0,0,0.0,0,0,0.0,0,0,0,0,0,0,0,0,0,0
../kbl_data/2021-2022,S39G01N148,창원 LG,Home,박정현,3,1,2,50.0,0,0,0.0,1,2,50.0,1,2,50.0,1,0,1,0,0,0,0,0,0,2
../kbl_data/2021-2022,S39G01N148,창원 LG,Home,윤원상,0,0,1,0.0,0,0,0.0,0,1,0.0,0,0,0.0,0,0,0,0,0,0,0,0,0,0
../kbl_data/2021-2022,S39G01N148,창원 LG,Home,아셈 마레이,8,4,11,36.4,0,0,0.0,4,11,36.4,0,0,0.0,2,7,9,2,2,2,0,2,2,4
../kbl_data/2021-2022,S39G01N148,창원 LG,Home,이승우,4,1,3,33.3,0,0,0.0,1,3,33.3,2,4,50.0,0,3,3,0,1,1,0,0,0,0
../kbl_data/2021-2022,S39G01N148,창원 LG,Home,사마르도 사무엘스,9,4,7,57.1,0,0,0.0,4,7,57.1,1,1,100.0,0,0,0,1,0,0,0,0,0,1
../kbl_data/2021-2022,S39G01N148,울산 현대모비스,Away,이현민,0,0,1,0.0,0,4,0.0,0,5,0.0,0,0,0.0,1,3,4,3,0,0,0,0,1,3
../kbl_data/2021-2022,S39G01N148,울산 현대모비스,Away,함지훈,10,3,4,75.0,0,0,0.0,3,4,75.0,4,4,100.0,1,4,5,3,0,1,0,0,4,1
../kbl_data/2021-2022,S39G01N148,울산 현대모비스,Away,최진수,0,0,0,0.0,0,0,0.0,0,0,0.0,0,0,0.0,0,0,0,0,0,0,0,0,1,0
../kbl_data/2021-2022,S39G01N148,울산 현대모비스,Away,박지훈,0,0,0,0.0,0,0,0.0,0,0,0.0,0,0,0.0,0,0,0,0,0,0,0,0,0,0
../kbl_data/2021-2022,S39G01N148,울산 현대모비스,Away,장재석,6,2,3,66.7,0,0,0.0,2,3,66.7,2,3,66.7,2,1,3,2,1,1,0,0,2,1
../kbl_data/2021-2022,S39G01N148,울산 현대모비스,Away,김영현,11,1,1,100.0,3,4,75.0,4,5,80.0,0,0,0.0,0,2,2,0,0,1,1,0,0,4
../kbl_data/2021-2022,S39G01N148,울산 현대모비스,Away,김국찬,11,0,2,0.0,3,8,37.5,3,10,30.0,2,2,100.0,0,2,2,0,3,0,0,0,0,0
../kbl_data/2021-2022,S39G01N148,울산 현대모비스,Away,이우석,20,7,10,70.0,0,2,0.0,7,12,58.3,6,9,66.7,3,9,12,6,0,1,0,0,3,2
../kbl_data/2021-2022,S39G01N148,울산 현대모비스,Away,라숀 토마스,15,7,19,36.8,0,0,0.0,7,19,36.8,1,2,50.0,5,4,9,1,3,1,0,1,2,4
../kbl_data/2021-2022,S39G01N148,울산 현대모비스,Away,신민석,0,0,0,0.0,0,0,0.0,0,0,0.0,0,0,0.0,0,0,0,0,0,0,0,0,0,0
../kbl_data/2021-2022,S39G01N148,울산 현대모비스,Away,김동준,0,0,0,0.0,0,1,0.0,0,1,0.0,0,0,0.0,0,1,1,0,0,0,0,0,0,0
../kbl_data/2021-2022,S39G01N148,울산 현대모비스,Away,에릭 버크너,0,0,0,0.0,0,0,0.0,0,0,0.0,0,0,0.0,0,1,1,0,0,0,0,0,0,2
../kbl_data/2021-2022,S39G01N149,전주 KCC,Home,송창용,10,4,7,57.1,0,3,0.0,4,10,40.0,2,2,100.0,0,2,2,1,1,0,1,0,1,2
../kbl_data/2021-2022,S39G01N149,전주 KCC,Home,이정현,4,2,5,40.0,0,3,0.0,2,8,25.0,0,0,0.0,0,1,1,3,0,0,0,0,1,3
../kbl_data/2021-2022,S39G01N149,전주 KCC,Home,정창영,10,1,1,100.0,1,3,33.3,2,4,50.0,5,6,83.3,0,0,0,3,0,0,0,0,1,0
../kbl_data/2021-2022,S39G01N149,전주 KCC,Home,라건아,15,6,10,60.0,1,3,33.3,7,13,53.8,0,0,0.0,1,5,6,1,0,1,0,1,2,1
../kbl_data/2021-2022,S39G01N149,전주 KCC,Home,김상규,3,0,0,0.0,0,0,0.0,0,0,0.0,3,4,75.0,1,1,2,2,2,0,0,0,0,0
../kbl_data/2021-2022,S39G01N149,전주 KCC,Home,박재현,3,0,1,0.0,1,1,100.0,1,2,50.0,0,0,0.0,0,0,0,1,1,0,0,0,2,0
../kbl_data/2021-2022,S39G01N149,전주 KCC,Home,이진욱,3,0,1,0.0,1,2,50.0,1,3,33.3,0,0,0.0,0,1,1,3,0,0,1,0,1,2
../kbl_data/2021-2022,S39G01N149,전주 KCC,Home,유현준,10,3,3,100.0,1,1,100.0,4,4,100.0,1,2,50.0,1,2,3,3,1,0,1,0,3,3
../kbl_data/2021-2022,S39G01N149,전주 KCC,Home,곽동기,0,0,0,0.0,0,0,0.0,0,0,0.0,0,0,0.0,0,0,0,0,0,0,0,0,0,0
../kbl_data/2021-2022,S39G01N149,전주 KCC,Home,라타비우스 윌리엄스,12,5,9,55.6,0,1,0.0,5,10,50.0,2,2,100.0,1,5,6,2,3,0,0,3,1,2
../kbl_data/2021-2022,S39G01N149,전주 KCC,Home,곽정훈,3,0,1,0.0,1,1,100.0,1,2,50.0,0,0,0.0,1,2,3,0,0,0,0,0,0,4
../kbl_data/2021-2022,S39G01N149,전주 KCC,Home,이근휘,11,1,2,50.0,2,5,40.0,3,7,42.9,3,3,100.0,0,0,0,1,0,0,0,0,0,2
../kbl_data/2021-2022,S39G01N149,수원 KT,Away,김동욱,7,1,1,100.0,1,1,100.0,2,2,100.0,2,2,100.0,0,2,2,2,1,0,0,0,1,3
../kbl_data/2021-2022,S39G01N149,수원 KT,Away,김영환,10,1,2,50.0,2,7,28.6,3,9,33.3,2,2,100.0,2,4,6,3,0,0,0,0,0,0
../kbl_data/2021-2022,S39G01N149,수원 KT,Away,김종범,0,0,1,0.0,0,1,0.0,0,2,0.0,0,0,0.0,0,0,0,0,0,2,0,0,1,0
../kbl_data/2021-2022,S39G01N149,수원 KT,Away,최성모,5,2,2,100.0,0,0,0.0,2,2,100.0,1,1,100.0,1,0,1,0,0,0,0,0,2,0
../kbl_data/2021-2022,S39G01N149,수원 KT,Away,허훈,11,3,4,75.0,1,5,20.0,4,9,44.4,2,2,100.0,0,2,2,9,4,0,0,0,2,3
../kbl_data/2021-2022,S39G01N149,수원 KT,Away,양홍석,15,6,7,85.7,1,3,33.3,7,10,70.0,0,0,0.0,1,7,8,5,3,0,0,0,1,3
../kbl_data/2021-2022,S39G01N149,수원 KT,Away,박준영,0,0,0,0.0,0,0,0.0,0,0,0.0,0,0,0.0,0,0,0,0,0,0,0,0,0,1
../kbl_data/2021-2022,S39G01N149,수원 KT,Away,캐디 라렌,35,10,15,66.7,3,3,100.0,13,18,72.2,6,8,75.0,1,5,6,2,2,2,0,2,5,3
../kbl_data/2021-2022,S39G01N149,수원 KT,Away,박지원,0,0,1,0.0,0,0,0.0,0,1,0.0,0,0,0.0,0,2,2,0,0,1,0,0,1,0
../kbl_data/2021-2022,S39G01N149,수원 KT,Away,마이크 마이어스,8,3,3,100.0,0,0,0.0,3,3,100.0,2,2,100.0,0,1,1,0,0,0,0,1,0,0
../kbl_data/2021-2022,S39G01N149,수원 KT,Away,김준환,0,0,0,0.0,0,0,0.0,0,0,0.0,0,0,0.0,0,0,0,0,0,0,0,0,0,0
../kbl_data/2021-2022,S39G01N149,수원 KT,Away,하윤기,6,2,6,33.3,0,0,0.0,2,6,33.3,2,2,100.0,3,3,6,1,0,0,0,1,0,3
../kbl_data/2021-2022,S39G01N150,서울 삼성,Home,김동량,4,2,4,50.0,0,1,0.0,2,5,40.0,0,0,0.0,1,1,2,1,1,0,0,0,1,1
../kbl_data/2021-2022,S39G01N150,서울 삼성,Home,김시래,5,1,3,33.3,1,1,100.0,2,4,50.0,0,0,0.0,0,2,2,1,0,0,0,0,2,2
../kbl_data/2021-2022,S39G01N150,서울 삼성,Home,김현수,0,0,0,0.0,0,0,0.0,0,0,0.0,0,0,0.0,0,0,0,1,0,0,0,0,0,0
../kbl_data/2021-2022,S39G01N150,서울 삼성,Home,임동섭,2,1,2,50.0,0,0,0.0,1,2,50.0,0,0,0.0,0,1,1,0,0,0,0,0,1,1
../kbl_data/2021-2022,S39G01N150,서울 삼성,Home,배수용,2,1,2,50.0,0,0,0.0,1,2,50.0,0,0,0.0,1,1,2,0,0,0,0,0,0,0
../kbl_data/2021-2022,S39G01N150,서울 삼성,Home,이호현,0,0,0,0.0,0,0,0.0,0,0,0.0,0,0,0.0,0,1,1,2,0,0,0,0,0,0
../kbl_data/2021-2022,S39G01N150,서울 삼성,Home,강바일,2,0,5,0.0,0,1,0.0,0,6,0.0,2,2,100.0,0,0,0,0,1,0,0,0,0,3
../kbl_data/2021-2022,S39G01N150,서울 삼성,Home,차민석,13,3,5,60.0,0,0,0.0,3,5,60.0,7,8,87.5,0,1,1,1,1,2,1,0,2,1
../kbl_data/2021-2022,S39G01N150,서울 삼성,Home,전형준,1,0,3,0.0,0,1,0.0,0,4,0.0,1,2,50.0,0,3,3,3,1,0,0,0,0,4
../kbl_data/2021-2022,S39G01N150,서울 삼성,Home,다니엘 오셰푸,6,3,10,30.0,0,0,0.0,3,10,30.0,0,0,0.0,1,2,3,0,0,0,0,0,4,1
../kbl_data/2021-2022,S39G01N150,서울 삼성,Home,이원석,16,8,13,61.5,0,1,0.0,8,14,57.1,0,0,0.0,2,1,3,0,1,0,1,0,2,3
../kbl_data/2021-2022,S39G01N150,서울 삼성,Home,토마스 로빈슨,11,5,12,41.7,0,0,0.0,5,12,41.7,1,1,100.0,2,8,10,0,1,1,0,0,2,3
../kbl_data/2021-2022,S39G01N150,원주 DB,Away,윤호영,0,0,1,0.0,0,0,0.0,0,1,0.0,0,0,0.0,0,4,4,1,0,0,0,0,0,4
../kbl_data/2021-2022,S39G01N150,원주 DB,Away,박찬희,2,1,2,50.0,0,0,0.0,1,2,50.0,0,0,0.0,0,0,0,9,4,0,0,0,4,3
../kbl_data/2021-2022,S39G01N150,원주 DB,Away,정준원,7,2,3,66.7,1,1,100.0,3,4,75.0,0,0,0.0,0,1,1,0,0,0,0,0,0,1
../kbl_data/2021-2022,S39G01N150,원주 DB,Away,김종규,11,4,5,80.0,0,0,0.0,4,5,80.0,3,4,75.0,0,3,3,1,0,0,0,0,1,0
../kbl_data/2021-2022,S39G01N150,원주 DB,Away,허웅,11,5,6,83.3,0,0,0.0,5,6,83.3,1,3,33.3,0,3,3,4,0,0,0,0,0,0
../kbl_data/2021-2022,S39G01N150,원주 DB,Away,김영훈,3,0,1,0.0,1,1,100.0,1,2,50.0,0,0,0.0,0,0,0,0,0,0,0,0,0,0
../kbl_data/2021-2022,S39G01N150,원주 DB,Away,강상재,14,4,5,80.0,2,3,66.7,6,8,75.0,0,0,0.0,0,3,3,1,0,0,0,0,1,1
../kbl_data/2021-2022,S39G01N150,원주 DB,Away,김철욱,6,0,4,0.0,2,5,40.0,2,9,22.2,0,0,0.0,0,2,2,1,1,1,0,0,1,3
../kbl_data/2021-2022,S39G01N150,원주 DB,Away,이준희,9,4,7,57.1,0,2,0.0,4,9,44.4,1,2,50.0,1,0,1,2,1,0,2,0,1,2
../kbl_data/2021-2022,S39G01N150,원주 DB,Away,레나드 프리먼,11,5,10,50.0,0,0,0.0,5,10,50.0,1,2,50.0,4,10,14,0,0,0,0,2,1,1
../kbl_data/2021-2022,S39G01N150,원주 DB,Away,정호영,5,1,4,25.0,1,3,33.3,2,7,28.6,0,0,0.0,1,1,2,6,0,1,1,0,1,2
../kbl_data/2021-2022,S39G01N150,원주 DB,Away,조니 오브라이언트,9,3,3,100.0,1,2,50.0,4,5,80.0,0,0,0.0,0,2,2,0,1,0,0,0,1,1
../kbl_data/2021-2022,S39G01N151,안양 KGC,Home,양희종,5,1,2,50.0,1,2,50.0,2,4,50.0,0,0,0.0,1,1,2,1,1,1,0,0,2,2
../kbl_data/2021-2022,S39G01N151,안양 KGC,Home,박형철,0,0,0,0.0,0,0,0.0,0,0,0.0,0,0,0.0,0,0,0,0,0,0,0,0,0,0
../kbl_data/2021-2022,S39G01N151,안양 KGC,Home,함준후,0,0,0,0.0,0,0,0.0,0,0,0.0,0,0,0.0,1,1,2,0,0,0,0,0,1,1
../kbl_data/2021-2022,S39G01N151,안양 KGC,Home,오세근,16,6,8,75.0,0,0,0.0,6,8,75.0,4,4,100.0,1,7,8,1,1,0,0,0,0,3
../kbl_data/2021-2022,S39G01N151,안양 KGC,Home,문성곤,9,2,3,66.7,1,4,25.0,3,7,42.9,2,2,100.0,1,2,3,1,2,1,0,0,1,4
../kbl_data/2021-2022,S39G01N151,안양 KGC,Home,전성현,18,2,7,28.6,4,9,44.4,6,16,37.5,2,2,100.0,1,2,3,1,2,0,0,0,1,0
../kbl_data/2021-2022,S39G01N151,안양 KGC,Home,박지훈,3,1,4,25.0,0,0,0.0,1,4,25.0,1,2,50.0,0,2,2,1,0,0,0,0,0,3
../kbl_data/2021-2022,S39G01N151,안양 KGC,Home,이우정,0,0,0,0.0,0,0,0.0,0,0,0.0,0,0,0.0,0,0,0,0,0,0,0,0,0,0
../kbl_data/2021-2022,S39G01N151,안양 KGC,Home,대릴 먼로,0,0,0,0.0,0,0,0.0,0,0,0.0,0,0,0.0,0,0,0,1,0,0,0,0,0,1
../kbl_data/2021-2022,S39G01N151,안양 KGC,Home,변준형,9,1,5,20.0,2,9,22.2,3,14,21.4,1,2,50.0,0,0,0,5,0,0,0,0,1,2
../kbl_data/2021-2022,S39G01N151,안양 KGC,Home,한승희,0,0,0,0.0,0,0,0.0,0,0,0.0,0,0,0.0,0,0,0,0,0,0,0,0,0,0
../kbl_data/2021-2022,S39G01N151,안양 KGC,Home,오마리 스펠맨,6,0,4,0.0,1,8,12.5,1,12,8.3,3,4,75.0,4,15,19,8,1,1,0,0,3,3
../kbl_data/2021-2022,S39G01N151,서울 SK,Away,양우섭,0,0,0,0.0,0,0,0.0,0,0,0.0,0,0,0.0,0,0,0,0,0,0,0,0,0,0
../kbl_data/2021-2022,S39G01N151,서울 SK,Away,허일영,0,0,1,0.0,0,0,0.0,0,1,0.0,0,0,0.0,0,2,2,1,0,0,0,0,1,2
../kbl_data/2021-2022,S39G01N151,서울 SK,Away,김선형,22,7,11,63.6,1,5,20.0,8,16,50.0,5,5,100.0,1,2,3,2,1,0,0,1,2,1
../kbl_data/2021-2022,S39G01N151,서울 SK,Away,최부경,4,1,2,50.0,0,0,0.0,1,2,50.0,2,2,100.0,2,1,3,0,1,0,0,0,1,1
../kbl_data/2021-2022,S39G01N151,서울 SK,Away,리온 윌리엄스,0,0,0,0.0,0,0,0.0,0,0,0.0,0,0,0.0,0,2,2,1,0,0,0,0,0,1
../kbl_data/2021-2022,S39G01N151,서울 SK,Away,배병준,0,0,0,0.0,0,0,0.0,0,0,0.0,0,0,0.0,0,0,0,0,0,0,0,0,0,0
../kbl_data/2021-2022,S39G01N151,서울 SK,Away,이현석,0,0,0,0.0,0,0,0.0,0,0,0.0,0,0,0.0,0,0,0,0,1,0,0,0,0,0
../kbl_data/2021-2022,S39G01N151,서울 SK,Away,최원혁,2,1,1,100.0,0,0,0.0,1,1,100.0,0,0,0.0,0,1,1,1,0,0,0,0,1,0
../kbl_data/2021-2022,S39G01N151,서울 SK,Away,최준용,12,2,5,40.0,2,8,25.0,4,13,30.8,2,2,100.0,1,8,9,2,0,1,0,1,1,3
../kbl_data/2021-2022,S39G01N151,서울 SK,Away,안영준,6,0,7,0.0,2,5,40.0,2,12,16.7,0,0,0.0,1,5,6,1,0,1,1,0,1,3
../kbl_data/2021-2022,S39G01N151,서울 SK,Away,자밀 워니,19,7,15,46.7,0,1,0.0,7,16,43.8,5,5,100.0,4,8,12,0,1,1,0,0,1,1
../kbl_data/2021-2022,S39G01N151,서울 SK,Away,오재현,2,0,4,0.0,0,2,0.0,0,6,0.0,2,2,100.0,1,3,4,2,1,2,0,0,1,4
../kbl_data/2021-2022,S39G01N152,전주 KCC,Home,송창용,14,3,4,75.0,2,4,50.0,5,8,62.5,2,5,40.0,0,2,2,4,0,0,1,0,1,1
../kbl_data/2021-2022,S39G01N152,전주 KCC,Home,이정현,7,1,3,33.3,1,5,20.0,2,8,25.0,2,3,66.7,0,8,8,3,0,0,0,0,1,4
../kbl_data/2021-2022,S39G01N152,전주 KCC,Home,정창영,2,1,4,25.0,0,2,0.0,1,6,16.7,0,4,0.0,2,1,3,4,2,1,0,0,2,2
../kbl_data/2021-2022,S39G01N152,전주 KCC,Home,라건아,31,12,16,75.0,1,4,25.0,13,20,65.0,4,4,100.0,5,7,12,1,0,1,0,1,0,2
../kbl_data/2021-2022,S39G01N152,전주 KCC,Home,김지완,2,0,1,0.0,0,1,0.0,0,2,0.0,2,2,100.0,0,1,1,3,2,0,0,0,2,2
../kbl_data/2021-2022,S39G01N152,전주 KCC,Home,김상규,5,2,4,50.0,0,1,0.0,2,5,40.0,1,1,100.0,1,1,2,0,1,1,0,0,2,1
../kbl_data/2021-2022,S39G01N152,전주 KCC,Home,박재현,0,0,0,0.0,0,0,0.0,0,0,0.0,0,0,0.0,0,0,0,0,0,0,0,0,0,0
../kbl_data/2021-2022,S39G01N152,전주 KCC,Home,이진욱,6,3,6,50.0,0,0,0.0,3,6,50.0,0,0,0.0,2,1,3,0,1,0,0,0,2,3
../kbl_data/2021-2022,S39G01N152,전주 KCC,Home,유현준,12,1,6,16.7,3,6,50.0,4,12,33.3,1,2,50.0,0,1,1,4,0,0,0,0,1,3
../kbl_data/2021-2022,S39G01N152,전주 KCC,Home,라타비우스 윌리엄스,2,0,1,0.0,0,0,0.0,0,1,0.0,2,2,100.0,1,0,1,0,1,0,0,0,1,0
../kbl_data/2021-2022,S39G01N152,전주 KCC,Home,곽정훈,0,0,0,0.0,0,0,0.0,0,0,0.0,0,0,0.0,0,0,0,0,0,0,0,0,0,0
../kbl_data/2021-2022,S39G01N152,전주 KCC,Home,이근휘,5,0,0,0.0,0,1,0.0,0,1,0.0,5,6,83.3,0,1,1,0,0,0,0,0,0,2
../kbl_data/2021-2022,S39G01N152,창원 LG,Away,강병현,6,2,3,66.7,0,2,0.0,2,5,40.0,2,2,100.0,0,3,3,1,1,0,0,0,1,3
../kbl_data/2021-2022,S39G01N152,창원 LG,Away,이관희,24,7,14,50.0,2,8,25.0,9,22,40.9,4,5,80.0,1,1,2,2,3,0,0,0,4,5
../kbl_data/2021-2022,S39G01N152,창원 LG,Away,정희재,15,4,7,57.1,2,5,40.0,6,12,50.0,1,2,50.0,2,5,7,3,1,1,0,0,0,4
../kbl_data/2021-2022,S39G01N152,창원 LG,Away,서민수,2,1,1,100.0,0,0,0.0,1,1,100.0,0,0,0.0,2,2,4,0,0,1,0,0,1,2
../kbl_data/2021-2022,S39G01N152,창원 LG,Away,한상혁,5,1,1,100.0,1,2,50.0,2,3,66.7,0,0,0.0,0,1,1,2,1,0,0,0,0,2
../kbl_data/2021-2022,S39G01N152,창원 LG,Away,이재도,5,1,5,20.0,1,2,50.0,2,7,28.6,0,0,0.0,0,2,2,2,2,0,0,0,0,1
../kbl_data/2021-2022,S39G01N152,창원 LG,Away,정인덕,0,0,0,0.0,0,0,0.0,0,0,0.0,0,0,0.0,0,0,0,0,0,0,0,0,0,0
../kbl_data/2021-2022,S39G01N152,창원 LG,Away,이광진,0,0,0,0.0,0,0,0.0,0,0,0.0,0,0,0.0,0,0,0,0,0,0,0,0,0,0
../kbl_data/2021-2022,S39G01N152,창원 LG,Away,윤원상,0,0,0,0.0,0,0,0.0,0,0,0.0,0,0,0.0,0,0,0,0,0,0,0,0,0,0
../kbl_data/2021-2022,S39G01N152,창원 LG,Away,아셈 마레이,20,9,14,64.3,0,1,0.0,9,15,60.0,2,5,40.0,7,11,18,7,1,1,0,1,2,2
../kbl_data/2021-2022,S39G01N152,창원 LG,Away,이승우,13,5,7,71.4,1,3,33.3,6,10,60.0,0,0,0.0,2,2,4,0,1,0,0,0,1,5
../kbl_data/2021-2022,S39G01N152,창원 LG,Away,사마르도 사무엘스,0,0,2,0.0,0,0,0.0,0,2,0.0,0,0,0.0,0,0,0,0,0,0,0,0,0,0
../kbl_data/2021-2022,S39G01N153,대구 한국가스공사,Home,민성주,0,0,0,0.0,0,0,0.0,0,0,0.0,0,0,0.0,0,0,0,0,0,1,0,0,0,2
../kbl_data/2021-2022,S39G01N153,대구 한국가스공사,Home,홍경기,19,2,2,100.0,5,6,83.3,7,8,87.5,0,0,0.0,0,5,5,1,1,0,0,0,0,2
../kbl_data/2021-2022,S39G01N153,대구 한국가스공사,Home,조상열,0,0,0,0.0,0,0,0.0,0,0,0.0,0,0,0.0,0,0,0,0,0,0,0,0,0,0
../kbl_data/2021-2022,S39G01N153,대구 한국가스공사,Home,이대헌,10,5,7,71.4,0,2,0.0,5,9,55.6,0,0,0.0,0,2,2,3,0,0,0,0,1,4
../kbl_data/2021-2022,S39G01N153,대구 한국가스공사,Home,두경민,15,5,8,62.5,1,8,12.5,6,16,37.5,2,2,100.0,0,1,1,6,1,0,0,0,4,2
../kbl_data/2021-2022,S39G01N153,대구 한국가스공사,Home,박봉진,0,0,0,0.0,0,0,0.0,0,0,0.0,0,0,0.0,0,0,0,0,0,0,0,0,0,0
../kbl_data/2021-2022,S39G01N153,대구 한국가스공사,Home,김낙현,10,2,4,50.0,2,6,33.3,4,10,40.0,0,0,0.0,2,0,2,4,0,0,1,0,4,3
../kbl_data/2021-2022,S39G01N153,대구 한국가스공사,Home,전현우,1,0,0,0.0,0,1,0.0,0,1,0.0,1,2,50.0,0,1,1,0,0,0,0,0,0,0
../kbl_data/2021-2022,S39G01N153,대구 한국가스공사,Home,이윤기,0,0,0,0.0,0,0,0.0,0,0,0.0,0,0,0.0,0,0,0,0,0,0,0,0,0,2
../kbl_data/2021-2022,S39G01N153,대구 한국가스공사,Home,양준우,4,2,2,100.0,0,0,0.0,2,2,100.0,0,0,0.0,0,0,0,1,1,0,0,0,2,1
../kbl_data/2021-2022,S39G01N153,대구 한국가스공사,Home,클리프 알렉산더,16,5,8,62.5,0,0,0.0,5,8,62.5,6,6,100.0,0,9,9,2,4,1,0,4,3,3
../kbl_data/2021-2022,S39G01N153,대구 한국가스공사,Home,신승민,0,0,0,0.0,0,0,0.0,0,0,0.0,0,0,0.0,1,2,3,1,1,1,0,0,1,3
../kbl_data/2021-2022,S39G01N153,울산 현대모비스,Away,이현민,6,0,1,0.0,2,4,50.0,2,5,40.0,0,0,0.0,0,1,1,5,2,0,0,0,2,3
../kbl_data/2021-2022,S39G01N153,울산 현대모비스,Away,함지훈,7,3,6,50.0,0,0,0.0,3,6,50.0,1,2,50.0,0,1,1,2,2,0,0,0,0,0
../kbl_data/2021-2022,S39G01N153,울산 현대모비스,Away,최진수,2,1,1,100.0,0,2,0.0,1,3,33.3,0,0,0.0,0,0,0,0,1,0,0,0,0,1
../kbl_data/2021-2022,S39G01N153,울산 현대모비스,Away,박지훈,0,0,0,0.0,0,1,0.0,0,1,0.0,0,0,0.0,0,1,1,0,0,0,0,0,0,0
../kbl_data/2021-2022,S39G01N153,울산 현대모비스,Away,장재석,4,0,5,0.0,0,0,0.0,0,5,0.0,4,4,100.0,1,2,3,2,0,1,0,0,2,2
../kbl_data/2021-2022,S39G01N153,울산 현대모비스,Away,김영현,0,0,0,0.0,0,2,0.0,0,2,0.0,0,0,0.0,0,1,1,1,0,0,0,0,0,3
../kbl_data/2021-2022,S39G01N153,울산 현대모비스,Away,김국찬,12,2,3,66.7,2,10,20.0,4,13,30.8,2,2,100.0,0,1,1,1,1,0,0,0,0,2
../kbl_data/2021-2022,S39G01N153,울산 현대모비스,Away,이우석,16,4,6,66.7,2,4,50.0,6,10,60.0,2,2,100.0,3,5,8,5,1,0,0,0,3,2
../kbl_data/2021-2022,S39G01N153,울산 현대모비스,Away,라숀 토마스,28,10,14,71.4,0,0,0.0,10,14,71.4,8,10,80.0,7,3,10,0,2,1,0,0,2,2
../kbl_data/2021-2022,S39G01N153,울산 현대모비스,Away,신민석,0,0,0,0.0,0,0,0.0,0,0,0.0,0,0,0.0,0,0,0,0,1,0,0,0,0,0
../kbl_data/2021-2022,S39G01N153,울산 현대모비스,Away,김동준,0,0,1,0.0,0,1,0.0,0,2,0.0,0,0,0.0,1,2,3,1,0,0,0,0,1,2
../kbl_data/2021-2022,S39G01N153,울산 현대모비스,Away,에릭 버크너,4,2,2,100.0,0,0,0.0,2,2,100.0,0,0,0.0,1,1,2,0,0,0,0,0,0,0
../kbl_data/2021-2022,S39G01N154,고양 오리온,Home,임종일,5,1,1,100.0,1,2,50.0,2,3,66.7,0,0,0.0,2,0,2,2,1,0,0,0,0,1
../kbl_data/2021-2022,S39G01N154,고양 오리온,Home,이대성,25,10,15,66.7,1,4,25.0,11,19,57.9,2,2,100.0,0,0,0,7,0,0,1,0,3,1
../kbl_data/2021-2022,S39G01N154,고양 오리온,Home,한호빈,2,0,1,0.0,0,1,0.0,0,2,0.0,2,2,100.0,0,1,1,1,3,0,0,0,2,0
../kbl_data/2021-2022,S39G01N154,고양 오리온,Home,이정제,0,0,0,0.0,0,0,0.0,0,0,0.0,0,0,0.0,0,0,0,0,0,0,0,0,0,1
../kbl_data/2021-2022,S39G01N154,고양 오리온,Home,이승현,23,9,11,81.8,1,5,20.0,10,16,62.5,2,2,100.0,2,7,9,1,2,0,1,0,0,3
../kbl_data/2021-2022,S39G01N154,고양 오리온,Home,김진유,0,0,1,0.0,0,0,0.0,0,1,0.0,0,0,0.0,0,0,0,1,0,0,0,0,0,1
../kbl_data/2021-2022,S39G01N154,고양 오리온,Home,제임스 메이스,3,1,6,16.7,0,1,0.0,1,7,14.3,1,2,50.0,2,1,3,2,0,0,0,0,0,0
../kbl_data/2021-2022,S39G01N154,고양 오리온,Home,머피 할로웨이,16,8,17,47.1,0,0,0.0,8,17,47.1,0,0,0.0,3,8,11,3,0,0,0,0,1,4
../kbl_data/2021-2022,S39G01N154,고양 오리온,Home,조한진,11,1,1,100.0,2,3,66.7,3,4,75.0,3,4,75.0,0,1,1,0,0,0,0,0,0,1
../kbl_data/2021-2022,S39G01N154,고양 오리온,Home,김세창,0,0,0,0.0,0,0,0.0,0,0,0.0,0,0,0.0,0,0,0,0,0,0,0,0,0,0
../kbl_data/2021-2022,S39G01N154,고양 오리온,Home,박진철,0,0,2,0.0,0,0,0.0,0,2,0.0,0,0,0.0,2,0,2,0,0,0,0,0,0,0
../kbl_data/2021-2022,S39G01N154,고양 오리온,Home,문시윤,4,2,3,66.7,0,0,0.0,2,3,66.7,0,2,0.0,3,2,5,0,0,0,0,0,0,2
../kbl_data/2021-2022,S39G01N154,수원 KT,Away,김동욱,6,0,2,0.0,2,5,40.0,2,7,28.6,0,2,0.0,0,1,1,5,1,0,0,0,1,1
../kbl_data/2021-2022,S39G01N154,수원 KT,Away,김영환,5,1,1,100.0,1,2,50.0,2,3,66.7,0,0,0.0,0,1,1,1,0,0,0,0,0,1
../kbl_data/2021-2022,S39G01N154,수원 KT,Away,김현민,0,0,0,0.0,0,0,0.0,0,0,0.0,0,0,0.0,0,0,0,0,0,0,0,0,1,0
../kbl_data/2021-2022,S39G01N154,수원 KT,Away,한희원,1,0,0,0.0,0,0,0.0,0,0,0.0,1,2,50.0,0,0,0,0,0,1,0,0,0,1
../kbl_data/2021-2022,S39G01N154,수원 KT,Away,최창진,0,0,0,0.0,0,0,0.0,0,0,0.0,0,0,0.0,0,0,0,0,0,0,0,0,0,1
../kbl_data/2021-2022,S39G01N154,수원 KT,Away,허훈,10,2,7,28.6,2,9,22.2,4,16,25.0,0,0,0.0,3,1,4,9,1,0,1,0,3,1
../kbl_data/2021-2022,S39G01N154,수원 KT,Away,양홍석,8,4,7,57.1,0,3,0.0,4,10,40.0,0,0,0.0,0,5,5,5,0,0,0,0,2,1
../kbl_data/2021-2022,S39G01N154,수원 KT,Away,캐디 라렌,35,14,19,73.7,2,2,100.0,16,21,76.2,1,2,50.0,5,11,16,1,0,1,0,4,2,1
../kbl_data/2021-2022,S39G01N154,수원 KT,Away,박지원,0,0,0,0.0,0,0,0.0,0,0,0.0,0,0,0.0,0,0,0,0,0,0,0,0,0,0
../kbl_data/2021-2022,S39G01N154,수원 KT,Away,마이크 마이어스,2,1,2,50.0,0,0,0.0,1,2,50.0,0,0,0.0,0,1,1,0,0,1,0,0,1,2
../kbl_data/2021-2022,S39G01N154,수원 KT,Away,김준환,0,0,0,0.0,0,0,0.0,0,0,0.0,0,0,0.0,0,0,0,0,0,0,0,0,0,0
../kbl_data/2021-2022,S39G01N154,수원 KT,Away,하윤기,14,6,8,75.0,0,0,0.0,6,8,75.0,2,4,50.0,3,2,5,1,1,0,0,0,2,4
../kbl_data/2021-2022,S39G01N155,서울 SK,Home,양우섭,0,0,1,0.0,0,0,0.0,0,1,0.0,0,0,0.0,0,0,0,0,0,0,0,0,0,0
../kbl_data/2021-2022,S39G01N155,서울 SK,Home,허일영,2,1,3,33.3,0,1,0.0,1,4,25.0,0,0,0.0,0,0,0,0,0,0,0,0,1,0
../kbl_data/2021-2022,S39G01N155,서울 SK,Home,김선형,19,7,11,63.6,1,3,33.3,8,14,57.1,2,3,66.7,0,5,5,5,1,1,0,0,3,0
../kbl_data/2021-2022,S39G01N155,서울 SK,Home,최부경,2,1,1,100.0,0,1,0.0,1,2,50.0,0,0,0.0,1,2,3,1,1,0,0,0,1,3
../kbl_data/2021-2022,S39G01N155,서울 SK,Home,리온 윌리엄스,0,0,1,0.0,0,1,0.0,0,2,0.0,0,0,0.0,0,0,0,1,0,0,0,0,0,1
../kbl_data/2021-2022,S39G01N155,서울 SK,Home,배병준,0,0,0,0.0,0,0,0.0,0,0,0.0,0,0,0.0,0,0,0,0,0,0,0,0,0,0
../kbl_data/2021-2022,S39G01N155,서울 SK,Home,이현석,0,0,0,0.0,0,0,0.0,0,0,0.0,0,0,0.0,0,0,0,0,0,0,0,0,0,1
../kbl_data/2021-2022,S39G01N155,서울 SK,Home,최원혁,0,0,1,0.0,0,0,0.0,0,1,0.0,0,0,0.0,1,0,1,1,0,0,0,0,1,3
../kbl_data/2021-2022,S39G01N155,서울 SK,Home,최준용,12,0,2,0.0,1,3,33.3,1,5,20.0,9,10,90.0,0,2,2,5,0,0,0,0,2,2
../kbl_data/2021-2022,S39G01N155,서울 SK,Home,안영준,15,5,5,100.0,1,5,20.0,6,10,60.0,2,3,66.7,0,4,4,1,1,0,1,0,3,4
../kbl_data/2021-2022,S39G01N155,서울 SK,Home,자밀 워니,24,8,16,50.0,1,1,100.0,9,17,52.9,5,5,100.0,3,9,12,3,1,0,0,0,2,1
../kbl_data/2021-2022,S39G01N155,서울 SK,Home,오재현,10,0,1,0.0,3,3,100.0,3,4,75.0,1,2,50.0,0,4,4,2,0,0,0,0,0,3
../kbl_data/2021-2022,S39G01N155,창원 LG,Away,강병현,0,0,1,0.0,0,1,0.0,0,2,0.0,0,0,0.0,0,0,0,0,0,0,0,0,0,1
../kbl_data/2021-2022,S39G01N155,창원 LG,Away,이관희,31,5,9,55.6,6,12,50.0,11,21,52.4,3,3,100.0,0,5,5,1,4,0,0,0,2,0
../kbl_data/2021-2022,S39G01N155,창원 LG,Away,정희재,2,1,3,33.3,0,2,0.0,1,5,20.0,0,0,0.0,1,3,4,1,0,0,0,0,1,1
../kbl_data/2021-2022,S39G01N155,창원 LG,Away,서민수,8,1,1,100.0,2,6,33.3,3,7,42.9,0,0,0.0,1,3,4,1,1,1,0,0,2,2
../kbl_data/2021-2022,S39G01N155,창원 LG,Away,한상혁,2,1,3,33.3,0,1,0.0,1,4,25.0,0,0,0.0,1,2,3,4,1,0,0,0,2,2
../kbl_data/2021-2022,S39G01N155,창원 LG,Away,이재도,5,1,2,50.0,1,3,33.3,2,5,40.0,0,0,0.0,1,0,1,2,0,0,0,0,0,2
../kbl_data/2021-2022,S39G01N155,창원 LG,Away,정인덕,0,0,0,0.0,0,0,0.0,0,0,0.0,0,0,0.0,0,0,0,0,0,0,0,0,0,0
../kbl_data/2021-2022,S39G01N155,창원 LG,Away,이광진,0,0,0,0.0,0,1,0.0,0,1,0.0,0,0,0.0,0,0,0,0,0,0,0,0,1,0
../kbl_data/2021-2022,S39G01N155,창원 LG,Away,윤원상,5,1,1,100.0,1,2,50.0,2,3,66.7,0,0,0.0,1,0,1,1,1,0,0,0,0,3
../kbl_data/2021-2022,S39G01N155,창원 LG,Away,아셈 마레이,8,4,8,50.0,0,0,0.0,4,8,50.0,0,0,0.0,5,4,9,4,2,2,0,2,3,4
../kbl_data/2021-2022,S39G01N155,창원 LG,Away,이승우,10,4,9,44.4,0,2,0.0,4,11,36.4,2,4,50.0,2,5,7,2,2,0,1,0,1,5
../kbl_data/2021-2022,S39G01N155,창원 LG,Away,사마르도 사무엘스,5,2,3,66.7,0,1,0.0,2,4,50.0,1,2,50.0,0,2,2,0,0,1,0,0,2,1
../kbl_data/2021-2022,S39G01N156,원주 DB,Home,윤호영,0,0,0,0.0,0,0,0.0,0,0,0.0,0,0,0.0,0,0,0,0,0,0,0,0,0,0
../kbl_data/2021-2022,S39G01N156,원주 DB,Home,박찬희,0,0,3,0.0,0,1,0.0,0,4,0.0,0,0,0.0,0,2,2,3,0,0,0,0,1,1
../kbl_data/2021-2022,S39G01N156,원주 DB,Home,정준원,6,3,7,42.9,0,1,0.0,3,8,37.5,0,0,0.0,1,0,1,0,1,0,0,0,0,1
../kbl_data/2021-2022,S39G01N156,원주 DB,Home,김종규,6,2,4,50.0,0,1,0.0,2,5,40.0,2,2,100.0,2,1,3,1,0,0,0,0,0,2
../kbl_data/2021-2022,S39G01N156,원주 DB,Home,허웅,15,3,7,42.9,3,9,33.3,6,16,37.5,0,0,0.0,1,2,3,4,0,0,0,0,2,2
../kbl_data/2021-2022,S39G01N156,원주 DB,Home,김영훈,0,0,0,0.0,0,0,0.0,0,0,0.0,0,0,0.0,0,1,1,0,2,0,0,0,0,1
../kbl_data/2021-2022,S39G01N156,원주 DB,Home,강상재,8,4,6,66.7,0,1,0.0,4,7,57.1,0,0,0.0,2,7,9,3,3,0,0,0,1,4
../kbl_data/2021-2022,S39G01N156,원주 DB,Home,김훈,0,0,0,0.0,0,0,0.0,0,0,0.0,0,0,0.0,0,0,0,0,0,0,0,0,0,0
../kbl_data/2021-2022,S39G01N156,원주 DB,Home,이준희,10,4,6,66.7,0,1,0.0,4,7,57.1,2,2,100.0,0,1,1,7,0,0,0,0,0,1
../kbl_data/2021-2022,S39G01N156,원주 DB,Home,레나드 프리먼,11,4,6,66.7,1,2,50.0,5,8,62.5,0,1,0.0,0,3,3,0,1,0,0,1,0,0
../kbl_data/2021-2022,S39G01N156,원주 DB,Home,정호영,8,2,3,66.7,1,4,25.0,3,7,42.9,1,1,100.0,1,0,1,2,1,1,0,0,0,4
../kbl_data/2021-2022,S39G01N156,원주 DB,Home,조니 오브라이언트,18,2,10,20.0,4,5,80.0,6,15,40.0,2,2,100.0,3,10,13,1,1,0,0,0,1,3
../kbl_data/2021-2022,S39G01N156,전주 KCC,Away,송창용,3,0,1,0.0,1,2,50.0,1,3,33.3,0,0,0.0,1,2,3,0,0,0,0,0,2,1
../kbl_data/2021-2022,S39G01N156,전주 KCC,Away,이정현,0,0,1,0.0,0,1,0.0,0,2,0.0,0,0,0.0,0,2,2,0,0,0,0,0,0,1
../kbl_data/2021-2022,S39G01N156,전주 KCC,Away,정창영,3,1,3,33.3,0,4,0.0,1,7,14.3,1,2,50.0,0,1,1,3,0,1,0,0,0,2
../kbl_data/2021-2022,S39G01N156,전주 KCC,Away,라건아,22,9,10,90.0,1,3,33.3,10,13,76.9,1,3,33.3,1,9,10,0,0,0,0,1,1,1
../kbl_data/2021-2022,S39G01N156,전주 KCC,Away,김지완,25,2,8,25.0,5,5,100.0,7,13,53.8,6,7,85.7,0,2,2,5,1,0,0,0,2,3
../kbl_data/2021-2022,S39G01N156,전주 KCC,Away,김상규,9,3,3,100.0,0,3,0.0,3,6,50.0,3,7,42.9,3,5,8,0,1,0,0,0,2,1
../kbl_data/2021-2022,S39G01N156,전주 KCC,Away,박재현,0,0,0,0.0,0,0,0.0,0,0,0.0,0,0,0.0,0,0,0,0,0,0,0,0,0,0
../kbl_data/2021-2022,S39G01N156,전주 KCC,Away,이진욱,0,0,1,0.0,0,1,0.0,0,2,0.0,0,0,0.0,0,1,1,0,0,0,0,0,1,0
../kbl_data/2021-2022,S39G01N156,전주 KCC,Away,유현준,6,1,3,33.3,0,4,0.0,1,7,14.3,4,5,80.0,0,2,2,4,2,0,0,0,3,3
../kbl_data/2021-2022,S39G01N156,전주 KCC,Away,라타비우스 윌리엄스,6,2,5,40.0,0,0,0.0,2,5,40.0,2,2,100.0,2,7,9,0,1,1,0,1,2,1
../kbl_data/2021-2022,S39G01N156,전주 KCC,Away,곽정훈,0,0,0,0.0,0,1,0.0,0,1,0.0,0,0,0.0,0,2,2,0,0,0,0,0,0,1
../kbl_data/2021-2022,S39G01N156,전주 KCC,Away,이근휘,0,0,1,0.0,0,1,0.0,0,2,0.0,0,0,0.0,1,0,1,0,0,0,0,0,0,1
../kbl_data/2021-2022,S39G01N157,서울 삼성,Home,김동량,6,3,4,75.0,0,1,0.0,3,5,60.0,0,0,0.0,3,4,7,1,1,0,0,0,1,3
../kbl_data/2021-2022,S39G01N157,서울 삼성,Home,김시래,11,4,6,66.7,1,7,14.3,5,13,38.5,0,0,0.0,0,2,2,4,1,0,0,0,3,2
../kbl_data/2021-2022,S39G01N157,서울 삼성,Home,임동섭,5,1,5,20.0,1,4,25.0,2,9,22.2,0,0,0.0,2,1,3,0,0,0,0,0,0,2
../kbl_data/2021-2022,S39G01N157,서울 삼성,Home,배수용,0,0,0,0.0,0,0,0.0,0,0,0.0,0,0,0.0,0,0,0,0,0,0,0,0,0,0
../kbl_data/2021-2022,S39G01N157,서울 삼성,Home,천기범,4,2,3,66.7,0,0,0.0,2,3,66.7,0,0,0.0,0,2,2,0,0,1,0,0,1,2
../kbl_data/2021-2022,S39G01N157,서울 삼성,Home,정희원,0,0,0,0.0,0,0,0.0,0,0,0.0,0,0,0.0,0,0,0,0,1,0,0,0,0,1
../kbl_data/2021-2022,S39G01N157,서울 삼성,Home,강바일,0,0,0,0.0,0,0,0.0,0,0,0.0,0,0,0.0,0,0,0,0,0,0,0,0,0,0
../kbl_data/2021-2022,S39G01N157,서울 삼성,Home,차민석,2,1,6,16.7,0,0,0.0,1,6,16.7,0,0,0.0,2,1,3,0,0,0,3,0,0,5
../kbl_data/2021-2022,S39G01N157,서울 삼성,Home,전형준,0,0,1,0.0,0,0,0.0,0,1,0.0,0,0,0.0,0,1,1,0,2,0,0,0,0,2
../kbl_data/2021-2022,S39G01N157,서울 삼성,Home,다니엘 오셰푸,4,1,6,16.7,0,0,0.0,1,6,16.7,2,2,100.0,1,5,6,0,0,1,0,0,1,1
../kbl_data/2021-2022,S39G01N157,서울 삼성,Home,이원석,4,1,5,20.0,0,0,0.0,1,5,20.0,2,3,66.7,0,1,1,1,0,0,0,0,2,4
../kbl_data/2021-2022,S39G01N157,서울 삼성,Home,토마스 로빈슨,20,6,18,33.3,1,3,33.3,7,21,33.3,5,6,83.3,4,5,9,1,0,0,0,0,3,4
../kbl_data/2021-2022,S39G01N157,울산 현대모비스,Away,이현민,11,4,5,80.0,1,1,100.0,5,6,83.3,0,0,0.0,1,2,3,3,0,0,0,0,1,1
../kbl_data/2021-2022,S39G01N157,울산 현대모비스,Away,함지훈,8,1,3,33.3,1,1,100.0,2,4,50.0,3,6,50.0,2,1,3,4,0,0,0,0,0,1
../kbl_data/2021-2022,S39G01N157,울산 현대모비스,Away,최진수,8,3,5,60.0,0,3,0.0,3,8,37.5,2,4,50.0,1,1,2,1,0,1,0,0,0,1
../kbl_data/2021-2022,S39G01N157,울산 현대모비스,Away,박지훈,2,1,1,100.0,0,0,0.0,1,1,100.0,0,2,0.0,0,0,0,0,0,0,0,0,0,0
../kbl_data/2021-2022,S39G01N157,울산 현대모비스,Away,장재석,2,1,3,33.3,0,0,0.0,1,3,33.3,0,0,0.0,0,4,4,1,0,0,0,0,2,2
../kbl_data/2021-2022,S39G01N157,울산 현대모비스,Away,김영현,0,0,2,0.0,0,2,0.0,0,4,0.0,0,0,0.0,0,0,0,0,0,0,1,0,0,1
../kbl_data/2021-2022,S39G01N157,울산 현대모비스,Away,김국찬,0,0,0,0.0,0,2,0.0,0,2,0.0,0,0,0.0,0,0,0,1,0,0,0,0,2,3
../kbl_data/2021-2022,S39G01N157,울산 현대모비스,Away,이우석,12,3,6,50.0,2,3,66.7,5,9,55.6,0,0,0.0,1,4,5,5,0,1,0,0,1,2
../kbl_data/2021-2022,S39G01N157,울산 현대모비스,Away,라숀 토마스,30,9,12,75.0,0,0,0.0,9,12,75.0,12,15,80.0,5,9,14,1,2,2,0,0,5,4
../kbl_data/2021-2022,S39G01N157,울산 현대모비스,Away,신민석,2,1,1,100.0,0,0,0.0,1,1,100.0,0,0,0.0,0,4,4,0,0,0,0,0,0,1
../kbl_data/2021-2022,S39G01N157,울산 현대모비스,Away,김동준,2,0,1,0.0,0,1,0.0,0,2,0.0,2,2,100.0,0,2,2,1,0,0,0,0,1,0
../kbl_data/2021-2022,S39G01N157,울산 현대모비스,Away,에릭 버크너,3,1,2,50.0,0,0,0.0,1,2,50.0,1,2,50.0,0,4,4,0,1,0,0,0,0,3
../kbl_data/2021-2022,S39G01N158,안양 KGC,Home,양희종,0,0,1,0.0,0,3,0.0,0,4,0.0,0,0,0.0,3,3,6,0,0,0,1,0,1,0
../kbl_data/2021-2022,S39G01N158,안양 KGC,Home,함준후,3,0,0,0.0,1,2,50.0,1,2,50.0,0,0,0.0,0,0,0,0,0,0,0,0,0,2
../kbl_data/2021-2022,S39G01N158,안양 KGC,Home,오세근,10,4,8,50.0,0,2,0.0,4,10,40.0,2,2,100.0,1,3,4,4,0,0,0,0,1,2
../kbl_data/2021-2022,S39G01N158,안양 KGC,Home,문성곤,6,0,0,0.0,2,6,33.3,2,6,33.3,0,0,0.0,0,5,5,4,0,2,0,0,1,5
../kbl_data/2021-2022,S39G01N158,안양 KGC,Home,전성현,9,0,0,0.0,3,8,37.5,3,8,37.5,0,0,0.0,0,1,1,1,0,0,0,0,1,0
../kbl_data/2021-2022,S39G01N158,안양 KGC,Home,박지훈,7,2,4,50.0,1,1,100.0,3,5,60.0,0,3,0.0,0,1,1,3,1,0,0,0,0,4
../kbl_data/2021-2022,S39G01N158,안양 KGC,Home,이우정,0,0,0,0.0,0,0,0.0,0,0,0.0,0,0,0.0,0,0,0,0,0,0,0,0,0,0
../kbl_data/2021-2022,S39G01N158,안양 KGC,Home,대릴 먼로,0,0,1,0.0,0,1,0.0,0,2,0.0,0,0,0.0,1,1,2,1,1,0,0,0,0,0
../kbl_data/2021-2022,S39G01N158,안양 KGC,Home,우동현,0,0,0,0.0,0,1,0.0,0,1,0.0,0,0,0.0,0,0,0,0,0,0,0,0,0,1
../kbl_data/2021-2022,S39G01N158,안양 KGC,Home,변준형,23,2,2,100.0,6,10,60.0,8,12,66.7,1,1,100.0,0,3,3,1,2,0,0,0,3,3
../kbl_data/2021-2022,S39G01N158,안양 KGC,Home,한승희,2,1,1,100.0,0,0,0.0,1,1,100.0,0,0,0.0,0,0,0,0,0,0,1,0,0,0
../kbl_data/2021-2022,S39G01N158,안양 KGC,Home,오마리 스펠맨,19,5,6,83.3,3,7,42.9,8,13,61.5,0,0,0.0,0,7,7,5,3,2,0,0,2,1
../kbl_data/2021-2022,S39G01N158,대구 한국가스공사,Away,민성주,0,0,0,0.0,0,0,0.0,0,0,0.0,0,0,0.0,0,0,0,0,0,0,0,0,0,0
../kbl_data/2021-2022,S39G01N158,대구 한국가스공사,Away,홍경기,0,0,1,0.0,0,0,0.0,0,1,0.0,0,0,0.0,0,0,0,0,1,0,1,0,1,0
../kbl_data/2021-2022,S39G01N158,대구 한국가스공사,Away,이대헌,4,2,7,28.6,0,1,0.0,2,8,25.0,0,0,0.0,0,3,3,2,1,0,0,0,3,2
../kbl_data/2021-2022,S39G01N158,대구 한국가스공사,Away,두경민,14,2,5,40.0,2,6,33.3,4,11,36.4,4,4,100.0,0,4,4,9,2,0,0,0,2,2
../kbl_data/2021-2022,S39G01N158,대구 한국가스공사,Away,박봉진,0,0,0,0.0,0,0,0.0,0,0,0.0,0,0,0.0,0,0,0,0,0,0,0,0,0,0
../kbl_data/2021-2022,S39G01N158,대구 한국가스공사,Away,김낙현,13,2,3,66.7,3,5,60.0,5,8,62.5,0,0,0.0,0,2,2,4,1,0,0,0,3,4
../kbl_data/2021-2022,S39G01N158,대구 한국가스공사,Away,전현우,18,2,4,50.0,4,8,50.0,6,12,50.0,2,2,100.0,0,3,3,1,0,0,0,0,0,2
../kbl_data/2021-2022,S39G01N158,대구 한국가스공사,Away,이윤기,0,0,0,0.0,0,0,0.0,0,0,0.0,0,0,0.0,0,0,0,0,0,0,0,0,0,0
../kbl_data/2021-2022,S39G01N158,대구 한국가스공사,Away,양준우,3,0,0,0.0,1,1,100.0,1,1,100.0,0,0,0.0,0,0,0,0,0,0,0,0,0,2
../kbl_data/2021-2022,S39G01N158,대구 한국가스공사,Away,이도헌,0,0,0,0.0,0,0,0.0,0,0,0.0,0,0,0.0,0,0,0,0,0,0,0,0,0,0
../kbl_data/2021-2022,S39G01N158,대구 한국가스공사,Away,클리프 알렉산더,8,2,7,28.6,0,0,0.0,2,7,28.6,4,4,100.0,4,14,18,1,0,0,0,0,2,1
../kbl_data/2021-2022,S39G01N158,대구 한국가스공사,Away,신승민,13,1,3,33.3,3,4,75.0,4,7,57.1,2,2,100.0,1,2,3,2,1,0,0,0,2,3
../kbl_data/2021-2022,S39G01N159,안양 KGC,Home,양희종,0,0,0,0.0,0,3,0.0,0,3,0.0,0,0,0.0,0,3,3,0,3,0,0,0,1,3
../kbl_data/2021-2022,S39G01N159,안양 KGC,Home,함준후,0,0,0,0.0,0,1,0.0,0,1,0.0,0,0,0.0,0,0,0,1,0,0,0,0,0,1
../kbl_data/2021-2022,S39G01N159,안양 KGC,Home,오세근,21,10,15,66.7,0,1,0.0,10,16,62.5,1,3,33.3,4,7,11,3,0,0,0,0,1,3
../kbl_data/2021-2022,S39G01N159,안양 KGC,Home,문성곤,12,0,1,0.0,4,9,44.4,4,10,40.0,0,0,0.0,2,0,2,4,0,0,0,0,1,4
../kbl_data/2021-2022,S39G01N159,안양 KGC,Home,전성현,19,1,3,33.3,5,9,55.6,6,12,50.0,2,2,100.0,2,1,3,1,1,0,0,0,0,1
../kbl_data/2021-2022,S39G01N159,안양 KGC,Home,박지훈,4,2,2,100.0,0,0,0.0,2,2,100.0,0,0,0.0,1,1,2,1,0,0,0,0,1,1
../kbl_data/2021-2022,S39G01N159,안양 KGC,Home,이우정,0,0,0,0.0,0,0,0.0,0,0,0.0,0,0,0.0,0,0,0,0,0,0,0,0,0,0
../kbl_data/2021-2022,S39G01N159,안양 KGC,Home,대릴 먼로,7,2,5,40.0,0,1,0.0,2,6,33.3,3,4,75.0,3,6,9,6,0,1,0,0,3,4
../kbl_data/2021-2022,S39G01N159,안양 KGC,Home,우동현,0,0,0,0.0,0,0,0.0,0,0,0.0,0,0,0.0,0,0,0,0,0,0,0,0,0,0
../kbl_data/2021-2022,S39G01N159,안양 KGC,Home,변준형,7,1,2,50.0,0,5,0.0,1,7,14.3,5,5,100.0,0,1,1,4,0,0,0,0,2,3
../kbl_data/2021-2022,S39G01N159,안양 KGC,Home,한승희,0,0,0,0.0,0,0,0.0,0,0,0.0,0,0,0.0,0,0,0,0,0,0,0,0,0,0
../kbl_data/2021-2022,S39G01N159,안양 KGC,Home,오마리 스펠맨,9,3,4,75.0,1,4,25.0,4,8,50.0,0,0,0.0,0,3,3,2,0,0,0,0,1,2
../kbl_data/2021-2022,S39G01N159,창원 LG,Away,강병현,4,0,0,0.0,1,2,50.0,1,2,50.0,1,2,50.0,0,1,1,0,0,0,0,0,0,3
../kbl_data/2021-2022,S39G01N159,창원 LG,Away,변기훈,0,0,0,0.0,0,1,0.0,0,1,0.0,0,0,0.0,0,0,0,0,0,0,0,0,0,0
../kbl_data/2021-2022,S39G01N159,창원 LG,Away,이관희,29,6,9,66.7,5,8,62.5,11,17,64.7,2,2,100.0,0,5,5,0,0,0,0,0,3,2
../kbl_data/2021-2022,S39G01N159,창원 LG,Away,정희재,3,1,1,100.0,0,3,0.0,1,4,25.0,1,2,50.0,0,2,2,1,0,0,0,0,1,4
../kbl_data/2021-2022,S39G01N159,창원 LG,Away,서민수,2,1,1,100.0,0,3,0.0,1,4,25.0,0,0,0.0,1,0,1,1,0,0,0,0,1,2
../kbl_data/2021-2022,S39G01N159,창원 LG,Away,한상혁,2,1,1,100.0,0,0,0.0,1,1,100.0,0,0,0.0,0,0,0,1,0,0,0,0,1,2
../kbl_data/2021-2022,S39G01N159,창원 LG,Away,이재도,11,2,6,33.3,1,3,33.3,3,9,33.3,4,4,100.0,1,3,4,2,1,0,0,0,0,1
../kbl_data/2021-2022,S39G01N159,창원 LG,Away,정인덕,0,0,0,0.0,0,0,0.0,0,0,0.0,0,0,0.0,0,0,0,0,0,0,0,0,0,0
../kbl_data/2021-2022,S39G01N159,창원 LG,Away,윤원상,0,0,0,0.0,0,0,0.0,0,0,0.0,0,0,0.0,0,0,0,0,0,0,0,0,0,0
../kbl_data/2021-2022,S39G01N159,창원 LG,Away,아셈 마레이,17,6,12,50.0,0,0,0.0,6,12,50.0,5,8,62.5,6,10,16,6,4,1,0,0,3,4
../kbl_data/2021-2022,S39G01N159,창원 LG,Away,이승우,11,2,5,40.0,1,2,50.0,3,7,42.9,4,6,66.7,2,0,2,2,1,0,0,0,0,1
../kbl_data/2021-2022,S39G01N159,창원 LG,Away,사마르도 사무엘스,3,0,3,0.0,1,1,100.0,1,4,25.0,0,0,0.0,1,5,6,0,1,0,0,0,1,0
../kbl_data/2021-2022,S39G01N160,수원 KT,Home,김동욱,0,0,1,0.0,0,1,0.0,0,2,0.0,0,0,0.0,1,0,1,1,0,0,0,0,2,2
../kbl_data/2021-2022,S39G01N160,수원 KT,Home,김영환,3,0,2,0.0,1,5,20.0,1,7,14.3,0,0,0.0,1,0,1,1,1,1,0,0,0,2
../kbl_data/2021-2022,S39G01N160,수원 KT,Home,최창진,2,0,0,0.0,0,2,0.0,0,2,0.0,2,2,100.0,0,2,2,1,0,0,0,0,0,2
../kbl_data/2021-2022,S39G01N160,수원 KT,Home,정성우,9,1,5,20.0,2,2,100.0,3,7,42.9,1,1,100.0,0,3,3,1,1,0,0,0,0,2
../kbl_data/2021-2022,S39G01N160,수원 KT,Home,허훈,27,7,11,63.6,4,8,50.0,11,19,57.9,1,1,100.0,0,0,0,7,1,0,0,0,3,3
../kbl_data/2021-2022,S39G01N160,수원 KT,Home,양홍석,10,2,5,40.0,2,6,33.3,4,11,36.4,0,0,0.0,1,7,8,5,0,1,0,0,2,3
../kbl_data/2021-2022,S39G01N160,수원 KT,Home,박준영,0,0,2,0.0,0,0,0.0,0,2,0.0,0,0,0.0,1,1,2,1,0,0,0,0,0,0
../kbl_data/2021-2022,S39G01N160,수원 KT,Home,캐디 라렌,31,11,15,73.3,1,3,33.3,12,18,66.7,6,7,85.7,3,15,18,4,1,1,0,0,4,2
../kbl_data/2021-2022,S39G01N160,수원 KT,Home,박지원,0,0,0,0.0,0,0,0.0,0,0,0.0,0,0,0.0,0,0,0,0,0,0,0,0,0,0
../kbl_data/2021-2022,S39G01N160,수원 KT,Home,마이크 마이어스,0,0,1,0.0,0,0,0.0,0,1,0.0,0,0,0.0,0,1,1,1,0,0,0,0,0,1
../kbl_data/2021-2022,S39G01N160,수원 KT,Home,김준환,0,0,0,0.0,0,0,0.0,0,0,0.0,0,0,0.0,0,0,0,0,0,0,0,0,0,0
../kbl_data/2021-2022,S39G01N160,수원 KT,Home,하윤기,0,0,1,0.0,0,0,0.0,0,1,0.0,0,0,0.0,1,0,1,0,0,0,0,0,0,0
../kbl_data/2021-2022,S39G01N160,서울 SK,Away,양우섭,3,0,1,0.0,1,1,100.0,1,2,50.0,0,0,0.0,0,0,0,2,1,0,0,0,1,0
../kbl_data/2021-2022,S39G01N160,서울 SK,Away,허일영,4,2,3,66.7,0,3,0.0,2,6,33.3,0,0,0.0,0,0,0,0,0,0,0,0,0,1
../kbl_data/2021-2022,S39G01N160,서울 SK,Away,김선형,16,5,14,35.7,1,3,33.3,6,17,35.3,3,3,100.0,0,3,3,7,1,0,0,0,3,1
../kbl_data/2021-2022,S39G01N160,서울 SK,Away,최부경,0,0,1,0.0,0,0,0.0,0,1,0.0,0,0,0.0,0,0,0,0,0,0,0,0,0,1
../kbl_data/2021-2022,S39G01N160,서울 SK,Away,리온 윌리엄스,2,1,3,33.3,0,0,0.0,1,3,33.3,0,0,0.0,2,0,2,0,2,0,0,0,0,3
../kbl_data/2021-2022,S39G01N160,서울 SK,Away,배병준,0,0,0,0.0,0,0,0.0,0,0,0.0,0,0,0.0,0,0,0,0,0,0,0,0,0,0
../kbl_data/2021-2022,S39G01N160,서울 SK,Away,이현석,0,0,0,0.0,0,0,0.0,0,0,0.0,0,0,0.0,0,0,0,0,0,0,0,0,0,0
../kbl_data/2021-2022,S39G01N160,서울 SK,Away,최원혁,6,0,0,0.0,2,4,50.0,2,4,50.0,0,0,0.0,1,0,1,1,2,0,0,0,0,4
../kbl_data/2021-2022,S39G01N160,서울 SK,Away,최준용,4,2,4,50.0,0,2,0.0,2,6,33.3,0,2,0.0,2,6,8,4,0,0,0,1,0,2
../kbl_data/2021-2022,S39G01N160,서울 SK,Away,안영준,17,4,8,50.0,3,4,75.0,7,12,58.3,0,0,0.0,4,7,11,1,0,0,0,0,0,1
../kbl_data/2021-2022,S39G01N160,서울 SK,Away,자밀 워니,30,13,28,46.4,0,1,0.0,13,29,44.8,4,7,57.1,6,7,13,3,1,1,0,1,0,3
../kbl_data/2021-2022,S39G01N160,서울 SK,Away,오재현,3,0,1,0.0,1,2,50.0,1,3,33.3,0,0,0.0,1,0,1,0,0,0,2,0,1,1
../kbl_data/2021-2022,S39G01N161,전주 KCC,Home,이정현,40,12,18,66.7,2,8,25.0,14,26,53.8,10,12,83.3,4,8,12,8,0,0,0,0,6,10
../kbl_data/2021-2022,S39G01N161,전주 KCC,Home,정창영,10,2,4,50.0,2,3,66.7,4,7,57.1,0,0,0.0,1,1,2,3,0,0,0,0,1,4
../kbl_data/2021-2022,S39G01N161,전주 KCC,Home,라건아,14,6,11,54.5,0,4,0.0,6,15,40.0,2,3,66.7,7,13,20,0,1,1,0,0,3,1
../kbl_data/2021-2022,S39G01N161,전주 KCC,Home,김지완,7,2,5,40.0,1,3,33.3,3,8,37.5,0,2,0.0,0,0,0,6,0,0,0,0,1,3
../kbl_data/2021-2022,S39G01N161,전주 KCC,Home,김상규,13,4,5,80.0,1,2,50.0,5,7,71.4,2,2,100.0,4,1,5,1,0,0,0,0,0,1
../kbl_data/2021-2022,S39G01N161,전주 KCC,Home,전준범,6,0,1,0.0,2,4,50.0,2,5,40.0,0,0,0.0,0,1,1,1,0,0,0,0,0,1
../kbl_data/2021-2022,S39G01N161,전주 KCC,Home,박재현,0,0,0,0.0,0,0,0.0,0,0,0.0,0,0,0.0,0,0,0,0,0,0,0,0,0,0
../kbl_data/2021-2022,S39G01N161,전주 KCC,Home,송교창,8,1,2,50.0,2,2,100.0,3,4,75.0,0,0,0.0,0,3,3,1,0,0,0,0,0,3
../kbl_data/2021-2022,S39G01N161,전주 KCC,Home,이진욱,0,0,0,0.0,0,0,0.0,0,0,0.0,0,0,0.0,0,0,0,1,0,0,0,0,1,0
../kbl_data/2021-2022,S39G01N161,전주 KCC,Home,유현준,13,3,4,75.0,1,2,50.0,4,6,66.7,4,5,80.0,0,0,0,2,0,0,0,0,2,1
../kbl_data/2021-2022,S39G01N161,전주 KCC,Home,라타비우스 윌리엄스,2,1,1,100.0,0,0,0.0,1,1,100.0,0,2,0.0,1,1,2,0,0,0,0,1,0,1
../kbl_data/2021-2022,S39G01N161,전주 KCC,Home,이근휘,0,0,0,0.0,0,1,0.0,0,1,0.0,0,0,0.0,0,0,0,0,0,0,0,0,0,0
../kbl_data/2021-2022,S39G01N161,고양 오리온,Away,오용준,0,0,0,0.0,0,0,0.0,0,0,0.0,0,0,0.0,0,0,0,0,0,0,0,0,0,0
../kbl_data/2021-2022,S39G01N161,고양 오리온,Away,김강선,6,1,2,50.0,0,3,0.0,1,5,20.0,4,4,100.0,0,0,0,1,1,0,0,0,1,2
../kbl_data/2021-2022,S39G01N161,고양 오리온,Away,임종일,0,0,0,0.0,0,0,0.0,0,0,0.0,0,0,0.0,0,1,1,0,0,0,0,0,0,0
../kbl_data/2021-2022,S39G01N161,고양 오리온,Away,이대성,17,3,11,27.3,3,6,50.0,6,17,35.3,2,2,100.0,1,2,3,3,1,0,0,0,1,3
../kbl_data/2021-2022,S39G01N161,고양 오리온,Away,한호빈,13,1,1,100.0,3,8,37.5,4,9,44.4,2,2,100.0,2,2,4,3,0,0,0,0,0,3
../kbl_data/2021-2022,S39G01N161,고양 오리온,Away,이정제,0,0,0,0.0,0,0,0.0,0,0,0.0,0,0,0.0,0,0,0,0,1,0,0,0,0,0
../kbl_data/2021-2022,S39G01N161,고양 오리온,Away,이승현,10,4,7,57.1,0,1,0.0,4,8,50.0,2,3,66.7,5,4,9,2,1,1,0,0,0,3
../kbl_data/2021-2022,S39G01N161,고양 오리온,Away,제임스 메이스,3,1,8,12.5,0,2,0.0,1,10,10.0,1,2,50.0,5,3,8,2,0,0,0,0,2,2
../kbl_data/2021-2022,S39G01N161,고양 오리온,Away,머피 할로웨이,15,7,14,50.0,0,0,0.0,7,14,50.0,1,2,50.0,2,5,7,4,2,2,0,1,1,2
../kbl_data/2021-2022,S39G01N161,고양 오리온,Away,조한진,0,0,0,0.0,0,1,0.0,0,1,0.0,0,0,0.0,0,0,0,1,1,0,0,0,0,2
../kbl_data/2021-2022,S39G01N161,고양 오리온,Away,이정현,40,12,18,66.7,2,8,25.0,14,26,53.8,10,12,83.3,4,8,12,8,0,0,0,0,6,10
../kbl_data/2021-2022,S39G01N161,고양 오리온,Away,문시윤,0,0,0,0.0,0,0,0.0,0,0,0.0,0,0,0.0,0,0,0,0,0,0,0,0,0,0
../kbl_data/2021-2022,S39G01N162,대구 한국가스공사,Home,정영삼,4,2,2,100.0,0,1,0.0,2,3,66.7,0,0,0.0,1,1,2,2,0,0,0,0,0,0
../kbl_data/2021-2022,S39G01N162,대구 한국가스공사,Home,민성주,0,0,0,0.0,0,0,0.0,0,0,0.0,0,0,0.0,0,0,0,0,0,0,0,0,0,0
../kbl_data/2021-2022,S39G01N162,대구 한국가스공사,Home,홍경기,0,0,1,0.0,0,0,0.0,0,1,0.0,0,0,0.0,0,0,0,0,0,0,0,0,0,0
../kbl_data/2021-2022,S39G01N162,대구 한국가스공사,Home,차바위,3,0,1,0.0,1,3,33.3,1,4,25.0,0,0,0.0,4,2,6,2,2,1,0,0,1,4
../kbl_data/2021-2022,S39G01N162,대구 한국가스공사,Home,이대헌,6,3,9,33.3,0,1,0.0,3,10,30.0,0,0,0.0,1,3,4,2,1,0,0,0,2,3
../kbl_data/2021-2022,S39G01N162,대구 한국가스공사,Home,두경민,20,5,8,62.5,2,5,40.0,7,13,53.8,4,4,100.0,1,4,5,7,2,0,0,0,1,3
../kbl_data/2021-2022,S39G01N162,대구 한국가스공사,Home,김낙현,22,3,6,50.0,3,7,42.9,6,13,46.2,7,8,87.5,2,0,2,6,1,0,1,0,0,1
../kbl_data/2021-2022,S39G01N162,대구 한국가스공사,Home,전현우,12,0,0,0.0,4,5,80.0,4,5,80.0,0,0,0.0,0,1,1,0,0,0,0,0,0,1
../kbl_data/2021-2022,S39G01N162,대구 한국가스공사,Home,이윤기,0,0,0,0.0,0,1,0.0,0,1,0.0,0,0,0.0,1,0,1,0,0,0,0,0,0,1
../kbl_data/2021-2022,S39G01N162,대구 한국가스공사,Home,앤드류 니콜슨,22,6,11,54.5,2,5,40.0,8,16,50.0,4,5,80.0,0,6,6,1,0,0,0,0,2,1
../kbl_data/2021-2022,S39G01N162,대구 한국가스공사,Home,신승민,6,0,0,0.0,2,2,100.0,2,2,100.0,0,0,0.0,0,0,0,3,1,0,0,0,1,4
../kbl_data/2021-2022,S39G01N162,대구 한국가스공사,Home,디제이 화이트,7,3,5,60.0,0,0,0.0,3,5,60.0,1,1,100.0,1,8,9,1,0,0,0,0,2,1
../kbl_data/2021-2022,S39G01N162,원주 DB,Away,윤호영,2,1,2,50.0,0,0,0.0,1,2,50.0,0,0,0.0,0,0,0,0,0,0,0,0,0,1
../kbl_data/2021-2022,S39G01N162,원주 DB,Away,박찬희,0,0,1,0.0,0,2,0.0,0,3,0.0,0,0,0.0,1,1,2,0,1,0,0,0,1,0
../kbl_data/2021-2022,S39G01N162,원주 DB,Away,정준원,5,2,2,100.0,0,0,0.0,2,2,100.0,1,1,100.0,1,1,2,0,0,0,0,0,0,0
../kbl_data/2021-2022,S39G01N162,원주 DB,Away,김종규,9,3,6,50.0,1,3,33.3,4,9,44.4,0,0,0.0,2,5,7,1,0,0,0,0,2,4
../kbl_data/2021-2022,S39G01N162,원주 DB,Away,허웅,17,3,5,60.0,1,4,25.0,4,9,44.4,8,9,88.9,0,3,3,4,1,0,0,0,3,4
../kbl_data/2021-2022,S39G01N162,원주 DB,Away,김영훈,0,0,0,0.0,0,0,0.0,0,0,0.0,0,0,0.0,0,0,0,0,0,0,1,0,0,3
../kbl_data/2021-2022,S39G01N162,원주 DB,Away,배강률,0,0,0,0.0,0,0,0.0,0,0,0.0,0,0,0.0,0,0,0,0,0,0,0,0,0,0
../kbl_data/2021-2022,S39G01N162,원주 DB,Away,강상재,13,5,9,55.6,1,4,25.0,6,13,46.2,0,1,0.0,4,6,10,3,2,2,0,0,0,3
../kbl_data/2021-2022,S39G01N162,원주 DB,Away,이용우,5,1,1,100.0,1,4,25.0,2,5,40.0,0,0,0.0,1,1,2,0,0,0,0,0,1,0
../kbl_data/2021-2022,S39G01N162,원주 DB,Away,이준희,0,0,3,0.0,0,1,0.0,0,4,0.0,0,0,0.0,2,0,2,1,0,0,0,0,0,1
../kbl_data/2021-2022,S39G01N162,원주 DB,Away,정호영,9,3,4,75.0,0,9,0.0,3,13,23.1,3,3,100.0,0,1,1,6,2,1,0,0,1,3
../kbl_data/2021-2022,S39G01N162,원주 DB,Away,조니 오브라이언트,27,8,11,72.7,3,7,42.9,11,18,61.1,2,5,40.0,5,4,9,1,1,2,0,0,3,4
../kbl_data/2021-2022,S39G01N163,울산 현대모비스,Home,이현민,3,1,1,100.0,0,0,0.0,1,1,100.0,1,1,100.0,0,2,2,3,0,0,0,0,0,1
../kbl_data/2021-2022,S39G01N163,울산 현대모비스,Home,함지훈,10,3,9,33.3,0,0,0.0,3,9,33.3,4,5,80.0,3,4,7,2,0,2,0,0,5,3
../kbl_data/2021-2022,S39G01N163,울산 현대모비스,Home,최진수,0,0,0,0.0,0,1,0.0,0,1,0.0,0,0,0.0,0,0,0,1,0,0,0,0,0,0
../kbl_data/2021-2022,S39G01N163,울산 현대모비스,Home,박지훈,6,0,6,0.0,2,6,33.3,2,12,16.7,0,0,0.0,0,0,0,8,0,0,0,0,4,8
../kbl_data/2021-2022,S39G01N163,울산 현대모비스,Home,장재석,0,0,3,0.0,0,0,0.0,0,3,0.0,0,0,0.0,0,2,2,0,0,0,0,0,2,4
../kbl_data/2021-2022,S39G01N163,울산 현대모비스,Home,김영현,3,0,0,0.0,1,4,25.0,1,4,25.0,0,0,0.0,1,1,2,1,0,0,2,0,0,4
../kbl_data/2021-2022,S39G01N163,울산 현대모비스,Home,김국찬,11,1,2,50.0,3,8,37.5,4,10,40.0,0,0,0.0,0,2,2,2,1,0,0,0,0,1
../kbl_data/2021-2022,S39G01N163,울산 현대모비스,Home,서명진,6,0,4,0.0,2,2,100.0,2,6,33.3,0,0,0.0,0,2,2,1,0,0,0,0,1,0
../kbl_data/2021-2022,S39G01N163,울산 현대모비스,Home,이우석,17,5,8,62.5,2,2,100.0,7,10,70.0,1,2,50.0,1,4,5,3,0,0,0,0,0,0
../kbl_data/2021-2022,S39G01N163,울산 현대모비스,Home,라숀 토마스,17,7,11,63.6,0,1,0.0,7,12,58.3,3,6,50.0,2,4,6,3,2,1,0,2,1,4
../kbl_data/2021-2022,S39G01N163,울산 현대모비스,Home,신민석,6,1,2,50.0,1,2,50.0,2,4,50.0,1,2,50.0,0,3,3,0,0,0,0,0,0,0
../kbl_data/2021-2022,S39G01N163,울산 현대모비스,Home,에릭 버크너,4,2,2,100.0,0,0,0.0,2,2,100.0,0,0,0.0,0,3,3,0,0,0,0,0,0,2
../kbl_data/2021-2022,S39G01N163,안양 KGC,Away,양희종,0,0,2,0.0,0,1,0.0,0,3,0.0,0,0,0.0,0,0,0,0,0,0,0,0,0,0
../kbl_data/2021-2022,S39G01N163,안양 KGC,Away,박형철,0,0,0,0.0,0,0,0.0,0,0,0.0,0,0,0.0,0,0,0,0,0,0,0,0,0,0
../kbl_data/2021-2022,S39G01N163,안양 KGC,Away,함준후,0,0,0,0.0,0,0,0.0,0,0,0.0,0,0,0.0,0,0,0,0,0,0,0,0,0,0
../kbl_data/2021-2022,S39G01N163,안양 KGC,Away,오세근,6,3,7,42.9,0,0,0.0,3,7,42.9,0,0,0.0,2,0,2,3,0,0,0,0,0,2
../kbl_data/2021-2022,S39G01N163,안양 KGC,Away,문성곤,0,0,0,0.0,0,3,0.0,0,3,0.0,0,0,0.0,4,7,11,3,2,0,0,0,1,4
../kbl_data/2021-2022,S39G01N163,안양 KGC,Away,전성현,22,2,6,33.3,5,11,45.5,7,17,41.2,3,5,60.0,1,3,4,3,0,0,0,0,2,2
../kbl_data/2021-2022,S39G01N163,안양 KGC,Away,박지훈,6,0,6,0.0,2,6,33.3,2,12,16.7,0,0,0.0,0,0,0,8,0,0,0,0,4,8
../kbl_data/2021-2022,S39G01N163,안양 KGC,Away,정강호,0,0,0,0.0,0,0,0.0,0,0,0.0,0,0,0.0,0,0,0,0,0,0,0,0,0,0
../kbl_data/2021-2022,S39G01N163,안양 KGC,Away,이우정,0,0,1,0.0,0,1,0.0,0,2,0.0,0,0,0.0,0,0,0,1,0,0,0,0,0,1
../kbl_data/2021-2022,S39G01N163,안양 KGC,Away,대릴 먼로,26,7,13,53.8,3,6,50.0,10,19,52.6,3,4,75.0,5,14,19,5,0,0,0,1,3,3
../kbl_data/2021-2022,S39G01N163,안양 KGC,Away,우동현,9,0,0,0.0,2,8,25.0,2,8,25.0,3,4,75.0,0,3,3,2,2,0,1,0,0,2
../kbl_data/2021-2022,S39G01N163,안양 KGC,Away,한승희,7,3,3,100.0,0,1,0.0,3,4,75.0,1,2,50.0,3,0,3,0,0,1,1,0,1,4
../kbl_data/2021-2022,S39G01N164,전주 KCC,Home,이정현,16,6,6,100.0,0,0,0.0,6,6,100.0,4,5,80.0,1,1,2,1,0,0,0,0,4,2
../kbl_data/2021-2022,S39G01N164,전주 KCC,Home,정창영,3,0,2,0.0,1,1,100.0,1,3,33.3,0,0,0.0,0,1,1,2,0,0,0,0,2,0
../kbl_data/2021-2022,S39G01N164,전주 KCC,Home,라건아,17,8,11,72.7,0,2,0.0,8,13,61.5,1,3,33.3,3,9,12,0,1,0,0,1,3,1
../kbl_data/2021-2022,S39G01N164,전주 KCC,Home,김지완,9,3,4,75.0,1,5,20.0,4,9,44.4,0,0,0.0,0,3,3,7,0,0,0,0,0,2
../kbl_data/2021-2022,S39G01N164,전주 KCC,Home,김상규,5,1,1,100.0,1,2,50.0,2,3,66.7,0,0,0.0,2,1,3,0,0,0,0,0,1,0
../kbl_data/2021-2022,S39G01N164,전주 KCC,Home,전준범,5,1,1,100.0,1,4,25.0,2,5,40.0,0,0,0.0,0,0,0,1,0,0,0,0,0,0
../kbl_data/2021-2022,S39G01N164,전주 KCC,Home,박재현,3,0,3,0.0,1,3,33.3,1,6,16.7,0,0,0.0,0,3,3,7,1,0,0,0,0,3
../kbl_data/2021-2022,S39G01N164,전주 KCC,Home,송교창,5,1,2,50.0,1,11,9.1,2,13,15.4,0,0,0.0,1,3,4,1,4,1,0,0,0,3
../kbl_data/2021-2022,S39G01N164,전주 KCC,Home,이진욱,0,0,0,0.0,0,0,0.0,0,0,0.0,0,0,0.0,0,0,0,0,0,0,0,0,1,0
../kbl_data/2021-2022,S39G01N164,전주 KCC,Home,유현준,7,1,2,50.0,1,1,100.0,2,3,66.7,2,2,100.0,0,0,0,2,2,0,1,0,1,1
../kbl_data/2021-2022,S39G01N164,전주 KCC,Home,라타비우스 윌리엄스,15,6,8,75.0,0,0,0.0,6,8,75.0,3,7,42.9,3,6,9,1,1,0,0,1,0,5
../kbl_data/2021-2022,S39G01N164,전주 KCC,Home,이근휘,0,0,1,0.0,0,0,0.0,0,1,0.0,0,0,0.0,0,0,0,1,0,0,0,0,1,1
../kbl_data/2021-2022,S39G01N164,서울 삼성,Away,김동량,7,2,3,66.7,1,1,100.0,3,4,75.0,0,0,0.0,0,0,0,0,2,0,0,0,0,0
../kbl_data/2021-2022,S39G01N164,서울 삼성,Away,김시래,8,4,10,40.0,0,0,0.0,4,10,40.0,0,0,0.0,0,3,3,4,0,0,0,0,3,2
../kbl_data/2021-2022,S39G01N164,서울 삼성,Away,김현수,8,0,2,0.0,2,7,28.6,2,9,22.2,2,2,100.0,0,2,2,1,1,0,1,0,2,0
../kbl_data/2021-2022,S39G01N164,서울 삼성,Away,배수용,0,0,0,0.0,0,1,0.0,0,1,0.0,0,0,0.0,0,2,2,0,0,0,0,0,1,1
../kbl_data/2021-2022,S39G01N164,서울 삼성,Away,이호현,4,2,5,40.0,0,1,0.0,2,6,33.3,0,0,0.0,2,2,4,1,1,0,0,0,2,0
../kbl_data/2021-2022,S39G01N164,서울 삼성,Away,정희원,0,0,0,0.0,0,0,0.0,0,0,0.0,0,0,0.0,0,0,0,0,1,0,0,0,0,5
../kbl_data/2021-2022,S39G01N164,서울 삼성,Away,강바일,0,0,0,0.0,0,0,0.0,0,0,0.0,0,0,0.0,0,1,1,1,0,0,0,0,1,2
../kbl_data/2021-2022,S39G01N164,서울 삼성,Away,차민석,0,0,1,0.0,0,0,0.0,0,1,0.0,0,0,0.0,0,1,1,0,0,0,0,0,2,2
../kbl_data/2021-2022,S39G01N164,서울 삼성,Away,전형준,3,0,0,0.0,1,4,25.0,1,4,25.0,0,0,0.0,0,0,0,1,1,0,0,0,1,5
../kbl_data/2021-2022,S39G01N164,서울 삼성,Away,다니엘 오셰푸,10,5,12,41.7,0,0,0.0,5,12,41.7,0,0,0.0,4,5,9,1,0,0,0,1,1,0
../kbl_data/2021-2022,S39G01N164,서울 삼성,Away,이원석,11,3,4,75.0,1,2,50.0,4,6,66.7,2,4,50.0,0,3,3,0,0,0,0,0,0,1
../kbl_data/2021-2022,S39G01N164,서울 삼성,Away,토마스 로빈슨,19,8,12,66.7,0,0,0.0,8,12,66.7,3,7,42.9,1,12,13,2,1,1,0,1,4,4
../kbl_data/2021-2022,S39G01N165,고양 오리온,Home,김강선,5,2,2,100.0,0,3,0.0,2,5,40.0,1,1,100.0,0,0,0,0,0,0,0,0,1,1
../kbl_data/2021-2022,S39G01N165,고양 오리온,Home,최현민,0,0,0,0.0,0,0,0.0,0,0,0.0,0,0,0.0,0,0,0,0,0,0,0,0,0,0
../kbl_data/2021-2022,S39G01N165,고양 오리온,Home,임종일,2,1,2,50.0,0,0,0.0,1,2,50.0,0,0,0.0,0,2,2,1,0,0,0,0,1,2
../kbl_data/2021-2022,S39G01N165,고양 오리온,Home,이대성,16,3,7,42.9,3,6,50.0,6,13,46.2,1,2,50.0,0,6,6,7,2,0,0,0,1,2
../kbl_data/2021-2022,S39G01N165,고양 오리온,Home,한호빈,10,1,2,50.0,2,3,66.7,3,5,60.0,2,2,100.0,0,0,0,4,0,0,0,0,0,1
../kbl_data/2021-2022,S39G01N165,고양 오리온,Home,이정제,0,0,0,0.0,0,0,0.0,0,0,0.0,0,0,0.0,0,0,0,0,0,0,0,0,0,0
../kbl_data/2021-2022,S39G01N165,고양 오리온,Home,이승현,11,3,6,50.0,1,4,25.0,4,10,40.0,2,2,100.0,4,3,7,2,0,0,0,0,3,2
../kbl_data/2021-2022,S39G01N165,고양 오리온,Home,김진유,0,0,0,0.0,0,0,0.0,0,0,0.0,0,0,0.0,0,0,0,0,0,0,0,0,0,0
../kbl_data/2021-2022,S39G01N165,고양 오리온,Home,제임스 메이스,9,3,5,60.0,1,1,100.0,4,6,66.7,0,0,0.0,3,1,4,1,0,0,0,0,1,1
../kbl_data/2021-2022,S39G01N165,고양 오리온,Home,머피 할로웨이,18,8,12,66.7,0,0,0.0,8,12,66.7,2,2,100.0,2,8,10,2,3,1,0,1,1,2
../kbl_data/2021-2022,S39G01N165,고양 오리온,Home,조한진,4,2,2,100.0,0,3,0.0,2,5,40.0,0,0,0.0,0,3,3,2,0,0,0,0,1,1
../kbl_data/2021-2022,S39G01N165,고양 오리온,Home,이정현,12,4,5,80.0,1,4,25.0,5,9,55.6,1,1,100.0,0,3,3,2,1,0,0,0,0,2
../kbl_data/2021-2022,S39G01N165,대구 한국가스공사,Away,정영삼,0,0,1,0.0,0,0,0.0,0,1,0.0,0,0,0.0,0,0,0,0,0,0,0,0,0,0
../kbl_data/2021-2022,S39G01N165,대구 한국가스공사,Away,민성주,0,0,0,0.0,0,0,0.0,0,0,0.0,0,0,0.0,0,0,0,0,0,0,0,0,0,0
../kbl_data/2021-2022,S39G01N165,대구 한국가스공사,Away,홍경기,0,0,0,0.0,0,0,0.0,0,0,0.0,0,0,0.0,0,0,0,0,0,0,0,0,0,0
../kbl_data/2021-2022,S39G01N165,대구 한국가스공사,Away,차바위,4,2,2,100.0,0,4,0.0,2,6,33.3,0,0,0.0,0,2,2,0,0,0,1,0,0,4
../kbl_data/2021-2022,S39G01N165,대구 한국가스공사,Away,이대헌,13,5,8,62.5,1,1,100.0,6,9,66.7,0,0,0.0,2,3,5,7,2,0,0,0,1,5
../kbl_data/2021-2022,S39G01N165,대구 한국가스공사,Away,두경민,14,4,8,50.0,2,5,40.0,6,13,46.2,0,0,0.0,3,5,8,8,3,0,0,0,1,2
../kbl_data/2021-2022,S39G01N165,대구 한국가스공사,Away,김낙현,5,1,4,25.0,1,2,50.0,2,6,33.3,0,0,0.0,0,2,2,7,2,0,0,0,1,3
../kbl_data/2021-2022,S39G01N165,대구 한국가스공사,Away,전현우,9,0,0,0.0,3,8,37.5,3,8,37.5,0,2,0.0,0,0,0,1,0,0,0,0,1,1
../kbl_data/2021-2022,S39G01N165,대구 한국가스공사,Away,이윤기,0,0,0,0.0,0,0,0.0,0,0,0.0,0,0,0.0,0,0,0,0,0,0,0,0,0,0
../kbl_data/2021-2022,S39G01N165,대구 한국가스공사,Away,앤드류 니콜슨,27,6,12,50.0,4,6,66.7,10,18,55.6,3,4,75.0,1,4,5,1,0,0,0,1,2,0
../kbl_data/2021-2022,S39G01N165,대구 한국가스공사,Away,신승민,2,1,1,100.0,0,0,0.0,1,1,100.0,0,0,0.0,1,0,1,2,0,0,0,0,1,2
../kbl_data/2021-2022,S39G01N165,대구 한국가스공사,Away,디제이 화이트,9,3,5,60.0,1,1,100.0,4,6,66.7,0,0,0.0,0,4,4,1,0,3,0,0,0,0
../kbl_data/2021-2022,S39G01N166,서울 SK,Home,양우섭,5,1,1,100.0,1,1,100.0,2,2,100.0,0,0,0.0,0,0,0,1,0,0,0,0,0,0
../kbl_data/2021-2022,S39G01N166,서울 SK,Home,허일영,10,2,2,100.0,2,4,50.0,4,6,66.7,0,0,0.0,1,4,5,0,0,0,0,0,0,1
../kbl_data/2021-2022,S39G01N166,서울 SK,Home,김선형,12,6,9,66.7,0,2,0.0,6,11,54.5,0,0,0.0,1,2,3,9,1,0,0,1,0,1
../kbl_data/2021-2022,S39G01N166,서울 SK,Home,김승원,0,0,1,0.0,0,0,0.0,0,1,0.0,0,0,0.0,0,0,0,0,0,1,0,0,0,1
../kbl_data/2021-2022,S39G01N166,서울 SK,Home,리온 윌리엄스,6,3,3,100.0,0,1,0.0,3,4,75.0,0,0,0.0,1,1,2,0,1,0,0,0,1,4
../kbl_data/2021-2022,S39G01N166,서울 SK,Home,배병준,7,3,7,42.9,0,0,0.0,3,7,42.9,1,1,100.0,1,0,1,0,0,0,1,0,1,0
../kbl_data/2021-2022,S39G01N166,서울 SK,Home,이현석,2,1,2,50.0,0,1,0.0,1,3,33.3,0,0,0.0,0,0,0,0,0,0,0,0,0,0
../kbl_data/2021-2022,S39G01N166,서울 SK,Home,최원혁,9,1,1,100.0,2,3,66.7,3,4,75.0,1,2,50.0,1,4,5,2,0,0,0,0,0,1
../kbl_data/2021-2022,S39G01N166,서울 SK,Home,최준용,16,3,6,50.0,3,4,75.0,6,10,60.0,1,1,100.0,1,4,5,5,2,1,1,0,3,1
../kbl_data/2021-2022,S39G01N166,서울 SK,Home,안영준,13,6,8,75.0,0,1,0.0,6,9,66.7,1,1,100.0,2,4,6,2,2,0,0,0,2,1
../kbl_data/2021-2022,S39G01N166,서울 SK,Home,자밀 워니,14,6,13,46.2,0,0,0.0,6,13,46.2,2,4,50.0,1,8,9,2,1,0,0,1,0,1
../kbl_data/2021-2022,S39G01N166,서울 SK,Home,오재현,7,2,5,40.0,1,3,33.3,3,8,37.5,0,0,0.0,0,1,1,1,0,0,1,0,2,4
../kbl_data/2021-2022,S39G01N166,원주 DB,Away,윤호영,5,1,1,100.0,1,1,100.0,2,2,100.0,0,0,0.0,0,1,1,0,0,0,1,0,2,3
../kbl_data/2021-2022,S39G01N166,원주 DB,Away,박찬희,4,2,5,40.0,0,1,0.0,2,6,33.3,0,0,0.0,0,3,3,1,0,0,0,0,1,2
../kbl_data/2021-2022,S39G01N166,원주 DB,Away,정준원,0,0,0,0.0,0,0,0.0,0,0,0.0,0,0,0.0,1,1,2,0,1,0,0,0,1,0
../kbl_data/2021-2022,S39G01N166,원주 DB,Away,김종규,25,3,5,60.0,6,8,75.0,9,13,69.2,1,1,100.0,4,5,9,2,0,1,0,1,3,4
../kbl_data/2021-2022,S39G01N166,원주 DB,Away,허웅,13,4,9,44.4,1,7,14.3,5,16,31.2,2,2,100.0,1,3,4,3,1,0,0,0,1,1
../kbl_data/2021-2022,S39G01N166,원주 DB,Away,김영훈,0,0,0,0.0,0,0,0.0,0,0,0.0,0,0,0.0,0,0,0,0,0,0,0,0,0,0
../kbl_data/2021-2022,S39G01N166,원주 DB,Away,배강률,0,0,0,0.0,0,0,0.0,0,0,0.0,0,0,0.0,0,1,1,0,0,0,0,0,0,0
../kbl_data/2021-2022,S39G01N166,원주 DB,Away,강상재,15,6,6,100.0,1,5,20.0,7,11,63.6,0,0,0.0,0,1,1,3,0,0,0,0,1,1
../kbl_data/2021-2022,S39G01N166,원주 DB,Away,나카무라 타이치,3,0,2,0.0,1,3,33.3,1,5,20.0,0,0,0.0,0,0,0,1,1,0,0,0,0,2
../kbl_data/2021-2022,S39G01N166,원주 DB,Away,이준희,4,2,4,50.0,0,2,0.0,2,6,33.3,0,0,0.0,1,3,4,2,0,0,0,0,1,3
../kbl_data/2021-2022,S39G01N166,원주 DB,Away,정호영,12,3,3,100.0,1,1,100.0,4,4,100.0,3,3,100.0,1,3,4,2,2,0,0,0,1,2
../kbl_data/2021-2022,S39G01N166,원주 DB,Away,조니 오브라이언트,11,3,8,37.5,1,7,14.3,4,15,26.7,2,2,100.0,2,4,6,2,0,0,0,0,1,2
../kbl_data/2021-2022,S39G01N167,창원 LG,Home,강병현,0,0,0,0.0,0,0,0.0,0,0,0.0,0,0,0.0,0,1,1,0,0,0,0,0,1,1
../kbl_data/2021-2022,S39G01N167,창원 LG,Home,변기훈,0,0,0,0.0,0,0,0.0,0,0,0.0,0,0,0.0,0,0,0,0,0,0,0,0,0,0
../kbl_data/2021-2022,S39G01N167,창원 LG,Home,이관희,19,7,17,41.2,1,4,25.0,8,21,38.1,2,2,100.0,2,3,5,3,0,0,0,0,0,2
../kbl_data/2021-2022,S39G01N167,창원 LG,Home,정희재,6,1,2,50.0,1,4,25.0,2,6,33.3,1,2,50.0,0,4,4,0,0,0,0,0,1,4
../kbl_data/2021-2022,S39G01N167,창원 LG,Home,서민수,3,0,2,0.0,1,2,50.0,1,4,25.0,0,0,0.0,1,1,2,2,1,0,1,0,0,2
../kbl_data/2021-2022,S39G01N167,창원 LG,Home,한상혁,2,0,0,0.0,0,0,0.0,0,0,0.0,2,2,100.0,2,0,2,0,0,0,0,0,2,0
../kbl_data/2021-2022,S39G01N167,창원 LG,Home,이재도,13,4,6,66.7,1,3,33.3,5,9,55.6,2,4,50.0,0,1,1,5,1,0,1,0,1,0
../kbl_data/2021-2022,S39G01N167,창원 LG,Home,정인덕,0,0,0,0.0,0,1,0.0,0,1,0.0,0,0,0.0,0,1,1,1,0,0,0,0,0,0
../kbl_data/2021-2022,S39G01N167,창원 LG,Home,박정현,2,1,2,50.0,0,0,0.0,1,2,50.0,0,0,0.0,0,1,1,0,0,0,0,0,0,1
../kbl_data/2021-2022,S39G01N167,창원 LG,Home,아셈 마레이,28,12,16,75.0,0,0,0.0,12,16,75.0,4,7,57.1,8,6,14,4,2,2,0,1,1,3
../kbl_data/2021-2022,S39G01N167,창원 LG,Home,이승우,7,2,4,50.0,1,2,50.0,3,6,50.0,0,2,0.0,2,8,10,1,1,0,0,0,1,3
../kbl_data/2021-2022,S39G01N167,창원 LG,Home,사마르도 사무엘스,5,2,4,50.0,0,1,0.0,2,5,40.0,1,2,50.0,0,0,0,0,0,0,0,0,1,2
../kbl_data/2021-2022,S39G01N167,수원 KT,Away,김동욱,6,0,2,0.0,2,6,33.3,2,8,25.0,0,0,0.0,0,2,2,2,1,0,0,0,3,2
../kbl_data/2021-2022,S39G01N167,수원 KT,Away,최창진,0,0,1,0.0,0,1,0.0,0,2,0.0,0,0,0.0,0,1,1,1,0,0,0,0,0,2
../kbl_data/2021-2022,S39G01N167,수원 KT,Away,정성우,15,5,6,83.3,1,4,25.0,6,10,60.0,2,2,100.0,2,1,3,2,0,0,0,0,0,3
../kbl_data/2021-2022,S39G01N167,수원 KT,Away,허훈,5,1,5,20.0,1,3,33.3,2,8,25.0,0,0,0.0,0,0,0,6,0,0,0,0,2,0
../kbl_data/2021-2022,S39G01N167,수원 KT,Away,양홍석,10,3,5,60.0,1,3,33.3,4,8,50.0,1,2,50.0,0,3,3,2,0,0,0,0,2,1
../kbl_data/2021-2022,S39G01N167,수원 KT,Away,박준영,2,1,2,50.0,0,0,0.0,1,2,50.0,0,0,0.0,1,1,2,0,0,0,0,0,0,1
../kbl_data/2021-2022,S39G01N167,수원 KT,Away,캐디 라렌,10,4,7,57.1,0,2,0.0,4,9,44.4,2,2,100.0,0,6,6,0,0,2,0,1,2,5
../kbl_data/2021-2022,S39G01N167,수원 KT,Away,문상옥,0,0,0,0.0,0,0,0.0,0,0,0.0,0,0,0.0,0,0,0,0,0,0,0,0,0,0
../kbl_data/2021-2022,S39G01N167,수원 KT,Away,박지원,11,3,4,75.0,1,1,100.0,4,5,80.0,2,2,100.0,0,1,1,1,1,0,0,0,1,3
../kbl_data/2021-2022,S39G01N167,수원 KT,Away,마이크 마이어스,5,1,3,33.3,0,0,0.0,1,3,33.3,3,4,75.0,1,5,6,1,0,0,1,0,1,3
../kbl_data/2021-2022,S39G01N167,수원 KT,Away,김준환,0,0,0,0.0,0,0,0.0,0,0,0.0,0,0,0.0,0,1,1,0,1,0,0,0,0,0
../kbl_data/2021-2022,S39G01N167,수원 KT,Away,하윤기,6,3,3,100.0,0,0,0.0,3,3,100.0,0,0,0.0,0,0,0,0,0,0,0,0,0,0
../kbl_data/2021-2022,S39G01N168,고양 오리온,Home,김강선,10,0,1,0.0,3,6,50.0,3,7,42.9,1,2,50.0,0,2,2,3,0,0,0,0,1,1
../kbl_data/2021-2022,S39G01N168,고양 오리온,Home,최현민,0,0,0,0.0,0,0,0.0,0,0,0.0,0,0,0.0,0,0,0,0,0,0,0,0,0,0
../kbl_data/2021-2022,S39G01N168,고양 오리온,Home,임종일,0,0,0,0.0,0,1,0.0,0,1,0.0,0,0,0.0,1,1,2,1,0,1,0,0,0,4
../kbl_data/2021-2022,S39G01N168,고양 오리온,Home,이대성,9,3,8,37.5,1,4,25.0,4,12,33.3,0,0,0.0,1,1,2,5,1,0,0,0,0,1
../kbl_data/2021-2022,S39G01N168,고양 오리온,Home,한호빈,13,1,1,100.0,3,7,42.9,4,8,50.0,2,4,50.0,0,0,0,5,1,0,1,0,1,2
../kbl_data/2021-2022,S39G01N168,고양 오리온,Home,이정제,2,1,1,100.0,0,0,0.0,1,1,100.0,0,0,0.0,0,0,0,0,0,0,0,0,0,0
../kbl_data/2021-2022,S39G01N168,고양 오리온,Home,이승현,13,6,11,54.5,0,2,0.0,6,13,46.2,1,1,100.0,2,4,6,3,0,0,0,0,1,3
../kbl_data/2021-2022,S39G01N168,고양 오리온,Home,제임스 메이스,9,3,6,50.0,0,0,0.0,3,6,50.0,3,4,75.0,1,1,2,1,1,1,0,0,1,4
../kbl_data/2021-2022,S39G01N168,고양 오리온,Home,머피 할로웨이,9,3,5,60.0,0,0,0.0,3,5,60.0,3,3,100.0,0,6,6,1,1,0,0,0,2,1
../kbl_data/2021-2022,S39G01N168,고양 오리온,Home,조한진,0,0,0,0.0,0,0,0.0,0,0,0.0,0,0,0.0,0,0,0,0,0,0,0,0,0,1
../kbl_data/2021-2022,S39G01N168,고양 오리온,Home,이정현,11,3,5,60.0,1,3,33.3,4,8,50.0,2,2,100.0,0,0,0,3,2,0,0,0,0,2
../kbl_data/2021-2022,S39G01N168,고양 오리온,Home,문시윤,0,0,0,0.0,0,0,0.0,0,0,0.0,0,0,0.0,0,0,0,0,0,0,0,0,0,0
../kbl_data/2021-2022,S39G01N168,서울 삼성,Away,김동량,0,0,0,0.0,0,0,0.0,0,0,0.0,0,0,0.0,0,0,0,0,0,0,0,0,1,1
../kbl_data/2021-2022,S39G01N168,서울 삼성,Away,김시래,14,4,10,40.0,1,2,50.0,5,12,41.7,3,4,75.0,2,7,9,6,0,0,0,0,2,4
../kbl_data/2021-2022,S39G01N168,서울 삼성,Away,김현수,14,3,3,100.0,2,3,66.7,5,6,83.3,2,3,66.7,1,4,5,2,1,0,0,0,4,4
../kbl_data/2021-2022,S39G01N168,서울 삼성,Away,배수용,0,0,0,0.0,0,0,0.0,0,0,0.0,0,0,0.0,0,0,0,0,0,0,0,0,0,0
../kbl_data/2021-2022,S39G01N168,서울 삼성,Away,이호현,0,0,0,0.0,0,0,0.0,0,0,0.0,0,0,0.0,0,0,0,0,0,0,0,0,0,0
../kbl_data/2021-2022,S39G01N168,서울 삼성,Away,정희원,1,0,0,0.0,0,1,0.0,0,1,0.0,1,2,50.0,0,1,1,1,0,1,1,0,1,2
../kbl_data/2021-2022,S39G01N168,서울 삼성,Away,강바일,7,2,2,100.0,1,2,50.0,3,4,75.0,0,0,0.0,0,1,1,0,1,0,0,0,0,3
../kbl_data/2021-2022,S39G01N168,서울 삼성,Away,전형준,0,0,0,0.0,0,4,0.0,0,4,0.0,0,0,0.0,1,0,1,0,0,0,0,0,1,2
../kbl_data/2021-2022,S39G01N168,서울 삼성,Away,다니엘 오셰푸,8,4,6,66.7,0,0,0.0,4,6,66.7,0,4,0.0,3,7,10,5,1,0,0,1,2,2
../kbl_data/2021-2022,S39G01N168,서울 삼성,Away,조우성,0,0,0,0.0,0,0,0.0,0,0,0.0,0,0,0.0,0,0,0,0,0,0,0,0,0,0
../kbl_data/2021-2022,S39G01N168,서울 삼성,Away,이원석,12,5,8,62.5,0,0,0.0,5,8,62.5,2,2,100.0,1,4,5,0,1,0,0,0,3,4
../kbl_data/2021-2022,S39G01N168,서울 삼성,Away,토마스 로빈슨,14,7,11,63.6,0,1,0.0,7,12,58.3,0,0,0.0,2,2,4,1,0,0,0,1,3,1
../kbl_data/2021-2022,S39G01N169,전주 KCC,Home,이정현,10,2,5,40.0,0,6,0.0,2,11,18.2,6,7,85.7,2,5,7,7,0,0,0,0,1,2
../kbl_data/2021-2022,S39G01N169,전주 KCC,Home,정창영,2,1,3,33.3,0,1,0.0,1,4,25.0,0,0,0.0,0,1,1,6,1,0,0,0,4,3
../kbl_data/2021-2022,S39G01N169,전주 KCC,Home,라건아,32,12,13,92.3,2,2,100.0,14,15,93.3,2,2,100.0,3,8,11,4,0,1,0,0,2,1
../kbl_data/2021-2022,S39G01N169,전주 KCC,Home,김지완,1,0,0,0.0,0,2,0.0,0,2,0.0,1,2,50.0,0,0,0,0,0,0,0,0,1,2
../kbl_data/2021-2022,S39G01N169,전주 KCC,Home,김상규,12,2,2,100.0,2,2,100.0,4,4,100.0,2,2,100.0,0,6,6,1,0,0,0,0,0,0
../kbl_data/2021-2022,S39G01N169,전주 KCC,Home,전준범,2,0,1,0.0,0,2,0.0,0,3,0.0,2,3,66.7,0,0,0,0,0,0,0,0,0,0
../kbl_data/2021-2022,S39G01N169,전주 KCC,Home,박재현,4,1,1,100.0,0,2,0.0,1,3,33.3,2,2,100.0,0,1,1,2,0,0,0,0,0,4
../kbl_data/2021-2022,S39G01N169,전주 KCC,Home,송교창,13,3,6,50.0,2,3,66.7,5,9,55.6,1,2,50.0,1,2,3,0,3,0,1,0,2,2
../kbl_data/2021-2022,S39G01N169,전주 KCC,Home,이진욱,0,0,0,0.0,0,0,0.0,0,0,0.0,0,0,0.0,0,0,0,0,0,0,0,0,0,0
../kbl_data/2021-2022,S39G01N169,전주 KCC,Home,유현준,2,1,5,20.0,0,1,0.0,1,6,16.7,0,0,0.0,0,0,0,1,0,0,0,0,0,0
../kbl_data/2021-2022,S39G01N169,전주 KCC,Home,라타비우스 윌리엄스,2,1,1,100.0,0,0,0.0,1,1,100.0,0,0,0.0,1,0,1,0,0,0,0,0,0,0
../kbl_data/2021-2022,S39G01N169,전주 KCC,Home,이근휘,0,0,0,0.0,0,0,0.0,0,0,0.0,0,0,0.0,0,0,0,0,0,0,0,0,0,0
../kbl_data/2021-2022,S39G01N169,안양 KGC,Away,양희종,3,0,0,0.0,1,2,50.0,1,2,50.0,0,0,0.0,0,0,0,2,0,0,0,0,0,0
../kbl_data/2021-2022,S39G01N169,안양 KGC,Away,박형철,0,0,0,0.0,0,0,0.0,0,0,0.0,0,0,0.0,0,0,0,0,0,0,0,0,0,0
../kbl_data/2021-2022,S39G01N169,안양 KGC,Away,함준후,0,0,0,0.0,0,0,0.0,0,0,0.0,0,0,0.0,1,1,2,0,2,0,0,0,0,0
../kbl_data/2021-2022,S39G01N169,안양 KGC,Away,오세근,9,4,9,44.4,0,0,0.0,4,9,44.4,1,2,50.0,3,3,6,0,0,0,0,0,1,5
../kbl_data/2021-2022,S39G01N169,안양 KGC,Away,문성곤,3,0,0,0.0,1,8,12.5,1,8,12.5,0,0,0.0,0,3,3,5,1,0,0,0,0,3
../kbl_data/2021-2022,S39G01N169,안양 KGC,Away,전성현,21,1,4,25.0,6,8,75.0,7,12,58.3,1,1,100.0,0,2,2,2,0,0,0,0,4,1
../kbl_data/2021-2022,S39G01N169,안양 KGC,Away,박지훈,14,4,5,80.0,2,4,50.0,6,9,66.7,0,0,0.0,1,1,2,5,0,0,0,0,1,3
../kbl_data/2021-2022,S39G01N169,안양 KGC,Away,정강호,0,0,0,0.0,0,0,0.0,0,0,0.0,0,0,0.0,0,0,0,0,0,0,0,0,0,0
../kbl_data/2021-2022,S39G01N169,안양 KGC,Away,이우정,0,0,0,0.0,0,0,0.0,0,0,0.0,0,0,0.0,0,0,0,0,0,0,0,0,0,0
../kbl_data/2021-2022,S39G01N169,안양 KGC,Away,대릴 먼로,27,6,11,54.5,5,7,71.4,11,18,61.1,0,0,0.0,1,8,9,7,4,0,0,2,3,3
../kbl_data/2021-2022,S39G01N169,안양 KGC,Away,우동현,0,0,0,0.0,0,2,0.0,0,2,0.0,0,0,0.0,0,1,1,0,0,0,1,0,0,0
../kbl_data/2021-2022,S39G01N169,안양 KGC,Away,한승희,4,2,3,66.7,0,0,0.0,2,3,66.7,0,0,0.0,0,1,1,0,1,0,0,0,0,4
../kbl_data/2021-2022,S39G01N170,원주 DB,Home,윤호영,0,0,0,0.0,0,0,0.0,0,0,0.0,0,0,0.0,0,0,0,0,0,0,0,0,0,0
../kbl_data/2021-2022,S39G01N170,원주 DB,Home,박찬희,0,0,1,0.0,0,0,0.0,0,1,0.0,0,0,0.0,0,1,1,4,0,0,0,0,1,2
../kbl_data/2021-2022,S39G01N170,원주 DB,Home,정준원,11,4,7,57.1,1,1,100.0,5,8,62.5,0,0,0.0,0,2,2,0,0,0,0,0,1,0
../kbl_data/2021-2022,S39G01N170,원주 DB,Home,박경상,11,1,1,100.0,2,4,50.0,3,5,60.0,3,4,75.0,0,3,3,0,0,0,1,0,2,2
../kbl_data/2021-2022,S39G01N170,원주 DB,Home,김종규,13,5,9,55.6,0,0,0.0,5,9,55.6,3,3,100.0,0,8,8,1,0,1,0,0,1,3
../kbl_data/2021-2022,S39G01N170,원주 DB,Home,허웅,24,8,11,72.7,1,3,33.3,9,14,64.3,5,5,100.0,0,2,2,5,3,0,0,0,3,2
../kbl_data/2021-2022,S39G01N170,원주 DB,Home,김영훈,1,0,0,0.0,0,0,0.0,0,0,0.0,1,3,33.3,0,0,0,0,0,0,0,0,0,0
../kbl_data/2021-2022,S39G01N170,원주 DB,Home,배강률,0,0,0,0.0,0,0,0.0,0,0,0.0,0,0,0.0,0,0,0,0,0,0,0,0,0,0
../kbl_data/2021-2022,S39G01N170,원주 DB,Home,강상재,4,1,2,50.0,0,2,0.0,1,4,25.0,2,2,100.0,1,2,3,5,2,0,0,0,1,1
../kbl_data/2021-2022,S39G01N170,원주 DB,Home,나카무라 타이치,0,0,0,0.0,0,0,0.0,0,0,0.0,0,0,0.0,0,0,0,0,0,0,0,0,0,0
../kbl_data/2021-2022,S39G01N170,원주 DB,Home,이준희,4,2,4,50.0,0,1,0.0,2,5,40.0,0,0,0.0,1,0,1,2,1,0,0,0,0,4
../kbl_data/2021-2022,S39G01N170,원주 DB,Home,조니 오브라이언트,20,8,10,80.0,1,3,33.3,9,13,69.2,1,2,50.0,0,12,12,1,1,0,0,0,3,3
../kbl_data/2021-2022,S39G01N170,창원 LG,Away,강병현,3,0,0,0.0,1,3,33.3,1,3,33.3,0,0,0.0,0,0,0,3,1,0,0,0,0,2
../kbl_data/2021-2022,S39G01N170,창원 LG,Away,변기훈,0,0,0,0.0,0,0,0.0,0,0,0.0,0,0,0.0,0,0,0,0,0,0,0,0,0,0
../kbl_data/2021-2022,S39G01N170,창원 LG,Away,이관희,8,2,5,40.0,1,4,25.0,3,9,33.3,1,1,100.0,0,2,2,3,1,1,1,0,5,1
../kbl_data/2021-2022,S39G01N170,창원 LG,Away,정희재,6,0,2,0.0,2,7,28.6,2,9,22.2,0,0,0.0,1,1,2,0,0,0,0,0,1,4
../kbl_data/2021-2022,S39G01N170,창원 LG,Away,서민수,16,1,1,100.0,4,8,50.0,5,9,55.6,2,2,100.0,1,4,5,1,0,0,0,0,0,4
../kbl_data/2021-2022,S39G01N170,창원 LG,Away,한상혁,3,0,0,0.0,1,1,100.0,1,1,100.0,0,0,0.0,0,1,1,0,0,0,0,0,0,0
../kbl_data/2021-2022,S39G01N170,창원 LG,Away,이재도,9,1,5,20.0,1,4,25.0,2,9,22.2,4,4,100.0,0,2,2,5,3,0,0,0,0,3
../kbl_data/2021-2022,S39G01N170,창원 LG,Away,정인덕,2,1,1,100.0,0,0,0.0,1,1,100.0,0,0,0.0,0,2,2,1,0,0,0,0,0,1
../kbl_data/2021-2022,S39G01N170,창원 LG,Away,박정현,0,0,0,0.0,0,0,0.0,0,0,0.0,0,0,0.0,0,0,0,0,0,0,0,0,0,0
../kbl_data/2021-2022,S39G01N170,창원 LG,Away,아셈 마레이,15,7,15,46.7,0,0,0.0,7,15,46.7,1,3,33.3,4,6,10,6,1,0,0,1,4,3
../kbl_data/2021-2022,S39G01N170,창원 LG,Away,이승우,17,7,9,77.8,1,1,100.0,8,10,80.0,0,0,0.0,2,2,4,2,1,0,0,0,2,3
../kbl_data/2021-2022,S39G01N170,창원 LG,Away,사마르도 사무엘스,2,1,3,33.3,0,0,0.0,1,3,33.3,0,2,0.0,0,2,2,1,0,0,0,0,0,1
../kbl_data/2021-2022,S39G01N171,울산 현대모비스,Home,이현민,11,0,3,0.0,2,2,100.0,2,5,40.0,5,7,71.4,2,1,3,7,2,0,1,0,4,1
../kbl_data/2021-2022,S39G01N171,울산 현대모비스,Home,함지훈,10,4,5,80.0,0,1,0.0,4,6,66.7,2,4,50.0,3,0,3,4,1,1,0,0,2,1
../kbl_data/2021-2022,S39G01N171,울산 현대모비스,Home,최진수,7,3,4,75.0,0,1,0.0,3,5,60.0,1,2,50.0,0,0,0,1,1,0,0,0,1,3
../kbl_data/2021-2022,S39G01N171,울산 현대모비스,Home,박지훈,0,0,0,0.0,0,0,0.0,0,0,0.0,0,0,0.0,0,0,0,0,0,0,0,0,0,0
../kbl_data/2021-2022,S39G01N171,울산 현대모비스,Home,장재석,2,1,3,33.3,0,0,0.0,1,3,33.3,0,0,0.0,0,5,5,0,0,0,0,0,3,3
../kbl_data/2021-2022,S39G01N171,울산 현대모비스,Home,김국찬,0,0,3,0.0,0,2,0.0,0,5,0.0,0,0,0.0,0,0,0,1,0,0,0,0,1,2
../kbl_data/2021-2022,S39G01N171,울산 현대모비스,Home,서명진,4,2,4,50.0,0,4,0.0,2,8,25.0,0,0,0.0,1,1,2,2,0,0,0,0,0,1
../kbl_data/2021-2022,S39G01N171,울산 현대모비스,Home,이우석,13,6,13,46.2,0,2,0.0,6,15,40.0,1,1,100.0,0,1,1,2,2,0,0,0,4,1
../kbl_data/2021-2022,S39G01N171,울산 현대모비스,Home,라숀 토마스,19,8,14,57.1,0,0,0.0,8,14,57.1,3,4,75.0,6,9,15,0,1,1,1,0,1,3
../kbl_data/2021-2022,S39G01N171,울산 현대모비스,Home,신민석,0,0,0,0.0,0,0,0.0,0,0,0.0,0,0,0.0,0,0,0,0,0,0,0,0,0,0
../kbl_data/2021-2022,S39G01N171,울산 현대모비스,Home,김동준,0,0,0,0.0,0,2,0.0,0,2,0.0,0,0,0.0,0,0,0,0,0,0,0,0,0,0
../kbl_data/2021-2022,S39G01N171,울산 현대모비스,Home,에릭 버크너,13,6,7,85.7,0,0,0.0,6,7,85.7,1,1,100.0,2,3,5,0,0,1,1,1,0,2
../kbl_data/2021-2022,S39G01N171,수원 KT,Away,김동욱,3,0,1,0.0,1,4,25.0,1,5,20.0,0,0,0.0,0,2,2,0,0,0,0,0,3,1
../kbl_data/2021-2022,S39G01N171,수원 KT,Away,최창진,0,0,1,0.0,0,1,0.0,0,2,0.0,0,0,0.0,1,2,3,3,0,0,1,0,0,2
../kbl_data/2021-2022,S39G01N171,수원 KT,Away,정성우,4,2,5,40.0,0,2,0.0,2,7,28.6,0,0,0.0,1,0,1,0,0,0,0,0,1,4
../kbl_data/2021-2022,S39G01N171,수원 KT,Away,허훈,6,0,0,0.0,2,3,66.7,2,3,66.7,0,0,0.0,0,0,0,1,1,0,0,0,1,1
../kbl_data/2021-2022,S39G01N171,수원 KT,Away,양홍석,30,6,7,85.7,5,10,50.0,11,17,64.7,3,3,100.0,1,4,5,1,1,1,0,0,4,2
../kbl_data/2021-2022,S39G01N171,수원 KT,Away,박준영,0,0,1,0.0,0,0,0.0,0,1,0.0,0,0,0.0,0,1,1,1,0,0,0,0,0,2
../kbl_data/2021-2022,S39G01N171,수원 KT,Away,캐디 라렌,9,1,8,12.5,0,0,0.0,1,8,12.5,7,8,87.5,4,5,9,1,3,3,0,0,3,5
../kbl_data/2021-2022,S39G01N171,수원 KT,Away,문상옥,0,0,0,0.0,0,0,0.0,0,0,0.0,0,0,0.0,0,0,0,0,0,0,0,0,0,0
../kbl_data/2021-2022,S39G01N171,수원 KT,Away,박지원,16,7,9,77.8,0,1,0.0,7,10,70.0,2,2,100.0,1,4,5,5,3,0,0,1,1,2
../kbl_data/2021-2022,S39G01N171,수원 KT,Away,마이크 마이어스,0,0,0,0.0,0,0,0.0,0,0,0.0,0,0,0.0,1,2,3,2,0,0,0,0,2,2
../kbl_data/2021-2022,S39G01N171,수원 KT,Away,김준환,0,0,0,0.0,0,0,0.0,0,0,0.0,0,0,0.0,0,0,0,0,0,0,0,0,0,0
../kbl_data/2021-2022,S39G01N171,수원 KT,Away,하윤기,8,4,9,44.4,0,0,0.0,4,9,44.4,0,0,0.0,0,1,1,1,1,1,1,0,3,0
../kbl_data/2021-2022,S39G01N172,서울 SK,Home,양우섭,0,0,0,0.0,0,1,0.0,0,1,0.0,0,0,0.0,0,1,1,2,0,0,0,0,0,2
../kbl_data/2021-2022,S39G01N172,서울 SK,Home,허일영,8,1,1,100.0,2,3,66.7,3,4,75.0,0,0,0.0,2,3,5,0,0,0,0,0,0,2
../kbl_data/2021-2022,S39G01N172,서울 SK,Home,김선형,17,6,8,75.0,1,5,20.0,7,13,53.8,2,3,66.7,1,1,2,4,2,0,0,0,2,0
../kbl_data/2021-2022,S39G01N172,서울 SK,Home,최부경,2,1,3,33.3,0,0,0.0,1,3,33.3,0,0,0.0,1,1,2,1,0,0,0,0,0,2
../kbl_data/2021-2022,S39G01N172,서울 SK,Home,리온 윌리엄스,3,1,3,33.3,0,1,0.0,1,4,25.0,1,1,100.0,1,1,2,0,0,0,0,0,1,1
../kbl_data/2021-2022,S39G01N172,서울 SK,Home,배병준,0,0,0,0.0,0,0,0.0,0,0,0.0,0,0,0.0,0,0,0,0,0,0,0,0,0,0
../kbl_data/2021-2022,S39G01N172,서울 SK,Home,이현석,0,0,0,0.0,0,0,0.0,0,0,0.0,0,0,0.0,0,0,0,0,0,0,0,0,0,0
../kbl_data/2021-2022,S39G01N172,서울 SK,Home,최원혁,0,0,1,0.0,0,1,0.0,0,2,0.0,0,0,0.0,1,0,1,0,0,0,0,0,0,5
../kbl_data/2021-2022,S39G01N172,서울 SK,Home,최준용,15,5,5,100.0,1,4,25.0,6,9,66.7,2,2,100.0,4,9,13,7,0,0,0,0,2,3
../kbl_data/2021-2022,S39G01N172,서울 SK,Home,안영준,15,2,7,28.6,3,7,42.9,5,14,35.7,2,3,66.7,3,6,9,3,2,0,0,1,2,3
../kbl_data/2021-2022,S39G01N172,서울 SK,Home,자밀 워니,37,16,26,61.5,0,4,0.0,16,30,53.3,5,5,100.0,4,7,11,2,0,0,0,0,1,0
../kbl_data/2021-2022,S39G01N172,서울 SK,Home,오재현,0,0,0,0.0,0,3,0.0,0,3,0.0,0,2,0.0,1,0,1,1,1,0,0,0,0,0
../kbl_data/2021-2022,S39G01N172,대구 한국가스공사,Away,정영삼,0,0,0,0.0,0,0,0.0,0,0,0.0,0,0,0.0,0,1,1,1,0,0,0,0,0,0
../kbl_data/2021-2022,S39G01N172,대구 한국가스공사,Away,민성주,0,0,0,0.0,0,0,0.0,0,0,0.0,0,0,0.0,0,0,0,0,0,1,0,0,0,1
../kbl_data/2021-2022,S39G01N172,대구 한국가스공사,Away,홍경기,15,3,4,75.0,3,5,60.0,6,9,66.7,0,0,0.0,0,0,0,2,0,0,0,0,0,5
../kbl_data/2021-2022,S39G01N172,대구 한국가스공사,Away,차바위,0,0,1,0.0,0,2,0.0,0,3,0.0,0,0,0.0,0,3,3,2,0,0,1,0,0,2
../kbl_data/2021-2022,S39G01N172,대구 한국가스공사,Away,이대헌,7,3,3,100.0,0,1,0.0,3,4,75.0,1,3,33.3,1,0,1,1,0,1,0,0,1,1
../kbl_data/2021-2022,S39G01N172,대구 한국가스공사,Away,두경민,17,2,5,40.0,4,7,57.1,6,12,50.0,1,2,50.0,0,4,4,7,1,0,0,0,3,1
../kbl_data/2021-2022,S39G01N172,대구 한국가스공사,Away,김낙현,0,0,2,0.0,0,2,0.0,0,4,0.0,0,0,0.0,0,1,1,2,0,0,0,0,0,0
../kbl_data/2021-2022,S39G01N172,대구 한국가스공사,Away,전현우,11,1,1,100.0,3,5,60.0,4,6,66.7,0,0,0.0,1,0,1,2,0,0,0,0,0,3
../kbl_data/2021-2022,S39G01N172,대구 한국가스공사,Away,이윤기,3,0,0,0.0,1,1,100.0,1,1,100.0,0,0,0.0,0,0,0,1,0,0,0,0,0,1
../kbl_data/2021-2022,S39G01N172,대구 한국가스공사,Away,앤드류 니콜슨,27,8,17,47.1,3,6,50.0,11,23,47.8,2,2,100.0,2,7,9,0,1,1,0,1,1,3
../kbl_data/2021-2022,S39G01N172,대구 한국가스공사,Away,신승민,0,0,1,0.0,0,2,0.0,0,3,0.0,0,0,0.0,0,2,2,0,2,0,1,0,1,2
../kbl_data/2021-2022,S39G01N172,대구 한국가스공사,Away,디제이 화이트,7,2,4,50.0,1,2,50.0,3,6,50.0,0,0,0.0,1,3,4,0,0,0,0,0,2,0
../kbl_data/2021-2022,S39G01N173,창원 LG,Home,강병현,0,0,0,0.0,0,2,0.0,0,2,0.0,0,0,0.0,2,0,2,0,0,0,0,0,1,3
../kbl_data/2021-2022,S39G01N173,창원 LG,Home,이관희,11,2,7,28.6,1,2,50.0,3,9,33.3,4,4,100.0,0,0,0,2,0,0,0,0,0,2
../kbl_data/2021-2022,S39G01N173,창원 LG,Home,정희재,15,2,3,66.7,1,4,25.0,3,7,42.9,8,10,80.0,2,3,5,3,1,0,0,0,1,2
../kbl_data/2021-2022,S39G01N173,창원 LG,Home,서민수,9,3,5,60.0,1,3,33.3,4,8,50.0,0,0,0.0,0,1,1,1,0,1,0,0,0,2
../kbl_data/2021-2022,S39G01N173,창원 LG,Home,한상혁,4,1,1,100.0,0,0,0.0,1,1,100.0,2,2,100.0,0,0,0,2,1,0,0,0,0,0
../kbl_data/2021-2022,S39G01N173,창원 LG,Home,이재도,14,4,6,66.7,2,5,40.0,6,11,54.5,0,0,0.0,0,4,4,2,0,0,0,0,0,1
../kbl_data/2021-2022,S39G01N173,창원 LG,Home,박인태,2,1,1,100.0,0,0,0.0,1,1,100.0,0,0,0.0,0,1,1,1,0,0,0,0,1,0
../kbl_data/2021-2022,S39G01N173,창원 LG,Home,박정현,3,0,1,0.0,1,3,33.3,1,4,25.0,0,0,0.0,1,3,4,1,0,0,1,0,0,1
../kbl_data/2021-2022,S39G01N173,창원 LG,Home,윤원상,6,0,0,0.0,2,3,66.7,2,3,66.7,0,0,0.0,1,0,1,0,0,0,0,0,0,1
../kbl_data/2021-2022,S39G01N173,창원 LG,Home,아셈 마레이,17,6,10,60.0,0,0,0.0,6,10,60.0,5,7,71.4,9,8,17,2,1,1,0,0,1,1
../kbl_data/2021-2022,S39G01N173,창원 LG,Home,이승우,2,1,4,25.0,0,2,0.0,1,6,16.7,0,0,0.0,0,3,3,4,1,1,2,0,4,3
../kbl_data/2021-2022,S39G01N173,창원 LG,Home,사마르도 사무엘스,8,4,5,80.0,0,0,0.0,4,5,80.0,0,0,0.0,0,2,2,0,0,0,0,1,2,1
../kbl_data/2021-2022,S39G01N173,서울 삼성,Away,김동량,2,0,1,0.0,0,1,0.0,0,2,0.0,2,4,50.0,3,3,6,1,1,0,0,0,1,5
../kbl_data/2021-2022,S39G01N173,서울 삼성,Away,김시래,20,4,8,50.0,4,7,57.1,8,15,53.3,0,0,0.0,2,3,5,0,2,0,0,0,2,2
../kbl_data/2021-2022,S39G01N173,서울 삼성,Away,이동엽,2,1,7,14.3,0,4,0.0,1,11,9.1,0,0,0.0,0,5,5,1,0,0,0,0,1,1
../kbl_data/2021-2022,S39G01N173,서울 삼성,Away,배수용,0,0,0,0.0,0,1,0.0,0,1,0.0,0,0,0.0,0,0,0,0,0,0,0,0,0,1
../kbl_data/2021-2022,S39G01N173,서울 삼성,Away,이호현,15,7,8,87.5,0,3,0.0,7,11,63.6,1,2,50.0,0,1,1,6,0,0,0,0,0,2
../kbl_data/2021-2022,S39G01N173,서울 삼성,Away,정희원,0,0,0,0.0,0,2,0.0,0,2,0.0,0,0,0.0,0,0,0,0,0,0,0,0,0,0
../kbl_data/2021-2022,S39G01N173,서울 삼성,Away,강바일,2,1,1,100.0,0,1,0.0,1,2,50.0,0,0,0.0,0,0,0,0,0,0,0,0,0,1
../kbl_data/2021-2022,S39G01N173,서울 삼성,Away,박민우,3,0,1,0.0,1,4,25.0,1,5,20.0,0,0,0.0,1,4,5,1,1,0,0,0,0,1
../kbl_data/2021-2022,S39G01N173,서울 삼성,Away,차민석,6,3,3,100.0,0,1,0.0,3,4,75.0,0,0,0.0,1,1,2,0,0,0,0,0,0,2
../kbl_data/2021-2022,S39G01N173,서울 삼성,Away,전형준,3,0,3,0.0,1,4,25.0,1,7,14.3,0,0,0.0,0,0,0,0,0,0,0,0,1,4
../kbl_data/2021-2022,S39G01N173,서울 삼성,Away,조우성,2,1,3,33.3,0,0,0.0,1,3,33.3,0,0,0.0,1,0,1,0,0,0,0,0,0,4
../kbl_data/2021-2022,S39G01N173,서울 삼성,Away,이원석,17,6,8,75.0,1,2,50.0,7,10,70.0,2,4,50.0,4,3,7,2,0,0,0,0,5,3
../kbl_data/2021-2022,S39G01N174,울산 현대모비스,Home,이현민,3,0,0,0.0,1,1,100.0,1,1,100.0,0,0,0.0,0,4,4,6,3,0,0,0,3,3
../kbl_data/2021-2022,S39G01N174,울산 현대모비스,Home,함지훈,5,1,3,33.3,1,1,100.0,2,4,50.0,0,0,0.0,1,1,2,8,0,0,0,0,0,2
../kbl_data/2021-2022,S39G01N174,울산 현대모비스,Home,최진수,9,4,6,66.7,0,4,0.0,4,10,40.0,1,2,50.0,0,3,3,2,4,0,0,1,0,1
../kbl_data/2021-2022,S39G01N174,울산 현대모비스,Home,박지훈,0,0,0,0.0,0,0,0.0,0,0,0.0,0,0,0.0,0,0,0,0,0,0,0,0,0,0
../kbl_data/2021-2022,S39G01N174,울산 현대모비스,Home,장재석,2,0,3,0.0,0,0,0.0,0,3,0.0,2,2,100.0,0,3,3,0,0,1,0,0,0,0
../kbl_data/2021-2022,S39G01N174,울산 현대모비스,Home,김국찬,0,0,0,0.0,0,0,0.0,0,0,0.0,0,0,0.0,0,0,0,0,0,0,0,0,0,1
../kbl_data/2021-2022,S39G01N174,울산 현대모비스,Home,서명진,11,3,4,75.0,1,3,33.3,4,7,57.1,2,4,50.0,1,4,5,2,0,0,0,0,1,2
../kbl_data/2021-2022,S39G01N174,울산 현대모비스,Home,이우석,15,5,12,41.7,1,1,100.0,6,13,46.2,2,2,100.0,0,1,1,3,3,0,0,0,1,2
../kbl_data/2021-2022,S39G01N174,울산 현대모비스,Home,라숀 토마스,29,13,18,72.2,0,1,0.0,13,19,68.4,3,4,75.0,2,6,8,3,4,2,0,2,3,2
../kbl_data/2021-2022,S39G01N174,울산 현대모비스,Home,신민석,0,0,0,0.0,0,0,0.0,0,0,0.0,0,0,0.0,0,0,0,0,0,0,0,0,1,1
../kbl_data/2021-2022,S39G01N174,울산 현대모비스,Home,김동준,0,0,1,0.0,0,0,0.0,0,1,0.0,0,0,0.0,0,0,0,0,0,0,0,0,0,0
../kbl_data/2021-2022,S39G01N174,울산 현대모비스,Home,에릭 버크너,8,3,3,100.0,0,0,0.0,3,3,100.0,2,3,66.7,0,2,2,0,0,0,0,0,2,0
../kbl_data/2021-2022,S39G01N174,원주 DB,Away,정준원,0,0,1,0.0,0,1,0.0,0,2,0.0,0,0,0.0,0,0,0,0,0,0,0,0,0,1
../kbl_data/2021-2022,S39G01N174,원주 DB,Away,박경상,0,0,0,0.0,0,2,0.0,0,2,0.0,0,0,0.0,0,0,0,1,0,0,0,0,0,1
../kbl_data/2021-2022,S39G01N174,원주 DB,Away,김종규,19,5,8,62.5,2,2,100.0,7,10,70.0,3,3,100.0,1,2,3,2,0,2,0,0,1,2
../kbl_data/2021-2022,S39G01N174,원주 DB,Away,허웅,8,2,4,50.0,1,5,20.0,3,9,33.3,1,4,25.0,0,2,2,5,0,0,0,0,4,4
../kbl_data/2021-2022,S39G01N174,원주 DB,Away,김영훈,0,0,0,0.0,0,0,0.0,0,0,0.0,0,0,0.0,0,0,0,0,0,0,0,0,0,0
../kbl_data/2021-2022,S39G01N174,원주 DB,Away,강상재,6,3,6,50.0,0,2,0.0,3,8,37.5,0,0,0.0,0,3,3,0,1,0,0,0,0,0
../kbl_data/2021-2022,S39G01N174,원주 DB,Away,김철욱,2,1,1,100.0,0,0,0.0,1,1,100.0,0,0,0.0,1,0,1,1,0,0,0,0,0,0
../kbl_data/2021-2022,S39G01N174,원주 DB,Away,김훈,5,1,3,33.3,1,5,20.0,2,8,25.0,0,0,0.0,1,0,1,0,0,0,0,0,0,2
../kbl_data/2021-2022,S39G01N174,원주 DB,Away,나카무라 타이치,4,2,3,66.7,0,0,0.0,2,3,66.7,0,0,0.0,1,1,2,1,2,0,0,0,1,2
../kbl_data/2021-2022,S39G01N174,원주 DB,Away,이준희,9,3,5,60.0,1,2,50.0,4,7,57.1,0,0,0.0,1,1,2,3,1,1,0,0,2,0
../kbl_data/2021-2022,S39G01N174,원주 DB,Away,정호영,0,0,1,0.0,0,0,0.0,0,1,0.0,0,0,0.0,0,1,1,2,0,0,0,0,5,1
../kbl_data/2021-2022,S39G01N174,원주 DB,Away,조니 오브라이언트,16,5,9,55.6,2,5,40.0,7,14,50.0,0,0,0.0,3,10,13,3,3,0,0,0,4,3
../kbl_data/2021-2022,S39G01N175,안양 KGC,Home,양희종,0,0,0,0.0,0,0,0.0,0,0,0.0,0,0,0.0,0,0,0,0,0,0,0,0,0,0
../kbl_data/2021-2022,S39G01N175,안양 KGC,Home,함준후,2,1,1,100.0,0,0,0.0,1,1,100.0,0,0,0.0,3,0,3,0,0,0,0,0,0,1
../kbl_data/2021-2022,S39G01N175,안양 KGC,Home,오세근,6,2,3,66.7,0,0,0.0,2,3,66.7,2,2,100.0,1,4,5,2,0,1,0,0,3,4
../kbl_data/2021-2022,S39G01N175,안양 KGC,Home,문성곤,10,1,1,100.0,2,6,33.3,3,7,42.9,2,2,100.0,1,8,9,4,2,0,1,0,0,2
../kbl_data/2021-2022,S39G01N175,안양 KGC,Home,전성현,10,0,1,0.0,3,10,30.0,3,11,27.3,1,1,100.0,0,1,1,2,0,0,0,0,2,3
../kbl_data/2021-2022,S39G01N175,안양 KGC,Home,박지훈,9,2,3,66.7,1,4,25.0,3,7,42.9,2,2,100.0,0,1,1,2,0,0,0,0,1,1
../kbl_data/2021-2022,S39G01N175,안양 KGC,Home,정강호,0,0,0,0.0,0,0,0.0,0,0,0.0,0,0,0.0,0,0,0,0,0,0,0,0,0,0
../kbl_data/2021-2022,S39G01N175,안양 KGC,Home,이우정,0,0,0,0.0,0,0,0.0,0,0,0.0,0,0,0.0,0,0,0,0,0,0,0,0,0,0
../kbl_data/2021-2022,S39G01N175,안양 KGC,Home,대릴 먼로,18,9,13,69.2,0,4,0.0,9,17,52.9,0,0,0.0,2,10,12,4,1,1,2,0,1,3
../kbl_data/2021-2022,S39G01N175,안양 KGC,Home,우동현,0,0,0,0.0,0,0,0.0,0,0,0.0,0,0,0.0,0,0,0,0,0,0,0,0,0,0
../kbl_data/2021-2022,S39G01N175,안양 KGC,Home,변준형,15,3,5,60.0,3,6,50.0,6,11,54.5,0,0,0.0,1,0,1,5,2,2,0,0,4,2
../kbl_data/2021-2022,S39G01N175,안양 KGC,Home,한승희,8,4,5,80.0,0,0,0.0,4,5,80.0,0,0,0.0,2,0,2,1,0,0,0,0,0,4
../kbl_data/2021-2022,S39G01N175,고양 오리온,Away,김강선,3,0,0,0.0,1,2,50.0,1,2,50.0,0,0,0.0,0,0,0,1,0,0,0,0,0,0
../kbl_data/2021-2022,S39G01N175,고양 오리온,Away,최현민,0,0,0,0.0,0,2,0.0,0,2,0.0,0,0,0.0,0,0,0,0,0,0,0,0,0,0
../kbl_data/2021-2022,S39G01N175,고양 오리온,Away,임종일,0,0,0,0.0,0,0,0.0,0,0,0.0,0,0,0.0,0,0,0,0,0,0,0,0,0,0
../kbl_data/2021-2022,S39G01N175,고양 오리온,Away,이대성,25,5,8,62.5,2,5,40.0,7,13,53.8,9,12,75.0,0,2,2,2,3,0,0,0,3,3
../kbl_data/2021-2022,S39G01N175,고양 오리온,Away,한호빈,10,2,4,50.0,2,3,66.7,4,7,57.1,0,0,0.0,0,2,2,0,1,0,1,0,1,2
../kbl_data/2021-2022,S39G01N175,고양 오리온,Away,이정제,4,2,3,66.7,0,0,0.0,2,3,66.7,0,0,0.0,1,1,2,2,0,0,0,0,0,2
../kbl_data/2021-2022,S39G01N175,고양 오리온,Away,이승현,8,4,10,40.0,0,2,0.0,4,12,33.3,0,0,0.0,0,2,2,0,0,0,0,0,1,0
../kbl_data/2021-2022,S39G01N175,고양 오리온,Away,김진유,0,0,0,0.0,0,3,0.0,0,3,0.0,0,0,0.0,1,2,3,1,1,0,0,0,0,4
../kbl_data/2021-2022,S39G01N175,고양 오리온,Away,제임스 메이스,11,3,7,42.9,1,2,50.0,4,9,44.4,2,2,100.0,5,7,12,6,0,0,0,0,4,5
../kbl_data/2021-2022,S39G01N175,고양 오리온,Away,조한진,2,1,2,50.0,0,0,0.0,1,2,50.0,0,1,0.0,0,0,0,0,0,0,0,0,0,1
../kbl_data/2021-2022,S39G01N175,고양 오리온,Away,이정현,2,1,3,33.3,0,2,0.0,1,5,20.0,0,0,0.0,1,3,4,3,0,0,0,0,1,1
../kbl_data/2021-2022,S39G01N175,고양 오리온,Away,문시윤,0,0,0,0.0,0,0,0.0,0,0,0.0,0,0,0.0,0,0,0,0,0,0,0,0,0,0
../kbl_data/2021-2022,S39G01N176,울산 현대모비스,Home,이현민,3,0,1,0.0,1,1,100.0,1,2,50.0,0,0,0.0,0,1,1,4,1,0,0,0,3,2
../kbl_data/2021-2022,S39G01N176,울산 현대모비스,Home,함지훈,13,5,8,62.5,1,2,50.0,6,10,60.0,0,0,0.0,2,2,4,4,1,0,0,0,3,1
../kbl_data/2021-2022,S39G01N176,울산 현대모비스,Home,최진수,14,5,6,83.3,1,4,25.0,6,10,60.0,1,1,100.0,1,3,4,1,1,0,0,2,1,2
../kbl_data/2021-2022,S39G01N176,울산 현대모비스,Home,박지훈,2,1,1,100.0,0,2,0.0,1,3,33.3,0,0,0.0,0,2,2,0,0,0,0,0,0,0
../kbl_data/2021-2022,S39G01N176,울산 현대모비스,Home,장재석,11,5,8,62.5,0,0,0.0,5,8,62.5,1,3,33.3,2,1,3,2,2,1,0,0,0,4
../kbl_data/2021-2022,S39G01N176,울산 현대모비스,Home,김국찬,0,0,1,0.0,0,2,0.0,0,3,0.0,0,0,0.0,0,0,0,1,0,0,0,0,1,1
../kbl_data/2021-2022,S39G01N176,울산 현대모비스,Home,서명진,20,5,7,71.4,3,7,42.9,8,14,57.1,1,1,100.0,1,2,3,5,1,0,0,0,2,1
../kbl_data/2021-2022,S39G01N176,울산 현대모비스,Home,이우석,3,0,3,0.0,1,1,100.0,1,4,25.0,0,0,0.0,1,1,2,6,2,0,0,0,2,0
../kbl_data/2021-2022,S39G01N176,울산 현대모비스,Home,라숀 토마스,14,7,14,50.0,0,2,0.0,7,16,43.8,0,0,0.0,3,5,8,2,1,1,0,1,0,4
../kbl_data/2021-2022,S39G01N176,울산 현대모비스,Home,신민석,0,0,0,0.0,0,0,0.0,0,0,0.0,0,0,0.0,0,0,0,0,0,0,0,0,0,0
../kbl_data/2021-2022,S39G01N176,울산 현대모비스,Home,김동준,0,0,0,0.0,0,0,0.0,0,0,0.0,0,0,0.0,0,0,0,0,0,0,0,0,0,0
../kbl_data/2021-2022,S39G01N176,울산 현대모비스,Home,에릭 버크너,2,1,1,100.0,0,0,0.0,1,1,100.0,0,0,0.0,1,2,3,0,0,0,0,1,1,1
../kbl_data/2021-2022,S39G01N176,전주 KCC,Away,송창용,0,0,0,0.0,0,0,0.0,0,0,0.0,0,0,0.0,0,0,0,0,0,0,0,0,0,0
../kbl_data/2021-2022,S39G01N176,전주 KCC,Away,이정현,11,3,4,75.0,1,4,25.0,4,8,50.0,2,2,100.0,1,1,2,8,0,0,0,0,3,1
../kbl_data/2021-2022,S39G01N176,전주 KCC,Away,정창영,7,3,4,75.0,0,2,0.0,3,6,50.0,1,2,50.0,1,1,2,2,1,0,0,0,3,0
../kbl_data/2021-2022,S39G01N176,전주 KCC,Away,라건아,28,11,17,64.7,1,1,100.0,12,18,66.7,3,4,75.0,5,6,11,4,0,0,0,1,2,3
../kbl_data/2021-2022,S39G01N176,전주 KCC,Away,김지완,9,1,2,50.0,2,4,50.0,3,6,50.0,1,2,50.0,0,1,1,3,2,0,0,0,3,2
../kbl_data/2021-2022,S39G01N176,전주 KCC,Away,김상규,4,2,3,66.7,0,2,0.0,2,5,40.0,0,0,0.0,1,1,2,1,1,0,1,0,0,0
../kbl_data/2021-2022,S39G01N176,전주 KCC,Away,전준범,7,2,4,50.0,1,2,50.0,3,6,50.0,0,0,0.0,1,4,5,1,0,0,1,0,0,2
../kbl_data/2021-2022,S39G01N176,전주 KCC,Away,박재현,0,0,0,0.0,0,0,0.0,0,0,0.0,0,0,0.0,0,0,0,0,0,0,0,0,0,0
../kbl_data/2021-2022,S39G01N176,전주 KCC,Away,송교창,7,3,3,100.0,0,2,0.0,3,5,60.0,1,2,50.0,0,3,3,3,1,0,0,0,0,3
../kbl_data/2021-2022,S39G01N176,전주 KCC,Away,이진욱,2,1,2,50.0,0,1,0.0,1,3,33.3,0,0,0.0,2,0,2,2,0,0,0,0,1,1
../kbl_data/2021-2022,S39G01N176,전주 KCC,Away,유현준,11,2,6,33.3,2,3,66.7,4,9,44.4,1,1,100.0,1,3,4,1,1,0,0,0,1,1
../kbl_data/2021-2022,S39G01N176,전주 KCC,Away,라타비우스 윌리엄스,2,1,2,50.0,0,0,0.0,1,2,50.0,0,0,0.0,2,1,3,1,1,0,0,0,0,0
../kbl_data/2021-2022,S39G01N177,고양 오리온,Home,오용준,0,0,0,0.0,0,0,0.0,0,0,0.0,0,0,0.0,0,0,0,0,0,0,0,0,0,0
../kbl_data/2021-2022,S39G01N177,고양 오리온,Home,김강선,2,1,3,33.3,0,4,0.0,1,7,14.3,0,0,0.0,2,2,4,0,1,0,0,0,0,1
../kbl_data/2021-2022,S39G01N177,고양 오리온,Home,이대성,13,3,9,33.3,2,7,28.6,5,16,31.2,1,2,50.0,0,1,1,6,0,0,0,0,2,1
../kbl_data/2021-2022,S39G01N177,고양 오리온,Home,한호빈,10,0,2,0.0,2,2,100.0,2,4,50.0,4,4,100.0,0,1,1,1,0,0,0,0,0,1
../kbl_data/2021-2022,S39G01N177,고양 오리온,Home,이정제,0,0,0,0.0,0,0,0.0,0,0,0.0,0,0,0.0,1,0,1,0,0,0,0,0,0,1
../kbl_data/2021-2022,S39G01N177,고양 오리온,Home,최승욱,4,2,3,66.7,0,2,0.0,2,5,40.0,0,0,0.0,2,2,4,1,1,0,0,0,0,3
../kbl_data/2021-2022,S39G01N177,고양 오리온,Home,이승현,13,2,7,28.6,3,6,50.0,5,13,38.5,0,0,0.0,0,3,3,2,0,0,0,0,1,0
../kbl_data/2021-2022,S39G01N177,고양 오리온,Home,김진유,0,0,0,0.0,0,0,0.0,0,0,0.0,0,0,0.0,0,0,0,0,0,0,0,0,0,0
../kbl_data/2021-2022,S39G01N177,고양 오리온,Home,머피 할로웨이,20,8,13,61.5,0,0,0.0,8,13,61.5,4,6,66.7,7,7,14,5,4,1,0,1,0,1
../kbl_data/2021-2022,S39G01N177,고양 오리온,Home,조한진,3,0,2,0.0,1,3,33.3,1,5,20.0,0,0,0.0,0,1,1,0,0,0,0,0,0,3
../kbl_data/2021-2022,S39G01N177,고양 오리온,Home,박진철,0,0,1,0.0,0,0,0.0,0,1,0.0,0,0,0.0,0,0,0,1,0,0,0,0,0,3
../kbl_data/2021-2022,S39G01N177,고양 오리온,Home,이정현,10,4,7,57.1,0,1,0.0,4,8,50.0,2,2,100.0,0,4,4,1,1,0,0,0,0,0
../kbl_data/2021-2022,S39G01N177,원주 DB,Away,박찬희,2,1,5,20.0,0,1,0.0,1,6,16.7,0,0,0.0,0,2,2,3,1,0,0,0,2,1
../kbl_data/2021-2022,S39G01N177,원주 DB,Away,정준원,0,0,0,0.0,0,0,0.0,0,0,0.0,0,0,0.0,0,0,0,0,0,0,0,0,0,0
../kbl_data/2021-2022,S39G01N177,원주 DB,Away,김종규,10,5,9,55.6,0,1,0.0,5,10,50.0,0,2,0.0,2,5,7,1,0,1,0,0,0,1
../kbl_data/2021-2022,S39G01N177,원주 DB,Away,허웅,10,2,3,66.7,2,6,33.3,4,9,44.4,0,0,0.0,0,3,3,4,1,0,0,0,1,4
../kbl_data/2021-2022,S39G01N177,원주 DB,Away,김영훈,0,0,0,0.0,0,0,0.0,0,0,0.0,0,0,0.0,2,2,4,0,0,0,0,0,1,4
../kbl_data/2021-2022,S39G01N177,원주 DB,Away,강상재,5,1,4,25.0,1,2,50.0,2,6,33.3,0,0,0.0,0,3,3,3,0,0,0,0,2,1
../kbl_data/2021-2022,S39G01N177,원주 DB,Away,김철욱,0,0,0,0.0,0,0,0.0,0,0,0.0,0,0,0.0,0,0,0,0,0,0,0,0,1,0
../kbl_data/2021-2022,S39G01N177,원주 DB,Away,이용우,0,0,0,0.0,0,0,0.0,0,0,0.0,0,0,0.0,0,0,0,0,0,0,0,0,0,0
../kbl_data/2021-2022,S39G01N177,원주 DB,Away,이준희,8,4,4,100.0,0,0,0.0,4,4,100.0,0,1,0.0,1,0,1,4,0,0,0,0,1,2
../kbl_data/2021-2022,S39G01N177,원주 DB,Away,레나드 프리먼,3,1,2,50.0,0,0,0.0,1,2,50.0,1,2,50.0,0,4,4,2,0,0,0,0,1,1
../kbl_data/2021-2022,S39G01N177,원주 DB,Away,정호영,15,2,3,66.7,3,6,50.0,5,9,55.6,2,2,100.0,0,1,1,0,0,0,0,0,2,1
../kbl_data/2021-2022,S39G01N177,원주 DB,Away,조니 오브라이언트,20,8,12,66.7,1,2,50.0,9,14,64.3,1,3,33.3,4,9,13,1,0,0,0,0,3,3
../kbl_data/2021-2022,S39G01N178,서울 삼성,Home,김시래,13,2,4,50.0,3,5,60.0,5,9,55.6,0,0,0.0,0,1,1,2,2,0,0,0,4,1
../kbl_data/2021-2022,S39G01N178,서울 삼성,Home,이동엽,2,1,4,25.0,0,0,0.0,1,4,25.0,0,0,0.0,0,0,0,4,1,0,0,0,3,0
../kbl_data/2021-2022,S39G01N178,서울 삼성,Home,배수용,4,0,0,0.0,1,2,50.0,1,2,50.0,1,3,33.3,0,0,0,0,0,0,0,0,0,0
../kbl_data/2021-2022,S39G01N178,서울 삼성,Home,이호현,15,5,7,71.4,1,3,33.3,6,10,60.0,2,2,100.0,1,1,2,3,2,0,0,0,3,1
../kbl_data/2021-2022,S39G01N178,서울 삼성,Home,정희원,0,0,2,0.0,0,0,0.0,0,2,0.0,0,0,0.0,0,1,1,0,0,0,0,0,0,0
../kbl_data/2021-2022,S39G01N178,서울 삼성,Home,정준수,0,0,0,0.0,0,0,0.0,0,0,0.0,0,0,0.0,0,0,0,0,0,0,0,0,0,0
../kbl_data/2021-2022,S39G01N178,서울 삼성,Home,강바일,15,2,2,100.0,3,6,50.0,5,8,62.5,2,2,100.0,1,1,2,0,1,0,1,0,0,5
../kbl_data/2021-2022,S39G01N178,서울 삼성,Home,박민우,4,0,1,0.0,1,6,16.7,1,7,14.3,1,2,50.0,0,2,2,0,0,0,1,0,0,3
../kbl_data/2021-2022,S39G01N178,서울 삼성,Home,차민석,4,2,3,66.7,0,2,0.0,2,5,40.0,0,0,0.0,1,3,4,1,1,0,0,0,4,2
../kbl_data/2021-2022,S39G01N178,서울 삼성,Home,전형준,3,0,0,0.0,1,2,50.0,1,2,50.0,0,0,0.0,0,0,0,2,0,0,0,0,1,2
../kbl_data/2021-2022,S39G01N178,서울 삼성,Home,조우성,4,2,4,50.0,0,0,0.0,2,4,50.0,0,0,0.0,1,6,7,0,2,0,0,0,0,3
../kbl_data/2021-2022,S39G01N178,서울 삼성,Home,이원석,9,3,9,33.3,1,2,50.0,4,11,36.4,0,1,0.0,0,1,1,1,1,2,0,0,1,2
../kbl_data/2021-2022,S39G01N178,서울 SK,Away,양우섭,3,0,1,0.0,1,1,100.0,1,2,50.0,0,0,0.0,1,2,3,2,1,1,0,0,0,2
../kbl_data/2021-2022,S39G01N178,서울 SK,Away,허일영,10,3,3,100.0,1,4,25.0,4,7,57.1,1,1,100.0,2,2,4,1,0,0,0,0,0,1
../kbl_data/2021-2022,S39G01N178,서울 SK,Away,김선형,15,5,5,100.0,1,2,50.0,6,7,85.7,2,2,100.0,1,1,2,1,3,0,0,0,3,1
../kbl_data/2021-2022,S39G01N178,서울 SK,Away,최부경,10,5,7,71.4,0,2,0.0,5,9,55.6,0,0,0.0,0,4,4,1,0,0,0,1,1,3
../kbl_data/2021-2022,S39G01N178,서울 SK,Away,리온 윌리엄스,7,2,4,50.0,0,1,0.0,2,5,40.0,3,4,75.0,5,8,13,1,2,1,0,0,1,1
../kbl_data/2021-2022,S39G01N178,서울 SK,Away,배병준,10,5,7,71.4,0,0,0.0,5,7,71.4,0,0,0.0,0,1,1,1,1,0,0,0,0,0
../kbl_data/2021-2022,S39G01N178,서울 SK,Away,이현석,2,1,4,25.0,0,2,0.0,1,6,16.7,0,0,0.0,0,1,1,1,0,0,0,0,2,0
../kbl_data/2021-2022,S39G01N178,서울 SK,Away,최원혁,2,1,2,50.0,0,0,0.0,1,2,50.0,0,0,0.0,0,1,1,0,2,0,0,0,3,2
../kbl_data/2021-2022,S39G01N178,서울 SK,Away,최준용,12,1,4,25.0,3,6,50.0,4,10,40.0,1,2,50.0,0,3,3,0,0,1,0,0,2,3
../kbl_data/2021-2022,S39G01N178,서울 SK,Away,안영준,6,1,4,25.0,1,4,25.0,2,8,25.0,1,2,50.0,1,2,3,3,2,1,0,0,0,0
../kbl_data/2021-2022,S39G01N178,서울 SK,Away,자밀 워니,13,6,8,75.0,0,1,0.0,6,9,66.7,1,2,50.0,2,3,5,8,2,0,0,0,2,0
../kbl_data/2021-2022,S39G01N178,서울 SK,Away,오재현,2,0,1,0.0,0,0,0.0,0,1,0.0,2,2,100.0,1,2,3,5,1,1,0,0,0,3
../kbl_data/2021-2022,S39G01N179,안양 KGC,Home,함준후,0,0,0,0.0,0,1,0.0,0,1,0.0,0,0,0.0,1,2,3,1,0,0,0,0,0,1
../kbl_data/2021-2022,S39G01N179,안양 KGC,Home,오세근,9,2,6,33.3,1,1,100.0,3,7,42.9,2,2,100.0,4,3,7,2,1,0,0,0,1,2
../kbl_data/2021-2022,S39G01N179,안양 KGC,Home,문성곤,12,1,1,100.0,3,7,42.9,4,8,50.0,1,2,50.0,2,3,5,0,2,0,0,0,2,0
../kbl_data/2021-2022,S39G01N179,안양 KGC,Home,전성현,11,1,4,25.0,2,8,25.0,3,12,25.0,3,3,100.0,1,1,2,0,2,0,0,0,3,3
../kbl_data/2021-2022,S39G01N179,안양 KGC,Home,박지훈,0,0,2,0.0,0,1,0.0,0,3,0.0,0,0,0.0,0,0,0,3,1,0,0,0,0,1
../kbl_data/2021-2022,S39G01N179,안양 KGC,Home,정강호,0,0,0,0.0,0,0,0.0,0,0,0.0,0,0,0.0,0,0,0,0,0,0,0,0,0,0
../kbl_data/2021-2022,S39G01N179,안양 KGC,Home,이우정,0,0,0,0.0,0,0,0.0,0,0,0.0,0,0,0.0,0,0,0,0,0,0,0,0,0,0
../kbl_data/2021-2022,S39G01N179,안양 KGC,Home,대릴 먼로,17,4,10,40.0,3,11,27.3,7,21,33.3,0,0,0.0,5,10,15,8,2,2,1,1,6,2
../kbl_data/2021-2022,S39G01N179,안양 KGC,Home,우동현,8,1,1,100.0,2,5,40.0,3,6,50.0,0,2,0.0,1,0,1,1,1,0,0,0,0,1
../kbl_data/2021-2022,S39G01N179,안양 KGC,Home,변준형,8,4,8,50.0,0,4,0.0,4,12,33.3,0,1,0.0,1,2,3,5,1,0,0,0,2,4
../kbl_data/2021-2022,S39G01N179,안양 KGC,Home,한승희,0,0,1,0.0,0,0,0.0,0,1,0.0,0,0,0.0,1,0,1,0,0,0,0,0,1,3
../kbl_data/2021-2022,S39G01N179,안양 KGC,Home,주현우,2,1,2,50.0,0,0,0.0,1,2,50.0,0,0,0.0,1,0,1,0,0,0,0,0,0,0
../kbl_data/2021-2022,S39G01N179,수원 KT,Away,김동욱,0,0,0,0.0,0,1,0.0,0,1,0.0,0,0,0.0,0,0,0,0,0,0,0,0,2,1
../kbl_data/2021-2022,S39G01N179,수원 KT,Away,김영환,0,0,1,0.0,0,1,0.0,0,2,0.0,0,0,0.0,2,1,3,0,2,0,0,0,1,0
../kbl_data/2021-2022,S39G01N179,수원 KT,Away,최창진,2,1,2,50.0,0,2,0.0,1,4,25.0,0,0,0.0,0,1,1,2,1,0,0,0,0,3
../kbl_data/2021-2022,S39G01N179,수원 KT,Away,정성우,16,5,5,100.0,1,9,11.1,6,14,42.9,3,3,100.0,0,1,1,2,1,0,2,0,0,3
../kbl_data/2021-2022,S39G01N179,수원 KT,Away,허훈,9,1,2,50.0,1,4,25.0,2,6,33.3,4,5,80.0,1,4,5,6,1,0,1,0,5,3
../kbl_data/2021-2022,S39G01N179,수원 KT,Away,양홍석,15,6,8,75.0,0,2,0.0,6,10,60.0,3,3,100.0,1,3,4,4,0,0,0,0,2,2
../kbl_data/2021-2022,S39G01N179,수원 KT,Away,박준영,0,0,0,0.0,0,0,0.0,0,0,0.0,0,0,0.0,0,0,0,0,0,0,0,0,0,0
../kbl_data/2021-2022,S39G01N179,수원 KT,Away,캐디 라렌,23,9,14,64.3,0,2,0.0,9,16,56.2,5,7,71.4,6,10,16,0,1,1,0,0,1,0
../kbl_data/2021-2022,S39G01N179,수원 KT,Away,문상옥,0,0,0,0.0,0,0,0.0,0,0,0.0,0,0,0.0,0,0,0,0,0,0,0,0,0,0
../kbl_data/2021-2022,S39G01N179,수원 KT,Away,박지원,2,1,1,100.0,0,2,0.0,1,3,33.3,0,0,0.0,0,0,0,0,0,0,0,0,2,0
../kbl_data/2021-2022,S39G01N179,수원 KT,Away,마이크 마이어스,4,2,5,40.0,0,0,0.0,2,5,40.0,0,1,0.0,3,5,8,1,0,1,0,1,2,0
../kbl_data/2021-2022,S39G01N179,수원 KT,Away,하윤기,6,3,7,42.9,0,0,0.0,3,7,42.9,0,0,0.0,2,2,4,0,2,0,0,0,0,2
../kbl_data/2021-2022,S39G01N180,대구 한국가스공사,Home,홍경기,0,0,0,0.0,0,1,0.0,0,1,0.0,0,0,0.0,0,0,0,0,0,0,0,0,1,0
../kbl_data/2021-2022,S39G01N180,대구 한국가스공사,Home,차바위,9,3,3,100.0,1,1,100.0,4,4,100.0,0,0,0.0,0,6,6,1,2,0,1,0,0,3
../kbl_data/2021-2022,S39G01N180,대구 한국가스공사,Home,이대헌,17,8,12,66.7,0,1,0.0,8,13,61.5,1,1,100.0,3,1,4,2,2,0,0,0,1,2
../kbl_data/2021-2022,S39G01N180,대구 한국가스공사,Home,두경민,20,3,6,50.0,4,7,57.1,7,13,53.8,2,3,66.7,0,2,2,6,0,0,1,0,4,0
../kbl_data/2021-2022,S39G01N180,대구 한국가스공사,Home,박봉진,0,0,0,0.0,0,0,0.0,0,0,0.0,0,0,0.0,0,0,0,0,0,0,0,0,0,0
../kbl_data/2021-2022,S39G01N180,대구 한국가스공사,Home,김낙현,22,5,8,62.5,4,7,57.1,9,15,60.0,0,0,0.0,0,1,1,2,0,0,0,0,2,4
../kbl_data/2021-2022,S39G01N180,대구 한국가스공사,Home,전현우,3,0,0,0.0,1,3,33.3,1,3,33.3,0,0,0.0,1,1,2,2,1,0,0,0,0,3
../kbl_data/2021-2022,S39G01N180,대구 한국가스공사,Home,이윤기,0,0,0,0.0,0,0,0.0,0,0,0.0,0,0,0.0,0,0,0,0,0,0,0,0,0,0
../kbl_data/2021-2022,S39G01N180,대구 한국가스공사,Home,양준우,0,0,0,0.0,0,0,0.0,0,0,0.0,0,0,0.0,0,0,0,0,0,0,0,0,0,0
../kbl_data/2021-2022,S39G01N180,대구 한국가스공사,Home,앤드류 니콜슨,0,0,0,0.0,0,0,0.0,0,0,0.0,0,0,0.0,0,3,3,3,2,0,0,0,0,0
../kbl_data/2021-2022,S39G01N180,대구 한국가스공사,Home,신승민,4,2,4,50.0,0,1,0.0,2,5,40.0,0,0,0.0,0,1,1,1,0,0,0,0,0,2
../kbl_data/2021-2022,S39G01N180,대구 한국가스공사,Home,디제이 화이트,10,4,8,50.0,0,0,0.0,4,8,50.0,2,2,100.0,3,7,10,4,1,4,0,0,1,2
../kbl_data/2021-2022,S39G01N180,전주 KCC,Away,송창용,0,0,0,0.0,0,0,0.0,0,0,0.0,0,0,0.0,0,0,0,2,0,0,0,0,0,0
../kbl_data/2021-2022,S39G01N180,전주 KCC,Away,이정현,5,1,3,33.3,0,2,0.0,1,5,20.0,3,3,100.0,0,0,0,0,0,0,0,0,4,1
../kbl_data/2021-2022,S39G01N180,전주 KCC,Away,정창영,4,1,1,100.0,0,2,0.0,1,3,33.3,2,2,100.0,0,1,1,1,1,0,0,0,0,2
../kbl_data/2021-2022,S39G01N180,전주 KCC,Away,라건아,15,4,9,44.4,1,2,50.0,5,11,45.5,4,4,100.0,4,2,6,4,1,0,0,2,1,0
../kbl_data/2021-2022,S39G01N180,전주 KCC,Away,김지완,12,0,2,0.0,4,6,66.7,4,8,50.0,0,0,0.0,0,0,0,2,1,0,0,0,1,0
../kbl_data/2021-2022,S39G01N180,전주 KCC,Away,김상규,8,1,1,100.0,2,4,50.0,3,5,60.0,0,0,0.0,1,3,4,0,0,0,0,0,2,2
../kbl_data/2021-2022,S39G01N180,전주 KCC,Away,전준범,3,0,0,0.0,1,2,50.0,1,2,50.0,0,0,0.0,1,1,2,0,1,0,0,0,2,2
../kbl_data/2021-2022,S39G01N180,전주 KCC,Away,박재현,0,0,1,0.0,0,2,0.0,0,3,0.0,0,0,0.0,1,0,1,0,0,0,0,0,0,3
../kbl_data/2021-2022,S39G01N180,전주 KCC,Away,송교창,7,2,4,50.0,1,4,25.0,3,8,37.5,0,0,0.0,0,3,3,0,0,0,0,0,1,1
../kbl_data/2021-2022,S39G01N180,전주 KCC,Away,이진욱,0,0,1,0.0,0,0,0.0,0,1,0.0,0,0,0.0,0,2,2,0,0,0,0,0,0,0
../kbl_data/2021-2022,S39G01N180,전주 KCC,Away,유현준,5,0,0,0.0,1,3,33.3,1,3,33.3,2,2,100.0,0,0,0,3,2,0,0,0,0,1
../kbl_data/2021-2022,S39G01N180,전주 KCC,Away,라타비우스 윌리엄스,6,3,6,50.0,0,0,0.0,3,6,50.0,0,1,0.0,2,4,6,0,0,1,0,1,3,3
../kbl_data/2021-2022,S39G01N181,울산 현대모비스,Home,이현민,7,2,3,66.7,1,2,50.0,3,5,60.0,0,0,0.0,0,0,0,1,0,0,0,0,1,0
../kbl_data/2021-2022,S39G01N181,울산 현대모비스,Home,함지훈,8,3,4,75.0,0,0,0.0,3,4,75.0,2,3,66.7,0,4,4,2,0,0,0,0,0,2
../kbl_data/2021-2022,S39G01N181,울산 현대모비스,Home,최진수,0,0,3,0.0,0,0,0.0,0,3,0.0,0,0,0.0,0,2,2,0,0,0,0,0,0,3
../kbl_data/2021-2022,S39G01N181,울산 현대모비스,Home,박지훈,0,0,0,0.0,0,0,0.0,0,0,0.0,0,0,0.0,0,1,1,0,0,0,0,0,0,1
../kbl_data/2021-2022,S39G01N181,울산 현대모비스,Home,장재석,3,1,2,50.0,0,0,0.0,1,2,50.0,1,2,50.0,1,2,3,2,0,1,0,1,0,0
../kbl_data/2021-2022,S39G01N181,울산 현대모비스,Home,김영현,6,1,1,100.0,1,4,25.0,2,5,40.0,1,2,50.0,0,1,1,0,1,1,1,0,0,3
../kbl_data/2021-2022,S39G01N181,울산 현대모비스,Home,김국찬,2,0,0,0.0,0,2,0.0,0,2,0.0,2,2,100.0,0,0,0,2,1,0,0,0,1,3
../kbl_data/2021-2022,S39G01N181,울산 현대모비스,Home,서명진,14,3,4,75.0,1,2,50.0,4,6,66.7,5,5,100.0,0,2,2,2,0,0,0,0,1,3
../kbl_data/2021-2022,S39G01N181,울산 현대모비스,Home,이우석,26,10,14,71.4,2,4,50.0,12,18,66.7,0,0,0.0,1,4,5,5,2,0,0,0,3,2
../kbl_data/2021-2022,S39G01N181,울산 현대모비스,Home,라숀 토마스,21,8,11,72.7,0,0,0.0,8,11,72.7,5,8,62.5,2,13,15,2,1,1,0,1,3,4
../kbl_data/2021-2022,S39G01N181,울산 현대모비스,Home,신민석,0,0,0,0.0,0,0,0.0,0,0,0.0,0,0,0.0,0,0,0,0,0,0,0,0,0,0
../kbl_data/2021-2022,S39G01N181,울산 현대모비스,Home,에릭 버크너,4,2,2,100.0,0,0,0.0,2,2,100.0,0,2,0.0,0,4,4,0,0,2,0,1,2,4
../kbl_data/2021-2022,S39G01N181,창원 LG,Away,변기훈,2,1,2,50.0,0,1,0.0,1,3,33.3,0,0,0.0,0,0,0,0,1,0,0,0,0,2
../kbl_data/2021-2022,S39G01N181,창원 LG,Away,이관희,12,2,9,22.2,1,4,25.0,3,13,23.1,5,7,71.4,1,3,4,2,0,0,0,0,2,1
../kbl_data/2021-2022,S39G01N181,창원 LG,Away,정희재,5,1,2,50.0,1,2,50.0,2,4,50.0,0,0,0.0,0,0,0,0,0,0,0,0,0,3
../kbl_data/2021-2022,S39G01N181,창원 LG,Away,서민수,5,1,2,50.0,1,3,33.3,2,5,40.0,0,0,0.0,1,0,1,1,0,0,0,0,0,5
../kbl_data/2021-2022,S39G01N181,창원 LG,Away,한상혁,3,0,2,0.0,1,1,100.0,1,3,33.3,0,0,0.0,0,0,0,0,0,0,0,0,0,1
../kbl_data/2021-2022,S39G01N181,창원 LG,Away,이재도,9,3,9,33.3,0,4,0.0,3,13,23.1,3,3,100.0,0,1,1,4,1,0,0,0,1,0
../kbl_data/2021-2022,S39G01N181,창원 LG,Away,정인덕,0,0,0,0.0,0,1,0.0,0,1,0.0,0,0,0.0,0,0,0,0,0,0,0,0,0,0
../kbl_data/2021-2022,S39G01N181,창원 LG,Away,박정현,4,2,5,40.0,0,0,0.0,2,5,40.0,0,0,0.0,1,3,4,0,0,0,0,0,0,4
../kbl_data/2021-2022,S39G01N181,창원 LG,Away,윤원상,0,0,0,0.0,0,1,0.0,0,1,0.0,0,0,0.0,0,0,0,0,0,0,0,0,0,0
../kbl_data/2021-2022,S39G01N181,창원 LG,Away,아셈 마레이,2,1,1,100.0,0,0,0.0,1,1,100.0,0,0,0.0,2,3,5,3,1,1,0,0,0,3
../kbl_data/2021-2022,S39G01N181,창원 LG,Away,이승우,16,6,6,100.0,0,0,0.0,6,6,100.0,4,7,57.1,3,5,8,3,4,1,1,0,4,2
../kbl_data/2021-2022,S39G01N181,창원 LG,Away,사마르도 사무엘스,16,4,10,40.0,1,2,50.0,5,12,41.7,5,6,83.3,0,3,3,2,0,0,0,1,2,5
../kbl_data/2021-2022,S39G01N182,서울 SK,Home,양우섭,0,0,0,0.0,0,0,0.0,0,0,0.0,0,0,0.0,0,0,0,2,1,0,0,0,0,0
../kbl_data/2021-2022,S39G01N182,서울 SK,Home,허일영,7,2,4,50.0,1,2,50.0,3,6,50.0,0,0,0.0,1,3,4,1,1,2,0,0,1,2
../kbl_data/2021-2022,S39G01N182,서울 SK,Home,김선형,18,9,14,64.3,0,2,0.0,9,16,56.2,0,0,0.0,1,2,3,3,1,0,0,0,4,0
../kbl_data/2021-2022,S39G01N182,서울 SK,Home,최부경,9,3,3,100.0,1,2,50.0,4,5,80.0,0,0,0.0,2,2,4,0,1,0,0,0,0,2
../kbl_data/2021-2022,S39G01N182,서울 SK,Home,리온 윌리엄스,4,2,4,50.0,0,0,0.0,2,4,50.0,0,0,0.0,3,4,7,0,0,0,0,0,1,2
../kbl_data/2021-2022,S39G01N182,서울 SK,Home,배병준,2,1,2,50.0,0,0,0.0,1,2,50.0,0,0,0.0,0,0,0,0,0,0,0,0,1,0
../kbl_data/2021-2022,S39G01N182,서울 SK,Home,이현석,0,0,0,0.0,0,0,0.0,0,0,0.0,0,0,0.0,0,0,0,0,0,0,0,0,0,0
../kbl_data/2021-2022,S39G01N182,서울 SK,Home,최원혁,0,0,0,0.0,0,1,0.0,0,1,0.0,0,0,0.0,0,1,1,3,0,0,1,0,1,3
../kbl_data/2021-2022,S39G01N182,서울 SK,Home,최준용,21,7,11,63.6,1,2,50.0,8,13,61.5,4,6,66.7,2,3,5,3,0,1,0,0,1,4
../kbl_data/2021-2022,S39G01N182,서울 SK,Home,안영준,14,7,12,58.3,0,6,0.0,7,18,38.9,0,1,0.0,1,3,4,2,2,1,0,1,1,3
../kbl_data/2021-2022,S39G01N182,서울 SK,Home,자밀 워니,23,9,15,60.0,0,1,0.0,9,16,56.2,5,6,83.3,6,6,12,2,2,1,0,1,3,1
../kbl_data/2021-2022,S39G01N182,서울 SK,Home,오재현,2,1,3,33.3,0,1,0.0,1,4,25.0,0,0,0.0,3,2,5,1,2,0,0,0,1,4
../kbl_data/2021-2022,S39G01N182,원주 DB,Away,박찬희,11,1,4,25.0,3,6,50.0,4,10,40.0,0,0,0.0,0,1,1,3,2,0,0,0,3,4
../kbl_data/2021-2022,S39G01N182,원주 DB,Away,정준원,0,0,1,0.0,0,2,0.0,0,3,0.0,0,0,0.0,1,0,1,0,0,0,0,0,0,1
../kbl_data/2021-2022,S39G01N182,원주 DB,Away,박경상,0,0,0,0.0,0,1,0.0,0,1,0.0,0,0,0.0,0,0,0,0,1,0,0,0,0,0
../kbl_data/2021-2022,S39G01N182,원주 DB,Away,김종규,14,2,6,33.3,2,3,66.7,4,9,44.4,4,4,100.0,2,2,4,0,2,3,1,0,2,3
../kbl_data/2021-2022,S39G01N182,원주 DB,Away,허웅,22,8,10,80.0,1,6,16.7,9,16,56.2,3,3,100.0,0,1,1,3,2,0,0,0,1,2
../kbl_data/2021-2022,S39G01N182,원주 DB,Away,강상재,11,4,9,44.4,1,3,33.3,5,12,41.7,0,0,0.0,4,4,8,2,1,1,0,0,2,2
../kbl_data/2021-2022,S39G01N182,원주 DB,Away,김철욱,1,0,0,0.0,0,0,0.0,0,0,0.0,1,2,50.0,0,0,0,0,0,0,0,0,1,1
../kbl_data/2021-2022,S39G01N182,원주 DB,Away,김훈,0,0,0,0.0,0,0,0.0,0,0,0.0,0,0,0.0,0,0,0,0,0,0,0,0,0,2
../kbl_data/2021-2022,S39G01N182,원주 DB,Away,나카무라 타이치,0,0,0,0.0,0,0,0.0,0,0,0.0,0,0,0.0,0,0,0,0,0,0,0,0,0,0
../kbl_data/2021-2022,S39G01N182,원주 DB,Away,이준희,0,0,0,0.0,0,0,0.0,0,0,0.0,0,0,0.0,0,0,0,0,0,0,0,0,0,0
../kbl_data/2021-2022,S39G01N182,원주 DB,Away,정호영,0,0,0,0.0,0,2,0.0,0,2,0.0,0,0,0.0,1,4,5,1,0,0,0,0,0,0
../kbl_data/2021-2022,S39G01N182,원주 DB,Away,조니 오브라이언트,25,7,15,46.7,2,6,33.3,9,21,42.9,5,6,83.3,5,7,12,3,2,1,1,1,5,2
../kbl_data/2021-2022,S39G01N183,수원 KT,Home,김동욱,0,0,0,0.0,0,2,0.0,0,2,0.0,0,0,0.0,0,1,1,2,0,0,0,0,0,0
../kbl_data/2021-2022,S39G01N183,수원 KT,Home,김현민,4,2,4,50.0,0,1,0.0,2,5,40.0,0,0,0.0,2,2,4,2,1,0,1,0,2,3
../kbl_data/2021-2022,S39G01N183,수원 KT,Home,한희원,8,1,4,25.0,2,4,50.0,3,8,37.5,0,0,0.0,1,1,2,0,1,0,0,0,0,2
../kbl_data/2021-2022,S39G01N183,수원 KT,Home,정성우,5,2,4,50.0,0,3,0.0,2,7,28.6,1,2,50.0,0,1,1,6,2,0,0,0,0,2
../kbl_data/2021-2022,S39G01N183,수원 KT,Home,최성모,2,1,1,100.0,0,0,0.0,1,1,100.0,0,0,0.0,0,0,0,1,0,0,0,0,0,0
../kbl_data/2021-2022,S39G01N183,수원 KT,Home,허훈,15,3,6,50.0,2,7,28.6,5,13,38.5,3,3,100.0,1,3,4,4,2,0,1,0,1,2
../kbl_data/2021-2022,S39G01N183,수원 KT,Home,양홍석,19,5,8,62.5,3,7,42.9,8,15,53.3,0,0,0.0,3,4,7,3,0,0,0,0,2,1
../kbl_data/2021-2022,S39G01N183,수원 KT,Home,박준영,4,2,3,66.7,0,0,0.0,2,3,66.7,0,0,0.0,1,0,1,0,1,0,0,0,0,1
../kbl_data/2021-2022,S39G01N183,수원 KT,Home,캐디 라렌,4,2,7,28.6,0,1,0.0,2,8,25.0,0,0,0.0,0,6,6,1,0,1,0,1,2,1
../kbl_data/2021-2022,S39G01N183,수원 KT,Home,박지원,9,3,3,100.0,1,1,100.0,4,4,100.0,0,0,0.0,0,0,0,2,1,0,0,0,0,2
../kbl_data/2021-2022,S39G01N183,수원 KT,Home,마이크 마이어스,11,5,7,71.4,0,0,0.0,5,7,71.4,1,2,50.0,1,5,6,1,0,0,0,2,0,1
../kbl_data/2021-2022,S39G01N183,수원 KT,Home,하윤기,0,0,0,0.0,0,0,0.0,0,0,0.0,0,0,0.0,0,1,1,1,0,1,0,0,0,0
../kbl_data/2021-2022,S39G01N183,고양 오리온,Away,오용준,0,0,0,0.0,0,2,0.0,0,2,0.0,0,0,0.0,1,2,3,1,0,0,0,0,0,0
../kbl_data/2021-2022,S39G01N183,고양 오리온,Away,이대성,23,10,19,52.6,1,3,33.3,11,22,50.0,0,0,0.0,2,2,4,2,1,0,0,0,4,0
../kbl_data/2021-2022,S39G01N183,고양 오리온,Away,한호빈,5,0,1,0.0,1,6,16.7,1,7,14.3,2,2,100.0,1,1,2,2,1,0,0,0,1,1
../kbl_data/2021-2022,S39G01N183,고양 오리온,Away,이정제,0,0,0,0.0,0,0,0.0,0,0,0.0,0,0,0.0,0,1,1,1,0,0,0,0,0,0
../kbl_data/2021-2022,S39G01N183,고양 오리온,Away,최승욱,2,1,1,100.0,0,0,0.0,1,1,100.0,0,0,0.0,0,1,1,1,0,0,0,0,1,1
../kbl_data/2021-2022,S39G01N183,고양 오리온,Away,이승현,14,4,8,50.0,2,3,66.7,6,11,54.5,0,0,0.0,0,5,5,0,0,1,0,0,1,3
../kbl_data/2021-2022,S39G01N183,고양 오리온,Away,김진유,5,1,1,100.0,1,2,50.0,2,3,66.7,0,2,0.0,0,3,3,1,2,0,0,0,1,2
../kbl_data/2021-2022,S39G01N183,고양 오리온,Away,제임스 메이스,1,0,1,0.0,0,1,0.0,0,2,0.0,1,2,50.0,0,3,3,1,0,0,0,0,2,0
../kbl_data/2021-2022,S39G01N183,고양 오리온,Away,머피 할로웨이,5,2,4,50.0,0,0,0.0,2,4,50.0,1,2,50.0,3,9,12,4,1,1,0,0,3,2
../kbl_data/2021-2022,S39G01N183,고양 오리온,Away,조한진,2,1,3,33.3,0,2,0.0,1,5,20.0,0,0,0.0,0,0,0,0,0,0,0,0,0,0
../kbl_data/2021-2022,S39G01N183,고양 오리온,Away,이정현,7,1,3,33.3,1,3,33.3,2,6,33.3,2,2,100.0,0,2,2,1,0,0,0,0,1,2
../kbl_data/2021-2022,S39G01N183,고양 오리온,Away,문시윤,1,0,0,0.0,0,0,0.0,0,0,0.0,1,2,50.0,3,0,3,1,0,0,0,0,1,0
../kbl_data/2021-2022,S39G01N184,안양 KGC,Home,양희종,5,1,1,100.0,1,8,12.5,2,9,22.2,0,0,0.0,0,2,2,2,2,1,0,0,1,0
../kbl_data/2021-2022,S39G01N184,안양 KGC,Home,함준후,6,3,4,75.0,0,2,0.0,3,6,50.0,0,0,0.0,0,3,3,3,1,0,0,0,0,5
../kbl_data/2021-2022,S39G01N184,안양 KGC,Home,오세근,15,6,7,85.7,1,4,25.0,7,11,63.6,0,0,0.0,2,7,9,3,0,0,0,0,2,0
../kbl_data/2021-2022,S39G01N184,안양 KGC,Home,문성곤,5,2,5,40.0,0,1,0.0,2,6,33.3,1,2,50.0,4,5,9,1,1,0,0,0,1,1
../kbl_data/2021-2022,S39G01N184,안양 KGC,Home,전성현,16,1,4,25.0,4,12,33.3,5,16,31.2,2,2,100.0,0,2,2,2,1,0,0,0,1,2
../kbl_data/2021-2022,S39G01N184,안양 KGC,Home,박지훈,4,2,3,66.7,0,0,0.0,2,3,66.7,0,0,0.0,1,0,1,2,1,0,0,0,1,1
../kbl_data/2021-2022,S39G01N184,안양 KGC,Home,대릴 먼로,14,4,7,57.1,0,2,0.0,4,9,44.4,6,7,85.7,1,8,9,4,1,0,0,0,1,1
../kbl_data/2021-2022,S39G01N184,안양 KGC,Home,우동현,3,1,1,100.0,0,3,0.0,1,4,25.0,1,1,100.0,0,0,0,0,0,0,0,0,0,0
../kbl_data/2021-2022,S39G01N184,안양 KGC,Home,변준형,3,1,2,50.0,0,1,0.0,1,3,33.3,1,1,100.0,1,2,3,3,0,0,1,0,1,2
../kbl_data/2021-2022,S39G01N184,안양 KGC,Home,한승희,8,3,5,60.0,0,1,0.0,3,6,50.0,2,2,100.0,4,0,4,1,1,0,0,0,2,4
../kbl_data/2021-2022,S39G01N184,안양 KGC,Home,주현우,0,0,1,0.0,0,0,0.0,0,1,0.0,0,0,0.0,0,0,0,0,0,0,0,0,0,2
../kbl_data/2021-2022,S39G01N184,안양 KGC,Home,조은후,3,1,2,50.0,0,0,0.0,1,2,50.0,1,1,100.0,1,1,2,2,0,0,0,0,1,2
../kbl_data/2021-2022,S39G01N184,서울 삼성,Away,김동량,8,4,8,50.0,0,0,0.0,4,8,50.0,0,0,0.0,2,5,7,0,0,0,0,0,0,1
../kbl_data/2021-2022,S39G01N184,서울 삼성,Away,김시래,6,1,5,20.0,0,2,0.0,1,7,14.3,4,6,66.7,0,2,2,5,3,0,0,0,5,1
../kbl_data/2021-2022,S39G01N184,서울 삼성,Away,이동엽,7,2,3,66.7,1,4,25.0,3,7,42.9,0,0,0.0,0,2,2,0,1,0,0,0,1,1
../kbl_data/2021-2022,S39G01N184,서울 삼성,Away,배수용,0,0,0,0.0,0,0,0.0,0,0,0.0,0,0,0.0,0,0,0,0,0,0,0,0,0,0
../kbl_data/2021-2022,S39G01N184,서울 삼성,Away,이호현,6,2,7,28.6,0,2,0.0,2,9,22.2,2,2,100.0,1,1,2,6,1,0,0,0,1,2
../kbl_data/2021-2022,S39G01N184,서울 삼성,Away,정희원,2,1,1,100.0,0,1,0.0,1,2,50.0,0,0,0.0,0,2,2,0,0,0,0,0,0,0
../kbl_data/2021-2022,S39G01N184,서울 삼성,Away,강바일,0,0,0,0.0,0,1,0.0,0,1,0.0,0,0,0.0,0,0,0,0,0,0,0,0,0,2
../kbl_data/2021-2022,S39G01N184,서울 삼성,Away,박민우,9,0,0,0.0,3,6,50.0,3,6,50.0,0,0,0.0,0,2,2,1,0,0,0,0,1,0
../kbl_data/2021-2022,S39G01N184,서울 삼성,Away,차민석,8,3,5,60.0,0,1,0.0,3,6,50.0,2,2,100.0,1,8,9,1,0,0,0,0,0,4
../kbl_data/2021-2022,S39G01N184,서울 삼성,Away,전형준,2,1,3,33.3,0,1,0.0,1,4,25.0,0,2,0.0,0,0,0,0,0,0,0,0,2,3
../kbl_data/2021-2022,S39G01N184,서울 삼성,Away,조우성,3,1,3,33.3,0,0,0.0,1,3,33.3,1,2,50.0,1,3,4,0,0,0,0,0,0,1
../kbl_data/2021-2022,S39G01N184,서울 삼성,Away,이원석,15,4,10,40.0,0,1,0.0,4,11,36.4,7,10,70.0,2,3,5,0,1,0,0,0,2,4
../kbl_data/2021-2022,S39G01N185,창원 LG,Home,강병현,0,0,0,0.0,0,2,0.0,0,2,0.0,0,0,0.0,0,1,1,0,0,0,0,0,1,0
../kbl_data/2021-2022,S39G01N185,창원 LG,Home,변기훈,0,0,1,0.0,0,0,0.0,0,1,0.0,0,0,0.0,0,0,0,0,0,0,0,0,0,1
../kbl_data/2021-2022,S39G01N185,창원 LG,Home,이관희,5,0,3,0.0,1,11,9.1,1,14,7.1,2,2,100.0,0,2,2,0,2,0,1,0,0,4
../kbl_data/2021-2022,S39G01N185,창원 LG,Home,정희재,0,0,0,0.0,0,1,0.0,0,1,0.0,0,0,0.0,0,2,2,1,0,0,0,0,0,5
../kbl_data/2021-2022,S39G01N185,창원 LG,Home,서민수,2,1,7,14.3,0,4,0.0,1,11,9.1,0,2,0.0,3,2,5,1,0,1,0,0,2,4
../kbl_data/2021-2022,S39G01N185,창원 LG,Home,한상혁,0,0,1,0.0,0,0,0.0,0,1,0.0,0,0,0.0,0,0,0,0,0,0,0,0,0,0
../kbl_data/2021-2022,S39G01N185,창원 LG,Home,이재도,13,4,6,66.7,1,9,11.1,5,15,33.3,2,2,100.0,3,3,6,1,3,0,0,0,3,1
../kbl_data/2021-2022,S39G01N185,창원 LG,Home,정인덕,0,0,0,0.0,0,0,0.0,0,0,0.0,0,0,0.0,0,0,0,0,0,0,0,0,0,0
../kbl_data/2021-2022,S39G01N185,창원 LG,Home,박정현,0,0,0,0.0,0,0,0.0,0,0,0.0,0,0,0.0,0,0,0,0,0,0,0,0,0,0
../kbl_data/2021-2022,S39G01N185,창원 LG,Home,아셈 마레이,11,5,12,41.7,0,0,0.0,5,12,41.7,1,6,16.7,10,9,19,1,3,1,0,1,5,3
../kbl_data/2021-2022,S39G01N185,창원 LG,Home,이승우,10,3,6,50.0,1,5,20.0,4,11,36.4,1,2,50.0,5,4,9,0,0,0,1,0,1,2
../kbl_data/2021-2022,S39G01N185,창원 LG,Home,사마르도 사무엘스,0,0,2,0.0,0,1,0.0,0,3,0.0,0,0,0.0,0,1,1,0,0,0,0,0,0,1
../kbl_data/2021-2022,S39G01N185,전주 KCC,Away,이정현,11,5,8,62.5,0,5,0.0,5,13,38.5,1,1,100.0,1,8,9,2,1,1,0,0,2,2
../kbl_data/2021-2022,S39G01N185,전주 KCC,Away,정창영,16,2,5,40.0,3,4,75.0,5,9,55.6,3,6,50.0,0,4,4,2,2,0,0,0,2,2
../kbl_data/2021-2022,S39G01N185,전주 KCC,Away,라건아,13,5,7,71.4,1,2,50.0,6,9,66.7,0,1,0.0,2,9,11,2,1,3,0,1,4,4
../kbl_data/2021-2022,S39G01N185,전주 KCC,Away,김지완,5,1,2,50.0,1,3,33.3,2,5,40.0,0,0,0.0,0,2,2,2,0,0,0,0,2,3
../kbl_data/2021-2022,S39G01N185,전주 KCC,Away,김상규,0,0,0,0.0,0,0,0.0,0,0,0.0,0,0,0.0,0,1,1,0,0,0,0,0,0,0
../kbl_data/2021-2022,S39G01N185,전주 KCC,Away,전준범,7,1,2,50.0,1,4,25.0,2,6,33.3,2,2,100.0,1,2,3,1,0,0,0,0,0,1
../kbl_data/2021-2022,S39G01N185,전주 KCC,Away,박재현,0,0,0,0.0,0,0,0.0,0,0,0.0,0,0,0.0,0,0,0,0,0,0,0,0,1,1
../kbl_data/2021-2022,S39G01N185,전주 KCC,Away,송교창,5,1,6,16.7,1,3,33.3,2,9,22.2,0,2,0.0,1,3,4,4,1,1,0,0,2,1
../kbl_data/2021-2022,S39G01N185,전주 KCC,Away,이진욱,0,0,0,0.0,0,0,0.0,0,0,0.0,0,0,0.0,0,0,0,0,0,0,0,0,0,0
../kbl_data/2021-2022,S39G01N185,전주 KCC,Away,유현준,3,0,0,0.0,0,1,0.0,0,1,0.0,3,4,75.0,0,1,1,2,1,0,0,0,1,2
../kbl_data/2021-2022,S39G01N185,전주 KCC,Away,라타비우스 윌리엄스,3,0,0,0.0,0,0,0.0,0,0,0.0,3,4,75.0,3,0,3,0,0,0,0,0,1,3
../kbl_data/2021-2022,S39G01N185,전주 KCC,Away,곽정훈,0,0,0,0.0,0,0,0.0,0,0,0.0,0,0,0.0,0,0,0,0,0,0,0,0,0,0
../kbl_data/2021-2022,S39G01N186,울산 현대모비스,Home,이현민,3,0,0,0.0,1,1,100.0,1,1,100.0,0,0,0.0,1,1,2,0,0,0,0,0,1,0
../kbl_data/2021-2022,S39G01N186,울산 현대모비스,Home,함지훈,14,3,5,60.0,0,0,0.0,3,5,60.0,8,8,100.0,2,3,5,4,1,0,0,0,0,2
../kbl_data/2021-2022,S39G01N186,울산 현대모비스,Home,최진수,8,0,1,0.0,2,2,100.0,2,3,66.7,2,2,100.0,0,2,2,1,1,0,0,0,0,4
../kbl_data/2021-2022,S39G01N186,울산 현대모비스,Home,박지훈,0,0,0,0.0,0,0,0.0,0,0,0.0,0,0,0.0,0,0,0,0,0,0,0,0,0,0
../kbl_data/2021-2022,S39G01N186,울산 현대모비스,Home,장재석,8,4,6,66.7,0,0,0.0,4,6,66.7,0,1,0.0,0,1,1,0,1,1,0,0,1,2
../kbl_data/2021-2022,S39G01N186,울산 현대모비스,Home,김영현,5,1,2,50.0,1,3,33.3,2,5,40.0,0,0,0.0,1,2,3,0,0,0,0,0,0,0
../kbl_data/2021-2022,S39G01N186,울산 현대모비스,Home,김국찬,3,0,0,0.0,1,3,33.3,1,3,33.3,0,0,0.0,0,0,0,1,0,0,0,0,0,1
../kbl_data/2021-2022,S39G01N186,울산 현대모비스,Home,서명진,7,2,5,40.0,1,4,25.0,3,9,33.3,0,0,0.0,0,3,3,3,1,0,0,0,4,1
../kbl_data/2021-2022,S39G01N186,울산 현대모비스,Home,이우석,7,2,10,20.0,1,2,50.0,3,12,25.0,0,0,0.0,1,9,10,7,0,0,0,0,0,2
../kbl_data/2021-2022,S39G01N186,울산 현대모비스,Home,라숀 토마스,19,9,17,52.9,0,0,0.0,9,17,52.9,1,5,20.0,3,8,11,2,1,1,0,2,2,3
../kbl_data/2021-2022,S39G01N186,울산 현대모비스,Home,신민석,0,0,0,0.0,0,1,0.0,0,1,0.0,0,0,0.0,0,0,0,0,0,0,0,0,0,0
../kbl_data/2021-2022,S39G01N186,울산 현대모비스,Home,에릭 버크너,3,1,2,50.0,0,0,0.0,1,2,50.0,1,2,50.0,1,1,2,0,0,0,0,0,3,2
../kbl_data/2021-2022,S39G01N186,대구 한국가스공사,Away,민성주,4,2,4,50.0,0,0,0.0,2,4,50.0,0,0,0.0,1,2,3,0,0,1,0,0,0,5
../kbl_data/2021-2022,S39G01N186,대구 한국가스공사,Away,홍경기,0,0,0,0.0,0,2,0.0,0,2,0.0,0,0,0.0,0,0,0,2,0,0,1,0,1,1
../kbl_data/2021-2022,S39G01N186,대구 한국가스공사,Away,차바위,2,1,2,50.0,0,2,0.0,1,4,25.0,0,0,0.0,1,3,4,3,1,0,1,0,1,3
../kbl_data/2021-2022,S39G01N186,대구 한국가스공사,Away,두경민,11,1,4,25.0,3,7,42.9,4,11,36.4,0,0,0.0,0,1,1,1,1,0,0,0,0,0
../kbl_data/2021-2022,S39G01N186,대구 한국가스공사,Away,박봉진,0,0,0,0.0,0,0,0.0,0,0,0.0,0,0,0.0,0,0,0,0,0,0,1,0,0,1
../kbl_data/2021-2022,S39G01N186,대구 한국가스공사,Away,김낙현,15,3,5,60.0,1,4,25.0,4,9,44.4,6,6,100.0,0,3,3,4,2,0,0,0,5,1
../kbl_data/2021-2022,S39G01N186,대구 한국가스공사,Away,전현우,8,1,1,100.0,2,4,50.0,3,5,60.0,0,0,0.0,1,1,2,0,1,0,0,0,0,2
../kbl_data/2021-2022,S39G01N186,대구 한국가스공사,Away,이윤기,0,0,0,0.0,0,0,0.0,0,0,0.0,0,0,0.0,0,0,0,0,0,0,0,0,0,1
../kbl_data/2021-2022,S39G01N186,대구 한국가스공사,Away,양준우,1,0,0,0.0,0,0,0.0,0,0,0.0,1,2,50.0,0,0,0,0,0,0,0,0,0,2
../kbl_data/2021-2022,S39G01N186,대구 한국가스공사,Away,앤드류 니콜슨,18,7,16,43.8,1,7,14.3,8,23,34.8,1,3,33.3,4,11,15,0,0,0,0,0,2,1
../kbl_data/2021-2022,S39G01N186,대구 한국가스공사,Away,신승민,2,1,2,50.0,0,0,0.0,1,2,50.0,0,0,0.0,0,0,0,1,0,0,0,0,1,3
../kbl_data/2021-2022,S39G01N186,대구 한국가스공사,Away,디제이 화이트,7,1,3,33.3,1,3,33.3,2,6,33.3,2,4,50.0,2,5,7,1,0,0,0,0,0,3
../kbl_data/2021-2022,S39G01N187,수원 KT,Home,김동욱,2,1,1,100.0,0,2,0.0,1,3,33.3,0,0,0.0,0,0,0,1,0,0,0,0,1,2
../kbl_data/2021-2022,S39G01N187,수원 KT,Home,김영환,16,2,2,100.0,3,3,100.0,5,5,100.0,3,3,100.0,1,2,3,0,2,0,0,0,2,2
../kbl_data/2021-2022,S39G01N187,수원 KT,Home,김현민,0,0,1,0.0,0,1,0.0,0,2,0.0,0,0,0.0,0,0,0,0,0,0,0,0,0,2
../kbl_data/2021-2022,S39G01N187,수원 KT,Home,한희원,0,0,0,0.0,0,0,0.0,0,0,0.0,0,0,0.0,0,0,0,0,0,0,0,0,0,0
../kbl_data/2021-2022,S39G01N187,수원 KT,Home,정성우,9,3,4,75.0,1,3,33.3,4,7,57.1,0,0,0.0,2,2,4,6,2,0,0,0,0,4
../kbl_data/2021-2022,S39G01N187,수원 KT,Home,허훈,23,4,8,50.0,4,4,100.0,8,12,66.7,3,4,75.0,2,2,4,8,1,0,0,0,3,1
../kbl_data/2021-2022,S39G01N187,수원 KT,Home,양홍석,6,2,6,33.3,0,3,0.0,2,9,22.2,2,2,100.0,1,2,3,1,0,0,0,0,1,1
../kbl_data/2021-2022,S39G01N187,수원 KT,Home,박준영,0,0,0,0.0,0,0,0.0,0,0,0.0,0,0,0.0,0,0,0,0,0,0,0,0,0,0
../kbl_data/2021-2022,S39G01N187,수원 KT,Home,캐디 라렌,22,8,10,80.0,0,1,0.0,8,11,72.7,6,8,75.0,2,8,10,0,0,2,0,2,4,2
../kbl_data/2021-2022,S39G01N187,수원 KT,Home,박지원,6,2,4,50.0,0,2,0.0,2,6,33.3,2,2,100.0,1,4,5,2,1,1,0,0,0,2
../kbl_data/2021-2022,S39G01N187,수원 KT,Home,마이크 마이어스,9,3,4,75.0,0,0,0.0,3,4,75.0,3,5,60.0,2,2,4,1,0,0,0,0,1,0
../kbl_data/2021-2022,S39G01N187,수원 KT,Home,하윤기,6,2,5,40.0,0,0,0.0,2,5,40.0,2,4,50.0,1,3,4,1,0,1,0,0,0,1
../kbl_data/2021-2022,S39G01N187,서울 삼성,Away,김동량,2,1,1,100.0,0,1,0.0,1,2,50.0,0,0,0.0,0,2,2,0,0,0,0,0,0,2
../kbl_data/2021-2022,S39G01N187,서울 삼성,Away,김시래,12,4,9,44.4,0,5,0.0,4,14,28.6,4,4,100.0,0,1,1,3,4,0,0,0,4,4
../kbl_data/2021-2022,S39G01N187,서울 삼성,Away,임동섭,11,1,4,25.0,3,5,60.0,4,9,44.4,0,0,0.0,3,4,7,0,0,0,0,0,1,3
../kbl_data/2021-2022,S39G01N187,서울 삼성,Away,이동엽,10,1,5,20.0,2,4,50.0,3,9,33.3,2,2,100.0,4,2,6,4,2,0,0,0,0,3
../kbl_data/2021-2022,S39G01N187,서울 삼성,Away,배수용,0,0,1,0.0,0,1,0.0,0,2,0.0,0,0,0.0,1,0,1,1,0,0,0,0,0,0
../kbl_data/2021-2022,S39G01N187,서울 삼성,Away,이호현,2,1,2,50.0,0,2,0.0,1,4,25.0,0,0,0.0,1,0,1,3,0,0,0,0,0,1
../kbl_data/2021-2022,S39G01N187,서울 삼성,Away,정희원,0,0,0,0.0,0,0,0.0,0,0,0.0,0,0,0.0,0,0,0,0,0,0,0,0,0,0
../kbl_data/2021-2022,S39G01N187,서울 삼성,Away,아이제아 힉스,28,13,19,68.4,0,3,0.0,13,22,59.1,2,2,100.0,3,4,7,5,1,3,0,0,6,3
../kbl_data/2021-2022,S39G01N187,서울 삼성,Away,차민석,0,0,1,0.0,0,0,0.0,0,1,0.0,0,0,0.0,1,0,1,1,0,0,0,0,0,3
../kbl_data/2021-2022,S39G01N187,서울 삼성,Away,전형준,2,1,1,100.0,0,0,0.0,1,1,100.0,0,0,0.0,0,0,0,1,0,0,0,0,1,1
../kbl_data/2021-2022,S39G01N187,서울 삼성,Away,이원석,7,2,6,33.3,0,0,0.0,2,6,33.3,3,3,100.0,1,4,5,1,0,1,1,0,0,4
../kbl_data/2021-2022,S39G01N187,서울 삼성,Away,제키 카마이클,6,3,5,60.0,0,0,0.0,3,5,60.0,0,0,0.0,0,0,0,0,0,0,0,0,0,3
../kbl_data/2021-2022,S39G01N188,원주 DB,Home,윤호영,0,0,0,0.0,0,0,0.0,0,0,0.0,0,0,0.0,1,0,1,0,1,0,0,0,0,0
../kbl_data/2021-2022,S39G01N188,원주 DB,Home,박찬희,2,1,3,33.3,0,4,0.0,1,7,14.3,0,0,0.0,0,3,3,1,0,0,0,0,1,1
../kbl_data/2021-2022,S39G01N188,원주 DB,Home,김현호,5,1,1,100.0,1,2,50.0,2,3,66.7,0,0,0.0,0,0,0,0,0,0,0,0,2,3
../kbl_data/2021-2022,S39G01N188,원주 DB,Home,정준원,2,1,1,100.0,0,1,0.0,1,2,50.0,0,0,0.0,0,0,0,0,0,0,0,0,0,0
../kbl_data/2021-2022,S39G01N188,원주 DB,Home,박경상,2,0,1,0.0,0,0,0.0,0,1,0.0,2,2,100.0,0,2,2,2,0,0,0,0,2,1
../kbl_data/2021-2022,S39G01N188,원주 DB,Home,김종규,3,0,2,0.0,1,1,100.0,1,3,33.3,0,0,0.0,1,7,8,1,0,1,0,0,3,2
../kbl_data/2021-2022,S39G01N188,원주 DB,Home,허웅,8,3,5,60.0,0,3,0.0,3,8,37.5,2,2,100.0,1,4,5,4,0,0,0,0,2,3
../kbl_data/2021-2022,S39G01N188,원주 DB,Home,김영훈,2,1,2,50.0,0,1,0.0,1,3,33.3,0,0,0.0,1,1,2,0,0,0,1,0,0,0
../kbl_data/2021-2022,S39G01N188,원주 DB,Home,강상재,9,0,4,0.0,3,4,75.0,3,8,37.5,0,0,0.0,1,2,3,3,1,1,0,0,1,0
../kbl_data/2021-2022,S39G01N188,원주 DB,Home,김철욱,0,0,0,0.0,0,0,0.0,0,0,0.0,0,0,0.0,0,0,0,0,0,0,0,0,0,0
../kbl_data/2021-2022,S39G01N188,원주 DB,Home,이준희,18,3,6,50.0,4,7,57.1,7,13,53.8,0,0,0.0,0,1,1,2,0,0,0,0,1,1
../kbl_data/2021-2022,S39G01N188,원주 DB,Home,조니 오브라이언트,12,3,7,42.9,1,5,20.0,4,12,33.3,3,3,100.0,1,9,10,4,0,0,0,0,4,3
../kbl_data/2021-2022,S39G01N188,안양 KGC,Away,함준후,5,1,2,50.0,1,2,50.0,2,4,50.0,0,0,0.0,1,0,1,1,0,0,0,0,0,1
../kbl_data/2021-2022,S39G01N188,안양 KGC,Away,오세근,16,8,12,66.7,0,1,0.0,8,13,61.5,0,0,0.0,1,6,7,0,0,0,0,0,2,1
../kbl_data/2021-2022,S39G01N188,안양 KGC,Away,문성곤,8,1,1,100.0,2,4,50.0,3,5,60.0,0,0,0.0,0,4,4,2,2,0,0,0,0,2
../kbl_data/2021-2022,S39G01N188,안양 KGC,Away,전성현,11,1,2,50.0,3,8,37.5,4,10,40.0,0,0,0.0,0,1,1,1,3,0,0,0,0,1
../kbl_data/2021-2022,S39G01N188,안양 KGC,Away,박지훈,10,2,5,40.0,2,5,40.0,4,10,40.0,0,0,0.0,0,1,1,3,2,0,0,0,0,3
../kbl_data/2021-2022,S39G01N188,안양 KGC,Away,정강호,0,0,0,0.0,0,0,0.0,0,0,0.0,0,0,0.0,0,0,0,0,0,0,0,0,0,0
../kbl_data/2021-2022,S39G01N188,안양 KGC,Away,이우정,0,0,0,0.0,0,0,0.0,0,0,0.0,0,0,0.0,0,0,0,0,0,0,0,0,0,0
../kbl_data/2021-2022,S39G01N188,안양 KGC,Away,대릴 먼로,9,2,4,50.0,1,2,50.0,3,6,50.0,2,4,50.0,2,12,14,3,2,0,0,0,1,1
../kbl_data/2021-2022,S39G01N188,안양 KGC,Away,우동현,0,0,2,0.0,0,2,0.0,0,4,0.0,0,0,0.0,0,1,1,1,0,0,0,0,0,2
../kbl_data/2021-2022,S39G01N188,안양 KGC,Away,변준형,16,6,8,75.0,1,4,25.0,7,12,58.3,1,2,50.0,1,4,5,12,1,1,0,0,1,1
../kbl_data/2021-2022,S39G01N188,안양 KGC,Away,한승희,4,2,4,50.0,0,0,0.0,2,4,50.0,0,0,0.0,0,1,1,0,0,0,1,0,2,4
../kbl_data/2021-2022,S39G01N188,안양 KGC,Away,주현우,2,1,2,50.0,0,0,0.0,1,2,50.0,0,0,0.0,1,1,2,0,0,0,0,0,0,0
../kbl_data/2021-2022,S39G01N189,고양 오리온,Home,오용준,3,0,0,0.0,1,4,25.0,1,4,25.0,0,0,0.0,1,0,1,0,1,0,0,0,1,1
../kbl_data/2021-2022,S39G01N189,고양 오리온,Home,이대성,13,3,8,37.5,0,2,0.0,3,10,30.0,7,8,87.5,1,0,1,2,1,1,0,0,3,0
../kbl_data/2021-2022,S39G01N189,고양 오리온,Home,한호빈,3,0,2,0.0,1,3,33.3,1,5,20.0,0,0,0.0,1,0,1,1,1,0,0,0,1,1
../kbl_data/2021-2022,S39G01N189,고양 오리온,Home,이정제,6,3,6,50.0,0,0,0.0,3,6,50.0,0,0,0.0,1,0,1,1,1,0,0,0,0,3
../kbl_data/2021-2022,S39G01N189,고양 오리온,Home,최승욱,0,0,1,0.0,0,1,0.0,0,2,0.0,0,0,0.0,0,1,1,0,0,0,0,0,0,0
../kbl_data/2021-2022,S39G01N189,고양 오리온,Home,이승현,8,1,4,25.0,2,4,50.0,3,8,37.5,0,0,0.0,1,1,2,4,5,0,0,0,1,2
../kbl_data/2021-2022,S39G01N189,고양 오리온,Home,김진유,3,0,1,0.0,1,1,100.0,1,2,50.0,0,0,0.0,1,0,1,0,0,0,0,0,0,1
../kbl_data/2021-2022,S39G01N189,고양 오리온,Home,머피 할로웨이,31,13,16,81.2,0,0,0.0,13,16,81.2,5,5,100.0,5,11,16,2,2,1,0,0,1,2
../kbl_data/2021-2022,S39G01N189,고양 오리온,Home,조한진,0,0,1,0.0,0,4,0.0,0,5,0.0,0,0,0.0,0,0,0,1,1,0,0,0,0,2
../kbl_data/2021-2022,S39G01N189,고양 오리온,Home,김세창,3,0,0,0.0,1,1,100.0,1,1,100.0,0,0,0.0,0,0,0,0,0,0,0,0,1,1
../kbl_data/2021-2022,S39G01N189,고양 오리온,Home,이정현,7,1,7,14.3,1,2,50.0,2,9,22.2,2,2,100.0,1,0,1,3,0,1,0,0,1,2
../kbl_data/2021-2022,S39G01N189,고양 오리온,Home,문시윤,0,0,0,0.0,0,0,0.0,0,0,0.0,0,0,0.0,0,0,0,0,0,0,0,0,0,2
../kbl_data/2021-2022,S39G01N189,서울 SK,Away,양우섭,0,0,0,0.0,0,0,0.0,0,0,0.0,0,0,0.0,0,0,0,0,0,0,0,0,0,0
../kbl_data/2021-2022,S39G01N189,서울 SK,Away,허일영,3,0,2,0.0,1,1,100.0,1,3,33.3,0,0,0.0,3,3,6,1,0,0,0,0,1,2
../kbl_data/2021-2022,S39G01N189,서울 SK,Away,김선형,19,5,7,71.4,2,4,50.0,7,11,63.6,3,4,75.0,1,2,3,6,0,0,0,0,3,2
../kbl_data/2021-2022,S39G01N189,서울 SK,Away,최부경,6,3,5,60.0,0,0,0.0,3,5,60.0,0,0,0.0,2,5,7,4,1,0,0,0,0,3
../kbl_data/2021-2022,S39G01N189,서울 SK,Away,리온 윌리엄스,10,2,8,25.0,1,1,100.0,3,9,33.3,3,6,50.0,3,7,10,2,2,0,0,0,1,2
../kbl_data/2021-2022,S39G01N189,서울 SK,Away,이원대,0,0,0,0.0,0,0,0.0,0,0,0.0,0,0,0.0,0,0,0,0,0,0,0,0,0,0
../kbl_data/2021-2022,S39G01N189,서울 SK,Away,배병준,0,0,1,0.0,0,0,0.0,0,1,0.0,0,0,0.0,0,0,0,0,0,0,0,0,0,0
../kbl_data/2021-2022,S39G01N189,서울 SK,Away,최원혁,2,1,1,100.0,0,0,0.0,1,1,100.0,0,0,0.0,0,0,0,3,1,0,0,0,3,2
../kbl_data/2021-2022,S39G01N189,서울 SK,Away,최준용,22,6,10,60.0,3,5,60.0,9,15,60.0,1,4,25.0,1,4,5,4,1,2,0,0,4,2
../kbl_data/2021-2022,S39G01N189,서울 SK,Away,안영준,29,2,5,40.0,7,10,70.0,9,15,60.0,4,4,100.0,0,4,4,2,1,0,0,0,1,2
../kbl_data/2021-2022,S39G01N189,서울 SK,Away,브랜든 브라운,1,0,1,0.0,0,1,0.0,0,2,0.0,1,2,50.0,1,0,1,1,0,0,0,0,1,0
../kbl_data/2021-2022,S39G01N189,서울 SK,Away,김형빈,0,0,0,0.0,0,0,0.0,0,0,0.0,0,0,0.0,0,0,0,0,0,0,0,0,0,0
../kbl_data/2021-2022,S39G01N190,대구 한국가스공사,Home,민성주,0,0,0,0.0,0,0,0.0,0,0,0.0,0,0,0.0,0,0,0,0,0,0,0,0,0,0
../kbl_data/2021-2022,S39G01N190,대구 한국가스공사,Home,홍경기,3,0,0,0.0,0,0,0.0,0,0,0.0,3,3,100.0,1,0,1,1,0,0,0,0,0,1
../kbl_data/2021-2022,S39G01N190,대구 한국가스공사,Home,차바위,0,0,1,0.0,0,3,0.0,0,4,0.0,0,0,0.0,3,8,11,3,1,0,0,0,2,4
../kbl_data/2021-2022,S39G01N190,대구 한국가스공사,Home,두경민,10,2,6,33.3,0,6,0.0,2,12,16.7,6,6,100.0,0,2,2,7,0,0,0,0,0,3
../kbl_data/2021-2022,S39G01N190,대구 한국가스공사,Home,박봉진,0,0,0,0.0,0,0,0.0,0,0,0.0,0,0,0.0,0,0,0,0,0,0,0,0,0,0
../kbl_data/2021-2022,S39G01N190,대구 한국가스공사,Home,김낙현,19,5,9,55.6,2,6,33.3,7,15,46.7,3,3,100.0,1,2,3,3,0,0,1,0,1,1
../kbl_data/2021-2022,S39G01N190,대구 한국가스공사,Home,전현우,11,0,0,0.0,3,5,60.0,3,5,60.0,2,3,66.7,2,3,5,1,1,0,1,0,0,3
../kbl_data/2021-2022,S39G01N190,대구 한국가스공사,Home,이윤기,0,0,0,0.0,0,0,0.0,0,0,0.0,0,0,0.0,0,0,0,0,0,0,0,0,0,0
../kbl_data/2021-2022,S39G01N190,대구 한국가스공사,Home,양준우,0,0,0,0.0,0,0,0.0,0,0,0.0,0,0,0.0,0,0,0,0,0,0,0,0,0,0
../kbl_data/2021-2022,S39G01N190,대구 한국가스공사,Home,앤드류 니콜슨,33,10,14,71.4,2,6,33.3,12,20,60.0,7,8,87.5,1,6,7,2,0,1,0,1,3,2
../kbl_data/2021-2022,S39G01N190,대구 한국가스공사,Home,신승민,7,1,1,100.0,1,1,100.0,2,2,100.0,2,2,100.0,0,0,0,0,2,0,1,0,1,4
../kbl_data/2021-2022,S39G01N190,대구 한국가스공사,Home,디제이 화이트,3,0,2,0.0,1,1,100.0,1,3,33.3,0,0,0.0,0,1,1,0,0,1,0,0,1,2
../kbl_data/2021-2022,S39G01N190,창원 LG,Away,강병현,0,0,0,0.0,0,0,0.0,0,0,0.0,0,0,0.0,0,0,0,0,0,0,0,0,0,0
../kbl_data/2021-2022,S39G01N190,창원 LG,Away,이관희,23,4,13,30.8,4,7,57.1,8,20,40.0,3,3,100.0,0,5,5,1,1,0,0,0,0,2
../kbl_data/2021-2022,S39G01N190,창원 LG,Away,정희재,10,1,1,100.0,2,3,66.7,3,4,75.0,2,3,66.7,1,3,4,0,0,0,0,0,3,2
../kbl_data/2021-2022,S39G01N190,창원 LG,Away,서민수,3,0,1,0.0,1,2,50.0,1,3,33.3,0,0,0.0,1,1,2,0,0,0,0,0,1,2
../kbl_data/2021-2022,S39G01N190,창원 LG,Away,한상혁,0,0,0,0.0,0,1,0.0,0,1,0.0,0,0,0.0,0,0,0,1,0,0,0,0,0,0
../kbl_data/2021-2022,S39G01N190,창원 LG,Away,이재도,4,2,4,50.0,0,2,0.0,2,6,33.3,0,0,0.0,0,0,0,5,0,0,0,0,1,3
../kbl_data/2021-2022,S39G01N190,창원 LG,Away,정인덕,0,0,0,0.0,0,0,0.0,0,0,0.0,0,0,0.0,0,0,0,0,0,0,0,0,0,0
../kbl_data/2021-2022,S39G01N190,창원 LG,Away,정해원,9,0,1,0.0,3,4,75.0,3,5,60.0,0,0,0.0,0,1,1,0,3,0,0,0,0,4
../kbl_data/2021-2022,S39G01N190,창원 LG,Away,박정현,0,0,1,0.0,0,0,0.0,0,1,0.0,0,0,0.0,0,0,0,0,0,0,0,0,0,0
../kbl_data/2021-2022,S39G01N190,창원 LG,Away,아셈 마레이,17,7,14,50.0,0,0,0.0,7,14,50.0,3,4,75.0,5,10,15,5,1,0,0,0,2,3
../kbl_data/2021-2022,S39G01N190,창원 LG,Away,이승우,14,7,12,58.3,0,0,0.0,7,12,58.3,0,0,0.0,4,4,8,2,0,0,1,0,2,4
../kbl_data/2021-2022,S39G01N190,창원 LG,Away,사마르도 사무엘스,0,0,2,0.0,0,2,0.0,0,4,0.0,0,0,0.0,2,1,3,1,0,0,0,0,1,1
../kbl_data/2021-2022,S39G01N191,전주 KCC,Home,이정현,12,1,5,20.0,2,5,40.0,3,10,30.0,4,5,80.0,2,2,4,1,0,0,0,0,1,3
../kbl_data/2021-2022,S39G01N191,전주 KCC,Home,정창영,11,3,4,75.0,1,2,50.0,4,6,66.7,2,3,66.7,0,1,1,1,0,0,0,0,0,2
../kbl_data/2021-2022,S39G01N191,전주 KCC,Home,라건아,10,5,13,38.5,0,3,0.0,5,16,31.2,0,0,0.0,3,13,16,3,0,0,0,0,3,2
../kbl_data/2021-2022,S39G01N191,전주 KCC,Home,김지완,14,1,3,33.3,4,9,44.4,5,12,41.7,0,0,0.0,0,0,0,1,1,0,0,0,3,1
../kbl_data/2021-2022,S39G01N191,전주 KCC,Home,김상규,4,1,3,33.3,0,1,0.0,1,4,25.0,2,2,100.0,0,3,3,1,0,0,1,0,0,1
../kbl_data/2021-2022,S39G01N191,전주 KCC,Home,전준범,4,0,1,0.0,1,4,25.0,1,5,20.0,1,2,50.0,0,3,3,1,0,0,0,0,0,2
../kbl_data/2021-2022,S39G01N191,전주 KCC,Home,박재현,8,1,1,100.0,2,2,100.0,3,3,100.0,0,0,0.0,0,0,0,1,1,0,0,0,1,5
../kbl_data/2021-2022,S39G01N191,전주 KCC,Home,송교창,2,1,3,33.3,0,5,0.0,1,8,12.5,0,0,0.0,0,6,6,6,0,1,0,0,2,2
../kbl_data/2021-2022,S39G01N191,전주 KCC,Home,이진욱,0,0,0,0.0,0,0,0.0,0,0,0.0,0,0,0.0,0,0,0,0,0,0,0,0,0,0
../kbl_data/2021-2022,S39G01N191,전주 KCC,Home,유현준,7,0,1,0.0,2,4,50.0,2,5,40.0,1,2,50.0,3,0,3,2,1,1,0,0,2,0
../kbl_data/2021-2022,S39G01N191,전주 KCC,Home,라타비우스 윌리엄스,0,0,0,0.0,0,0,0.0,0,0,0.0,0,0,0.0,0,0,0,0,0,0,0,0,0,0
../kbl_data/2021-2022,S39G01N191,전주 KCC,Home,곽정훈,0,0,0,0.0,0,0,0.0,0,0,0.0,0,0,0.0,0,0,0,0,0,0,0,0,0,0
../kbl_data/2021-2022,S39G01N191,서울 SK,Away,양우섭,0,0,2,0.0,0,0,0.0,0,2,0.0,0,0,0.0,0,0,0,2,1,0,0,0,0,1
../kbl_data/2021-2022,S39G01N191,서울 SK,Away,허일영,9,2,3,66.7,1,4,25.0,3,7,42.9,2,2,100.0,3,1,4,1,0,0,0,0,1,3
../kbl_data/2021-2022,S39G01N191,서울 SK,Away,김선형,11,5,11,45.5,0,2,0.0,5,13,38.5,1,1,100.0,1,5,6,3,2,0,0,0,2,2
../kbl_data/2021-2022,S39G01N191,서울 SK,Away,최부경,4,2,5,40.0,0,2,0.0,2,7,28.6,0,0,0.0,2,0,2,2,1,0,0,0,0,1
../kbl_data/2021-2022,S39G01N191,서울 SK,Away,리온 윌리엄스,0,0,0,0.0,0,0,0.0,0,0,0.0,0,0,0.0,0,1,1,0,0,0,0,0,0,2
../kbl_data/2021-2022,S39G01N191,서울 SK,Away,배병준,0,0,0,0.0,0,0,0.0,0,0,0.0,0,0,0.0,0,0,0,0,0,0,0,0,0,0
../kbl_data/2021-2022,S39G01N191,서울 SK,Away,이현석,9,1,1,100.0,2,5,40.0,3,6,50.0,1,2,50.0,0,2,2,1,1,0,0,0,0,3
../kbl_data/2021-2022,S39G01N191,서울 SK,Away,최원혁,2,1,1,100.0,0,0,0.0,1,1,100.0,0,0,0.0,2,0,2,1,0,0,0,0,0,4
../kbl_data/2021-2022,S39G01N191,서울 SK,Away,최준용,16,5,8,62.5,2,3,66.7,7,11,63.6,0,0,0.0,1,9,10,8,2,3,0,1,3,1
../kbl_data/2021-2022,S39G01N191,서울 SK,Away,안영준,13,3,6,50.0,2,7,28.6,5,13,38.5,1,2,50.0,1,5,6,1,1,1,0,0,0,2
../kbl_data/2021-2022,S39G01N191,서울 SK,Away,자밀 워니,22,8,17,47.1,1,2,50.0,9,19,47.4,3,4,75.0,4,11,15,0,2,2,0,3,2,0
../kbl_data/2021-2022,S39G01N191,서울 SK,Away,오재현,0,0,0,0.0,0,0,0.0,0,0,0.0,0,0,0.0,0,0,0,0,0,0,0,0,0,0
../kbl_data/2021-2022,S39G01N192,고양 오리온,Home,오용준,0,0,0,0.0,0,0,0.0,0,0,0.0,0,0,0.0,0,0,0,0,0,0,0,0,0,0
../kbl_data/2021-2022,S39G01N192,고양 오리온,Home,김강선,6,0,0,0.0,1,2,50.0,1,2,50.0,3,3,100.0,1,2,3,1,0,0,0,0,0,2
../kbl_data/2021-2022,S39G01N192,고양 오리온,Home,최현민,3,0,1,0.0,1,3,33.3,1,4,25.0,0,0,0.0,2,1,3,2,0,1,0,0,0,0
../kbl_data/2021-2022,S39G01N192,고양 오리온,Home,이대성,11,4,13,30.8,0,3,0.0,4,16,25.0,3,4,75.0,0,2,2,6,0,1,0,0,3,3
../kbl_data/2021-2022,S39G01N192,고양 오리온,Home,한호빈,9,2,5,40.0,1,3,33.3,3,8,37.5,2,2,100.0,0,1,1,4,1,0,0,0,0,3
../kbl_data/2021-2022,S39G01N192,고양 오리온,Home,이정제,2,1,2,50.0,0,0,0.0,1,2,50.0,0,0,0.0,0,1,1,0,0,1,0,0,2,3
../kbl_data/2021-2022,S39G01N192,고양 오리온,Home,이승현,15,6,15,40.0,1,1,100.0,7,16,43.8,0,0,0.0,2,8,10,1,1,1,0,0,2,3
../kbl_data/2021-2022,S39G01N192,고양 오리온,Home,김진유,0,0,0,0.0,0,0,0.0,0,0,0.0,0,0,0.0,0,0,0,0,0,0,0,0,0,0
../kbl_data/2021-2022,S39G01N192,고양 오리온,Home,제임스 메이스,18,5,12,41.7,1,3,33.3,6,15,40.0,5,9,55.6,6,6,12,0,3,3,0,0,2,5
../kbl_data/2021-2022,S39G01N192,고양 오리온,Home,박진철,0,0,0,0.0,0,0,0.0,0,0,0.0,0,0,0.0,0,4,4,0,2,2,0,0,0,3
../kbl_data/2021-2022,S39G01N192,고양 오리온,Home,이정현,0,0,0,0.0,0,1,0.0,0,1,0.0,0,0,0.0,0,0,0,0,0,0,0,0,0,1
../kbl_data/2021-2022,S39G01N192,고양 오리온,Home,문시윤,0,0,0,0.0,0,0,0.0,0,0,0.0,0,0,0.0,0,0,0,0,0,0,0,0,0,0
../kbl_data/2021-2022,S39G01N192,울산 현대모비스,Away,이현민,0,0,1,0.0,0,1,0.0,0,2,0.0,0,0,0.0,0,1,1,3,1,0,0,0,1,4
../kbl_data/2021-2022,S39G01N192,울산 현대모비스,Away,함지훈,19,3,6,50.0,2,3,66.7,5,9,55.6,7,8,87.5,3,1,4,3,0,0,0,0,0,0
../kbl_data/2021-2022,S39G01N192,울산 현대모비스,Away,최진수,13,3,7,42.9,1,1,100.0,4,8,50.0,4,4,100.0,1,5,6,0,0,0,0,0,1,1
../kbl_data/2021-2022,S39G01N192,울산 현대모비스,Away,박지훈,0,0,0,0.0,0,0,0.0,0,0,0.0,0,0,0.0,1,1,2,0,1,0,0,0,0,0
../kbl_data/2021-2022,S39G01N192,울산 현대모비스,Away,장재석,0,0,4,0.0,0,0,0.0,0,4,0.0,0,0,0.0,3,0,3,0,0,0,0,0,0,3
../kbl_data/2021-2022,S39G01N192,울산 현대모비스,Away,김영현,0,0,0,0.0,0,0,0.0,0,0,0.0,0,0,0.0,0,0,0,0,0,0,0,0,0,0
../kbl_data/2021-2022,S39G01N192,울산 현대모비스,Away,김국찬,0,0,1,0.0,0,0,0.0,0,1,0.0,0,0,0.0,0,1,1,1,0,0,0,0,0,0
../kbl_data/2021-2022,S39G01N192,울산 현대모비스,Away,서명진,6,2,2,100.0,0,2,0.0,2,4,50.0,2,2,100.0,0,1,1,3,1,0,0,0,3,3
../kbl_data/2021-2022,S39G01N192,울산 현대모비스,Away,이우석,6,3,8,37.5,0,3,0.0,3,11,27.3,0,0,0.0,1,7,8,2,0,0,0,0,0,3
../kbl_data/2021-2022,S39G01N192,울산 현대모비스,Away,라숀 토마스,24,7,22,31.8,0,0,0.0,7,22,31.8,10,14,71.4,7,10,17,4,2,2,0,1,2,4
../kbl_data/2021-2022,S39G01N192,울산 현대모비스,Away,신민석,0,0,0,0.0,0,1,0.0,0,1,0.0,0,0,0.0,0,0,0,0,0,0,0,0,0,0
../kbl_data/2021-2022,S39G01N192,울산 현대모비스,Away,에릭 버크너,0,0,2,0.0,0,0,0.0,0,2,0.0,0,0,0.0,1,1,2,0,0,1,0,0,1,0
../kbl_data/2021-2022,S39G01N193,대구 한국가스공사,Home,민성주,0,0,0,0.0,0,0,0.0,0,0,0.0,0,0,0.0,0,0,0,0,0,0,0,0,0,0
../kbl_data/2021-2022,S39G01N193,대구 한국가스공사,Home,홍경기,0,0,0,0.0,0,1,0.0,0,1,0.0,0,0,0.0,0,1,1,1,0,0,1,0,0,2
../kbl_data/2021-2022,S39G01N193,대구 한국가스공사,Home,차바위,5,0,0,0.0,1,2,50.0,1,2,50.0,2,2,100.0,2,1,3,1,0,0,0,0,1,5
../kbl_data/2021-2022,S39G01N193,대구 한국가스공사,Home,이대헌,17,6,10,60.0,1,1,100.0,7,11,63.6,2,3,66.7,1,3,4,2,1,0,0,0,3,2
../kbl_data/2021-2022,S39G01N193,대구 한국가스공사,Home,김낙현,19,1,3,33.3,4,9,44.4,5,12,41.7,5,5,100.0,0,4,4,11,0,0,0,0,0,1
../kbl_data/2021-2022,S39G01N193,대구 한국가스공사,Home,전현우,14,0,5,0.0,4,5,80.0,4,10,40.0,2,2,100.0,1,3,4,0,2,0,0,0,0,4
../kbl_data/2021-2022,S39G01N193,대구 한국가스공사,Home,이윤기,0,0,0,0.0,0,0,0.0,0,0,0.0,0,0,0.0,0,0,0,0,0,0,0,0,0,0
../kbl_data/2021-2022,S39G01N193,대구 한국가스공사,Home,양준우,6,0,0,0.0,2,2,100.0,2,2,100.0,0,0,0.0,0,2,2,3,0,0,0,0,1,0
../kbl_data/2021-2022,S39G01N193,대구 한국가스공사,Home,이도헌,0,0,0,0.0,0,0,0.0,0,0,0.0,0,0,0.0,0,0,0,0,0,0,0,0,0,0
../kbl_data/2021-2022,S39G01N193,대구 한국가스공사,Home,앤드류 니콜슨,28,9,17,52.9,2,8,25.0,11,25,44.0,4,4,100.0,2,9,11,1,1,0,0,1,2,1
../kbl_data/2021-2022,S39G01N193,대구 한국가스공사,Home,신승민,1,0,1,0.0,0,1,0.0,0,2,0.0,1,2,50.0,4,2,6,1,1,1,0,0,0,2
../kbl_data/2021-2022,S39G01N193,대구 한국가스공사,Home,디제이 화이트,6,1,2,50.0,1,1,100.0,2,3,66.7,1,2,50.0,0,2,2,0,0,0,0,1,2,1
../kbl_data/2021-2022,S39G01N193,원주 DB,Away,윤호영,0,0,0,0.0,0,0,0.0,0,0,0.0,0,0,0.0,0,0,0,0,0,0,0,0,0,0
../kbl_data/2021-2022,S39G01N193,원주 DB,Away,박찬희,2,1,4,25.0,0,2,0.0,1,6,16.7,0,0,0.0,1,1,2,3,0,0,0,0,1,0
../kbl_data/2021-2022,S39G01N193,원주 DB,Away,김현호,0,0,0,0.0,0,1,0.0,0,1,0.0,0,0,0.0,0,0,0,0,0,0,0,0,0,3
../kbl_data/2021-2022,S39G01N193,원주 DB,Away,정준원,0,0,0,0.0,0,0,0.0,0,0,0.0,0,0,0.0,0,0,0,0,0,0,0,0,0,0
../kbl_data/2021-2022,S39G01N193,원주 DB,Away,김종규,9,3,6,50.0,1,3,33.3,4,9,44.4,0,2,0.0,1,5,6,1,0,0,0,1,2,4
../kbl_data/2021-2022,S39G01N193,원주 DB,Away,허웅,27,5,8,62.5,2,6,33.3,7,14,50.0,11,11,100.0,0,6,6,4,0,0,0,0,0,2
../kbl_data/2021-2022,S39G01N193,원주 DB,Away,김영훈,6,0,1,0.0,2,3,66.7,2,4,50.0,0,0,0.0,2,0,2,1,2,0,1,0,0,2
../kbl_data/2021-2022,S39G01N193,원주 DB,Away,강상재,4,0,2,0.0,1,4,25.0,1,6,16.7,1,2,50.0,1,4,5,3,0,0,0,0,1,0
../kbl_data/2021-2022,S39G01N193,원주 DB,Away,김철욱,0,0,0,0.0,0,0,0.0,0,0,0.0,0,0,0.0,0,0,0,0,0,0,0,0,0,0
../kbl_data/2021-2022,S39G01N193,원주 DB,Away,이용우,11,2,6,33.3,2,3,66.7,4,9,44.4,1,2,50.0,0,0,0,2,0,0,0,0,0,2
../kbl_data/2021-2022,S39G01N193,원주 DB,Away,이준희,10,3,3,100.0,1,5,20.0,4,8,50.0,1,2,50.0,0,1,1,6,1,0,0,0,1,3
../kbl_data/2021-2022,S39G01N193,원주 DB,Away,조니 오브라이언트,21,9,11,81.8,1,4,25.0,10,15,66.7,0,0,0.0,3,8,11,3,0,0,0,0,2,4
../kbl_data/2021-2022,S39G01N194,창원 LG,Home,강병현,5,1,1,100.0,1,3,33.3,2,4,50.0,0,0,0.0,0,0,0,1,0,0,0,0,0,2
../kbl_data/2021-2022,S39G01N194,창원 LG,Home,이관희,14,0,4,0.0,4,6,66.7,4,10,40.0,2,2,100.0,1,3,4,1,1,0,0,0,1,2
../kbl_data/2021-2022,S39G01N194,창원 LG,Home,정희재,0,0,0,0.0,0,1,0.0,0,1,0.0,0,0,0.0,1,0,1,0,0,0,0,0,0,1
../kbl_data/2021-2022,S39G01N194,창원 LG,Home,서민수,0,0,0,0.0,0,2,0.0,0,2,0.0,0,0,0.0,0,1,1,1,0,0,0,0,1,4
../kbl_data/2021-2022,S39G01N194,창원 LG,Home,한상혁,0,0,0,0.0,0,0,0.0,0,0,0.0,0,0,0.0,0,0,0,1,0,0,0,0,0,0
../kbl_data/2021-2022,S39G01N194,창원 LG,Home,이재도,2,1,5,20.0,0,0,0.0,1,5,20.0,0,0,0.0,2,1,3,6,1,0,0,0,1,1
../kbl_data/2021-2022,S39G01N194,창원 LG,Home,정해원,0,0,0,0.0,0,0,0.0,0,0,0.0,0,0,0.0,0,0,0,1,0,0,0,0,0,1
../kbl_data/2021-2022,S39G01N194,창원 LG,Home,박정현,12,4,8,50.0,1,1,100.0,5,9,55.6,1,1,100.0,3,5,8,1,1,0,0,0,2,1
../kbl_data/2021-2022,S39G01N194,창원 LG,Home,아셈 마레이,24,11,19,57.9,0,0,0.0,11,19,57.9,2,2,100.0,5,8,13,8,0,1,0,1,2,3
../kbl_data/2021-2022,S39G01N194,창원 LG,Home,이승우,16,3,7,42.9,2,4,50.0,5,11,45.5,4,6,66.7,3,6,9,2,0,0,0,0,1,2
../kbl_data/2021-2022,S39G01N194,창원 LG,Home,김종호,8,0,0,0.0,2,3,66.7,2,3,66.7,2,2,100.0,0,1,1,0,0,0,0,0,1,3
../kbl_data/2021-2022,S39G01N194,창원 LG,Home,사마르도 사무엘스,13,3,5,60.0,2,2,100.0,5,7,71.4,1,1,100.0,1,5,6,1,0,0,0,0,1,2
../kbl_data/2021-2022,S39G01N194,안양 KGC,Away,함준후,0,0,0,0.0,0,0,0.0,0,0,0.0,0,0,0.0,0,0,0,1,0,0,0,0,0,0
../kbl_data/2021-2022,S39G01N194,안양 KGC,Away,오세근,20,8,12,66.7,0,0,0.0,8,12,66.7,4,6,66.7,3,3,6,3,1,0,0,0,2,2
../kbl_data/2021-2022,S39G01N194,안양 KGC,Away,문성곤,3,0,2,0.0,0,6,0.0,0,8,0.0,3,4,75.0,4,4,8,0,0,0,0,0,2,3
../kbl_data/2021-2022,S39G01N194,안양 KGC,Away,전성현,18,2,5,40.0,3,9,33.3,5,14,35.7,5,5,100.0,0,3,3,2,2,0,0,0,0,2
../kbl_data/2021-2022,S39G01N194,안양 KGC,Away,박지훈,0,0,0,0.0,0,1,0.0,0,1,0.0,0,0,0.0,0,2,2,1,0,0,0,0,1,3
../kbl_data/2021-2022,S39G01N194,안양 KGC,Away,이우정,0,0,0,0.0,0,0,0.0,0,0,0.0,0,0,0.0,0,0,0,0,0,0,0,0,0,0
../kbl_data/2021-2022,S39G01N194,안양 KGC,Away,대릴 먼로,1,0,2,0.0,0,0,0.0,0,2,0.0,1,2,50.0,0,1,1,0,0,0,0,0,0,0
../kbl_data/2021-2022,S39G01N194,안양 KGC,Away,우동현,0,0,1,0.0,0,1,0.0,0,2,0.0,0,0,0.0,0,0,0,0,1,0,0,0,0,0
../kbl_data/2021-2022,S39G01N194,안양 KGC,Away,변준형,2,1,4,25.0,0,5,0.0,1,9,11.1,0,0,0.0,3,0,3,3,2,0,0,0,1,4
../kbl_data/2021-2022,S39G01N194,안양 KGC,Away,한승희,2,1,1,100.0,0,0,0.0,1,1,100.0,0,0,0.0,1,0,1,0,0,0,0,0,0,1
../kbl_data/2021-2022,S39G01N194,안양 KGC,Away,오마리 스펠맨,19,4,8,50.0,2,9,22.2,6,17,35.3,5,6,83.3,2,6,8,6,1,2,0,1,1,2
../kbl_data/2021-2022,S39G01N194,안양 KGC,Away,주현우,0,0,0,0.0,0,0,0.0,0,0,0.0,0,0,0.0,0,0,0,0,0,0,0,0,0,2
../kbl_data/2021-2022,S39G01N195,서울 SK,Home,양우섭,2,1,1,100.0,0,0,0.0,1,1,100.0,0,0,0.0,1,0,1,0,0,0,0,0,0,1
../kbl_data/2021-2022,S39G01N195,서울 SK,Home,허일영,0,0,2,0.0,0,2,0.0,0,4,0.0,0,0,0.0,0,1,1,0,0,0,0,0,1,1
../kbl_data/2021-2022,S39G01N195,서울 SK,Home,김선형,22,9,13,69.2,1,3,33.3,10,16,62.5,1,2,50.0,1,0,1,5,1,0,0,0,3,1
../kbl_data/2021-2022,S39G01N195,서울 SK,Home,최부경,0,0,0,0.0,0,0,0.0,0,0,0.0,0,0,0.0,3,2,5,1,0,0,0,0,0,3
../kbl_data/2021-2022,S39G01N195,서울 SK,Home,리온 윌리엄스,0,0,1,0.0,0,0,0.0,0,1,0.0,0,0,0.0,0,1,1,0,0,0,0,0,0,1
../kbl_data/2021-2022,S39G01N195,서울 SK,Home,배병준,0,0,0,0.0,0,0,0.0,0,0,0.0,0,0,0.0,0,0,0,0,0,0,0,0,0,0
../kbl_data/2021-2022,S39G01N195,서울 SK,Home,이현석,2,1,2,50.0,0,1,0.0,1,3,33.3,0,0,0.0,1,2,3,0,0,0,0,0,0,2
../kbl_data/2021-2022,S39G01N195,서울 SK,Home,최원혁,0,0,0,0.0,0,1,0.0,0,1,0.0,0,0,0.0,0,1,1,1,1,0,0,0,1,3
../kbl_data/2021-2022,S39G01N195,서울 SK,Home,최준용,16,5,14,35.7,0,1,0.0,5,15,33.3,6,7,85.7,6,9,15,1,0,1,0,0,2,4
../kbl_data/2021-2022,S39G01N195,서울 SK,Home,안영준,11,4,7,57.1,1,3,33.3,5,10,50.0,0,0,0.0,4,3,7,0,1,1,0,0,3,2
../kbl_data/2021-2022,S39G01N195,서울 SK,Home,자밀 워니,27,10,24,41.7,0,3,0.0,10,27,37.0,7,7,100.0,2,11,13,5,2,1,0,0,2,1
../kbl_data/2021-2022,S39G01N195,서울 SK,Home,오재현,0,0,1,0.0,0,1,0.0,0,2,0.0,0,0,0.0,2,0,2,0,0,0,0,0,0,0
../kbl_data/2021-2022,S39G01N195,수원 KT,Away,김동욱,3,0,0,0.0,1,6,16.7,1,6,16.7,0,0,0.0,0,0,0,3,1,0,0,0,0,2
../kbl_data/2021-2022,S39G01N195,수원 KT,Away,김영환,6,1,5,20.0,1,5,20.0,2,10,20.0,1,1,100.0,0,5,5,1,0,0,0,0,1,3
../kbl_data/2021-2022,S39G01N195,수원 KT,Away,최창진,0,0,0,0.0,0,0,0.0,0,0,0.0,0,0,0.0,0,0,0,0,0,0,0,0,0,0
../kbl_data/2021-2022,S39G01N195,수원 KT,Away,정성우,9,0,2,0.0,3,6,50.0,3,8,37.5,0,0,0.0,0,1,1,3,3,0,1,0,1,2
../kbl_data/2021-2022,S39G01N195,수원 KT,Away,허훈,12,2,4,50.0,2,7,28.6,4,11,36.4,2,2,100.0,0,1,1,5,2,0,0,0,3,2
../kbl_data/2021-2022,S39G01N195,수원 KT,Away,양홍석,17,3,7,42.9,3,5,60.0,6,12,50.0,2,2,100.0,3,3,6,1,1,0,0,0,2,3
../kbl_data/2021-2022,S39G01N195,수원 KT,Away,박준영,2,1,1,100.0,0,1,0.0,1,2,50.0,0,0,0.0,0,1,1,0,0,0,0,0,0,3
../kbl_data/2021-2022,S39G01N195,수원 KT,Away,캐디 라렌,17,6,13,46.2,0,2,0.0,6,15,40.0,5,6,83.3,5,9,14,1,1,4,0,0,3,4
../kbl_data/2021-2022,S39G01N195,수원 KT,Away,문상옥,0,0,0,0.0,0,0,0.0,0,0,0.0,0,0,0.0,0,0,0,0,0,0,0,0,0,0
../kbl_data/2021-2022,S39G01N195,수원 KT,Away,박지원,0,0,0,0.0,0,0,0.0,0,0,0.0,0,0,0.0,0,0,0,0,0,0,0,0,0,0
../kbl_data/2021-2022,S39G01N195,수원 KT,Away,마이크 마이어스,4,2,3,66.7,0,0,0.0,2,3,66.7,0,0,0.0,0,2,2,0,0,1,0,1,0,2
../kbl_data/2021-2022,S39G01N195,수원 KT,Away,하윤기,5,2,3,66.7,0,0,0.0,2,3,66.7,1,2,50.0,2,2,4,0,0,0,0,0,0,0
../kbl_data/2021-2022,S39G01N196,원주 DB,Home,윤호영,0,0,0,0.0,0,0,0.0,0,0,0.0,0,0,0.0,0,0,0,0,0,0,0,0,0,0
../kbl_data/2021-2022,S39G01N196,원주 DB,Home,박찬희,2,1,1,100.0,0,1,0.0,1,2,50.0,0,0,0.0,1,0,1,1,0,0,1,0,1,1
../kbl_data/2021-2022,S39G01N196,원주 DB,Home,김현호,5,1,1,100.0,1,3,33.3,2,4,50.0,0,0,0.0,1,3,4,2,1,0,0,0,1,1
../kbl_data/2021-2022,S39G01N196,원주 DB,Home,정준원,4,2,6,33.3,0,0,0.0,2,6,33.3,0,0,0.0,4,0,4,1,2,0,0,0,0,4
../kbl_data/2021-2022,S39G01N196,원주 DB,Home,김종규,10,5,9,55.6,0,0,0.0,5,9,55.6,0,0,0.0,3,9,12,1,0,1,0,1,0,3
../kbl_data/2021-2022,S39G01N196,원주 DB,Home,허웅,15,2,6,33.3,2,5,40.0,4,11,36.4,5,6,83.3,0,2,2,7,0,1,0,0,1,2
../kbl_data/2021-2022,S39G01N196,원주 DB,Home,김영훈,0,0,0,0.0,0,0,0.0,0,0,0.0,0,0,0.0,0,0,0,0,0,0,0,0,0,0
../kbl_data/2021-2022,S39G01N196,원주 DB,Home,강상재,8,4,8,50.0,0,0,0.0,4,8,50.0,0,0,0.0,3,4,7,1,2,0,0,0,2,3
../kbl_data/2021-2022,S39G01N196,원주 DB,Home,김철욱,0,0,2,0.0,0,1,0.0,0,3,0.0,0,0,0.0,0,0,0,2,0,0,0,0,0,1
../kbl_data/2021-2022,S39G01N196,원주 DB,Home,이용우,9,1,3,33.3,2,2,100.0,3,5,60.0,1,2,50.0,1,3,4,0,2,0,0,0,1,1
../kbl_data/2021-2022,S39G01N196,원주 DB,Home,이준희,2,1,5,20.0,0,0,0.0,1,5,20.0,0,0,0.0,2,1,3,1,0,0,0,0,0,0
../kbl_data/2021-2022,S39G01N196,원주 DB,Home,조니 오브라이언트,24,7,13,53.8,3,12,25.0,10,25,40.0,1,1,100.0,2,6,8,3,1,1,1,1,2,2
../kbl_data/2021-2022,S39G01N196,울산 현대모비스,Away,이현민,3,0,1,0.0,1,1,100.0,1,2,50.0,0,0,0.0,0,2,2,2,0,0,0,0,1,1
../kbl_data/2021-2022,S39G01N196,울산 현대모비스,Away,함지훈,12,5,9,55.6,0,1,0.0,5,10,50.0,2,2,100.0,1,1,2,6,0,1,0,0,1,1
../kbl_data/2021-2022,S39G01N196,울산 현대모비스,Away,최진수,2,1,1,100.0,0,2,0.0,1,3,33.3,0,0,0.0,0,2,2,1,0,1,0,0,0,1
../kbl_data/2021-2022,S39G01N196,울산 현대모비스,Away,박지훈,0,0,0,0.0,0,1,0.0,0,1,0.0,0,0,0.0,0,0,0,0,0,0,0,0,0,0
../kbl_data/2021-2022,S39G01N196,울산 현대모비스,Away,장재석,2,1,4,25.0,0,0,0.0,1,4,25.0,0,0,0.0,3,0,3,0,1,1,0,0,1,0
../kbl_data/2021-2022,S39G01N196,울산 현대모비스,Away,김영현,2,1,2,50.0,0,3,0.0,1,5,20.0,0,0,0.0,0,0,0,0,1,1,1,0,0,3
../kbl_data/2021-2022,S39G01N196,울산 현대모비스,Away,김국찬,8,1,1,100.0,2,5,40.0,3,6,50.0,0,0,0.0,0,0,0,0,0,0,0,0,0,3
../kbl_data/2021-2022,S39G01N196,울산 현대모비스,Away,서명진,0,0,2,0.0,0,4,0.0,0,6,0.0,0,0,0.0,1,4,5,5,1,0,0,0,3,0
../kbl_data/2021-2022,S39G01N196,울산 현대모비스,Away,이우석,7,3,6,50.0,0,2,0.0,3,8,37.5,1,1,100.0,1,3,4,4,0,0,0,0,2,1
../kbl_data/2021-2022,S39G01N196,울산 현대모비스,Away,라숀 토마스,25,11,20,55.0,0,1,0.0,11,21,52.4,3,4,75.0,7,7,14,3,1,2,0,1,3,2
../kbl_data/2021-2022,S39G01N196,울산 현대모비스,Away,신민석,0,0,0,0.0,0,0,0.0,0,0,0.0,0,0,0.0,0,0,0,0,0,0,0,0,0,0
../kbl_data/2021-2022,S39G01N196,울산 현대모비스,Away,에릭 버크너,7,3,5,60.0,0,0,0.0,3,5,60.0,1,2,50.0,0,6,6,1,1,0,0,1,1,1
../kbl_data/2021-2022,S39G01N197,전주 KCC,Home,이정현,5,1,3,33.3,0,5,0.0,1,8,12.5,3,3,100.0,0,1,1,1,0,0,0,0,0,0
../kbl_data/2021-2022,S39G01N197,전주 KCC,Home,정창영,3,1,2,50.0,0,2,0.0,1,4,25.0,1,2,50.0,0,1,1,2,0,0,0,0,1,1
../kbl_data/2021-2022,S39G01N197,전주 KCC,Home,라건아,25,7,11,63.6,0,1,0.0,7,12,58.3,11,11,100.0,6,11,17,4,0,0,0,2,2,1
../kbl_data/2021-2022,S39G01N197,전주 KCC,Home,김지완,9,1,1,100.0,2,4,50.0,3,5,60.0,1,2,50.0,0,1,1,5,3,0,0,0,1,3
../kbl_data/2021-2022,S39G01N197,전주 KCC,Home,김상규,12,3,4,75.0,1,1,100.0,4,5,80.0,3,5,60.0,2,6,8,1,1,0,0,0,0,2
../kbl_data/2021-2022,S39G01N197,전주 KCC,Home,전준범,14,2,3,66.7,2,6,33.3,4,9,44.4,4,5,80.0,0,3,3,2,3,0,0,0,0,3
../kbl_data/2021-2022,S39G01N197,전주 KCC,Home,박재현,3,0,1,0.0,1,2,50.0,1,3,33.3,0,0,0.0,0,0,0,0,0,0,0,0,0,4
../kbl_data/2021-2022,S39G01N197,전주 KCC,Home,송교창,0,0,0,0.0,0,0,0.0,0,0,0.0,0,0,0.0,1,0,1,0,0,0,0,0,1,0
../kbl_data/2021-2022,S39G01N197,전주 KCC,Home,이진욱,14,3,6,50.0,1,1,100.0,4,7,57.1,5,6,83.3,0,1,1,2,0,0,0,0,1,4
../kbl_data/2021-2022,S39G01N197,전주 KCC,Home,유현준,4,0,0,0.0,0,1,0.0,0,1,0.0,4,4,100.0,0,0,0,1,1,0,0,0,1,1
../kbl_data/2021-2022,S39G01N197,전주 KCC,Home,라타비우스 윌리엄스,8,4,4,100.0,0,0,0.0,4,4,100.0,0,1,0.0,0,3,3,1,0,0,0,1,1,1
../kbl_data/2021-2022,S39G01N197,전주 KCC,Home,곽정훈,2,1,1,100.0,0,0,0.0,1,1,100.0,0,0,0.0,0,1,1,0,0,0,0,0,0,0
../kbl_data/2021-2022,S39G01N197,서울 삼성,Away,김동량,13,4,7,57.1,1,5,20.0,5,12,41.7,2,2,100.0,1,6,7,1,1,0,0,0,1,3
../kbl_data/2021-2022,S39G01N197,서울 삼성,Away,김시래,15,2,3,66.7,2,6,33.3,4,9,44.4,5,6,83.3,2,4,6,5,0,0,0,0,3,1
../kbl_data/2021-2022,S39G01N197,서울 삼성,Away,임동섭,11,2,4,50.0,2,8,25.0,4,12,33.3,1,2,50.0,4,5,9,2,0,0,0,0,0,4
../kbl_data/2021-2022,S39G01N197,서울 삼성,Away,이동엽,5,1,4,25.0,1,1,100.0,2,5,40.0,0,0,0.0,1,0,1,1,0,0,1,0,2,2
../kbl_data/2021-2022,S39G01N197,서울 삼성,Away,배수용,1,0,0,0.0,0,0,0.0,0,0,0.0,1,2,50.0,2,0,2,0,0,1,0,0,2,4
../kbl_data/2021-2022,S39G01N197,서울 삼성,Away,이호현,2,1,3,33.3,0,1,0.0,1,4,25.0,0,0,0.0,0,0,0,0,0,0,0,0,1,0
../kbl_data/2021-2022,S39G01N197,서울 삼성,Away,정희원,3,0,0,0.0,1,4,25.0,1,4,25.0,0,0,0.0,0,2,2,0,0,0,0,0,0,1
../kbl_data/2021-2022,S39G01N197,서울 삼성,Away,정준수,3,1,2,50.0,0,2,0.0,1,4,25.0,1,2,50.0,3,1,4,2,0,0,0,0,0,2
../kbl_data/2021-2022,S39G01N197,서울 삼성,Away,박민우,12,0,3,0.0,4,8,50.0,4,11,36.4,0,0,0.0,2,1,3,0,0,0,0,0,1,5
../kbl_data/2021-2022,S39G01N197,서울 삼성,Away,차민석,4,2,5,40.0,0,0,0.0,2,5,40.0,0,0,0.0,1,1,2,1,0,0,0,0,1,3
../kbl_data/2021-2022,S39G01N197,서울 삼성,Away,전형준,2,1,3,33.3,0,3,0.0,1,6,16.7,0,0,0.0,1,1,2,3,1,0,1,0,0,3
../kbl_data/2021-2022,S39G01N197,서울 삼성,Away,이원석,0,0,0,0.0,0,0,0.0,0,0,0.0,0,0,0.0,0,0,0,0,0,0,0,0,0,0
../kbl_data/2021-2022,S39G01N198,안양 KGC,Home,양희종,3,0,0,0.0,1,3,33.3,1,3,33.3,0,0,0.0,1,5,6,0,0,0,0,0,2,3
../kbl_data/2021-2022,S39G01N198,안양 KGC,Home,함준후,4,2,3,66.7,0,1,0.0,2,4,50.0,0,0,0.0,1,1,2,1,0,0,0,0,0,1
../kbl_data/2021-2022,S39G01N198,안양 KGC,Home,오세근,8,4,6,66.7,0,1,0.0,4,7,57.1,0,0,0.0,0,3,3,2,0,0,0,0,0,2
../kbl_data/2021-2022,S39G01N198,안양 KGC,Home,문성곤,6,0,1,0.0,2,4,50.0,2,5,40.0,0,0,0.0,1,4,5,2,2,0,0,0,0,2
../kbl_data/2021-2022,S39G01N198,안양 KGC,Home,전성현,6,0,0,0.0,2,8,25.0,2,8,25.0,0,0,0.0,1,2,3,1,0,0,0,0,0,1
../kbl_data/2021-2022,S39G01N198,안양 KGC,Home,박지훈,10,2,4,50.0,2,7,28.6,4,11,36.4,0,0,0.0,0,3,3,2,0,0,0,0,1,0
../kbl_data/2021-2022,S39G01N198,안양 KGC,Home,대릴 먼로,6,2,5,40.0,0,4,0.0,2,9,22.2,2,2,100.0,0,2,2,7,2,0,0,0,1,1
../kbl_data/2021-2022,S39G01N198,안양 KGC,Home,우동현,3,0,0,0.0,1,2,50.0,1,2,50.0,0,0,0.0,0,0,0,0,0,0,0,0,0,0
../kbl_data/2021-2022,S39G01N198,안양 KGC,Home,변준형,6,2,4,50.0,0,4,0.0,2,8,25.0,2,2,100.0,0,1,1,5,0,0,0,0,0,0
../kbl_data/2021-2022,S39G01N198,안양 KGC,Home,한승희,4,2,2,100.0,0,2,0.0,2,4,50.0,0,0,0.0,2,4,6,0,0,0,1,0,0,4
../kbl_data/2021-2022,S39G01N198,안양 KGC,Home,오마리 스펠맨,16,5,6,83.3,2,4,50.0,7,10,70.0,0,0,0.0,2,4,6,1,0,1,0,2,1,0
../kbl_data/2021-2022,S39G01N198,안양 KGC,Home,조은후,8,2,2,100.0,1,4,25.0,3,6,50.0,1,1,100.0,1,1,2,0,0,0,0,0,0,2
../kbl_data/2021-2022,S39G01N198,대구 한국가스공사,Away,정영삼,0,0,0,0.0,0,1,0.0,0,1,0.0,0,0,0.0,0,1,1,1,0,0,0,0,0,0
../kbl_data/2021-2022,S39G01N198,대구 한국가스공사,Away,홍경기,6,0,1,0.0,2,4,50.0,2,5,40.0,0,0,0.0,1,0,1,0,0,0,0,0,0,2
../kbl_data/2021-2022,S39G01N198,대구 한국가스공사,Away,차바위,3,0,1,0.0,1,2,50.0,1,3,33.3,0,0,0.0,0,4,4,1,0,0,0,0,0,4
../kbl_data/2021-2022,S39G01N198,대구 한국가스공사,Away,조상열,0,0,0,0.0,0,1,0.0,0,1,0.0,0,0,0.0,1,2,3,1,0,0,0,0,0,1
../kbl_data/2021-2022,S39G01N198,대구 한국가스공사,Away,이대헌,11,3,5,60.0,0,2,0.0,3,7,42.9,5,6,83.3,5,6,11,2,2,0,0,0,4,0
../kbl_data/2021-2022,S39G01N198,대구 한국가스공사,Away,두경민,6,2,4,50.0,0,2,0.0,2,6,33.3,2,2,100.0,1,2,3,5,0,0,0,0,3,1
../kbl_data/2021-2022,S39G01N198,대구 한국가스공사,Away,박봉진,0,0,0,0.0,0,0,0.0,0,0,0.0,0,0,0.0,0,0,0,0,0,0,0,0,0,1
../kbl_data/2021-2022,S39G01N198,대구 한국가스공사,Away,김낙현,3,1,5,20.0,0,4,0.0,1,9,11.1,1,2,50.0,1,2,3,4,1,0,0,0,1,2
../kbl_data/2021-2022,S39G01N198,대구 한국가스공사,Away,전현우,3,0,1,0.0,1,7,14.3,1,8,12.5,0,0,0.0,0,4,4,0,0,0,0,0,1,5
../kbl_data/2021-2022,S39G01N198,대구 한국가스공사,Away,앤드류 니콜슨,16,6,12,50.0,1,2,50.0,7,14,50.0,1,2,50.0,1,7,8,0,0,1,0,0,2,0
../kbl_data/2021-2022,S39G01N198,대구 한국가스공사,Away,신승민,2,1,2,50.0,0,0,0.0,1,2,50.0,0,0,0.0,1,0,1,0,0,0,0,0,1,1
../kbl_data/2021-2022,S39G01N198,대구 한국가스공사,Away,디제이 화이트,15,5,8,62.5,1,4,25.0,6,12,50.0,2,2,100.0,2,4,6,0,0,0,0,0,0,0
../kbl_data/2021-2022,S39G01N199,수원 KT,Home,김동욱,3,0,2,0.0,1,4,25.0,1,6,16.7,0,0,0.0,2,2,4,0,0,0,0,0,1,1
../kbl_data/2021-2022,S39G01N199,수원 KT,Home,김영환,12,0,0,0.0,4,6,66.7,4,6,66.7,0,0,0.0,1,1,2,1,0,0,0,0,1,4
../kbl_data/2021-2022,S39G01N199,수원 KT,Home,김현민,0,0,0,0.0,0,0,0.0,0,0,0.0,0,0,0.0,0,0,0,0,0,0,0,0,0,0
../kbl_data/2021-2022,S39G01N199,수원 KT,Home,최창진,2,0,0,0.0,0,1,0.0,0,1,0.0,2,2,100.0,1,1,2,0,2,0,0,0,2,2
../kbl_data/2021-2022,S39G01N199,수원 KT,Home,정성우,2,1,4,25.0,0,3,0.0,1,7,14.3,0,0,0.0,1,4,5,2,0,0,1,0,0,4
../kbl_data/2021-2022,S39G01N199,수원 KT,Home,허훈,27,9,13,69.2,2,7,28.6,11,20,55.0,3,4,75.0,3,3,6,8,0,0,2,0,3,1
../kbl_data/2021-2022,S39G01N199,수원 KT,Home,양홍석,6,3,6,50.0,0,2,0.0,3,8,37.5,0,0,0.0,1,5,6,2,1,0,0,0,1,1
../kbl_data/2021-2022,S39G01N199,수원 KT,Home,박준영,0,0,0,0.0,0,0,0.0,0,0,0.0,0,0,0.0,0,0,0,0,0,0,0,0,0,0
../kbl_data/2021-2022,S39G01N199,수원 KT,Home,캐디 라렌,26,9,14,64.3,1,2,50.0,10,16,62.5,5,6,83.3,5,6,11,5,0,2,0,3,4,4
../kbl_data/2021-2022,S39G01N199,수원 KT,Home,박지원,0,0,0,0.0,0,0,0.0,0,0,0.0,0,0,0.0,0,0,0,0,0,0,0,0,0,0
../kbl_data/2021-2022,S39G01N199,수원 KT,Home,마이크 마이어스,0,0,1,0.0,0,0,0.0,0,1,0.0,0,0,0.0,0,0,0,0,0,0,0,0,0,0
../kbl_data/2021-2022,S39G01N199,수원 KT,Home,하윤기,6,1,4,25.0,0,0,0.0,1,4,25.0,4,6,66.7,3,1,4,0,0,0,0,0,1,2
../kbl_data/2021-2022,S39G01N199,원주 DB,Away,윤호영,5,2,2,100.0,0,2,0.0,2,4,50.0,1,1,100.0,0,0,0,0,1,0,1,0,0,3
../kbl_data/2021-2022,S39G01N199,원주 DB,Away,박찬희,8,1,3,33.3,2,8,25.0,3,11,27.3,0,0,0.0,1,3,4,6,5,0,0,0,1,3
../kbl_data/2021-2022,S39G01N199,원주 DB,Away,정준원,7,2,3,66.7,1,1,100.0,3,4,75.0,0,0,0.0,2,2,4,0,1,0,0,0,0,2
../kbl_data/2021-2022,S39G01N199,원주 DB,Away,김종규,3,1,4,25.0,0,0,0.0,1,4,25.0,1,1,100.0,0,2,2,4,0,2,0,0,0,3
../kbl_data/2021-2022,S39G01N199,원주 DB,Away,허웅,23,4,5,80.0,3,7,42.9,7,12,58.3,6,7,85.7,0,1,1,3,3,0,0,0,1,1
../kbl_data/2021-2022,S39G01N199,원주 DB,Away,김영훈,0,0,0,0.0,0,0,0.0,0,0,0.0,0,0,0.0,0,0,0,0,0,0,0,0,0,0
../kbl_data/2021-2022,S39G01N199,원주 DB,Away,강상재,9,2,4,50.0,1,1,100.0,3,5,60.0,2,3,66.7,1,2,3,2,0,1,0,0,3,3
../kbl_data/2021-2022,S39G01N199,원주 DB,Away,김철욱,0,0,0,0.0,0,1,0.0,0,1,0.0,0,0,0.0,0,1,1,0,0,0,1,0,0,0
../kbl_data/2021-2022,S39G01N199,원주 DB,Away,나카무라 타이치,0,0,0,0.0,0,0,0.0,0,0,0.0,0,0,0.0,0,0,0,0,0,0,0,0,0,0
../kbl_data/2021-2022,S39G01N199,원주 DB,Away,이용우,15,3,4,75.0,3,4,75.0,6,8,75.0,0,0,0.0,1,1,2,0,0,0,0,0,1,1
../kbl_data/2021-2022,S39G01N199,원주 DB,Away,이준희,0,0,0,0.0,0,0,0.0,0,0,0.0,0,0,0.0,0,0,0,0,0,0,0,0,0,0
../kbl_data/2021-2022,S39G01N199,원주 DB,Away,조니 오브라이언트,22,4,8,50.0,4,9,44.4,8,17,47.1,2,2,100.0,3,9,12,7,0,0,0,0,3,3
../kbl_data/2021-2022,S39G01N200,창원 LG,Home,강병현,3,0,1,0.0,1,3,33.3,1,4,25.0,0,0,0.0,0,2,2,0,0,0,0,0,0,1
../kbl_data/2021-2022,S39G01N200,창원 LG,Home,이관희,11,4,10,40.0,1,8,12.5,5,18,27.8,0,0,0.0,2,0,2,2,0,0,0,0,1,2
../kbl_data/2021-2022,S39G01N200,창원 LG,Home,정희재,0,0,0,0.0,0,0,0.0,0,0,0.0,0,0,0.0,0,0,0,0,0,0,0,0,0,0
../kbl_data/2021-2022,S39G01N200,창원 LG,Home,서민수,3,0,0,0.0,1,3,33.3,1,3,33.3,0,0,0.0,0,1,1,1,0,0,0,0,2,4
../kbl_data/2021-2022,S39G01N200,창원 LG,Home,한상혁,0,0,0,0.0,0,0,0.0,0,0,0.0,0,0,0.0,0,0,0,0,0,0,0,0,0,0
../kbl_data/2021-2022,S39G01N200,창원 LG,Home,이재도,10,3,7,42.9,1,5,20.0,4,12,33.3,1,2,50.0,0,4,4,2,2,0,0,0,0,1
../kbl_data/2021-2022,S39G01N200,창원 LG,Home,정해원,0,0,0,0.0,0,0,0.0,0,0,0.0,0,0,0.0,0,2,2,1,0,0,0,0,0,2
../kbl_data/2021-2022,S39G01N200,창원 LG,Home,박정현,9,4,10,40.0,0,1,0.0,4,11,36.4,1,3,33.3,4,4,8,0,2,2,0,0,3,5
../kbl_data/2021-2022,S39G01N200,창원 LG,Home,아셈 마레이,22,10,17,58.8,0,0,0.0,10,17,58.8,2,9,22.2,8,7,15,5,0,1,0,1,1,1
../kbl_data/2021-2022,S39G01N200,창원 LG,Home,이승우,6,3,7,42.9,0,1,0.0,3,8,37.5,0,2,0.0,5,7,12,1,0,0,1,0,2,5
../kbl_data/2021-2022,S39G01N200,창원 LG,Home,김종호,0,0,0,0.0,0,0,0.0,0,0,0.0,0,0,0.0,0,1,1,0,0,0,0,0,0,2
../kbl_data/2021-2022,S39G01N200,창원 LG,Home,사마르도 사무엘스,0,0,1,0.0,0,0,0.0,0,1,0.0,0,0,0.0,1,1,2,0,0,0,0,0,1,3
../kbl_data/2021-2022,S39G01N200,고양 오리온,Away,오용준,0,0,0,0.0,0,0,0.0,0,0,0.0,0,0,0.0,0,0,0,0,0,0,0,0,0,0
../kbl_data/2021-2022,S39G01N200,고양 오리온,Away,김강선,5,1,2,50.0,1,4,25.0,2,6,33.3,0,0,0.0,2,2,4,1,0,0,0,0,0,1
../kbl_data/2021-2022,S39G01N200,고양 오리온,Away,최현민,8,1,2,50.0,2,3,66.7,3,5,60.0,0,1,0.0,1,3,4,1,0,0,1,0,0,2
../kbl_data/2021-2022,S39G01N200,고양 오리온,Away,이대성,12,3,12,25.0,1,6,16.7,4,18,22.2,3,5,60.0,0,2,2,1,0,0,0,0,1,1
../kbl_data/2021-2022,S39G01N200,고양 오리온,Away,한호빈,9,0,1,0.0,1,2,50.0,1,3,33.3,6,6,100.0,0,3,3,3,1,0,0,0,1,2
../kbl_data/2021-2022,S39G01N200,고양 오리온,Away,이정제,0,0,0,0.0,0,0,0.0,0,0,0.0,0,0,0.0,0,0,0,0,0,0,0,0,0,0
../kbl_data/2021-2022,S39G01N200,고양 오리온,Away,이승현,11,1,9,11.1,1,3,33.3,2,12,16.7,6,6,100.0,3,5,8,4,0,1,1,0,2,3
../kbl_data/2021-2022,S39G01N200,고양 오리온,Away,김진유,0,0,0,0.0,0,1,0.0,0,1,0.0,0,0,0.0,0,0,0,0,0,0,0,0,0,2
../kbl_data/2021-2022,S39G01N200,고양 오리온,Away,제임스 메이스,17,3,5,60.0,3,4,75.0,6,9,66.7,2,4,50.0,2,4,6,4,1,0,1,1,0,3
../kbl_data/2021-2022,S39G01N200,고양 오리온,Away,박진철,4,2,3,66.7,0,0,0.0,2,3,66.7,0,0,0.0,1,4,5,0,0,1,0,0,1,5
../kbl_data/2021-2022,S39G01N200,고양 오리온,Away,이정현,5,2,6,33.3,0,1,0.0,2,7,28.6,1,2,50.0,1,2,3,1,0,0,2,0,2,1
../kbl_data/2021-2022,S39G01N200,고양 오리온,Away,문시윤,0,0,0,0.0,0,0,0.0,0,0,0.0,0,0,0.0,0,0,0,0,0,0,0,0,0,0
../kbl_data/2021-2022,S39G01N201,서울 삼성,Home,김동량,14,4,7,57.1,2,3,66.7,6,10,60.0,0,0,0.0,3,4,7,0,0,0,0,0,1,3
../kbl_data/2021-2022,S39G01N201,서울 삼성,Home,김시래,15,3,6,50.0,3,5,60.0,6,11,54.5,0,0,0.0,1,0,1,1,1,0,0,0,8,2
../kbl_data/2021-2022,S39G01N201,서울 삼성,Home,임동섭,3,0,2,0.0,1,2,50.0,1,4,25.0,0,0,0.0,0,0,0,0,0,0,0,0,0,3
../kbl_data/2021-2022,S39G01N201,서울 삼성,Home,이동엽,0,0,5,0.0,0,1,0.0,0,6,0.0,0,0,0.0,1,2,3,4,1,0,1,0,3,1
../kbl_data/2021-2022,S39G01N201,서울 삼성,Home,배수용,3,1,1,100.0,0,1,0.0,1,2,50.0,1,1,100.0,0,1,1,0,1,0,0,0,0,1
../kbl_data/2021-2022,S39G01N201,서울 삼성,Home,이호현,2,1,2,50.0,0,1,0.0,1,3,33.3,0,0,0.0,0,0,0,0,0,0,0,0,1,1
../kbl_data/2021-2022,S39G01N201,서울 삼성,Home,정희원,3,0,1,0.0,1,3,33.3,1,4,25.0,0,0,0.0,0,0,0,0,0,0,0,0,0,2
../kbl_data/2021-2022,S39G01N201,서울 삼성,Home,정준수,0,0,1,0.0,0,0,0.0,0,1,0.0,0,0,0.0,1,2,3,2,0,0,0,0,0,0
../kbl_data/2021-2022,S39G01N201,서울 삼성,Home,박민우,6,2,4,50.0,0,1,0.0,2,5,40.0,2,2,100.0,0,2,2,3,1,1,0,0,0,3
../kbl_data/2021-2022,S39G01N201,서울 삼성,Home,차민석,5,2,3,66.7,0,0,0.0,2,3,66.7,1,1,100.0,0,0,0,0,0,0,0,0,0,3
../kbl_data/2021-2022,S39G01N201,서울 삼성,Home,전형준,9,3,3,100.0,0,2,0.0,3,5,60.0,3,4,75.0,0,1,1,2,2,0,0,0,3,3
../kbl_data/2021-2022,S39G01N201,서울 삼성,Home,이원석,9,4,6,66.7,0,3,0.0,4,9,44.4,1,2,50.0,2,4,6,2,0,1,0,0,2,3
../kbl_data/2021-2022,S39G01N201,울산 현대모비스,Away,이현민,0,0,1,0.0,0,0,0.0,0,1,0.0,0,0,0.0,0,0,0,1,1,0,1,0,0,1
../kbl_data/2021-2022,S39G01N201,울산 현대모비스,Away,함지훈,7,2,3,66.7,0,0,0.0,2,3,66.7,3,4,75.0,4,4,8,4,1,0,0,0,1,1
../kbl_data/2021-2022,S39G01N201,울산 현대모비스,Away,최진수,0,0,0,0.0,0,1,0.0,0,1,0.0,0,0,0.0,0,0,0,1,0,0,0,0,0,0
../kbl_data/2021-2022,S39G01N201,울산 현대모비스,Away,박지훈,7,2,3,66.7,1,3,33.3,3,6,50.0,0,0,0.0,1,3,4,5,3,0,1,0,1,1
../kbl_data/2021-2022,S39G01N201,울산 현대모비스,Away,장재석,9,4,4,100.0,0,0,0.0,4,4,100.0,1,2,50.0,1,5,6,2,0,1,0,1,3,3
../kbl_data/2021-2022,S39G01N201,울산 현대모비스,Away,김국찬,9,0,0,0.0,2,5,40.0,2,5,40.0,3,4,75.0,0,3,3,1,1,0,0,0,1,1
../kbl_data/2021-2022,S39G01N201,울산 현대모비스,Away,서명진,9,0,2,0.0,3,6,50.0,3,8,37.5,0,0,0.0,0,1,1,3,1,1,0,0,0,0
../kbl_data/2021-2022,S39G01N201,울산 현대모비스,Away,이우석,7,2,3,66.7,1,4,25.0,3,7,42.9,0,0,0.0,0,0,0,1,1,0,0,0,1,1
../kbl_data/2021-2022,S39G01N201,울산 현대모비스,Away,라숀 토마스,22,10,17,58.8,0,0,0.0,10,17,58.8,2,3,66.7,3,4,7,1,2,0,0,2,1,1
../kbl_data/2021-2022,S39G01N201,울산 현대모비스,Away,신민석,5,0,3,0.0,1,3,33.3,1,6,16.7,2,2,100.0,0,3,3,2,0,0,0,0,1,2
../kbl_data/2021-2022,S39G01N201,울산 현대모비스,Away,김동준,7,3,3,100.0,0,1,0.0,3,4,75.0,1,1,100.0,0,0,0,2,1,0,0,0,2,2
../kbl_data/2021-2022,S39G01N201,울산 현대모비스,Away,에릭 버크너,12,5,5,100.0,0,0,0.0,5,5,100.0,2,5,40.0,2,2,4,1,0,1,0,3,0,0
../kbl_data/2021-2022,S39G01N202,고양 오리온,Home,오용준,2,1,1,100.0,0,0,0.0,1,1,100.0,0,0,0.0,0,0,0,0,0,0,0,0,0,3
../kbl_data/2021-2022,S39G01N202,고양 오리온,Home,김강선,6,1,1,100.0,1,2,50.0,2,3,66.7,1,1,100.0,2,1,3,0,1,0,0,0,0,2
../kbl_data/2021-2022,S39G01N202,고양 오리온,Home,최현민,3,0,1,0.0,1,1,100.0,1,2,50.0,0,0,0.0,1,0,1,0,1,0,0,0,2,0
../kbl_data/2021-2022,S39G01N202,고양 오리온,Home,이대성,37,13,16,81.2,2,4,50.0,15,20,75.0,5,5,100.0,3,4,7,4,0,0,1,0,5,1
../kbl_data/2021-2022,S39G01N202,고양 오리온,Home,한호빈,4,2,3,66.7,0,3,0.0,2,6,33.3,0,0,0.0,0,1,1,6,1,0,0,0,3,3
../kbl_data/2021-2022,S39G01N202,고양 오리온,Home,이승현,16,6,12,50.0,1,1,100.0,7,13,53.8,1,1,100.0,2,2,4,2,0,0,0,0,2,1
../kbl_data/2021-2022,S39G01N202,고양 오리온,Home,김진유,5,1,1,100.0,1,1,100.0,2,2,100.0,0,0,0.0,0,0,0,0,1,0,0,0,0,1
../kbl_data/2021-2022,S39G01N202,고양 오리온,Home,제임스 메이스,6,3,5,60.0,0,2,0.0,3,7,42.9,0,0,0.0,1,5,6,2,2,0,0,0,0,1
../kbl_data/2021-2022,S39G01N202,고양 오리온,Home,머피 할로웨이,18,8,10,80.0,0,1,0.0,8,11,72.7,2,3,66.7,0,3,3,3,1,1,0,2,0,2
../kbl_data/2021-2022,S39G01N202,고양 오리온,Home,조한진,0,0,0,0.0,0,0,0.0,0,0,0.0,0,0,0.0,0,0,0,0,0,0,0,0,0,0
../kbl_data/2021-2022,S39G01N202,고양 오리온,Home,박진철,0,0,0,0.0,0,0,0.0,0,0,0.0,0,0,0.0,0,1,1,0,0,0,0,0,0,1
../kbl_data/2021-2022,S39G01N202,고양 오리온,Home,이정현,38,10,20,50.0,2,14,14.3,12,34,35.3,12,14,85.7,0,6,6,8,6,2,2,0,8,10
../kbl_data/2021-2022,S39G01N202,전주 KCC,Away,이정현,38,10,20,50.0,2,14,14.3,12,34,35.3,12,14,85.7,0,6,6,8,6,2,2,0,8,10
../kbl_data/2021-2022,S39G01N202,전주 KCC,Away,정창영,8,4,5,80.0,0,0,0.0,4,5,80.0,0,0,0.0,0,0,0,5,1,0,0,0,3,2
../kbl_data/2021-2022,S39G01N202,전주 KCC,Away,라건아,26,11,14,78.6,1,1,100.0,12,15,80.0,1,1,100.0,4,8,12,1,0,0,0,0,3,3
../kbl_data/2021-2022,S39G01N202,전주 KCC,Away,김지완,0,0,1,0.0,0,1,0.0,0,2,0.0,0,0,0.0,0,0,0,0,0,0,0,0,2,3
../kbl_data/2021-2022,S39G01N202,전주 KCC,Away,김상규,18,7,8,87.5,1,3,33.3,8,11,72.7,1,1,100.0,2,4,6,3,1,0,0,0,0,1
../kbl_data/2021-2022,S39G01N202,전주 KCC,Away,전준범,7,0,2,0.0,1,2,50.0,1,4,25.0,4,5,80.0,0,0,0,4,0,0,0,0,1,2
../kbl_data/2021-2022,S39G01N202,전주 KCC,Away,박재현,0,0,1,0.0,0,0,0.0,0,1,0.0,0,0,0.0,0,0,0,1,0,0,0,0,0,1
../kbl_data/2021-2022,S39G01N202,전주 KCC,Away,송교창,0,0,0,0.0,0,0,0.0,0,0,0.0,0,0,0.0,0,0,0,0,0,0,0,0,0,0
../kbl_data/2021-2022,S39G01N202,전주 KCC,Away,이진욱,0,0,0,0.0,0,0,0.0,0,0,0.0,0,0,0.0,0,0,0,0,0,0,0,0,2,1
../kbl_data/2021-2022,S39G01N202,전주 KCC,Away,유현준,11,3,4,75.0,1,4,25.0,4,8,50.0,2,2,100.0,1,1,2,4,5,0,0,0,2,0
../kbl_data/2021-2022,S39G01N202,전주 KCC,Away,라타비우스 윌리엄스,7,3,4,75.0,0,0,0.0,3,4,75.0,1,2,50.0,3,2,5,0,1,0,0,2,0,1
../kbl_data/2021-2022,S39G01N202,전주 KCC,Away,이근휘,0,0,0,0.0,0,1,0.0,0,1,0.0,0,0,0.0,0,0,0,0,0,0,0,0,0,0
../kbl_data/2021-2022,S39G01N203,수원 KT,Home,김영환,9,0,4,0.0,3,6,50.0,3,10,30.0,0,0,0.0,0,4,4,1,0,1,0,0,1,2
../kbl_data/2021-2022,S39G01N203,수원 KT,Home,김현민,0,0,0,0.0,0,1,0.0,0,1,0.0,0,0,0.0,1,0,1,0,0,0,0,0,0,1
../kbl_data/2021-2022,S39G01N203,수원 KT,Home,한희원,0,0,1,0.0,0,0,0.0,0,1,0.0,0,0,0.0,1,0,1,0,0,0,0,0,0,0
../kbl_data/2021-2022,S39G01N203,수원 KT,Home,최창진,2,0,0,0.0,0,0,0.0,0,0,0.0,2,2,100.0,1,0,1,0,0,0,0,0,0,0
../kbl_data/2021-2022,S39G01N203,수원 KT,Home,정성우,7,2,5,40.0,1,1,100.0,3,6,50.0,0,0,0.0,1,2,3,0,1,0,0,0,1,1
../kbl_data/2021-2022,S39G01N203,수원 KT,Home,최성모,0,0,0,0.0,0,0,0.0,0,0,0.0,0,0,0.0,0,0,0,0,0,0,0,0,0,0
../kbl_data/2021-2022,S39G01N203,수원 KT,Home,허훈,13,5,9,55.6,0,3,0.0,5,12,41.7,3,5,60.0,1,0,1,1,1,0,1,0,1,2
../kbl_data/2021-2022,S39G01N203,수원 KT,Home,박준영,0,0,0,0.0,0,0,0.0,0,0,0.0,0,0,0.0,0,0,0,0,0,0,0,0,0,0
../kbl_data/2021-2022,S39G01N203,수원 KT,Home,캐디 라렌,13,3,15,20.0,0,2,0.0,3,17,17.6,7,10,70.0,3,5,8,1,1,2,0,0,3,2
../kbl_data/2021-2022,S39G01N203,수원 KT,Home,박지원,13,3,4,75.0,0,1,0.0,3,5,60.0,7,7,100.0,3,3,6,4,2,0,0,0,2,3
../kbl_data/2021-2022,S39G01N203,수원 KT,Home,마이크 마이어스,2,1,2,50.0,0,0,0.0,1,2,50.0,0,0,0.0,2,1,3,0,0,0,0,0,1,0
../kbl_data/2021-2022,S39G01N203,수원 KT,Home,하윤기,9,4,13,30.8,0,0,0.0,4,13,30.8,1,2,50.0,7,6,13,1,0,2,1,1,0,2
../kbl_data/2021-2022,S39G01N203,울산 현대모비스,Away,이현민,4,2,4,50.0,0,0,0.0,2,4,50.0,0,0,0.0,0,0,0,2,0,0,0,0,1,2
../kbl_data/2021-2022,S39G01N203,울산 현대모비스,Away,함지훈,13,5,6,83.3,1,2,50.0,6,8,75.0,0,2,0.0,4,6,10,2,0,0,0,0,1,2
../kbl_data/2021-2022,S39G01N203,울산 현대모비스,Away,최진수,0,0,0,0.0,0,1,0.0,0,1,0.0,0,0,0.0,0,0,0,0,0,0,0,0,2,1
../kbl_data/2021-2022,S39G01N203,울산 현대모비스,Away,박지훈,0,0,0,0.0,0,2,0.0,0,2,0.0,0,0,0.0,2,0,2,0,0,0,0,0,0,0
../kbl_data/2021-2022,S39G01N203,울산 현대모비스,Away,장재석,4,1,3,33.3,0,0,0.0,1,3,33.3,2,2,100.0,2,2,4,0,0,1,0,0,0,3
../kbl_data/2021-2022,S39G01N203,울산 현대모비스,Away,김국찬,8,1,2,50.0,2,9,22.2,3,11,27.3,0,0,0.0,0,1,1,3,0,0,1,0,1,1
../kbl_data/2021-2022,S39G01N203,울산 현대모비스,Away,서명진,1,0,3,0.0,0,2,0.0,0,5,0.0,1,2,50.0,1,2,3,2,0,0,0,0,1,1
../kbl_data/2021-2022,S39G01N203,울산 현대모비스,Away,이우석,11,4,8,50.0,1,3,33.3,5,11,45.5,0,0,0.0,1,2,3,2,0,0,0,0,1,3
../kbl_data/2021-2022,S39G01N203,울산 현대모비스,Away,라숀 토마스,7,3,12,25.0,0,0,0.0,3,12,25.0,1,3,33.3,4,2,6,0,2,2,0,0,2,4
../kbl_data/2021-2022,S39G01N203,울산 현대모비스,Away,신민석,0,0,0,0.0,0,0,0.0,0,0,0.0,0,0,0.0,0,0,0,0,0,0,0,0,0,0
../kbl_data/2021-2022,S39G01N203,울산 현대모비스,Away,김동준,4,2,2,100.0,0,1,0.0,2,3,66.7,0,0,0.0,0,1,1,0,0,0,0,0,0,3
../kbl_data/2021-2022,S39G01N203,울산 현대모비스,Away,에릭 버크너,14,5,10,50.0,0,0,0.0,5,10,50.0,4,4,100.0,4,5,9,4,0,2,0,1,1,3
../kbl_data/2021-2022,S39G01N204,대구 한국가스공사,Home,민성주,0,0,0,0.0,0,0,0.0,0,0,0.0,0,0,0.0,0,0,0,0,0,0,0,0,0,0
../kbl_data/2021-2022,S39G01N204,대구 한국가스공사,Home,홍경기,0,0,0,0.0,0,1,0.0,0,1,0.0,0,0,0.0,0,1,1,0,0,0,0,0,0,1
../kbl_data/2021-2022,S39G01N204,대구 한국가스공사,Home,차바위,0,0,1,0.0,0,4,0.0,0,5,0.0,0,0,0.0,1,1,2,3,3,0,0,0,0,2
../kbl_data/2021-2022,S39G01N204,대구 한국가스공사,Home,이대헌,7,2,6,33.3,1,1,100.0,3,7,42.9,0,0,0.0,0,1,1,0,0,0,0,0,0,2
../kbl_data/2021-2022,S39G01N204,대구 한국가스공사,Home,두경민,10,1,3,33.3,2,6,33.3,3,9,33.3,2,2,100.0,1,2,3,1,5,0,0,0,3,1
../kbl_data/2021-2022,S39G01N204,대구 한국가스공사,Home,김낙현,0,0,0,0.0,0,6,0.0,0,6,0.0,0,0,0.0,0,0,0,7,2,0,0,0,0,1
../kbl_data/2021-2022,S39G01N204,대구 한국가스공사,Home,전현우,15,2,3,66.7,3,9,33.3,5,12,41.7,2,4,50.0,1,1,2,0,0,0,0,0,1,2
../kbl_data/2021-2022,S39G01N204,대구 한국가스공사,Home,이윤기,0,0,1,0.0,0,0,0.0,0,1,0.0,0,0,0.0,0,0,0,0,0,0,0,0,0,0
../kbl_data/2021-2022,S39G01N204,대구 한국가스공사,Home,양준우,0,0,0,0.0,0,1,0.0,0,1,0.0,0,0,0.0,0,3,3,1,0,0,0,0,1,1
../kbl_data/2021-2022,S39G01N204,대구 한국가스공사,Home,앤드류 니콜슨,20,4,8,50.0,3,10,30.0,7,18,38.9,3,4,75.0,0,6,6,0,1,1,0,0,0,2
../kbl_data/2021-2022,S39G01N204,대구 한국가스공사,Home,신승민,5,2,2,100.0,0,2,0.0,2,4,50.0,1,2,50.0,3,0,3,2,1,0,4,0,0,2
../kbl_data/2021-2022,S39G01N204,대구 한국가스공사,Home,디제이 화이트,4,2,5,40.0,0,2,0.0,2,7,28.6,0,0,0.0,0,2,2,0,0,0,0,0,1,2
../kbl_data/2021-2022,S39G01N204,서울 SK,Away,양우섭,0,0,0,0.0,0,0,0.0,0,0,0.0,0,0,0.0,0,0,0,0,0,0,0,0,0,0
../kbl_data/2021-2022,S39G01N204,서울 SK,Away,허일영,6,3,6,50.0,0,1,0.0,3,7,42.9,0,0,0.0,0,2,2,0,0,0,0,0,1,2
../kbl_data/2021-2022,S39G01N204,서울 SK,Away,최부경,2,1,2,50.0,0,1,0.0,1,3,33.3,0,0,0.0,0,4,4,0,0,0,0,0,2,3
../kbl_data/2021-2022,S39G01N204,서울 SK,Away,김승원,0,0,0,0.0,0,0,0.0,0,0,0.0,0,0,0.0,0,0,0,0,0,0,0,0,0,0
../kbl_data/2021-2022,S39G01N204,서울 SK,Away,이원대,0,0,0,0.0,0,1,0.0,0,1,0.0,0,0,0.0,0,0,0,0,0,0,0,0,0,1
../kbl_data/2021-2022,S39G01N204,서울 SK,Away,배병준,0,0,1,0.0,0,0,0.0,0,1,0.0,0,0,0.0,0,0,0,0,1,0,0,0,0,0
../kbl_data/2021-2022,S39G01N204,서울 SK,Away,이현석,14,2,2,100.0,3,4,75.0,5,6,83.3,1,2,50.0,1,5,6,0,0,0,0,0,0,2
../kbl_data/2021-2022,S39G01N204,서울 SK,Away,최원혁,7,1,3,33.3,1,4,25.0,2,7,28.6,2,2,100.0,1,4,5,0,0,0,0,0,3,3
../kbl_data/2021-2022,S39G01N204,서울 SK,Away,최준용,14,2,3,66.7,2,4,50.0,4,7,57.1,4,5,80.0,2,10,12,3,0,0,0,0,6,3
../kbl_data/2021-2022,S39G01N204,서울 SK,Away,안영준,19,4,6,66.7,2,4,50.0,6,10,60.0,5,6,83.3,2,4,6,2,1,0,0,0,1,3
../kbl_data/2021-2022,S39G01N204,서울 SK,Away,자밀 워니,19,9,18,50.0,0,0,0.0,9,18,50.0,1,2,50.0,4,10,14,6,0,1,0,0,2,0
../kbl_data/2021-2022,S39G01N204,서울 SK,Away,오재현,2,1,1,100.0,0,1,0.0,1,2,50.0,0,0,0.0,0,1,1,0,0,0,0,0,3,2
../kbl_data/2021-2022,S39G01N205,전주 KCC,Home,이정현,14,4,8,50.0,1,5,20.0,5,13,38.5,3,3,100.0,4,1,5,2,2,0,0,0,2,2
../kbl_data/2021-2022,S39G01N205,전주 KCC,Home,정창영,8,4,8,50.0,0,0,0.0,4,8,50.0,0,0,0.0,0,5,5,2,1,0,0,0,2,1
../kbl_data/2021-2022,S39G01N205,전주 KCC,Home,라건아,18,8,14,57.1,0,1,0.0,8,15,53.3,2,4,50.0,8,12,20,3,0,2,0,2,1,2
../kbl_data/2021-2022,S39G01N205,전주 KCC,Home,김지완,2,1,1,100.0,0,2,0.0,1,3,33.3,0,2,0.0,1,0,1,1,1,0,0,0,0,1
../kbl_data/2021-2022,S39G01N205,전주 KCC,Home,김상규,1,0,0,0.0,0,2,0.0,0,2,0.0,1,2,50.0,0,0,0,0,0,0,0,0,1,0
../kbl_data/2021-2022,S39G01N205,전주 KCC,Home,전준범,1,0,0,0.0,0,1,0.0,0,1,0.0,1,2,50.0,0,0,0,1,0,0,0,0,1,1
../kbl_data/2021-2022,S39G01N205,전주 KCC,Home,박재현,0,0,0,0.0,0,0,0.0,0,0,0.0,0,0,0.0,0,0,0,0,0,0,0,0,0,0
../kbl_data/2021-2022,S39G01N205,전주 KCC,Home,송교창,17,6,9,66.7,1,4,25.0,7,13,53.8,2,2,100.0,0,3,3,1,3,0,1,1,0,3
../kbl_data/2021-2022,S39G01N205,전주 KCC,Home,이진욱,0,0,0,0.0,0,0,0.0,0,0,0.0,0,0,0.0,0,1,1,0,0,0,0,0,0,0
../kbl_data/2021-2022,S39G01N205,전주 KCC,Home,유현준,12,1,6,16.7,2,5,40.0,3,11,27.3,4,4,100.0,1,2,3,3,1,0,1,0,1,3
../kbl_data/2021-2022,S39G01N205,전주 KCC,Home,라타비우스 윌리엄스,0,0,1,0.0,0,0,0.0,0,1,0.0,0,0,0.0,0,1,1,0,0,0,0,0,1,0
../kbl_data/2021-2022,S39G01N205,전주 KCC,Home,이근휘,0,0,0,0.0,0,0,0.0,0,0,0.0,0,0,0.0,0,0,0,0,0,0,0,0,0,0
../kbl_data/2021-2022,S39G01N205,안양 KGC,Away,박형철,0,0,0,0.0,0,0,0.0,0,0,0.0,0,0,0.0,0,0,0,0,0,0,0,0,0,0
../kbl_data/2021-2022,S39G01N205,안양 KGC,Away,함준후,0,0,0,0.0,0,0,0.0,0,0,0.0,0,0,0.0,0,1,1,0,0,0,0,0,1,0
../kbl_data/2021-2022,S39G01N205,안양 KGC,Away,오세근,11,4,7,57.1,1,1,100.0,5,8,62.5,0,0,0.0,2,3,5,1,0,0,0,0,2,4
../kbl_data/2021-2022,S39G01N205,안양 KGC,Away,문성곤,9,0,0,0.0,3,9,33.3,3,9,33.3,0,0,0.0,0,5,5,3,1,0,0,0,2,2
../kbl_data/2021-2022,S39G01N205,안양 KGC,Away,전성현,20,1,5,20.0,6,10,60.0,7,15,46.7,0,0,0.0,0,0,0,2,1,0,0,0,1,2
../kbl_data/2021-2022,S39G01N205,안양 KGC,Away,박지훈,2,1,2,50.0,0,1,0.0,1,3,33.3,0,0,0.0,0,2,2,4,0,0,0,0,0,2
../kbl_data/2021-2022,S39G01N205,안양 KGC,Away,대릴 먼로,3,0,3,0.0,1,2,50.0,1,5,20.0,0,0,0.0,0,3,3,0,0,0,0,0,0,1
../kbl_data/2021-2022,S39G01N205,안양 KGC,Away,우동현,0,0,0,0.0,0,1,0.0,0,1,0.0,0,0,0.0,0,0,0,0,0,0,0,0,0,1
../kbl_data/2021-2022,S39G01N205,안양 KGC,Away,변준형,12,1,3,33.3,3,6,50.0,4,9,44.4,1,2,50.0,2,3,5,3,2,1,0,0,3,3
../kbl_data/2021-2022,S39G01N205,안양 KGC,Away,한승희,0,0,0,0.0,0,0,0.0,0,0,0.0,0,0,0.0,1,0,1,0,0,0,0,0,0,3
../kbl_data/2021-2022,S39G01N205,안양 KGC,Away,오마리 스펠맨,11,3,6,50.0,1,7,14.3,4,13,30.8,2,4,50.0,1,8,9,6,2,0,0,1,3,1
../kbl_data/2021-2022,S39G01N205,안양 KGC,Away,주현우,0,0,0,0.0,0,0,0.0,0,0,0.0,0,0,0.0,0,0,0,0,0,0,0,0,0,0
../kbl_data/2021-2022,S39G01N206,원주 DB,Home,윤호영,7,2,3,66.7,0,0,0.0,2,3,66.7,3,4,75.0,1,1,2,5,0,0,1,0,0,0
../kbl_data/2021-2022,S39G01N206,원주 DB,Home,정준원,2,1,1,100.0,0,0,0.0,1,1,100.0,0,0,0.0,1,0,1,0,0,0,0,0,0,0
../kbl_data/2021-2022,S39G01N206,원주 DB,Home,박경상,0,0,0,0.0,0,0,0.0,0,0,0.0,0,0,0.0,0,0,0,0,0,0,0,0,0,0
../kbl_data/2021-2022,S39G01N206,원주 DB,Home,김종규,15,7,11,63.6,0,0,0.0,7,11,63.6,1,1,100.0,2,6,8,0,0,0,0,1,1,3
../kbl_data/2021-2022,S39G01N206,원주 DB,Home,허웅,21,6,8,75.0,3,6,50.0,9,14,64.3,0,0,0.0,0,1,1,8,1,0,1,0,1,2
../kbl_data/2021-2022,S39G01N206,원주 DB,Home,김영훈,0,0,0,0.0,0,1,0.0,0,1,0.0,0,0,0.0,1,0,1,1,0,0,1,0,0,3
../kbl_data/2021-2022,S39G01N206,원주 DB,Home,강상재,12,3,8,37.5,2,2,100.0,5,10,50.0,0,0,0.0,2,9,11,2,0,0,0,0,0,2
../kbl_data/2021-2022,S39G01N206,원주 DB,Home,김철욱,0,0,0,0.0,0,0,0.0,0,0,0.0,0,0,0.0,0,0,0,0,0,0,0,0,0,0
../kbl_data/2021-2022,S39G01N206,원주 DB,Home,나카무라 타이치,0,0,0,0.0,0,0,0.0,0,0,0.0,0,0,0.0,0,0,0,0,0,0,0,0,0,0
../kbl_data/2021-2022,S39G01N206,원주 DB,Home,이용우,0,0,1,0.0,0,2,0.0,0,3,0.0,0,0,0.0,0,1,1,0,0,0,0,0,1,0
../kbl_data/2021-2022,S39G01N206,원주 DB,Home,이준희,6,3,4,75.0,0,1,0.0,3,5,60.0,0,0,0.0,0,1,1,4,0,0,0,0,2,4
../kbl_data/2021-2022,S39G01N206,원주 DB,Home,조니 오브라이언트,13,5,12,41.7,1,7,14.3,6,19,31.6,0,0,0.0,0,4,4,1,1,0,0,0,2,2
../kbl_data/2021-2022,S39G01N206,고양 오리온,Away,김강선,0,0,0,0.0,0,3,0.0,0,3,0.0,0,0,0.0,0,1,1,0,1,0,0,0,1,1
../kbl_data/2021-2022,S39G01N206,고양 오리온,Away,최현민,0,0,0,0.0,0,3,0.0,0,3,0.0,0,0,0.0,0,0,0,0,0,0,0,0,2,3
../kbl_data/2021-2022,S39G01N206,고양 오리온,Away,이대성,21,8,14,57.1,1,2,50.0,9,16,56.2,2,2,100.0,2,5,7,2,2,0,0,0,2,1
../kbl_data/2021-2022,S39G01N206,고양 오리온,Away,한호빈,4,2,3,66.7,0,2,0.0,2,5,40.0,0,0,0.0,1,1,2,0,0,0,0,0,0,3
../kbl_data/2021-2022,S39G01N206,고양 오리온,Away,이승현,15,7,8,87.5,0,2,0.0,7,10,70.0,1,2,50.0,0,3,3,2,0,0,0,0,0,2
../kbl_data/2021-2022,S39G01N206,고양 오리온,Away,김진유,2,1,1,100.0,0,0,0.0,1,1,100.0,0,0,0.0,1,0,1,0,0,0,0,0,0,2
../kbl_data/2021-2022,S39G01N206,고양 오리온,Away,제임스 메이스,4,2,3,66.7,0,2,0.0,2,5,40.0,0,0,0.0,0,5,5,1,0,1,0,0,1,2
../kbl_data/2021-2022,S39G01N206,고양 오리온,Away,머피 할로웨이,16,7,14,50.0,0,1,0.0,7,15,46.7,2,2,100.0,3,7,10,1,1,4,0,0,1,0
../kbl_data/2021-2022,S39G01N206,고양 오리온,Away,조한진,0,0,0,0.0,0,0,0.0,0,0,0.0,0,0,0.0,0,0,0,1,0,0,0,0,0,0
../kbl_data/2021-2022,S39G01N206,고양 오리온,Away,박진철,0,0,0,0.0,0,0,0.0,0,0,0.0,0,0,0.0,0,1,1,0,0,0,0,0,1,0
../kbl_data/2021-2022,S39G01N206,고양 오리온,Away,이정현,6,2,4,50.0,0,2,0.0,2,6,33.3,2,2,100.0,0,2,2,0,1,0,0,0,0,0
../kbl_data/2021-2022,S39G01N206,고양 오리온,Away,문시윤,0,0,1,0.0,0,0,0.0,0,1,0.0,0,0,0.0,0,0,0,0,0,0,0,0,0,0
../kbl_data/2021-2022,S39G01N207,서울 삼성,Home,김동량,3,0,1,0.0,1,1,100.0,1,2,50.0,0,0,0.0,0,1,1,0,0,0,0,0,1,1
../kbl_data/2021-2022,S39G01N207,서울 삼성,Home,김시래,17,4,9,44.4,3,5,60.0,7,14,50.0,0,0,0.0,1,1,2,1,0,0,0,0,2,3
../kbl_data/2021-2022,S39G01N207,서울 삼성,Home,김현수,4,1,1,100.0,0,3,0.0,1,4,25.0,2,2,100.0,0,0,0,2,0,0,0,0,0,0
../kbl_data/2021-2022,S39G01N207,서울 삼성,Home,임동섭,17,2,4,50.0,4,5,80.0,6,9,66.7,1,1,100.0,2,3,5,1,1,1,1,0,2,4
../kbl_data/2021-2022,S39G01N207,서울 삼성,Home,이동엽,2,1,4,25.0,0,2,0.0,1,6,16.7,0,0,0.0,0,2,2,4,1,0,0,0,0,3
../kbl_data/2021-2022,S39G01N207,서울 삼성,Home,배수용,0,0,0,0.0,0,1,0.0,0,1,0.0,0,0,0.0,3,5,8,1,0,1,0,0,0,1
../kbl_data/2021-2022,S39G01N207,서울 삼성,Home,이호현,6,1,2,50.0,0,0,0.0,1,2,50.0,4,4,100.0,0,0,0,1,1,0,0,0,0,0
../kbl_data/2021-2022,S39G01N207,서울 삼성,Home,정희원,0,0,0,0.0,0,0,0.0,0,0,0.0,0,0,0.0,0,0,0,0,0,0,0,0,0,1
../kbl_data/2021-2022,S39G01N207,서울 삼성,Home,박민우,6,1,1,100.0,1,5,20.0,2,6,33.3,1,2,50.0,1,2,3,1,1,0,0,0,1,0
../kbl_data/2021-2022,S39G01N207,서울 삼성,Home,전형준,5,1,3,33.3,1,5,20.0,2,8,25.0,0,0,0.0,2,0,2,0,0,0,0,0,1,2
../kbl_data/2021-2022,S39G01N207,서울 삼성,Home,이원석,1,0,0,0.0,0,2,0.0,0,2,0.0,1,2,50.0,1,0,1,2,0,0,0,0,3,5
../kbl_data/2021-2022,S39G01N207,서울 삼성,Home,토마스 로빈슨,16,7,16,43.8,0,2,0.0,7,18,38.9,2,4,50.0,5,7,12,3,2,0,0,2,1,5
../kbl_data/2021-2022,S39G01N207,창원 LG,Away,강병현,0,0,1,0.0,0,1,0.0,0,2,0.0,0,0,0.0,1,2,3,0,0,0,0,0,0,0
../kbl_data/2021-2022,S39G01N207,창원 LG,Away,이관희,12,3,8,37.5,1,6,16.7,4,14,28.6,3,4,75.0,0,3,3,6,2,0,0,0,1,2
../kbl_data/2021-2022,S39G01N207,창원 LG,Away,정희재,15,6,7,85.7,1,1,100.0,7,8,87.5,0,1,0.0,2,2,4,1,1,0,0,0,2,1
../kbl_data/2021-2022,S39G01N207,창원 LG,Away,서민수,6,3,3,100.0,0,3,0.0,3,6,50.0,0,0,0.0,0,0,0,2,0,0,1,0,0,3
../kbl_data/2021-2022,S39G01N207,창원 LG,Away,한상혁,3,0,0,0.0,1,2,50.0,1,2,50.0,0,0,0.0,0,1,1,0,0,0,0,0,0,4
../kbl_data/2021-2022,S39G01N207,창원 LG,Away,이재도,10,3,4,75.0,1,6,16.7,4,10,40.0,1,1,100.0,1,2,3,6,0,0,0,0,0,1
../kbl_data/2021-2022,S39G01N207,창원 LG,Away,정해원,0,0,0,0.0,0,1,0.0,0,1,0.0,0,0,0.0,0,1,1,1,0,0,0,0,0,0
../kbl_data/2021-2022,S39G01N207,창원 LG,Away,박정현,2,1,2,50.0,0,0,0.0,1,2,50.0,0,2,0.0,1,0,1,0,0,0,0,0,0,0
../kbl_data/2021-2022,S39G01N207,창원 LG,Away,아셈 마레이,19,8,18,44.4,0,0,0.0,8,18,44.4,3,7,42.9,9,10,19,0,2,0,0,0,4,3
../kbl_data/2021-2022,S39G01N207,창원 LG,Away,이승우,19,6,10,60.0,0,2,0.0,6,12,50.0,7,8,87.5,6,4,10,7,1,0,0,0,2,3
../kbl_data/2021-2022,S39G01N207,창원 LG,Away,김종호,0,0,1,0.0,0,0,0.0,0,1,0.0,0,0,0.0,0,0,0,0,0,0,0,0,0,0
../kbl_data/2021-2022,S39G01N207,창원 LG,Away,사마르도 사무엘스,4,2,3,66.7,0,0,0.0,2,3,66.7,0,0,0.0,0,5,5,0,0,0,0,1,0,1
../kbl_data/2021-2022,S39G01N208,전주 KCC,Home,이정현,27,9,11,81.8,0,6,0.0,9,17,52.9,9,11,81.8,0,1,1,3,2,0,0,0,2,1
../kbl_data/2021-2022,S39G01N208,전주 KCC,Home,정창영,3,0,0,0.0,1,2,50.0,1,2,50.0,0,0,0.0,0,1,1,0,1,0,0,0,1,1
../kbl_data/2021-2022,S39G01N208,전주 KCC,Home,라건아,12,3,8,37.5,2,2,100.0,5,10,50.0,0,0,0.0,2,5,7,2,0,3,0,0,2,5
../kbl_data/2021-2022,S39G01N208,전주 KCC,Home,김지완,5,1,4,25.0,1,2,50.0,2,6,33.3,0,0,0.0,0,3,3,0,0,0,0,0,0,1
../kbl_data/2021-2022,S39G01N208,전주 KCC,Home,김상규,9,1,1,100.0,1,2,50.0,2,3,66.7,4,5,80.0,0,1,1,0,0,0,0,0,0,2
../kbl_data/2021-2022,S39G01N208,전주 KCC,Home,전준범,5,1,2,50.0,0,1,0.0,1,3,33.3,3,4,75.0,2,1,3,2,0,0,0,0,1,2
../kbl_data/2021-2022,S39G01N208,전주 KCC,Home,박재현,0,0,0,0.0,0,0,0.0,0,0,0.0,0,0,0.0,0,0,0,0,0,0,0,0,0,0
../kbl_data/2021-2022,S39G01N208,전주 KCC,Home,송교창,7,1,4,25.0,1,2,50.0,2,6,33.3,2,5,40.0,0,1,1,1,2,0,0,0,0,2
../kbl_data/2021-2022,S39G01N208,전주 KCC,Home,이진욱,0,0,0,0.0,0,0,0.0,0,0,0.0,0,0,0.0,0,0,0,0,0,0,0,0,0,1
../kbl_data/2021-2022,S39G01N208,전주 KCC,Home,유현준,15,5,8,62.5,1,3,33.3,6,11,54.5,2,2,100.0,2,3,5,2,0,0,0,0,2,1
../kbl_data/2021-2022,S39G01N208,전주 KCC,Home,라타비우스 윌리엄스,0,0,0,0.0,0,0,0.0,0,0,0.0,0,0,0.0,2,1,3,0,2,0,0,0,0,0
../kbl_data/2021-2022,S39G01N208,전주 KCC,Home,이근휘,0,0,0,0.0,0,0,0.0,0,0,0.0,0,0,0.0,0,0,0,0,0,0,0,0,0,1
../kbl_data/2021-2022,S39G01N208,수원 KT,Away,김영환,15,3,8,37.5,2,7,28.6,5,15,33.3,3,4,75.0,2,0,2,6,1,0,0,0,1,2
../kbl_data/2021-2022,S39G01N208,수원 KT,Away,김현민,0,0,1,0.0,0,0,0.0,0,1,0.0,0,0,0.0,0,0,0,0,0,0,0,0,0,1
../kbl_data/2021-2022,S39G01N208,수원 KT,Away,김윤태,0,0,0,0.0,0,0,0.0,0,0,0.0,0,0,0.0,0,0,0,0,0,0,0,0,0,0
../kbl_data/2021-2022,S39G01N208,수원 KT,Away,한희원,3,0,0,0.0,1,3,33.3,1,3,33.3,0,0,0.0,0,2,2,0,0,0,0,0,0,3
../kbl_data/2021-2022,S39G01N208,수원 KT,Away,최창진,2,1,2,50.0,0,0,0.0,1,2,50.0,0,0,0.0,0,1,1,0,0,0,0,0,0,3
../kbl_data/2021-2022,S39G01N208,수원 KT,Away,최성모,0,0,0,0.0,0,0,0.0,0,0,0.0,0,0,0.0,0,0,0,0,0,0,0,0,0,0
../kbl_data/2021-2022,S39G01N208,수원 KT,Away,허훈,13,1,4,25.0,3,6,50.0,4,10,40.0,2,4,50.0,0,0,0,8,1,0,0,0,4,2
../kbl_data/2021-2022,S39G01N208,수원 KT,Away,박준영,0,0,0,0.0,0,0,0.0,0,0,0.0,0,0,0.0,1,0,1,0,0,0,0,0,0,0
../kbl_data/2021-2022,S39G01N208,수원 KT,Away,박지원,21,6,8,75.0,2,3,66.7,8,11,72.7,3,4,75.0,3,3,6,5,1,0,0,0,3,4
../kbl_data/2021-2022,S39G01N208,수원 KT,Away,마이크 마이어스,17,7,10,70.0,0,0,0.0,7,10,70.0,3,6,50.0,5,10,15,5,1,1,0,2,0,4
../kbl_data/2021-2022,S39G01N208,수원 KT,Away,김준환,0,0,0,0.0,0,0,0.0,0,0,0.0,0,0,0.0,0,0,0,0,0,0,0,0,0,0
../kbl_data/2021-2022,S39G01N208,수원 KT,Away,하윤기,16,7,11,63.6,0,0,0.0,7,11,63.6,2,2,100.0,2,5,7,0,2,0,0,1,1,4
../kbl_data/2021-2022,S39G01N209,안양 KGC,Home,박형철,0,0,0,0.0,0,0,0.0,0,0,0.0,0,0,0.0,0,0,0,0,0,0,0,0,0,0
../kbl_data/2021-2022,S39G01N209,안양 KGC,Home,함준후,2,1,4,25.0,0,1,0.0,1,5,20.0,0,0,0.0,3,2,5,1,0,0,0,0,1,4
../kbl_data/2021-2022,S39G01N209,안양 KGC,Home,문성곤,9,2,3,66.7,1,5,20.0,3,8,37.5,2,3,66.7,3,2,5,3,3,0,0,0,1,1
../kbl_data/2021-2022,S39G01N209,안양 KGC,Home,전성현,19,2,8,25.0,4,9,44.4,6,17,35.3,3,4,75.0,1,3,4,2,0,1,0,0,2,2
../kbl_data/2021-2022,S39G01N209,안양 KGC,Home,박재한,0,0,0,0.0,0,0,0.0,0,0,0.0,0,0,0.0,0,0,0,0,0,0,0,0,0,0
../kbl_data/2021-2022,S39G01N209,안양 KGC,Home,박지훈,18,6,12,50.0,2,8,25.0,8,20,40.0,0,0,0.0,4,4,8,8,0,0,0,0,8,6
../kbl_data/2021-2022,S39G01N209,안양 KGC,Home,대릴 먼로,0,0,0,0.0,0,0,0.0,0,0,0.0,0,0,0.0,0,0,0,0,0,0,0,0,1,0
../kbl_data/2021-2022,S39G01N209,안양 KGC,Home,변준형,0,0,1,0.0,0,1,0.0,0,2,0.0,0,0,0.0,2,0,2,2,0,0,1,0,2,2
../kbl_data/2021-2022,S39G01N209,안양 KGC,Home,양승면,0,0,0,0.0,0,0,0.0,0,0,0.0,0,0,0.0,0,0,0,0,0,0,0,0,0,0
../kbl_data/2021-2022,S39G01N209,안양 KGC,Home,오마리 스펠맨,26,7,9,77.8,3,11,27.3,10,20,50.0,3,11,27.3,2,10,12,1,2,4,0,0,3,3
../kbl_data/2021-2022,S39G01N209,안양 KGC,Home,주현우,2,1,4,25.0,0,0,0.0,1,4,25.0,0,0,0.0,1,1,2,0,0,0,0,0,0,5
../kbl_data/2021-2022,S39G01N209,안양 KGC,Home,조은후,0,0,0,0.0,0,0,0.0,0,0,0.0,0,0,0.0,0,0,0,0,0,0,0,0,0,0
../kbl_data/2021-2022,S39G01N209,울산 현대모비스,Away,이현민,11,1,2,50.0,2,6,33.3,3,8,37.5,3,5,60.0,0,4,4,4,1,0,2,0,1,3
../kbl_data/2021-2022,S39G01N209,울산 현대모비스,Away,함지훈,8,2,5,40.0,0,0,0.0,2,5,40.0,4,4,100.0,4,3,7,2,0,0,0,0,0,1
../kbl_data/2021-2022,S39G01N209,울산 현대모비스,Away,최진수,2,1,1,100.0,0,0,0.0,1,1,100.0,0,0,0.0,0,1,1,0,1,0,0,0,0,1
../kbl_data/2021-2022,S39G01N209,울산 현대모비스,Away,박지훈,18,6,12,50.0,2,8,25.0,8,20,40.0,0,0,0.0,4,4,8,8,0,0,0,0,8,6
../kbl_data/2021-2022,S39G01N209,울산 현대모비스,Away,장재석,6,3,6,50.0,0,0,0.0,3,6,50.0,0,0,0.0,4,4,8,2,1,3,0,0,1,3
../kbl_data/2021-2022,S39G01N209,울산 현대모비스,Away,김영현,9,2,3,66.7,1,3,33.3,3,6,50.0,2,2,100.0,1,0,1,1,0,1,0,0,1,2
../kbl_data/2021-2022,S39G01N209,울산 현대모비스,Away,김국찬,8,0,2,0.0,2,7,28.6,2,9,22.2,2,3,66.7,0,1,1,1,0,0,0,0,1,1
../kbl_data/2021-2022,S39G01N209,울산 현대모비스,Away,서명진,0,0,0,0.0,0,2,0.0,0,2,0.0,0,0,0.0,0,0,0,0,0,0,0,0,1,0
../kbl_data/2021-2022,S39G01N209,울산 현대모비스,Away,이우석,8,3,8,37.5,0,3,0.0,3,11,27.3,2,2,100.0,1,3,4,2,1,0,0,0,3,3
../kbl_data/2021-2022,S39G01N209,울산 현대모비스,Away,라숀 토마스,21,9,20,45.0,0,0,0.0,9,20,45.0,3,4,75.0,8,7,15,2,1,0,0,1,2,2
../kbl_data/2021-2022,S39G01N209,울산 현대모비스,Away,김동준,3,0,0,0.0,1,1,100.0,1,1,100.0,0,0,0.0,0,0,0,1,0,0,0,0,0,0
../kbl_data/2021-2022,S39G01N209,울산 현대모비스,Away,에릭 버크너,4,2,3,66.7,0,0,0.0,2,3,66.7,0,0,0.0,3,0,3,0,0,0,0,1,0,1
../kbl_data/2021-2022,S39G01N210,대구 한국가스공사,Home,민성주,0,0,0,0.0,0,0,0.0,0,0,0.0,0,0,0.0,0,0,0,0,0,0,0,0,0,0
../kbl_data/2021-2022,S39G01N210,대구 한국가스공사,Home,홍경기,0,0,0,0.0,0,0,0.0,0,0,0.0,0,0,0.0,0,0,0,0,0,0,0,0,2,0
../kbl_data/2021-2022,S39G01N210,대구 한국가스공사,Home,차바위,7,2,3,66.7,0,1,0.0,2,4,50.0,3,3,100.0,0,0,0,0,2,0,0,0,2,1
../kbl_data/2021-2022,S39G01N210,대구 한국가스공사,Home,이대헌,8,4,7,57.1,0,1,0.0,4,8,50.0,0,0,0.0,2,4,6,2,1,0,0,0,0,4
../kbl_data/2021-2022,S39G01N210,대구 한국가스공사,Home,두경민,7,2,4,50.0,1,2,50.0,3,6,50.0,0,0,0.0,0,3,3,7,2,0,0,0,1,4
../kbl_data/2021-2022,S39G01N210,대구 한국가스공사,Home,김낙현,18,6,7,85.7,2,2,100.0,8,9,88.9,0,0,0.0,0,0,0,6,0,0,0,0,4,5
../kbl_data/2021-2022,S39G01N210,대구 한국가스공사,Home,전현우,15,1,1,100.0,4,7,57.1,5,8,62.5,1,1,100.0,0,1,1,3,1,0,0,0,2,3
../kbl_data/2021-2022,S39G01N210,대구 한국가스공사,Home,이윤기,0,0,0,0.0,0,0,0.0,0,0,0.0,0,0,0.0,0,0,0,0,0,0,0,0,0,0
../kbl_data/2021-2022,S39G01N210,대구 한국가스공사,Home,양준우,0,0,0,0.0,0,0,0.0,0,0,0.0,0,0,0.0,0,0,0,0,0,0,0,0,0,0
../kbl_data/2021-2022,S39G01N210,대구 한국가스공사,Home,앤드류 니콜슨,26,9,13,69.2,2,4,50.0,11,17,64.7,2,2,100.0,1,6,7,4,1,0,0,2,0,0
../kbl_data/2021-2022,S39G01N210,대구 한국가스공사,Home,신승민,5,0,0,0.0,1,2,50.0,1,2,50.0,2,2,100.0,0,1,1,1,0,1,0,0,2,4
../kbl_data/2021-2022,S39G01N210,대구 한국가스공사,Home,디제이 화이트,5,2,3,66.7,0,1,0.0,2,4,50.0,1,1,100.0,0,2,2,0,0,0,0,0,0,1
../kbl_data/2021-2022,S39G01N210,고양 오리온,Away,김강선,3,0,0,0.0,1,2,50.0,1,2,50.0,0,0,0.0,0,0,0,0,0,0,1,0,0,0
../kbl_data/2021-2022,S39G01N210,고양 오리온,Away,최현민,11,4,6,66.7,1,4,25.0,5,10,50.0,0,0,0.0,1,2,3,0,0,0,0,0,0,3
../kbl_data/2021-2022,S39G01N210,고양 오리온,Away,임종일,0,0,0,0.0,0,0,0.0,0,0,0.0,0,0,0.0,0,1,1,0,0,0,0,0,0,0
../kbl_data/2021-2022,S39G01N210,고양 오리온,Away,이대성,2,1,8,12.5,0,2,0.0,1,10,10.0,0,0,0.0,1,3,4,6,0,0,0,0,3,1
../kbl_data/2021-2022,S39G01N210,고양 오리온,Away,한호빈,0,0,0,0.0,0,2,0.0,0,2,0.0,0,0,0.0,0,0,0,0,1,0,0,0,0,0
../kbl_data/2021-2022,S39G01N210,고양 오리온,Away,이승현,34,7,10,70.0,5,6,83.3,12,16,75.0,5,5,100.0,3,1,4,2,1,1,0,0,0,2
../kbl_data/2021-2022,S39G01N210,고양 오리온,Away,김진유,0,0,0,0.0,0,0,0.0,0,0,0.0,0,0,0.0,0,1,1,1,1,0,0,0,1,2
../kbl_data/2021-2022,S39G01N210,고양 오리온,Away,제임스 메이스,2,1,1,100.0,0,2,0.0,1,3,33.3,0,0,0.0,1,4,5,2,1,0,0,0,1,0
../kbl_data/2021-2022,S39G01N210,고양 오리온,Away,머피 할로웨이,16,7,10,70.0,0,0,0.0,7,10,70.0,2,3,66.7,3,7,10,2,3,1,0,1,5,2
../kbl_data/2021-2022,S39G01N210,고양 오리온,Away,조한진,0,0,0,0.0,0,0,0.0,0,0,0.0,0,0,0.0,0,0,0,0,0,0,0,0,0,0
../kbl_data/2021-2022,S39G01N210,고양 오리온,Away,박진철,7,2,2,100.0,0,0,0.0,2,2,100.0,3,3,100.0,0,0,0,0,0,0,0,1,0,2
../kbl_data/2021-2022,S39G01N210,고양 오리온,Away,이정현,21,5,6,83.3,2,4,50.0,7,10,70.0,5,6,83.3,0,0,0,5,2,0,1,0,1,3
../kbl_data/2021-2022,S39G01N211,서울 삼성,Home,김시래,5,1,3,33.3,1,3,33.3,2,6,33.3,0,0,0.0,0,0,0,5,1,0,0,0,1,1
../kbl_data/2021-2022,S39G01N211,서울 삼성,Home,김현수,11,1,4,25.0,3,5,60.0,4,9,44.4,0,0,0.0,0,2,2,1,2,0,0,0,1,4
../kbl_data/2021-2022,S39G01N211,서울 삼성,Home,임동섭,3,0,4,0.0,1,6,16.7,1,10,10.0,0,0,0.0,0,0,0,0,0,1,0,0,0,1
../kbl_data/2021-2022,S39G01N211,서울 삼성,Home,이동엽,5,1,4,25.0,1,1,100.0,2,5,40.0,0,0,0.0,1,2,3,2,0,0,0,0,1,3
../kbl_data/2021-2022,S39G01N211,서울 삼성,Home,이호현,2,1,3,33.3,0,0,0.0,1,3,33.3,0,0,0.0,0,2,2,1,0,0,0,0,0,1
../kbl_data/2021-2022,S39G01N211,서울 삼성,Home,정희원,0,0,0,0.0,0,0,0.0,0,0,0.0,0,0,0.0,0,0,0,1,0,0,0,0,0,2
../kbl_data/2021-2022,S39G01N211,서울 삼성,Home,박민우,0,0,0,0.0,0,1,0.0,0,1,0.0,0,0,0.0,0,0,0,1,0,0,0,0,0,1
../kbl_data/2021-2022,S39G01N211,서울 삼성,Home,차민석,9,3,7,42.9,1,1,100.0,4,8,50.0,0,0,0.0,2,1,3,0,0,0,0,0,1,0
../kbl_data/2021-2022,S39G01N211,서울 삼성,Home,전형준,0,0,2,0.0,0,1,0.0,0,3,0.0,0,0,0.0,0,0,0,0,1,0,1,0,0,3
../kbl_data/2021-2022,S39G01N211,서울 삼성,Home,조우성,0,0,0,0.0,0,0,0.0,0,0,0.0,0,0,0.0,1,2,3,1,1,0,0,0,0,1
../kbl_data/2021-2022,S39G01N211,서울 삼성,Home,이원석,14,6,9,66.7,0,2,0.0,6,11,54.5,2,2,100.0,2,2,4,0,0,1,0,0,1,2
../kbl_data/2021-2022,S39G01N211,서울 삼성,Home,토마스 로빈슨,25,11,24,45.8,0,0,0.0,11,24,45.8,3,4,75.0,6,8,14,2,1,2,0,1,3,4
../kbl_data/2021-2022,S39G01N211,서울 SK,Away,양우섭,0,0,1,0.0,0,0,0.0,0,1,0.0,0,0,0.0,0,0,0,1,0,0,0,0,0,0
../kbl_data/2021-2022,S39G01N211,서울 SK,Away,허일영,10,2,6,33.3,1,5,20.0,3,11,27.3,3,3,100.0,2,2,4,0,0,0,0,0,0,1
../kbl_data/2021-2022,S39G01N211,서울 SK,Away,최부경,2,1,3,33.3,0,3,0.0,1,6,16.7,0,0,0.0,0,4,4,1,0,0,0,0,1,1
../kbl_data/2021-2022,S39G01N211,서울 SK,Away,김승원,0,0,0,0.0,0,0,0.0,0,0,0.0,0,0,0.0,0,0,0,0,0,0,0,0,0,0
../kbl_data/2021-2022,S39G01N211,서울 SK,Away,이원대,0,0,1,0.0,0,1,0.0,0,2,0.0,0,0,0.0,0,0,0,0,0,0,0,0,0,1
../kbl_data/2021-2022,S39G01N211,서울 SK,Away,배병준,2,0,1,0.0,0,0,0.0,0,1,0.0,2,2,100.0,1,2,3,1,1,0,0,0,0,0
../kbl_data/2021-2022,S39G01N211,서울 SK,Away,이현석,3,1,1,100.0,0,1,0.0,1,2,50.0,1,2,50.0,0,1,1,0,1,0,0,0,0,3
../kbl_data/2021-2022,S39G01N211,서울 SK,Away,최원혁,1,0,0,0.0,0,0,0.0,0,0,0.0,1,2,50.0,2,2,4,1,3,0,0,0,2,1
../kbl_data/2021-2022,S39G01N211,서울 SK,Away,최준용,25,7,7,100.0,2,5,40.0,9,12,75.0,5,6,83.3,2,5,7,6,1,2,0,0,3,2
../kbl_data/2021-2022,S39G01N211,서울 SK,Away,안영준,16,6,11,54.5,1,2,50.0,7,13,53.8,1,1,100.0,2,2,4,1,0,1,0,0,1,0
../kbl_data/2021-2022,S39G01N211,서울 SK,Away,자밀 워니,29,10,17,58.8,2,2,100.0,12,19,63.2,3,6,50.0,5,17,22,5,0,2,0,2,2,2
../kbl_data/2021-2022,S39G01N211,서울 SK,Away,오재현,10,3,6,50.0,1,3,33.3,4,9,44.4,1,2,50.0,1,0,1,1,2,2,0,0,1,3
../kbl_data/2021-2022,S39G01N212,창원 LG,Home,강병현,4,1,1,100.0,0,0,0.0,1,1,100.0,2,2,100.0,0,1,1,1,0,0,0,0,0,3
../kbl_data/2021-2022,S39G01N212,창원 LG,Home,이관희,10,3,9,33.3,1,3,33.3,4,12,33.3,1,3,33.3,0,5,5,4,1,0,0,0,0,2
../kbl_data/2021-2022,S39G01N212,창원 LG,Home,정희재,0,0,2,0.0,0,1,0.0,0,3,0.0,0,0,0.0,1,0,1,0,0,0,0,0,2,2
../kbl_data/2021-2022,S39G01N212,창원 LG,Home,서민수,5,1,2,50.0,1,4,25.0,2,6,33.3,0,0,0.0,1,0,1,1,0,0,0,0,1,2
../kbl_data/2021-2022,S39G01N212,창원 LG,Home,한상혁,0,0,0,0.0,0,0,0.0,0,0,0.0,0,0,0.0,0,1,1,0,2,1,0,0,0,0
../kbl_data/2021-2022,S39G01N212,창원 LG,Home,이재도,19,5,13,38.5,2,7,28.6,7,20,35.0,3,4,75.0,2,2,4,3,1,0,0,0,1,0
../kbl_data/2021-2022,S39G01N212,창원 LG,Home,정해원,0,0,0,0.0,0,0,0.0,0,0,0.0,0,0,0.0,0,1,1,0,0,0,0,0,0,1
../kbl_data/2021-2022,S39G01N212,창원 LG,Home,박정현,7,2,2,100.0,1,2,50.0,3,4,75.0,0,0,0.0,0,1,1,0,0,0,0,0,0,1
../kbl_data/2021-2022,S39G01N212,창원 LG,Home,아셈 마레이,22,10,16,62.5,0,1,0.0,10,17,58.8,2,10,20.0,4,13,17,3,2,0,1,0,0,2
../kbl_data/2021-2022,S39G01N212,창원 LG,Home,이승우,9,4,7,57.1,0,0,0.0,4,7,57.1,1,1,100.0,0,2,2,1,3,0,2,0,0,4
../kbl_data/2021-2022,S39G01N212,창원 LG,Home,김종호,0,0,0,0.0,0,0,0.0,0,0,0.0,0,0,0.0,0,0,0,0,0,0,0,0,0,0
../kbl_data/2021-2022,S39G01N212,창원 LG,Home,사마르도 사무엘스,6,3,4,75.0,0,0,0.0,3,4,75.0,0,0,0.0,0,0,0,0,1,0,0,0,3,0
../kbl_data/2021-2022,S39G01N212,원주 DB,Away,윤호영,5,1,3,33.3,1,1,100.0,2,4,50.0,0,0,0.0,3,3,6,4,1,2,0,0,2,4
../kbl_data/2021-2022,S39G01N212,원주 DB,Away,정준원,2,1,4,25.0,0,1,0.0,1,5,20.0,0,0,0.0,0,1,1,1,0,0,0,0,0,1
../kbl_data/2021-2022,S39G01N212,원주 DB,Away,박경상,0,0,1,0.0,0,1,0.0,0,2,0.0,0,0,0.0,0,0,0,0,0,0,0,0,0,1
../kbl_data/2021-2022,S39G01N212,원주 DB,Away,김종규,12,5,9,55.6,0,3,0.0,5,12,41.7,2,3,66.7,3,6,9,1,0,2,0,0,1,4
../kbl_data/2021-2022,S39G01N212,원주 DB,Away,허웅,32,4,8,50.0,7,12,58.3,11,20,55.0,3,3,100.0,1,5,6,9,0,0,1,0,4,5
../kbl_data/2021-2022,S39G01N212,원주 DB,Away,김영훈,0,0,0,0.0,0,2,0.0,0,2,0.0,0,0,0.0,1,0,1,1,1,0,1,0,1,1
../kbl_data/2021-2022,S39G01N212,원주 DB,Away,배강률,0,0,0,0.0,0,0,0.0,0,0,0.0,0,0,0.0,0,1,1,0,0,0,0,0,0,0
../kbl_data/2021-2022,S39G01N212,원주 DB,Away,맹상훈,0,0,0,0.0,0,0,0.0,0,0,0.0,0,0,0.0,0,0,0,0,0,0,0,0,0,0
../kbl_data/2021-2022,S39G01N212,원주 DB,Away,강상재,7,2,4,50.0,1,4,25.0,3,8,37.5,0,0,0.0,2,8,10,4,0,2,0,0,5,3
../kbl_data/2021-2022,S39G01N212,원주 DB,Away,김철욱,5,1,2,50.0,0,1,0.0,1,3,33.3,3,3,100.0,1,5,6,1,0,0,1,0,2,2
../kbl_data/2021-2022,S39G01N212,원주 DB,Away,윤성원,0,0,0,0.0,0,0,0.0,0,0,0.0,0,0,0.0,0,0,0,0,0,0,0,0,0,0
../kbl_data/2021-2022,S39G01N212,원주 DB,Away,이준희,14,4,9,44.4,2,4,50.0,6,13,46.2,0,0,0.0,0,1,1,2,0,0,0,0,2,4
../kbl_data/2021-2022,S39G01N213,안양 KGC,Home,양희종,0,0,0,0.0,0,1,0.0,0,1,0.0,0,0,0.0,0,2,2,1,0,0,0,0,1,2
../kbl_data/2021-2022,S39G01N213,안양 KGC,Home,함준후,0,0,0,0.0,0,0,0.0,0,0,0.0,0,0,0.0,0,0,0,0,0,0,0,0,0,0
../kbl_data/2021-2022,S39G01N213,안양 KGC,Home,오세근,10,5,9,55.6,0,4,0.0,5,13,38.5,0,1,0.0,3,7,10,6,0,2,0,0,1,3
../kbl_data/2021-2022,S39G01N213,안양 KGC,Home,문성곤,23,4,4,100.0,5,7,71.4,9,11,81.8,0,0,0.0,0,7,7,0,1,0,0,0,1,4
../kbl_data/2021-2022,S39G01N213,안양 KGC,Home,전성현,21,3,3,100.0,5,9,55.6,8,12,66.7,0,0,0.0,0,1,1,1,1,0,0,0,0,1
../kbl_data/2021-2022,S39G01N213,안양 KGC,Home,박지훈,8,1,1,100.0,2,3,66.7,3,4,75.0,0,1,0.0,0,3,3,5,0,0,1,0,1,1
../kbl_data/2021-2022,S39G01N213,안양 KGC,Home,대릴 먼로,12,3,9,33.3,1,3,33.3,4,12,33.3,3,4,75.0,2,5,7,5,3,0,1,0,3,4
../kbl_data/2021-2022,S39G01N213,안양 KGC,Home,우동현,5,1,1,100.0,1,4,25.0,2,5,40.0,0,0,0.0,0,0,0,0,0,0,0,0,0,2
../kbl_data/2021-2022,S39G01N213,안양 KGC,Home,변준형,9,2,3,66.7,1,4,25.0,3,7,42.9,2,2,100.0,1,0,1,5,1,0,1,0,3,4
../kbl_data/2021-2022,S39G01N213,안양 KGC,Home,한승희,5,2,2,100.0,0,0,0.0,2,2,100.0,1,1,100.0,1,0,1,1,0,0,0,0,0,2
../kbl_data/2021-2022,S39G01N213,안양 KGC,Home,오마리 스펠맨,13,3,4,75.0,2,2,100.0,5,6,83.3,1,2,50.0,1,3,4,0,0,1,0,2,0,0
../kbl_data/2021-2022,S39G01N213,안양 KGC,Home,조은후,0,0,0,0.0,0,1,0.0,0,1,0.0,0,0,0.0,0,0,0,1,0,0,0,0,0,0
../kbl_data/2021-2022,S39G01N213,수원 KT,Away,김동욱,7,2,2,100.0,1,2,50.0,3,4,75.0,0,0,0.0,1,0,1,0,0,0,0,0,1,1
../kbl_data/2021-2022,S39G01N213,수원 KT,Away,김영환,6,0,0,0.0,1,1,100.0,1,1,100.0,3,4,75.0,0,1,1,2,1,0,0,0,2,0
../kbl_data/2021-2022,S39G01N213,수원 KT,Away,김현민,2,1,1,100.0,0,0,0.0,1,1,100.0,0,0,0.0,0,1,1,0,0,0,0,0,0,3
../kbl_data/2021-2022,S39G01N213,수원 KT,Away,한희원,2,1,1,100.0,0,0,0.0,1,1,100.0,0,0,0.0,0,0,0,0,0,0,0,0,0,0
../kbl_data/2021-2022,S39G01N213,수원 KT,Away,정성우,0,0,4,0.0,0,2,0.0,0,6,0.0,0,0,0.0,0,1,1,7,1,0,0,0,0,2
../kbl_data/2021-2022,S39G01N213,수원 KT,Away,최성모,0,0,0,0.0,0,0,0.0,0,0,0.0,0,0,0.0,0,0,0,0,0,0,0,0,0,0
../kbl_data/2021-2022,S39G01N213,수원 KT,Away,허훈,23,3,4,75.0,3,4,75.0,6,8,75.0,8,11,72.7,0,0,0,5,1,0,0,0,1,3
../kbl_data/2021-2022,S39G01N213,수원 KT,Away,양홍석,9,0,2,0.0,2,5,40.0,2,7,28.6,3,4,75.0,0,4,4,0,0,0,0,0,1,3
../kbl_data/2021-2022,S39G01N213,수원 KT,Away,캐디 라렌,13,4,12,33.3,1,1,100.0,5,13,38.5,2,4,50.0,1,9,10,1,0,0,0,0,3,3
../kbl_data/2021-2022,S39G01N213,수원 KT,Away,박지원,9,1,3,33.3,2,6,33.3,3,9,33.3,1,2,50.0,1,0,1,3,1,0,1,0,1,4
../kbl_data/2021-2022,S39G01N213,수원 KT,Away,마이크 마이어스,10,5,9,55.6,0,0,0.0,5,9,55.6,0,0,0.0,5,3,8,2,0,0,0,2,0,1
../kbl_data/2021-2022,S39G01N213,수원 KT,Away,하윤기,8,3,6,50.0,0,0,0.0,3,6,50.0,2,4,50.0,3,5,8,1,0,0,0,0,1,1
../kbl_data/2021-2022,S39G01N214,울산 현대모비스,Home,이현민,5,1,4,25.0,1,1,100.0,2,5,40.0,0,0,0.0,0,1,1,2,1,0,0,0,4,1
../kbl_data/2021-2022,S39G01N214,울산 현대모비스,Home,함지훈,6,0,3,0.0,1,3,33.3,1,6,16.7,3,4,75.0,0,0,0,1,0,0,0,0,0,0
../kbl_data/2021-2022,S39G01N214,울산 현대모비스,Home,박지훈,8,1,2,50.0,2,3,66.7,3,5,60.0,0,0,0.0,2,2,4,1,0,0,0,0,0,4
../kbl_data/2021-2022,S39G01N214,울산 현대모비스,Home,장재석,11,5,6,83.3,0,0,0.0,5,6,83.3,1,2,50.0,2,3,5,0,2,0,0,0,1,0
../kbl_data/2021-2022,S39G01N214,울산 현대모비스,Home,김영현,2,1,1,100.0,0,1,0.0,1,2,50.0,0,0,0.0,0,0,0,1,1,0,0,0,0,4
../kbl_data/2021-2022,S39G01N214,울산 현대모비스,Home,서명진,16,4,8,50.0,2,9,22.2,6,17,35.3,2,3,66.7,1,2,3,5,3,0,0,0,1,4
../kbl_data/2021-2022,S39G01N214,울산 현대모비스,Home,강병현,0,0,0,0.0,0,0,0.0,0,0,0.0,0,0,0.0,0,0,0,0,0,0,0,0,0,0
../kbl_data/2021-2022,S39G01N214,울산 현대모비스,Home,이진석,0,0,0,0.0,0,0,0.0,0,0,0.0,0,0,0.0,0,0,0,0,0,0,0,0,0,1
../kbl_data/2021-2022,S39G01N214,울산 현대모비스,Home,신민석,8,1,7,14.3,2,8,25.0,3,15,20.0,0,0,0.0,1,3,4,1,5,1,0,0,0,2
../kbl_data/2021-2022,S39G01N214,울산 현대모비스,Home,김동준,2,1,2,50.0,0,1,0.0,1,3,33.3,0,0,0.0,0,2,2,3,0,0,0,0,2,1
../kbl_data/2021-2022,S39G01N214,울산 현대모비스,Home,정종현,0,0,0,0.0,0,0,0.0,0,0,0.0,0,0,0.0,0,0,0,0,0,0,0,0,0,0
../kbl_data/2021-2022,S39G01N214,울산 현대모비스,Home,에릭 버크너,12,5,11,45.5,0,0,0.0,5,11,45.5,2,4,50.0,4,8,12,5,1,2,1,2,3,1
../kbl_data/2021-2022,S39G01N214,서울 SK,Away,양우섭,4,2,3,66.7,0,1,0.0,2,4,50.0,0,0,0.0,3,1,4,2,1,0,0,0,2,1
../kbl_data/2021-2022,S39G01N214,서울 SK,Away,허일영,0,0,2,0.0,0,2,0.0,0,4,0.0,0,1,0.0,1,0,1,3,1,0,0,0,1,1
../kbl_data/2021-2022,S39G01N214,서울 SK,Away,최부경,9,3,3,100.0,0,0,0.0,3,3,100.0,3,4,75.0,1,0,1,0,0,0,0,0,0,1
../kbl_data/2021-2022,S39G01N214,서울 SK,Away,김승원,0,0,0,0.0,0,0,0.0,0,0,0.0,0,0,0.0,0,0,0,0,0,0,0,0,0,0
../kbl_data/2021-2022,S39G01N214,서울 SK,Away,이원대,0,0,0,0.0,0,0,0.0,0,0,0.0,0,0,0.0,0,0,0,0,0,0,0,0,0,0
../kbl_data/2021-2022,S39G01N214,서울 SK,Away,배병준,0,0,0,0.0,0,0,0.0,0,0,0.0,0,0,0.0,0,0,0,0,0,0,0,0,0,0
../kbl_data/2021-2022,S39G01N214,서울 SK,Away,이현석,10,2,2,100.0,2,7,28.6,4,9,44.4,0,0,0.0,2,2,4,1,0,0,0,0,0,3
../kbl_data/2021-2022,S39G01N214,서울 SK,Away,최원혁,2,1,1,100.0,0,1,0.0,1,2,50.0,0,0,0.0,1,3,4,0,3,0,0,0,2,2
../kbl_data/2021-2022,S39G01N214,서울 SK,Away,최준용,9,2,4,50.0,1,2,50.0,3,6,50.0,2,2,100.0,2,5,7,4,0,0,0,0,3,3
../kbl_data/2021-2022,S39G01N214,서울 SK,Away,안영준,17,5,10,50.0,2,6,33.3,7,16,43.8,1,2,50.0,1,2,3,3,2,2,0,0,4,3
../kbl_data/2021-2022,S39G01N214,서울 SK,Away,자밀 워니,20,8,22,36.4,1,2,50.0,9,24,37.5,1,3,33.3,4,13,17,4,0,2,0,1,7,1
../kbl_data/2021-2022,S39G01N214,서울 SK,Away,오재현,5,1,1,100.0,1,2,50.0,2,3,66.7,0,0,0.0,0,2,2,0,0,0,0,0,1,2
../kbl_data/2021-2022,S39G01N215,서울 삼성,Home,김동량,18,9,10,90.0,0,2,0.0,9,12,75.0,0,0,0.0,0,5,5,3,1,0,0,0,0,3
../kbl_data/2021-2022,S39G01N215,서울 삼성,Home,김시래,14,0,5,0.0,3,4,75.0,3,9,33.3,5,5,100.0,1,3,4,7,1,0,0,0,1,1
../kbl_data/2021-2022,S39G01N215,서울 삼성,Home,김현수,17,1,1,100.0,5,13,38.5,6,14,42.9,0,0,0.0,0,1,1,3,0,0,0,0,0,3
../kbl_data/2021-2022,S39G01N215,서울 삼성,Home,임동섭,12,3,4,75.0,2,6,33.3,5,10,50.0,0,0,0.0,2,4,6,2,0,0,1,0,0,3
../kbl_data/2021-2022,S39G01N215,서울 삼성,Home,이동엽,8,1,4,25.0,2,6,33.3,3,10,30.0,0,0,0.0,0,3,3,2,0,0,0,0,0,2
../kbl_data/2021-2022,S39G01N215,서울 삼성,Home,배수용,3,0,1,0.0,1,1,100.0,1,2,50.0,0,0,0.0,0,1,1,1,0,0,0,0,0,1
../kbl_data/2021-2022,S39G01N215,서울 삼성,Home,강바일,0,0,0,0.0,0,0,0.0,0,0,0.0,0,0,0.0,0,0,0,0,0,0,0,0,0,0
../kbl_data/2021-2022,S39G01N215,서울 삼성,Home,박민우,0,0,0,0.0,0,0,0.0,0,0,0.0,0,0,0.0,0,0,0,0,0,0,0,0,0,0
../kbl_data/2021-2022,S39G01N215,서울 삼성,Home,차민석,0,0,0,0.0,0,0,0.0,0,0,0.0,0,0,0.0,0,0,0,0,0,0,0,0,0,0
../kbl_data/2021-2022,S39G01N215,서울 삼성,Home,전형준,0,0,1,0.0,0,0,0.0,0,1,0.0,0,0,0.0,1,0,1,0,0,0,0,0,0,3
../kbl_data/2021-2022,S39G01N215,서울 삼성,Home,이원석,5,2,2,100.0,0,0,0.0,2,2,100.0,1,1,100.0,0,1,1,0,0,1,1,1,0,4
../kbl_data/2021-2022,S39G01N215,서울 삼성,Home,토마스 로빈슨,16,7,11,63.6,0,0,0.0,7,11,63.6,2,4,50.0,3,8,11,8,1,0,0,0,4,2
../kbl_data/2021-2022,S39G01N215,대구 한국가스공사,Away,민성주,0,0,0,0.0,0,0,0.0,0,0,0.0,0,0,0.0,0,0,0,0,0,0,0,0,0,0
../kbl_data/2021-2022,S39G01N215,대구 한국가스공사,Away,홍경기,0,0,0,0.0,0,0,0.0,0,0,0.0,0,0,0.0,0,1,1,0,0,0,0,0,0,0
../kbl_data/2021-2022,S39G01N215,대구 한국가스공사,Away,차바위,8,1,2,50.0,2,3,66.7,3,5,60.0,0,0,0.0,3,3,6,4,0,1,1,0,0,3
../kbl_data/2021-2022,S39G01N215,대구 한국가스공사,Away,이대헌,19,6,10,60.0,1,3,33.3,7,13,53.8,4,8,50.0,2,5,7,2,0,1,0,0,2,4
../kbl_data/2021-2022,S39G01N215,대구 한국가스공사,Away,두경민,3,0,1,0.0,1,3,33.3,1,4,25.0,0,0,0.0,0,0,0,3,0,0,1,0,1,2
../kbl_data/2021-2022,S39G01N215,대구 한국가스공사,Away,김낙현,24,3,6,50.0,4,7,57.1,7,13,53.8,6,7,85.7,1,2,3,8,1,0,0,0,1,1
../kbl_data/2021-2022,S39G01N215,대구 한국가스공사,Away,전현우,11,1,3,33.3,3,7,42.9,4,10,40.0,0,0,0.0,0,0,0,1,0,0,0,0,1,3
../kbl_data/2021-2022,S39G01N215,대구 한국가스공사,Away,이윤기,0,0,0,0.0,0,0,0.0,0,0,0.0,0,0,0.0,0,0,0,0,0,0,0,0,0,0
../kbl_data/2021-2022,S39G01N215,대구 한국가스공사,Away,양준우,0,0,0,0.0,0,0,0.0,0,0,0.0,0,0,0.0,0,0,0,0,0,0,0,0,0,0
../kbl_data/2021-2022,S39G01N215,대구 한국가스공사,Away,앤드류 니콜슨,26,12,19,63.2,0,2,0.0,12,21,57.1,2,3,66.7,2,11,13,2,0,1,0,0,1,2
../kbl_data/2021-2022,S39G01N215,대구 한국가스공사,Away,신승민,2,1,1,100.0,0,0,0.0,1,1,100.0,0,0,0.0,2,0,2,0,1,0,0,0,0,0
../kbl_data/2021-2022,S39G01N215,대구 한국가스공사,Away,디제이 화이트,2,1,3,33.3,0,0,0.0,1,3,33.3,0,0,0.0,0,3,3,0,0,0,0,0,0,1
../kbl_data/2021-2022,S39G01N216,원주 DB,Home,정준원,0,0,0,0.0,0,0,0.0,0,0,0.0,0,0,0.0,0,0,0,0,0,0,0,0,0,0
../kbl_data/2021-2022,S39G01N216,원주 DB,Home,김종규,12,6,13,46.2,0,0,0.0,6,13,46.2,0,0,0.0,1,2,3,1,0,1,0,0,1,2
../kbl_data/2021-2022,S39G01N216,원주 DB,Home,허웅,21,8,11,72.7,1,6,16.7,9,17,52.9,2,2,100.0,0,1,1,1,2,0,0,0,3,1
../kbl_data/2021-2022,S39G01N216,원주 DB,Home,김영훈,0,0,1,0.0,0,1,0.0,0,2,0.0,0,0,0.0,0,1,1,1,1,0,0,0,0,0
../kbl_data/2021-2022,S39G01N216,원주 DB,Home,강상재,8,1,5,20.0,2,3,66.7,3,8,37.5,0,0,0.0,1,2,3,4,1,1,0,0,2,3
../kbl_data/2021-2022,S39G01N216,원주 DB,Home,김철욱,0,0,0,0.0,0,0,0.0,0,0,0.0,0,0,0.0,0,0,0,0,0,0,0,0,0,0
../kbl_data/2021-2022,S39G01N216,원주 DB,Home,나카무라 타이치,6,0,2,0.0,2,5,40.0,2,7,28.6,0,0,0.0,0,2,2,2,2,0,0,0,0,2
../kbl_data/2021-2022,S39G01N216,원주 DB,Home,이용우,6,3,4,75.0,0,2,0.0,3,6,50.0,0,0,0.0,1,1,2,1,2,0,0,0,0,2
../kbl_data/2021-2022,S39G01N216,원주 DB,Home,이준희,0,0,2,0.0,0,2,0.0,0,4,0.0,0,0,0.0,2,4,6,5,1,0,0,0,2,2
../kbl_data/2021-2022,S39G01N216,원주 DB,Home,레나드 프리먼,16,7,7,100.0,0,0,0.0,7,7,100.0,2,3,66.7,3,4,7,2,2,0,0,1,0,0
../kbl_data/2021-2022,S39G01N216,원주 DB,Home,정호영,5,1,2,50.0,1,5,20.0,2,7,28.6,0,0,0.0,0,1,1,2,0,1,0,0,0,2
../kbl_data/2021-2022,S39G01N216,원주 DB,Home,조니 오브라이언트,5,1,3,33.3,0,1,0.0,1,4,25.0,3,4,75.0,2,3,5,1,0,1,1,0,2,2
../kbl_data/2021-2022,S39G01N216,전주 KCC,Away,이정현,9,3,4,75.0,1,3,33.3,4,7,57.1,0,0,0.0,0,1,1,1,0,1,0,0,1,1
../kbl_data/2021-2022,S39G01N216,전주 KCC,Away,라건아,14,3,9,33.3,2,2,100.0,5,11,45.5,2,2,100.0,4,2,6,0,0,0,0,0,0,2
../kbl_data/2021-2022,S39G01N216,전주 KCC,Away,김지완,4,2,2,100.0,0,0,0.0,2,2,100.0,0,0,0.0,0,0,0,3,1,0,0,0,2,1
../kbl_data/2021-2022,S39G01N216,전주 KCC,Away,김상규,0,0,0,0.0,0,0,0.0,0,0,0.0,0,0,0.0,0,0,0,0,0,0,0,0,0,0
../kbl_data/2021-2022,S39G01N216,전주 KCC,Away,전준범,6,0,4,0.0,2,4,50.0,2,8,25.0,0,0,0.0,0,2,2,4,0,0,0,0,1,1
../kbl_data/2021-2022,S39G01N216,전주 KCC,Away,박재현,2,1,3,33.3,0,2,0.0,1,5,20.0,0,0,0.0,0,0,0,2,0,0,0,0,1,1
../kbl_data/2021-2022,S39G01N216,전주 KCC,Away,이진욱,4,1,2,50.0,0,0,0.0,1,2,50.0,2,2,100.0,0,0,0,4,1,0,0,0,3,1
../kbl_data/2021-2022,S39G01N216,전주 KCC,Away,곽동기,6,3,4,75.0,0,0,0.0,3,4,75.0,0,0,0.0,1,1,2,0,0,1,0,0,1,1
../kbl_data/2021-2022,S39G01N216,전주 KCC,Away,라타비우스 윌리엄스,17,8,8,100.0,0,0,0.0,8,8,100.0,1,4,25.0,3,12,15,0,1,0,0,0,1,1
../kbl_data/2021-2022,S39G01N216,전주 KCC,Away,곽정훈,0,0,1,0.0,0,0,0.0,0,1,0.0,0,0,0.0,0,3,3,3,0,0,1,0,2,2
../kbl_data/2021-2022,S39G01N216,전주 KCC,Away,이근휘,12,0,0,0.0,4,7,57.1,4,7,57.1,0,0,0.0,0,2,2,5,2,0,0,0,2,4
../kbl_data/2021-2022,S39G01N216,전주 KCC,Away,서정현,11,5,8,62.5,0,1,0.0,5,9,55.6,1,2,50.0,1,5,6,2,0,0,0,0,1,0
../kbl_data/2021-2022,S39G01N217,고양 오리온,Home,김강선,6,0,0,0.0,2,6,33.3,2,6,33.3,0,0,0.0,1,2,3,0,3,1,0,0,1,4
../kbl_data/2021-2022,S39G01N217,고양 오리온,Home,최현민,3,0,0,0.0,1,2,50.0,1,2,50.0,0,0,0.0,1,0,1,0,0,0,0,0,1,1
../kbl_data/2021-2022,S39G01N217,고양 오리온,Home,임종일,2,1,1,100.0,0,3,0.0,1,4,25.0,0,0,0.0,0,1,1,0,0,0,1,0,0,3
../kbl_data/2021-2022,S39G01N217,고양 오리온,Home,이대성,16,5,12,41.7,1,3,33.3,6,15,40.0,3,3,100.0,1,3,4,6,0,0,0,0,2,1
../kbl_data/2021-2022,S39G01N217,고양 오리온,Home,한호빈,6,1,3,33.3,1,4,25.0,2,7,28.6,1,2,50.0,0,2,2,2,0,0,0,0,2,3
../kbl_data/2021-2022,S39G01N217,고양 오리온,Home,이정제,0,0,0,0.0,0,0,0.0,0,0,0.0,0,0,0.0,0,0,0,0,0,0,0,0,0,0
../kbl_data/2021-2022,S39G01N217,고양 오리온,Home,이승현,20,6,11,54.5,2,6,33.3,8,17,47.1,2,2,100.0,0,5,5,3,1,0,0,0,1,2
../kbl_data/2021-2022,S39G01N217,고양 오리온,Home,제임스 메이스,11,3,4,75.0,1,2,50.0,4,6,66.7,2,2,100.0,3,4,7,0,1,1,0,0,1,1
../kbl_data/2021-2022,S39G01N217,고양 오리온,Home,머피 할로웨이,11,5,11,45.5,0,1,0.0,5,12,41.7,1,4,25.0,6,2,8,6,3,1,0,2,2,1
../kbl_data/2021-2022,S39G01N217,고양 오리온,Home,조한진,0,0,0,0.0,0,0,0.0,0,0,0.0,0,0,0.0,0,0,0,0,0,0,0,0,0,0
../kbl_data/2021-2022,S39G01N217,고양 오리온,Home,박진철,2,1,2,50.0,0,0,0.0,1,2,50.0,0,0,0.0,1,2,3,0,0,0,0,1,1,1
../kbl_data/2021-2022,S39G01N217,고양 오리온,Home,이정현,0,0,0,0.0,0,0,0.0,0,0,0.0,0,0,0.0,0,0,0,0,0,0,0,0,0,0
../kbl_data/2021-2022,S39G01N217,서울 삼성,Away,김시래,21,4,4,100.0,2,3,66.7,6,7,85.7,7,8,87.5,2,7,9,12,2,0,0,0,3,4
../kbl_data/2021-2022,S39G01N217,서울 삼성,Away,김현수,6,3,3,100.0,0,4,0.0,3,7,42.9,0,0,0.0,0,0,0,1,1,0,0,0,1,0
../kbl_data/2021-2022,S39G01N217,서울 삼성,Away,임동섭,10,2,4,50.0,2,7,28.6,4,11,36.4,0,0,0.0,2,4,6,1,2,0,0,0,2,3
../kbl_data/2021-2022,S39G01N217,서울 삼성,Away,이동엽,14,3,4,75.0,2,5,40.0,5,9,55.6,2,2,100.0,2,2,4,1,1,0,0,0,2,2
../kbl_data/2021-2022,S39G01N217,서울 삼성,Away,정희원,0,0,0,0.0,0,0,0.0,0,0,0.0,0,0,0.0,0,0,0,0,0,0,0,0,0,0
../kbl_data/2021-2022,S39G01N217,서울 삼성,Away,강바일,0,0,0,0.0,0,0,0.0,0,0,0.0,0,0,0.0,0,0,0,0,0,0,0,0,0,0
../kbl_data/2021-2022,S39G01N217,서울 삼성,Away,아이제아 힉스,13,6,11,54.5,0,0,0.0,6,11,54.5,1,1,100.0,2,4,6,1,0,0,0,2,3,4
../kbl_data/2021-2022,S39G01N217,서울 삼성,Away,박민우,0,0,0,0.0,0,0,0.0,0,0,0.0,0,0,0.0,0,0,0,0,0,0,0,0,0,0
../kbl_data/2021-2022,S39G01N217,서울 삼성,Away,차민석,3,0,2,0.0,1,1,100.0,1,3,33.3,0,0,0.0,0,0,0,0,0,0,0,0,0,0
../kbl_data/2021-2022,S39G01N217,서울 삼성,Away,전형준,0,0,0,0.0,0,0,0.0,0,0,0.0,0,0,0.0,0,1,1,1,0,0,0,0,0,4
../kbl_data/2021-2022,S39G01N217,서울 삼성,Away,이원석,10,4,10,40.0,0,0,0.0,4,10,40.0,2,2,100.0,1,4,5,3,0,1,0,2,1,2
../kbl_data/2021-2022,S39G01N217,서울 삼성,Away,제키 카마이클,6,3,8,37.5,0,0,0.0,3,8,37.5,0,0,0.0,1,5,6,2,2,0,0,0,0,0
../kbl_data/2021-2022,S39G01N218,서울 SK,Home,양우섭,0,0,0,0.0,0,0,0.0,0,0,0.0,0,0,0.0,0,0,0,0,0,0,0,0,0,0
../kbl_data/2021-2022,S39G01N218,서울 SK,Home,허일영,2,1,2,50.0,0,0,0.0,1,2,50.0,0,0,0.0,0,1,1,0,1,0,0,0,0,2
../kbl_data/2021-2022,S39G01N218,서울 SK,Home,김선형,12,4,8,50.0,1,4,25.0,5,12,41.7,1,2,50.0,1,2,3,5,1,0,0,0,2,1
../kbl_data/2021-2022,S39G01N218,서울 SK,Home,최부경,2,1,2,50.0,0,0,0.0,1,2,50.0,0,0,0.0,0,2,2,0,0,0,0,0,0,3
../kbl_data/2021-2022,S39G01N218,서울 SK,Home,리온 윌리엄스,0,0,0,0.0,0,1,0.0,0,1,0.0,0,0,0.0,0,1,1,0,0,0,0,0,1,0
../kbl_data/2021-2022,S39G01N218,서울 SK,Home,이현석,1,0,0,0.0,0,1,0.0,0,1,0.0,1,2,50.0,0,1,1,0,0,0,0,0,0,3
../kbl_data/2021-2022,S39G01N218,서울 SK,Home,최원혁,5,1,1,100.0,1,1,100.0,2,2,100.0,0,2,0.0,1,3,4,0,0,0,0,0,0,0
../kbl_data/2021-2022,S39G01N218,서울 SK,Home,최준용,9,3,6,50.0,0,4,0.0,3,10,30.0,3,5,60.0,1,4,5,0,1,0,0,0,4,3
../kbl_data/2021-2022,S39G01N218,서울 SK,Home,안영준,21,3,4,75.0,3,8,37.5,6,12,50.0,6,6,100.0,1,1,2,2,3,0,0,0,0,2
../kbl_data/2021-2022,S39G01N218,서울 SK,Home,자밀 워니,22,8,21,38.1,1,1,100.0,9,22,40.9,3,3,100.0,5,8,13,6,0,0,0,1,0,3
../kbl_data/2021-2022,S39G01N218,서울 SK,Home,오재현,5,1,2,50.0,1,4,25.0,2,6,33.3,0,0,0.0,3,2,5,0,1,0,0,0,0,1
../kbl_data/2021-2022,S39G01N218,서울 SK,Home,선상혁,0,0,0,0.0,0,0,0.0,0,0,0.0,0,0,0.0,0,0,0,0,0,0,0,0,0,0
../kbl_data/2021-2022,S39G01N218,안양 KGC,Away,함준후,0,0,0,0.0,0,0,0.0,0,0,0.0,0,0,0.0,0,1,1,0,0,0,0,0,0,0
../kbl_data/2021-2022,S39G01N218,안양 KGC,Away,오세근,19,7,11,63.6,1,2,50.0,8,13,61.5,2,2,100.0,3,4,7,3,0,0,0,0,1,4
../kbl_data/2021-2022,S39G01N218,안양 KGC,Away,문성곤,12,2,2,100.0,2,5,40.0,4,7,57.1,2,2,100.0,3,6,9,2,2,0,0,0,2,2
../kbl_data/2021-2022,S39G01N218,안양 KGC,Away,전성현,21,1,2,50.0,6,14,42.9,7,16,43.8,1,3,33.3,0,1,1,0,2,0,0,0,0,0
../kbl_data/2021-2022,S39G01N218,안양 KGC,Away,박지훈,0,0,2,0.0,0,0,0.0,0,2,0.0,0,0,0.0,0,1,1,2,0,0,0,0,1,3
../kbl_data/2021-2022,S39G01N218,안양 KGC,Away,이우정,0,0,0,0.0,0,0,0.0,0,0,0.0,0,0,0.0,0,0,0,0,0,0,0,0,0,0
../kbl_data/2021-2022,S39G01N218,안양 KGC,Away,대릴 먼로,5,1,3,33.3,1,1,100.0,2,4,50.0,0,0,0.0,0,3,3,0,0,0,0,0,1,0
../kbl_data/2021-2022,S39G01N218,안양 KGC,Away,우동현,0,0,0,0.0,0,1,0.0,0,1,0.0,0,0,0.0,0,0,0,0,0,0,0,0,0,3
../kbl_data/2021-2022,S39G01N218,안양 KGC,Away,변준형,6,1,3,33.3,1,3,33.3,2,6,33.3,1,2,50.0,0,1,1,7,0,0,0,0,3,4
../kbl_data/2021-2022,S39G01N218,안양 KGC,Away,한승희,0,0,0,0.0,0,0,0.0,0,0,0.0,0,0,0.0,2,0,2,0,0,0,1,0,0,2
../kbl_data/2021-2022,S39G01N218,안양 KGC,Away,오마리 스펠맨,22,5,8,62.5,3,9,33.3,8,17,47.1,3,4,75.0,1,9,10,5,2,4,0,2,5,2
../kbl_data/2021-2022,S39G01N218,안양 KGC,Away,주현우,0,0,0,0.0,0,0,0.0,0,0,0.0,0,0,0.0,0,0,0,0,0,0,0,0,0,0
../kbl_data/2021-2022,S39G01N219,수원 KT,Home,김영환,2,1,3,33.3,0,3,0.0,1,6,16.7,0,0,0.0,3,2,5,1,1,0,0,0,0,2
../kbl_data/2021-2022,S39G01N219,수원 KT,Home,김현민,6,0,0,0.0,2,2,100.0,2,2,100.0,0,0,0.0,0,0,0,0,0,0,0,0,0,2
../kbl_data/2021-2022,S39G01N219,수원 KT,Home,한희원,0,0,0,0.0,0,0,0.0,0,0,0.0,0,0,0.0,0,0,0,0,0,0,0,0,0,0
../kbl_data/2021-2022,S39G01N219,수원 KT,Home,정성우,16,3,5,60.0,2,5,40.0,5,10,50.0,4,5,80.0,0,1,1,4,2,0,0,0,1,2
../kbl_data/2021-2022,S39G01N219,수원 KT,Home,허훈,11,0,3,0.0,3,8,37.5,3,11,27.3,2,2,100.0,0,3,3,13,0,1,0,0,4,1
../kbl_data/2021-2022,S39G01N219,수원 KT,Home,양홍석,14,4,5,80.0,2,7,28.6,6,12,50.0,0,0,0.0,0,5,5,4,0,1,0,0,1,2
../kbl_data/2021-2022,S39G01N219,수원 KT,Home,박준영,0,0,0,0.0,0,0,0.0,0,0,0.0,0,0,0.0,0,0,0,0,0,0,0,0,0,0
../kbl_data/2021-2022,S39G01N219,수원 KT,Home,캐디 라렌,12,5,8,62.5,0,2,0.0,5,10,50.0,2,2,100.0,1,9,10,0,2,4,0,0,0,5
../kbl_data/2021-2022,S39G01N219,수원 KT,Home,문상옥,0,0,0,0.0,0,0,0.0,0,0,0.0,0,0,0.0,0,0,0,0,0,0,0,0,0,0
../kbl_data/2021-2022,S39G01N219,수원 KT,Home,박지원,2,1,5,20.0,0,0,0.0,1,5,20.0,0,0,0.0,0,1,1,1,1,0,0,0,1,1
../kbl_data/2021-2022,S39G01N219,수원 KT,Home,마이크 마이어스,5,2,5,40.0,0,0,0.0,2,5,40.0,1,1,100.0,0,2,2,0,0,0,0,0,0,5
../kbl_data/2021-2022,S39G01N219,수원 KT,Home,하윤기,13,6,7,85.7,0,0,0.0,6,7,85.7,1,2,50.0,3,3,6,0,2,0,0,1,4,2
../kbl_data/2021-2022,S39G01N219,창원 LG,Away,강병현,1,0,1,0.0,0,0,0.0,0,1,0.0,1,2,50.0,0,0,0,0,0,0,0,0,1,0
../kbl_data/2021-2022,S39G01N219,창원 LG,Away,변기훈,0,0,1,0.0,0,1,0.0,0,2,0.0,0,0,0.0,2,0,2,0,0,0,0,0,0,1
../kbl_data/2021-2022,S39G01N219,창원 LG,Away,정희재,6,1,3,33.3,1,3,33.3,2,6,33.3,1,2,50.0,1,3,4,2,3,0,0,0,0,1
../kbl_data/2021-2022,S39G01N219,창원 LG,Away,서민수,5,1,1,100.0,1,3,33.3,2,4,50.0,0,0,0.0,0,3,3,0,0,0,0,0,0,2
../kbl_data/2021-2022,S39G01N219,창원 LG,Away,한상혁,4,2,3,66.7,0,1,0.0,2,4,50.0,0,0,0.0,0,0,0,1,0,0,0,0,0,1
../kbl_data/2021-2022,S39G01N219,창원 LG,Away,이재도,21,7,13,53.8,1,1,100.0,8,14,57.1,4,7,57.1,3,1,4,6,2,0,0,0,3,2
../kbl_data/2021-2022,S39G01N219,창원 LG,Away,정해원,0,0,0,0.0,0,1,0.0,0,1,0.0,0,0,0.0,0,0,0,0,0,0,0,0,0,0
../kbl_data/2021-2022,S39G01N219,창원 LG,Away,박정현,12,6,10,60.0,0,0,0.0,6,10,60.0,0,1,0.0,3,3,6,1,0,0,0,0,1,3
../kbl_data/2021-2022,S39G01N219,창원 LG,Away,윤원상,0,0,0,0.0,0,3,0.0,0,3,0.0,0,0,0.0,0,1,1,1,0,0,0,0,0,0
../kbl_data/2021-2022,S39G01N219,창원 LG,Away,아셈 마레이,17,4,15,26.7,1,1,100.0,5,16,31.2,6,14,42.9,6,12,18,3,1,1,0,0,5,3
../kbl_data/2021-2022,S39G01N219,창원 LG,Away,이승우,4,2,6,33.3,0,0,0.0,2,6,33.3,0,0,0.0,2,0,2,2,1,1,1,0,1,3
../kbl_data/2021-2022,S39G01N219,창원 LG,Away,사마르도 사무엘스,3,1,4,25.0,0,0,0.0,1,4,25.0,1,2,50.0,0,1,1,0,0,0,0,0,0,1
../kbl_data/2021-2022,S39G01N220,전주 KCC,Home,이정현,8,0,0,0.0,2,4,50.0,2,4,50.0,2,4,50.0,0,2,2,2,0,0,0,0,0,2
../kbl_data/2021-2022,S39G01N220,전주 KCC,Home,정창영,3,0,2,0.0,0,4,0.0,0,6,0.0,3,3,100.0,0,0,0,0,0,0,0,0,1,2
../kbl_data/2021-2022,S39G01N220,전주 KCC,Home,라건아,15,4,4,100.0,2,5,40.0,6,9,66.7,1,2,50.0,1,6,7,2,0,0,0,1,0,1
../kbl_data/2021-2022,S39G01N220,전주 KCC,Home,김지완,3,0,1,0.0,1,4,25.0,1,5,20.0,0,0,0.0,0,1,1,3,0,0,0,0,0,1
../kbl_data/2021-2022,S39G01N220,전주 KCC,Home,김상규,2,1,3,33.3,0,1,0.0,1,4,25.0,0,0,0.0,2,1,3,0,0,0,0,0,1,1
../kbl_data/2021-2022,S39G01N220,전주 KCC,Home,전준범,1,0,0,0.0,0,4,0.0,0,4,0.0,1,2,50.0,0,1,1,2,0,0,0,0,1,3
../kbl_data/2021-2022,S39G01N220,전주 KCC,Home,박재현,4,2,3,66.7,0,2,0.0,2,5,40.0,0,0,0.0,0,2,2,1,0,0,0,0,0,2
../kbl_data/2021-2022,S39G01N220,전주 KCC,Home,송교창,5,1,2,50.0,1,1,100.0,2,3,66.7,0,0,0.0,0,2,2,1,0,0,0,0,0,1
../kbl_data/2021-2022,S39G01N220,전주 KCC,Home,이진욱,6,3,3,100.0,0,0,0.0,3,3,100.0,0,1,0.0,0,1,1,0,1,0,0,0,2,0
../kbl_data/2021-2022,S39G01N220,전주 KCC,Home,라타비우스 윌리엄스,17,7,8,87.5,0,0,0.0,7,8,87.5,3,4,75.0,3,3,6,0,0,0,0,2,0,1
../kbl_data/2021-2022,S39G01N220,전주 KCC,Home,이근휘,5,1,2,50.0,1,4,25.0,2,6,33.3,0,0,0.0,0,0,0,2,0,0,0,0,0,0
../kbl_data/2021-2022,S39G01N220,전주 KCC,Home,서정현,7,2,5,40.0,1,1,100.0,3,6,50.0,0,0,0.0,0,0,0,1,0,0,0,0,0,5
../kbl_data/2021-2022,S39G01N220,대구 한국가스공사,Away,정영삼,1,0,1,0.0,0,1,0.0,0,2,0.0,1,2,50.0,0,0,0,0,0,0,0,0,0,2
../kbl_data/2021-2022,S39G01N220,대구 한국가스공사,Away,홍경기,15,3,3,100.0,3,4,75.0,6,7,85.7,0,0,0.0,0,1,1,1,0,0,0,0,0,4
../kbl_data/2021-2022,S39G01N220,대구 한국가스공사,Away,차바위,2,1,1,100.0,0,1,0.0,1,2,50.0,0,0,0.0,1,2,3,1,0,0,0,0,0,1
../kbl_data/2021-2022,S39G01N220,대구 한국가스공사,Away,조상열,0,0,0,0.0,0,0,0.0,0,0,0.0,0,0,0.0,0,0,0,0,0,0,0,0,0,0
../kbl_data/2021-2022,S39G01N220,대구 한국가스공사,Away,이대헌,25,11,14,78.6,0,1,0.0,11,15,73.3,3,4,75.0,3,5,8,4,2,0,0,1,0,2
../kbl_data/2021-2022,S39G01N220,대구 한국가스공사,Away,두경민,11,3,4,75.0,1,3,33.3,4,7,57.1,2,2,100.0,0,1,1,4,0,0,0,0,3,0
../kbl_data/2021-2022,S39G01N220,대구 한국가스공사,Away,박봉진,0,0,0,0.0,0,0,0.0,0,0,0.0,0,0,0.0,0,0,0,0,0,0,0,0,0,0
../kbl_data/2021-2022,S39G01N220,대구 한국가스공사,Away,김낙현,5,0,0,0.0,1,4,25.0,1,4,25.0,2,2,100.0,0,4,4,10,0,0,0,0,0,0
../kbl_data/2021-2022,S39G01N220,대구 한국가스공사,Away,전현우,9,2,3,66.7,1,2,50.0,3,5,60.0,2,3,66.7,0,0,0,1,2,0,0,0,0,2
../kbl_data/2021-2022,S39G01N220,대구 한국가스공사,Away,앤드류 니콜슨,7,2,2,100.0,1,3,33.3,3,5,60.0,0,0,0.0,0,3,3,0,0,1,0,0,0,0
../kbl_data/2021-2022,S39G01N220,대구 한국가스공사,Away,신승민,3,1,1,100.0,0,0,0.0,1,1,100.0,1,2,50.0,0,1,1,0,0,0,0,0,0,1
../kbl_data/2021-2022,S39G01N220,대구 한국가스공사,Away,디제이 화이트,10,5,8,62.5,0,3,0.0,5,11,45.5,0,0,0.0,0,12,12,2,0,0,0,0,0,4
../kbl_data/2021-2022,S39G01N221,원주 DB,Home,박찬희,2,1,3,33.3,0,2,0.0,1,5,20.0,0,0,0.0,1,5,6,6,1,0,0,0,1,2
../kbl_data/2021-2022,S39G01N221,원주 DB,Home,정준원,1,0,1,0.0,0,2,0.0,0,3,0.0,1,2,50.0,0,0,0,0,0,0,0,0,1,0
../kbl_data/2021-2022,S39G01N221,원주 DB,Home,김종규,11,4,8,50.0,1,5,20.0,5,13,38.5,0,0,0.0,2,0,2,1,0,1,0,2,2,2
../kbl_data/2021-2022,S39G01N221,원주 DB,Home,허웅,8,0,2,0.0,2,8,25.0,2,10,20.0,2,2,100.0,2,2,4,3,0,0,0,0,2,0
../kbl_data/2021-2022,S39G01N221,원주 DB,Home,김영훈,0,0,0,0.0,0,0,0.0,0,0,0.0,0,0,0.0,0,0,0,0,0,0,0,0,0,0
../kbl_data/2021-2022,S39G01N221,원주 DB,Home,강상재,17,7,9,77.8,0,1,0.0,7,10,70.0,3,4,75.0,1,1,2,2,3,0,0,0,2,4
../kbl_data/2021-2022,S39G01N221,원주 DB,Home,김철욱,4,2,2,100.0,0,1,0.0,2,3,66.7,0,0,0.0,2,1,3,0,0,0,0,0,0,1
../kbl_data/2021-2022,S39G01N221,원주 DB,Home,나카무라 타이치,2,1,1,100.0,0,2,0.0,1,3,33.3,0,0,0.0,0,0,0,0,0,0,0,0,0,3
../kbl_data/2021-2022,S39G01N221,원주 DB,Home,이용우,6,0,1,0.0,2,4,50.0,2,5,40.0,0,0,0.0,2,0,2,1,3,0,0,0,4,2
../kbl_data/2021-2022,S39G01N221,원주 DB,Home,이준희,0,0,1,0.0,0,0,0.0,0,1,0.0,0,0,0.0,1,0,1,4,1,0,0,0,0,2
../kbl_data/2021-2022,S39G01N221,원주 DB,Home,레나드 프리먼,8,4,5,80.0,0,1,0.0,4,6,66.7,0,0,0.0,1,0,1,0,0,0,0,0,1,0
../kbl_data/2021-2022,S39G01N221,원주 DB,Home,조니 오브라이언트,17,4,7,57.1,2,6,33.3,6,13,46.2,3,4,75.0,1,9,10,1,0,0,0,1,0,3
../kbl_data/2021-2022,S39G01N221,서울 삼성,Away,김시래,17,3,7,42.9,3,4,75.0,6,11,54.5,2,2,100.0,1,10,11,10,1,0,0,0,4,3
../kbl_data/2021-2022,S39G01N221,서울 삼성,Away,김현수,8,1,1,100.0,2,3,66.7,3,4,75.0,0,0,0.0,0,0,0,2,0,0,0,0,2,1
../kbl_data/2021-2022,S39G01N221,서울 삼성,Away,임동섭,13,2,6,33.3,3,6,50.0,5,12,41.7,0,0,0.0,3,3,6,0,2,0,0,0,1,4
../kbl_data/2021-2022,S39G01N221,서울 삼성,Away,이동엽,4,1,6,16.7,0,2,0.0,1,8,12.5,2,2,100.0,2,2,4,1,2,0,0,0,4,2
../kbl_data/2021-2022,S39G01N221,서울 삼성,Away,배수용,0,0,0,0.0,0,1,0.0,0,1,0.0,0,0,0.0,0,0,0,0,0,0,0,0,0,0
../kbl_data/2021-2022,S39G01N221,서울 삼성,Away,이호현,2,1,2,50.0,0,0,0.0,1,2,50.0,0,0,0.0,0,0,0,0,0,0,0,0,0,0
../kbl_data/2021-2022,S39G01N221,서울 삼성,Away,아이제아 힉스,18,6,6,100.0,0,1,0.0,6,7,85.7,6,6,100.0,1,7,8,3,0,1,0,1,0,1
../kbl_data/2021-2022,S39G01N221,서울 삼성,Away,박민우,3,1,1,100.0,0,0,0.0,1,1,100.0,1,1,100.0,0,0,0,0,0,0,0,0,0,1
../kbl_data/2021-2022,S39G01N221,서울 삼성,Away,차민석,0,0,0,0.0,0,0,0.0,0,0,0.0,0,0,0.0,0,0,0,1,1,1,0,0,0,0
../kbl_data/2021-2022,S39G01N221,서울 삼성,Away,전형준,0,0,0,0.0,0,0,0.0,0,0,0.0,0,0,0.0,0,0,0,0,0,0,0,0,0,0
../kbl_data/2021-2022,S39G01N221,서울 삼성,Away,이원석,21,10,16,62.5,0,0,0.0,10,16,62.5,1,2,50.0,3,2,5,2,1,1,1,1,0,2
../kbl_data/2021-2022,S39G01N221,서울 삼성,Away,제키 카마이클,3,1,5,20.0,0,0,0.0,1,5,20.0,1,2,50.0,1,1,2,0,0,0,0,0,3,4
../kbl_data/2021-2022,S39G01N222,전주 KCC,Home,송창용,3,0,1,0.0,1,2,50.0,1,3,33.3,0,0,0.0,0,0,0,0,0,0,0,0,0,1
../kbl_data/2021-2022,S39G01N222,전주 KCC,Home,이정현,25,5,10,50.0,5,8,62.5,10,18,55.6,0,0,0.0,0,3,3,3,0,0,0,0,0,3
../kbl_data/2021-2022,S39G01N222,전주 KCC,Home,정창영,11,2,2,100.0,2,3,66.7,4,5,80.0,1,1,100.0,0,1,1,2,0,0,0,0,2,0
../kbl_data/2021-2022,S39G01N222,전주 KCC,Home,라건아,23,8,14,57.1,1,2,50.0,9,16,56.2,4,4,100.0,8,10,18,2,1,0,0,0,1,2
../kbl_data/2021-2022,S39G01N222,전주 KCC,Home,김지완,7,2,5,40.0,1,3,33.3,3,8,37.5,0,0,0.0,0,4,4,6,0,0,1,0,3,3
../kbl_data/2021-2022,S39G01N222,전주 KCC,Home,박재현,2,1,1,100.0,0,1,0.0,1,2,50.0,0,0,0.0,0,0,0,0,0,0,0,0,0,1
../kbl_data/2021-2022,S39G01N222,전주 KCC,Home,송교창,14,7,9,77.8,0,1,0.0,7,10,70.0,0,0,0.0,2,2,4,5,2,0,0,1,2,2
../kbl_data/2021-2022,S39G01N222,전주 KCC,Home,이진욱,0,0,0,0.0,0,0,0.0,0,0,0.0,0,0,0.0,0,0,0,2,1,0,0,0,0,3
../kbl_data/2021-2022,S39G01N222,전주 KCC,Home,김진용,0,0,0,0.0,0,0,0.0,0,0,0.0,0,0,0.0,0,0,0,0,0,0,0,0,0,0
../kbl_data/2021-2022,S39G01N222,전주 KCC,Home,유현준,4,2,4,50.0,0,3,0.0,2,7,28.6,0,0,0.0,0,3,3,1,1,0,0,0,2,0
../kbl_data/2021-2022,S39G01N222,전주 KCC,Home,라타비우스 윌리엄스,3,1,1,100.0,0,0,0.0,1,1,100.0,1,2,50.0,0,1,1,1,0,0,0,0,0,0
../kbl_data/2021-2022,S39G01N222,전주 KCC,Home,곽정훈,0,0,0,0.0,0,0,0.0,0,0,0.0,0,0,0.0,0,0,0,0,0,0,0,0,0,0
../kbl_data/2021-2022,S39G01N222,울산 현대모비스,Away,이현민,2,0,0,0.0,0,0,0.0,0,0,0.0,2,3,66.7,0,0,0,1,1,0,0,0,2,0
../kbl_data/2021-2022,S39G01N222,울산 현대모비스,Away,함지훈,6,3,7,42.9,0,1,0.0,3,8,37.5,0,0,0.0,4,3,7,3,1,0,0,0,0,1
../kbl_data/2021-2022,S39G01N222,울산 현대모비스,Away,최진수,2,1,2,50.0,0,2,0.0,1,4,25.0,0,0,0.0,0,3,3,0,0,0,0,0,0,1
../kbl_data/2021-2022,S39G01N222,울산 현대모비스,Away,박지훈,5,0,2,0.0,1,1,100.0,1,3,33.3,2,2,100.0,0,1,1,0,1,0,0,0,0,4
../kbl_data/2021-2022,S39G01N222,울산 현대모비스,Away,김영현,0,0,0,0.0,0,1,0.0,0,1,0.0,0,0,0.0,0,0,0,0,0,0,0,0,0,1
../kbl_data/2021-2022,S39G01N222,울산 현대모비스,Away,김국찬,3,0,1,0.0,1,3,33.3,1,4,25.0,0,0,0.0,0,1,1,2,1,0,0,0,0,1
../kbl_data/2021-2022,S39G01N222,울산 현대모비스,Away,서명진,14,4,8,50.0,2,6,33.3,6,14,42.9,0,0,0.0,2,3,5,6,1,0,0,0,0,1
../kbl_data/2021-2022,S39G01N222,울산 현대모비스,Away,이우석,14,4,7,57.1,2,5,40.0,6,12,50.0,0,0,0.0,0,1,1,3,0,0,0,1,0,2
../kbl_data/2021-2022,S39G01N222,울산 현대모비스,Away,라숀 토마스,21,9,11,81.8,0,0,0.0,9,11,81.8,3,7,42.9,2,4,6,3,2,0,0,0,4,3
../kbl_data/2021-2022,S39G01N222,울산 현대모비스,Away,신민석,7,2,2,100.0,1,1,100.0,3,3,100.0,0,0,0.0,0,1,1,0,1,1,0,0,0,0
../kbl_data/2021-2022,S39G01N222,울산 현대모비스,Away,김동준,3,1,3,33.3,0,2,0.0,1,5,20.0,1,2,50.0,1,1,2,2,0,0,0,0,1,0
../kbl_data/2021-2022,S39G01N222,울산 현대모비스,Away,에릭 버크너,2,1,2,50.0,0,0,0.0,1,2,50.0,0,0,0.0,0,1,1,0,0,1,0,1,1,1
../kbl_data/2021-2022,S39G01N223,서울 SK,Home,양우섭,3,1,1,100.0,0,0,0.0,1,1,100.0,1,2,50.0,0,0,0,0,0,1,0,0,1,0
../kbl_data/2021-2022,S39G01N223,서울 SK,Home,허일영,0,0,3,0.0,0,0,0.0,0,3,0.0,0,0,0.0,2,1,3,0,0,1,0,0,1,1
../kbl_data/2021-2022,S39G01N223,서울 SK,Home,김선형,2,1,1,100.0,0,0,0.0,1,1,100.0,0,0,0.0,0,0,0,0,0,0,0,0,1,1
../kbl_data/2021-2022,S39G01N223,서울 SK,Home,최부경,3,0,1,0.0,1,2,50.0,1,3,33.3,0,0,0.0,0,1,1,0,1,1,0,0,0,1
../kbl_data/2021-2022,S39G01N223,서울 SK,Home,리온 윌리엄스,8,4,8,50.0,0,0,0.0,4,8,50.0,0,0,0.0,1,2,3,0,1,0,1,0,0,3
../kbl_data/2021-2022,S39G01N223,서울 SK,Home,이현석,5,0,1,0.0,1,3,33.3,1,4,25.0,2,2,100.0,1,2,3,2,1,0,0,0,0,2
../kbl_data/2021-2022,S39G01N223,서울 SK,Home,최원혁,6,0,0,0.0,2,3,66.7,2,3,66.7,0,0,0.0,0,0,0,2,0,0,0,0,0,4
../kbl_data/2021-2022,S39G01N223,서울 SK,Home,최준용,28,7,9,77.8,4,10,40.0,11,19,57.9,2,2,100.0,1,5,6,8,0,1,0,1,4,2
../kbl_data/2021-2022,S39G01N223,서울 SK,Home,안영준,11,1,4,25.0,3,6,50.0,4,10,40.0,0,0,0.0,3,5,8,3,0,1,1,0,4,2
../kbl_data/2021-2022,S39G01N223,서울 SK,Home,자밀 워니,8,1,5,20.0,2,2,100.0,3,7,42.9,0,0,0.0,0,8,8,2,0,0,0,0,0,0
../kbl_data/2021-2022,S39G01N223,서울 SK,Home,오재현,0,0,1,0.0,0,1,0.0,0,2,0.0,0,0,0.0,2,0,2,2,1,0,0,0,1,0
../kbl_data/2021-2022,S39G01N223,서울 SK,Home,선상혁,0,0,1,0.0,0,0,0.0,0,1,0.0,0,0,0.0,0,1,1,0,0,0,0,0,0,0
../kbl_data/2021-2022,S39G01N223,창원 LG,Away,변기훈,0,0,0,0.0,0,3,0.0,0,3,0.0,0,0,0.0,0,0,0,0,1,0,0,0,0,1
../kbl_data/2021-2022,S39G01N223,창원 LG,Away,이관희,15,1,5,20.0,4,13,30.8,5,18,27.8,1,2,50.0,1,5,6,1,1,0,0,0,0,2
../kbl_data/2021-2022,S39G01N223,창원 LG,Away,정희재,5,1,1,100.0,1,6,16.7,2,7,28.6,0,0,0.0,1,1,2,1,0,0,0,0,0,3
../kbl_data/2021-2022,S39G01N223,창원 LG,Away,한상혁,0,0,0,0.0,0,0,0.0,0,0,0.0,0,0,0.0,0,1,1,0,0,0,0,0,0,1
../kbl_data/2021-2022,S39G01N223,창원 LG,Away,이재도,10,5,8,62.5,0,3,0.0,5,11,45.5,0,0,0.0,1,2,3,5,4,0,0,0,1,2
../kbl_data/2021-2022,S39G01N223,창원 LG,Away,정인덕,0,0,0,0.0,0,0,0.0,0,0,0.0,0,0,0.0,0,0,0,0,0,0,0,0,0,0
../kbl_data/2021-2022,S39G01N223,창원 LG,Away,정해원,0,0,0,0.0,0,0,0.0,0,0,0.0,0,0,0.0,0,0,0,0,0,0,0,0,0,0
../kbl_data/2021-2022,S39G01N223,창원 LG,Away,박정현,17,7,14,50.0,1,2,50.0,8,16,50.0,0,0,0.0,4,1,5,3,1,0,0,0,3,2
../kbl_data/2021-2022,S39G01N223,창원 LG,Away,윤원상,0,0,0,0.0,0,0,0.0,0,0,0.0,0,0,0.0,1,0,1,0,0,0,0,0,0,0
../kbl_data/2021-2022,S39G01N223,창원 LG,Away,아셈 마레이,11,5,10,50.0,0,0,0.0,5,10,50.0,1,2,50.0,4,6,10,5,1,1,0,0,0,3
../kbl_data/2021-2022,S39G01N223,창원 LG,Away,이승우,9,3,5,60.0,1,2,50.0,4,7,57.1,0,0,0.0,2,4,6,0,0,0,1,0,1,3
../kbl_data/2021-2022,S39G01N223,창원 LG,Away,사마르도 사무엘스,2,1,1,100.0,0,1,0.0,1,2,50.0,0,0,0.0,0,0,0,1,0,0,0,0,2,1
../kbl_data/2021-2022,S39G01N224,수원 KT,Home,김동욱,5,1,1,100.0,1,3,33.3,2,4,50.0,0,0,0.0,0,1,1,1,0,0,0,0,1,1
../kbl_data/2021-2022,S39G01N224,수원 KT,Home,김영환,10,2,2,100.0,2,5,40.0,4,7,57.1,0,0,0.0,0,1,1,1,0,0,0,0,0,0
../kbl_data/2021-2022,S39G01N224,수원 KT,Home,김현민,4,2,3,66.7,0,0,0.0,2,3,66.7,0,0,0.0,0,1,1,1,1,0,0,1,0,2
../kbl_data/2021-2022,S39G01N224,수원 KT,Home,한희원,4,2,2,100.0,0,2,0.0,2,4,50.0,0,0,0.0,1,1,2,0,1,0,0,0,1,1
../kbl_data/2021-2022,S39G01N224,수원 KT,Home,정성우,10,2,2,100.0,2,5,40.0,4,7,57.1,0,0,0.0,0,0,0,5,0,0,0,0,2,1
../kbl_data/2021-2022,S39G01N224,수원 KT,Home,최성모,0,0,0,0.0,0,0,0.0,0,0,0.0,0,0,0.0,0,0,0,0,0,0,0,0,0,0
../kbl_data/2021-2022,S39G01N224,수원 KT,Home,허훈,12,2,5,40.0,2,7,28.6,4,12,33.3,2,2,100.0,0,3,3,5,1,0,0,0,3,1
../kbl_data/2021-2022,S39G01N224,수원 KT,Home,양홍석,8,1,2,50.0,1,3,33.3,2,5,40.0,3,4,75.0,1,4,5,0,0,0,0,0,3,0
../kbl_data/2021-2022,S39G01N224,수원 KT,Home,캐디 라렌,11,4,6,66.7,0,0,0.0,4,6,66.7,3,3,100.0,2,4,6,1,0,0,0,0,2,4
../kbl_data/2021-2022,S39G01N224,수원 KT,Home,박지원,11,4,6,66.7,0,1,0.0,4,7,57.1,3,4,75.0,1,3,4,1,1,0,0,0,0,1
../kbl_data/2021-2022,S39G01N224,수원 KT,Home,마이크 마이어스,10,5,6,83.3,0,0,0.0,5,6,83.3,0,2,0.0,3,3,6,1,1,0,0,0,2,5
../kbl_data/2021-2022,S39G01N224,수원 KT,Home,하윤기,7,3,9,33.3,0,0,0.0,3,9,33.3,1,2,50.0,6,5,11,4,0,0,0,0,2,3
../kbl_data/2021-2022,S39G01N224,대구 한국가스공사,Away,정영삼,0,0,0,0.0,0,1,0.0,0,1,0.0,0,0,0.0,0,0,0,0,0,0,0,0,0,1
../kbl_data/2021-2022,S39G01N224,대구 한국가스공사,Away,민성주,0,0,0,0.0,0,0,0.0,0,0,0.0,0,0,0.0,0,0,0,0,0,0,0,0,0,0
../kbl_data/2021-2022,S39G01N224,대구 한국가스공사,Away,홍경기,2,1,1,100.0,0,1,0.0,1,2,50.0,0,0,0.0,1,0,1,0,0,0,0,0,0,2
../kbl_data/2021-2022,S39G01N224,대구 한국가스공사,Away,차바위,0,0,0,0.0,0,0,0.0,0,0,0.0,0,0,0.0,1,2,3,1,2,0,0,0,1,3
../kbl_data/2021-2022,S39G01N224,대구 한국가스공사,Away,조상열,0,0,0,0.0,0,1,0.0,0,1,0.0,0,0,0.0,0,0,0,0,0,0,0,0,0,0
../kbl_data/2021-2022,S39G01N224,대구 한국가스공사,Away,이대헌,16,8,11,72.7,0,1,0.0,8,12,66.7,0,0,0.0,0,4,4,3,0,0,2,0,1,2
../kbl_data/2021-2022,S39G01N224,대구 한국가스공사,Away,두경민,4,2,2,100.0,0,4,0.0,2,6,33.3,0,0,0.0,1,0,1,4,3,0,1,0,0,3
../kbl_data/2021-2022,S39G01N224,대구 한국가스공사,Away,박봉진,0,0,0,0.0,0,0,0.0,0,0,0.0,0,0,0.0,0,0,0,0,0,0,0,0,0,3
../kbl_data/2021-2022,S39G01N224,대구 한국가스공사,Away,김낙현,20,4,5,80.0,4,7,57.1,8,12,66.7,0,0,0.0,0,3,3,9,2,0,2,0,2,2
../kbl_data/2021-2022,S39G01N224,대구 한국가스공사,Away,전현우,6,3,4,75.0,0,3,0.0,3,7,42.9,0,0,0.0,1,1,2,2,0,0,0,0,0,3
../kbl_data/2021-2022,S39G01N224,대구 한국가스공사,Away,앤드류 니콜슨,10,2,7,28.6,2,7,28.6,4,14,28.6,0,0,0.0,0,1,1,0,1,0,0,0,0,1
../kbl_data/2021-2022,S39G01N224,대구 한국가스공사,Away,디제이 화이트,31,10,10,100.0,1,5,20.0,11,15,73.3,8,10,80.0,0,4,4,0,0,1,0,1,4,1
../kbl_data/2021-2022,S39G01N225,고양 오리온,Home,김강선,3,0,0,0.0,1,5,20.0,1,5,20.0,0,0,0.0,0,0,0,2,0,0,1,0,1,3
../kbl_data/2021-2022,S39G01N225,고양 오리온,Home,최현민,0,0,0,0.0,0,2,0.0,0,2,0.0,0,0,0.0,0,4,4,1,2,0,0,0,1,1
../kbl_data/2021-2022,S39G01N225,고양 오리온,Home,이대성,7,2,6,33.3,1,1,100.0,3,7,42.9,0,0,0.0,1,2,3,4,0,0,0,0,4,1
../kbl_data/2021-2022,S39G01N225,고양 오리온,Home,한호빈,6,0,3,0.0,2,3,66.7,2,6,33.3,0,0,0.0,0,2,2,3,1,0,0,0,0,1
../kbl_data/2021-2022,S39G01N225,고양 오리온,Home,이정제,0,0,3,0.0,0,0,0.0,0,3,0.0,0,0,0.0,1,1,2,0,0,0,0,0,1,2
../kbl_data/2021-2022,S39G01N225,고양 오리온,Home,최승욱,5,1,3,33.3,1,2,50.0,2,5,40.0,0,2,0.0,0,2,2,0,0,0,0,0,0,0
../kbl_data/2021-2022,S39G01N225,고양 오리온,Home,김진유,0,0,0,0.0,0,0,0.0,0,0,0.0,0,0,0.0,0,0,0,1,0,0,0,0,0,0
../kbl_data/2021-2022,S39G01N225,고양 오리온,Home,제임스 메이스,22,6,9,66.7,3,6,50.0,9,15,60.0,1,1,100.0,2,2,4,0,1,0,0,0,0,1
../kbl_data/2021-2022,S39G01N225,고양 오리온,Home,머피 할로웨이,11,5,10,50.0,0,0,0.0,5,10,50.0,1,2,50.0,2,3,5,3,0,0,0,2,2,0
../kbl_data/2021-2022,S39G01N225,고양 오리온,Home,조한진,0,0,1,0.0,0,2,0.0,0,3,0.0,0,0,0.0,2,1,3,0,0,0,0,0,0,0
../kbl_data/2021-2022,S39G01N225,고양 오리온,Home,박진철,6,3,8,37.5,0,0,0.0,3,8,37.5,0,0,0.0,5,4,9,2,1,1,0,1,1,2
../kbl_data/2021-2022,S39G01N225,고양 오리온,Home,이정현,7,2,5,40.0,1,2,50.0,3,7,42.9,0,0,0.0,1,1,2,3,0,0,0,0,1,1
../kbl_data/2021-2022,S39G01N225,안양 KGC,Away,함준후,8,1,2,50.0,2,3,66.7,3,5,60.0,0,0,0.0,0,1,1,1,0,0,0,0,0,2
../kbl_data/2021-2022,S39G01N225,안양 KGC,Away,오세근,20,7,11,63.6,1,2,50.0,8,13,61.5,3,5,60.0,1,6,7,6,1,3,0,0,2,1
../kbl_data/2021-2022,S39G01N225,안양 KGC,Away,문성곤,7,3,3,100.0,0,3,0.0,3,6,50.0,1,3,33.3,1,4,5,0,3,0,0,0,0,1
../kbl_data/2021-2022,S39G01N225,안양 KGC,Away,전성현,20,1,3,33.3,6,12,50.0,7,15,46.7,0,0,0.0,0,3,3,1,1,0,0,0,1,1
../kbl_data/2021-2022,S39G01N225,안양 KGC,Away,박지훈,2,1,1,100.0,0,0,0.0,1,1,100.0,0,0,0.0,1,0,1,3,0,0,0,0,1,1
../kbl_data/2021-2022,S39G01N225,안양 KGC,Away,이우정,0,0,0,0.0,0,0,0.0,0,0,0.0,0,0,0.0,0,0,0,0,0,0,0,0,0,0
../kbl_data/2021-2022,S39G01N225,안양 KGC,Away,대릴 먼로,0,0,3,0.0,0,0,0.0,0,3,0.0,0,0,0.0,1,5,6,3,1,2,0,0,1,1
../kbl_data/2021-2022,S39G01N225,안양 KGC,Away,우동현,2,1,1,100.0,0,2,0.0,1,3,33.3,0,0,0.0,0,0,0,0,0,0,0,0,0,2
../kbl_data/2021-2022,S39G01N225,안양 KGC,Away,변준형,10,0,4,0.0,3,6,50.0,3,10,30.0,1,2,50.0,3,2,5,6,1,0,0,0,2,4
../kbl_data/2021-2022,S39G01N225,안양 KGC,Away,한승희,2,1,1,100.0,0,0,0.0,1,1,100.0,0,0,0.0,1,2,3,0,1,0,0,0,0,1
../kbl_data/2021-2022,S39G01N225,안양 KGC,Away,오마리 스펠맨,17,4,6,66.7,3,4,75.0,7,10,70.0,0,0,0.0,3,4,7,2,0,0,0,0,3,2
../kbl_data/2021-2022,S39G01N225,안양 KGC,Away,주현우,0,0,0,0.0,0,0,0.0,0,0,0.0,0,0,0.0,0,0,0,0,0,0,0,0,0,0
../kbl_data/2021-2022,S39G01N226,원주 DB,Home,윤호영,4,1,4,25.0,0,1,0.0,1,5,20.0,2,3,66.7,3,3,6,0,1,1,0,0,0,1
../kbl_data/2021-2022,S39G01N226,원주 DB,Home,박찬희,5,1,1,100.0,1,5,20.0,2,6,33.3,0,2,0.0,0,2,2,3,1,0,0,0,1,2
../kbl_data/2021-2022,S39G01N226,원주 DB,Home,정준원,0,0,0,0.0,0,0,0.0,0,0,0.0,0,0,0.0,0,0,0,0,0,0,0,0,0,0
../kbl_data/2021-2022,S39G01N226,원주 DB,Home,김종규,10,3,8,37.5,1,4,25.0,4,12,33.3,1,2,50.0,2,4,6,2,0,1,0,0,2,1
../kbl_data/2021-2022,S39G01N226,원주 DB,Home,허웅,13,2,4,50.0,3,5,60.0,5,9,55.6,0,0,0.0,0,1,1,7,1,0,0,0,2,0
../kbl_data/2021-2022,S39G01N226,원주 DB,Home,김영훈,0,0,0,0.0,0,0,0.0,0,0,0.0,0,0,0.0,0,0,0,0,0,0,0,0,0,0
../kbl_data/2021-2022,S39G01N226,원주 DB,Home,강상재,6,3,3,100.0,0,2,0.0,3,5,60.0,0,0,0.0,4,2,6,0,1,0,0,0,1,3
../kbl_data/2021-2022,S39G01N226,원주 DB,Home,나카무라 타이치,0,0,1,0.0,0,0,0.0,0,1,0.0,0,0,0.0,0,0,0,0,0,0,0,0,0,1
../kbl_data/2021-2022,S39G01N226,원주 DB,Home,이용우,10,2,5,40.0,2,5,40.0,4,10,40.0,0,0,0.0,0,1,1,2,2,0,0,0,0,2
../kbl_data/2021-2022,S39G01N226,원주 DB,Home,이준희,0,0,0,0.0,0,0,0.0,0,0,0.0,0,0,0.0,0,0,0,0,0,0,0,0,0,0
../kbl_data/2021-2022,S39G01N226,원주 DB,Home,레나드 프리먼,3,1,4,25.0,0,1,0.0,1,5,20.0,1,2,50.0,0,4,4,0,0,0,0,0,0,2
../kbl_data/2021-2022,S39G01N226,원주 DB,Home,조니 오브라이언트,20,5,11,45.5,3,10,30.0,8,21,38.1,1,2,50.0,2,7,9,1,2,1,1,1,1,2
../kbl_data/2021-2022,S39G01N226,서울 SK,Away,양우섭,0,0,0,0.0,0,0,0.0,0,0,0.0,0,0,0.0,0,0,0,0,0,0,0,0,0,0
../kbl_data/2021-2022,S39G01N226,서울 SK,Away,허일영,10,2,2,100.0,2,4,50.0,4,6,66.7,0,0,0.0,1,4,5,1,0,0,0,0,1,3
../kbl_data/2021-2022,S39G01N226,서울 SK,Away,최부경,3,1,4,25.0,0,0,0.0,1,4,25.0,1,2,50.0,0,3,3,2,0,0,0,0,1,4
../kbl_data/2021-2022,S39G01N226,서울 SK,Away,김승원,0,0,0,0.0,0,0,0.0,0,0,0.0,0,0,0.0,0,0,0,0,0,0,0,0,0,0
../kbl_data/2021-2022,S39G01N226,서울 SK,Away,리온 윌리엄스,10,4,10,40.0,0,0,0.0,4,10,40.0,2,2,100.0,6,12,18,1,2,0,0,0,1,2
../kbl_data/2021-2022,S39G01N226,서울 SK,Away,이원대,0,0,0,0.0,0,0,0.0,0,0,0.0,0,0,0.0,0,0,0,0,0,0,0,0,0,0
../kbl_data/2021-2022,S39G01N226,서울 SK,Away,이현석,0,0,0,0.0,0,3,0.0,0,3,0.0,0,0,0.0,1,3,4,2,1,0,0,0,3,2
../kbl_data/2021-2022,S39G01N226,서울 SK,Away,최원혁,0,0,1,0.0,0,2,0.0,0,3,0.0,0,0,0.0,0,2,2,1,0,0,0,0,0,4
../kbl_data/2021-2022,S39G01N226,서울 SK,Away,최준용,23,9,18,50.0,0,4,0.0,9,22,40.9,5,7,71.4,2,4,6,5,2,0,0,0,4,1
../kbl_data/2021-2022,S39G01N226,서울 SK,Away,안영준,29,7,9,77.8,5,9,55.6,12,18,66.7,0,1,0.0,0,4,4,4,1,0,0,0,0,0
../kbl_data/2021-2022,S39G01N226,서울 SK,Away,오재현,2,1,2,50.0,0,0,0.0,1,2,50.0,0,0,0.0,0,0,0,0,0,0,0,0,1,0
../kbl_data/2021-2022,S39G01N226,서울 SK,Away,선상혁,0,0,0,0.0,0,0,0.0,0,0,0.0,0,0,0.0,0,0,0,0,0,0,0,0,0,0
../kbl_data/2021-2022,S39G01N227,서울 삼성,Home,김시래,15,2,5,40.0,1,4,25.0,3,9,33.3,8,8,100.0,1,2,3,10,0,0,0,0,4,1
../kbl_data/2021-2022,S39G01N227,서울 삼성,Home,임동섭,9,1,3,33.3,2,6,33.3,3,9,33.3,1,2,50.0,1,6,7,0,1,0,0,0,1,3
../kbl_data/2021-2022,S39G01N227,서울 삼성,Home,이동엽,2,1,3,33.3,0,1,0.0,1,4,25.0,0,0,0.0,1,5,6,5,0,0,0,0,0,5
../kbl_data/2021-2022,S39G01N227,서울 삼성,Home,배수용,3,0,0,0.0,1,1,100.0,1,1,100.0,0,0,0.0,0,0,0,0,0,0,0,0,0,0
../kbl_data/2021-2022,S39G01N227,서울 삼성,Home,이호현,4,2,3,66.7,0,0,0.0,2,3,66.7,0,0,0.0,0,1,1,1,0,0,0,0,1,0
../kbl_data/2021-2022,S39G01N227,서울 삼성,Home,강바일,0,0,0,0.0,0,0,0.0,0,0,0.0,0,0,0.0,0,0,0,0,0,0,0,0,0,1
../kbl_data/2021-2022,S39G01N227,서울 삼성,Home,아이제아 힉스,19,9,15,60.0,0,2,0.0,9,17,52.9,1,4,25.0,2,3,5,0,1,0,0,3,3,3
../kbl_data/2021-2022,S39G01N227,서울 삼성,Home,박민우,2,1,1,100.0,0,0,0.0,1,1,100.0,0,0,0.0,0,0,0,0,0,0,0,0,0,1
../kbl_data/2021-2022,S39G01N227,서울 삼성,Home,차민석,0,0,0,0.0,0,0,0.0,0,0,0.0,0,0,0.0,0,0,0,0,0,0,0,0,0,0
../kbl_data/2021-2022,S39G01N227,서울 삼성,Home,전형준,9,1,2,50.0,2,2,100.0,3,4,75.0,1,1,100.0,0,2,2,0,0,0,0,0,1,4
../kbl_data/2021-2022,S39G01N227,서울 삼성,Home,이원석,12,5,6,83.3,0,0,0.0,5,6,83.3,2,2,100.0,1,3,4,0,0,1,0,0,1,3
../kbl_data/2021-2022,S39G01N227,서울 삼성,Home,제키 카마이클,3,1,6,16.7,0,0,0.0,1,6,16.7,1,2,50.0,0,6,6,1,0,0,0,0,2,2
../kbl_data/2021-2022,S39G01N227,울산 현대모비스,Away,이현민,3,0,1,0.0,1,1,100.0,1,2,50.0,0,0,0.0,0,0,0,2,0,0,1,0,0,0
../kbl_data/2021-2022,S39G01N227,울산 현대모비스,Away,함지훈,15,5,7,71.4,1,2,50.0,6,9,66.7,2,3,66.7,2,7,9,2,3,0,0,0,2,2
../kbl_data/2021-2022,S39G01N227,울산 현대모비스,Away,최진수,0,0,1,0.0,0,1,0.0,0,2,0.0,0,0,0.0,0,0,0,0,0,0,0,0,0,2
../kbl_data/2021-2022,S39G01N227,울산 현대모비스,Away,박지훈,8,0,0,0.0,2,4,50.0,2,4,50.0,2,2,100.0,1,1,2,0,0,0,0,0,0,2
../kbl_data/2021-2022,S39G01N227,울산 현대모비스,Away,김영현,0,0,0,0.0,0,0,0.0,0,0,0.0,0,0,0.0,0,0,0,0,0,0,0,0,0,0
../kbl_data/2021-2022,S39G01N227,울산 현대모비스,Away,김국찬,21,2,4,50.0,5,12,41.7,7,16,43.8,2,2,100.0,3,1,4,1,0,0,1,0,0,2
../kbl_data/2021-2022,S39G01N227,울산 현대모비스,Away,서명진,4,1,2,50.0,0,3,0.0,1,5,20.0,2,4,50.0,0,2,2,2,1,0,0,0,0,3
../kbl_data/2021-2022,S39G01N227,울산 현대모비스,Away,이우석,14,4,8,50.0,1,2,50.0,5,10,50.0,3,4,75.0,1,2,3,6,0,1,0,0,0,1
../kbl_data/2021-2022,S39G01N227,울산 현대모비스,Away,라숀 토마스,8,2,14,14.3,0,0,0.0,2,14,14.3,4,4,100.0,2,0,2,3,1,1,0,0,1,4
../kbl_data/2021-2022,S39G01N227,울산 현대모비스,Away,신민석,3,0,0,0.0,1,2,50.0,1,2,50.0,0,0,0.0,0,1,1,1,1,0,0,0,1,1
../kbl_data/2021-2022,S39G01N227,울산 현대모비스,Away,김동준,6,2,3,66.7,0,0,0.0,2,3,66.7,2,3,66.7,0,2,2,1,0,0,0,0,1,2
../kbl_data/2021-2022,S39G01N227,울산 현대모비스,Away,에릭 버크너,5,1,2,50.0,0,0,0.0,1,2,50.0,3,3,100.0,0,6,6,1,0,0,0,0,1,2
../kbl_data/2021-2022,S39G01N228,전주 KCC,Home,송창용,4,0,0,0.0,0,2,0.0,0,2,0.0,4,4,100.0,0,3,3,1,1,0,0,0,2,1
../kbl_data/2021-2022,S39G01N228,전주 KCC,Home,이정현,17,5,9,55.6,1,1,100.0,6,10,60.0,4,6,66.7,0,3,3,0,0,1,0,0,0,2
../kbl_data/2021-2022,S39G01N228,전주 KCC,Home,정창영,0,0,0,0.0,0,0,0.0,0,0,0.0,0,0,0.0,0,0,0,1,0,0,0,0,0,1
../kbl_data/2021-2022,S39G01N228,전주 KCC,Home,라건아,16,5,7,71.4,2,5,40.0,7,12,58.3,0,0,0.0,3,3,6,2,1,2,0,0,2,3
../kbl_data/2021-2022,S39G01N228,전주 KCC,Home,김지완,16,4,8,50.0,2,5,40.0,6,13,46.2,2,2,100.0,0,1,1,2,0,0,0,0,0,0
../kbl_data/2021-2022,S39G01N228,전주 KCC,Home,박재현,0,0,1,0.0,0,1,0.0,0,2,0.0,0,0,0.0,0,1,1,1,0,0,1,0,0,3
../kbl_data/2021-2022,S39G01N228,전주 KCC,Home,송교창,9,4,10,40.0,0,1,0.0,4,11,36.4,1,2,50.0,2,4,6,5,1,1,0,0,3,0
../kbl_data/2021-2022,S39G01N228,전주 KCC,Home,이진욱,1,0,0,0.0,0,0,0.0,0,0,0.0,1,2,50.0,0,0,0,0,0,0,0,0,0,1
../kbl_data/2021-2022,S39G01N228,전주 KCC,Home,김진용,0,0,4,0.0,0,0,0.0,0,4,0.0,0,0,0.0,2,1,3,0,0,0,0,0,1,0
../kbl_data/2021-2022,S39G01N228,전주 KCC,Home,유현준,6,0,2,0.0,2,3,66.7,2,5,40.0,0,0,0.0,0,3,3,2,1,0,1,0,3,2
../kbl_data/2021-2022,S39G01N228,전주 KCC,Home,라타비우스 윌리엄스,2,1,2,50.0,0,0,0.0,1,2,50.0,0,0,0.0,1,2,3,1,0,0,0,0,1,1
../kbl_data/2021-2022,S39G01N228,전주 KCC,Home,곽정훈,2,1,1,100.0,0,0,0.0,1,1,100.0,0,0,0.0,0,0,0,0,0,0,0,0,0,0
../kbl_data/2021-2022,S39G01N228,수원 KT,Away,김영환,2,1,3,33.3,0,2,0.0,1,5,20.0,0,0,0.0,0,2,2,2,1,0,0,0,0,1
../kbl_data/2021-2022,S39G01N228,수원 KT,Away,김현민,0,0,0,0.0,0,0,0.0,0,0,0.0,0,0,0.0,0,0,0,0,0,0,0,0,0,0
../kbl_data/2021-2022,S39G01N228,수원 KT,Away,한희원,2,1,1,100.0,0,1,0.0,1,2,50.0,0,0,0.0,0,0,0,0,0,0,0,0,0,1
../kbl_data/2021-2022,S39G01N228,수원 KT,Away,정성우,11,1,3,33.3,3,4,75.0,4,7,57.1,0,0,0.0,3,3,6,3,3,0,0,0,0,4
../kbl_data/2021-2022,S39G01N228,수원 KT,Away,최성모,0,0,0,0.0,0,0,0.0,0,0,0.0,0,0,0.0,0,0,0,0,0,0,0,0,0,0
../kbl_data/2021-2022,S39G01N228,수원 KT,Away,허훈,25,8,11,72.7,2,4,50.0,10,15,66.7,3,3,100.0,0,4,4,5,1,1,0,0,2,0
../kbl_data/2021-2022,S39G01N228,수원 KT,Away,양홍석,6,3,10,30.0,0,5,0.0,3,15,20.0,0,0,0.0,1,2,3,4,1,0,0,0,1,2
../kbl_data/2021-2022,S39G01N228,수원 KT,Away,박준영,2,1,1,100.0,0,0,0.0,1,1,100.0,0,0,0.0,0,1,1,0,0,0,0,0,0,0
../kbl_data/2021-2022,S39G01N228,수원 KT,Away,캐디 라렌,11,4,7,57.1,0,0,0.0,4,7,57.1,3,4,75.0,0,4,4,0,2,1,0,0,4,2
../kbl_data/2021-2022,S39G01N228,수원 KT,Away,박지원,12,3,5,60.0,1,2,50.0,4,7,57.1,3,4,75.0,3,2,5,1,0,0,0,0,1,5
../kbl_data/2021-2022,S39G01N228,수원 KT,Away,마이크 마이어스,14,7,8,87.5,0,0,0.0,7,8,87.5,0,1,0.0,2,9,11,5,0,0,0,3,1,3
../kbl_data/2021-2022,S39G01N228,수원 KT,Away,하윤기,6,3,5,60.0,0,0,0.0,3,5,60.0,0,0,0.0,2,0,2,0,1,1,0,0,1,1
../kbl_data/2021-2022,S39G01N229,대구 한국가스공사,Home,정영삼,0,0,0,0.0,0,1,0.0,0,1,0.0,0,0,0.0,0,1,1,0,0,0,0,0,0,0
../kbl_data/2021-2022,S39G01N229,대구 한국가스공사,Home,민성주,0,0,0,0.0,0,0,0.0,0,0,0.0,0,0,0.0,0,1,1,0,0,0,0,0,1,0
../kbl_data/2021-2022,S39G01N229,대구 한국가스공사,Home,홍경기,17,1,3,33.3,5,6,83.3,6,9,66.7,0,0,0.0,0,3,3,2,1,0,0,0,1,2
../kbl_data/2021-2022,S39G01N229,대구 한국가스공사,Home,차바위,9,2,2,100.0,1,2,50.0,3,4,75.0,2,2,100.0,2,5,7,0,0,0,0,0,0,2
../kbl_data/2021-2022,S39G01N229,대구 한국가스공사,Home,조상열,0,0,0,0.0,0,0,0.0,0,0,0.0,0,0,0.0,0,0,0,0,0,0,0,0,0,0
../kbl_data/2021-2022,S39G01N229,대구 한국가스공사,Home,이대헌,16,5,6,83.3,1,1,100.0,6,7,85.7,3,4,75.0,0,9,9,6,0,0,0,0,3,2
../kbl_data/2021-2022,S39G01N229,대구 한국가스공사,Home,두경민,12,3,5,60.0,2,4,50.0,5,9,55.6,0,0,0.0,1,2,3,7,2,0,0,0,1,2
../kbl_data/2021-2022,S39G01N229,대구 한국가스공사,Home,김낙현,2,1,3,33.3,0,1,0.0,1,4,25.0,0,0,0.0,0,0,0,8,1,0,1,0,0,2
../kbl_data/2021-2022,S39G01N229,대구 한국가스공사,Home,전현우,2,1,1,100.0,0,1,0.0,1,2,50.0,0,0,0.0,0,0,0,0,0,0,0,0,0,1
../kbl_data/2021-2022,S39G01N229,대구 한국가스공사,Home,앤드류 니콜슨,27,11,12,91.7,1,2,50.0,12,14,85.7,2,3,66.7,2,1,3,0,1,0,0,0,2,0
../kbl_data/2021-2022,S39G01N229,대구 한국가스공사,Home,신승민,0,0,1,0.0,0,1,0.0,0,2,0.0,0,0,0.0,0,0,0,0,0,0,0,0,1,2
../kbl_data/2021-2022,S39G01N229,대구 한국가스공사,Home,디제이 화이트,17,5,7,71.4,2,5,40.0,7,12,58.3,1,2,50.0,2,3,5,3,0,0,0,0,1,1
../kbl_data/2021-2022,S39G01N229,안양 KGC,Away,양희종,6,0,0,0.0,2,6,33.3,2,6,33.3,0,0,0.0,0,1,1,2,0,0,0,0,1,0
../kbl_data/2021-2022,S39G01N229,안양 KGC,Away,함준후,0,0,0,0.0,0,1,0.0,0,1,0.0,0,0,0.0,0,1,1,1,0,0,0,0,0,1
../kbl_data/2021-2022,S39G01N229,안양 KGC,Away,오세근,18,7,8,87.5,1,2,50.0,8,10,80.0,1,2,50.0,1,3,4,3,2,0,0,0,1,3
../kbl_data/2021-2022,S39G01N229,안양 KGC,Away,문성곤,3,0,0,0.0,1,3,33.3,1,3,33.3,0,0,0.0,1,1,2,2,1,0,0,0,0,3
../kbl_data/2021-2022,S39G01N229,안양 KGC,Away,전성현,12,0,0,0.0,3,7,42.9,3,7,42.9,3,3,100.0,0,1,1,0,0,0,0,0,0,2
../kbl_data/2021-2022,S39G01N229,안양 KGC,Away,박지훈,7,2,3,66.7,1,4,25.0,3,7,42.9,0,0,0.0,1,1,2,2,0,0,0,0,3,0
../kbl_data/2021-2022,S39G01N229,안양 KGC,Away,대릴 먼로,11,4,7,57.1,1,3,33.3,5,10,50.0,0,0,0.0,3,7,10,7,1,0,0,0,1,2
../kbl_data/2021-2022,S39G01N229,안양 KGC,Away,우동현,0,0,0,0.0,0,0,0.0,0,0,0.0,0,0,0.0,0,0,0,0,0,0,0,0,0,0
../kbl_data/2021-2022,S39G01N229,안양 KGC,Away,변준형,12,0,0,0.0,4,10,40.0,4,10,40.0,0,0,0.0,0,1,1,2,0,0,0,0,1,1
../kbl_data/2021-2022,S39G01N229,안양 KGC,Away,한승희,8,3,5,60.0,0,1,0.0,3,6,50.0,2,2,100.0,1,1,2,0,1,0,1,0,0,2
../kbl_data/2021-2022,S39G01N229,안양 KGC,Away,주현우,2,1,1,100.0,0,0,0.0,1,1,100.0,0,0,0.0,0,0,0,0,1,0,0,0,0,0
../kbl_data/2021-2022,S39G01N229,안양 KGC,Away,조은후,6,0,2,0.0,2,2,100.0,2,4,50.0,0,0,0.0,1,0,1,6,1,0,0,0,2,1
../kbl_data/2021-2022,S39G01N230,고양 오리온,Home,김강선,3,1,4,25.0,0,2,0.0,1,6,16.7,1,1,100.0,2,2,4,2,0,0,0,0,0,0
../kbl_data/2021-2022,S39G01N230,고양 오리온,Home,최현민,0,0,0,0.0,0,1,0.0,0,1,0.0,0,0,0.0,1,0,1,0,0,0,0,0,0,1
../kbl_data/2021-2022,S39G01N230,고양 오리온,Home,임종일,0,0,0,0.0,0,0,0.0,0,0,0.0,0,0,0.0,0,1,1,0,0,0,1,0,0,1
../kbl_data/2021-2022,S39G01N230,고양 오리온,Home,이대성,18,3,8,37.5,2,7,28.6,5,15,33.3,6,7,85.7,0,1,1,1,0,0,0,0,4,0
../kbl_data/2021-2022,S39G01N230,고양 오리온,Home,한호빈,9,1,3,33.3,2,3,66.7,3,6,50.0,1,2,50.0,1,1,2,2,0,0,0,0,1,1
../kbl_data/2021-2022,S39G01N230,고양 오리온,Home,이정제,2,1,2,50.0,0,0,0.0,1,2,50.0,0,0,0.0,2,1,3,0,0,2,0,0,1,3
../kbl_data/2021-2022,S39G01N230,고양 오리온,Home,최승욱,2,1,1,100.0,0,0,0.0,1,1,100.0,0,0,0.0,0,0,0,0,0,0,0,0,1,1
../kbl_data/2021-2022,S39G01N230,고양 오리온,Home,제임스 메이스,12,3,6,50.0,2,4,50.0,5,10,50.0,0,0,0.0,2,2,4,1,1,0,0,0,0,0
../kbl_data/2021-2022,S39G01N230,고양 오리온,Home,머피 할로웨이,8,3,7,42.9,0,0,0.0,3,7,42.9,2,2,100.0,1,6,7,4,3,3,0,1,2,4
../kbl_data/2021-2022,S39G01N230,고양 오리온,Home,조한진,0,0,2,0.0,0,3,0.0,0,5,0.0,0,0,0.0,1,5,6,0,1,0,0,0,1,3
../kbl_data/2021-2022,S39G01N230,고양 오리온,Home,박진철,9,4,4,100.0,0,0,0.0,4,4,100.0,1,1,100.0,2,2,4,2,1,1,0,1,0,1
../kbl_data/2021-2022,S39G01N230,고양 오리온,Home,이정현,18,2,3,66.7,4,4,100.0,6,7,85.7,2,2,100.0,0,5,5,2,0,1,0,0,2,3
../kbl_data/2021-2022,S39G01N230,창원 LG,Away,이관희,7,3,13,23.1,0,1,0.0,3,14,21.4,1,1,100.0,2,4,6,4,2,0,0,0,4,3
../kbl_data/2021-2022,S39G01N230,창원 LG,Away,서민수,16,2,6,33.3,4,13,30.8,6,19,31.6,0,0,0.0,2,3,5,1,1,0,0,0,1,3
../kbl_data/2021-2022,S39G01N230,창원 LG,Away,한상혁,4,2,2,100.0,0,2,0.0,2,4,50.0,0,0,0.0,0,0,0,4,0,0,0,0,0,1
../kbl_data/2021-2022,S39G01N230,창원 LG,Away,이재도,11,2,4,50.0,2,5,40.0,4,9,44.4,1,1,100.0,0,2,2,2,0,1,0,0,2,2
../kbl_data/2021-2022,S39G01N230,창원 LG,Away,박인태,0,0,0,0.0,0,0,0.0,0,0,0.0,0,0,0.0,0,0,0,0,0,0,0,0,0,0
../kbl_data/2021-2022,S39G01N230,창원 LG,Away,정인덕,0,0,0,0.0,0,0,0.0,0,0,0.0,0,0,0.0,0,0,0,0,0,0,0,0,0,0
../kbl_data/2021-2022,S39G01N230,창원 LG,Away,정해원,0,0,0,0.0,0,2,0.0,0,2,0.0,0,0,0.0,1,0,1,0,1,0,0,0,0,1
../kbl_data/2021-2022,S39G01N230,창원 LG,Away,이광진,0,0,0,0.0,0,0,0.0,0,0,0.0,0,0,0.0,0,0,0,0,0,0,0,0,0,0
../kbl_data/2021-2022,S39G01N230,창원 LG,Away,윤원상,0,0,0,0.0,0,0,0.0,0,0,0.0,0,0,0.0,0,0,0,0,0,0,0,0,0,0
../kbl_data/2021-2022,S39G01N230,창원 LG,Away,아셈 마레이,21,7,15,46.7,0,0,0.0,7,15,46.7,7,15,46.7,9,9,18,3,2,1,0,0,3,2
../kbl_data/2021-2022,S39G01N230,창원 LG,Away,이승우,12,6,10,60.0,0,0,0.0,6,10,60.0,0,0,0.0,0,2,2,1,1,0,1,0,1,5
../kbl_data/2021-2022,S39G01N230,창원 LG,Away,사마르도 사무엘스,2,1,2,50.0,0,0,0.0,1,2,50.0,0,0,0.0,0,2,2,0,0,0,0,0,1,2
../kbl_data/2021-2022,S39G01N231,서울 삼성,Home,김시래,16,2,3,66.7,3,7,42.9,5,10,50.0,3,4,75.0,0,5,5,6,1,0,0,0,5,3
../kbl_data/2021-2022,S39G01N231,서울 삼성,Home,김현수,8,2,5,40.0,1,9,11.1,3,14,21.4,1,1,100.0,0,3,3,3,3,0,0,0,0,3
../kbl_data/2021-2022,S39G01N231,서울 삼성,Home,임동섭,0,0,1,0.0,0,1,0.0,0,2,0.0,0,0,0.0,0,1,1,0,1,0,0,0,0,2
../kbl_data/2021-2022,S39G01N231,서울 삼성,Home,이동엽,9,3,4,75.0,1,6,16.7,4,10,40.0,0,0,0.0,0,5,5,1,1,0,0,0,0,3
../kbl_data/2021-2022,S39G01N231,서울 삼성,Home,정희원,3,0,0,0.0,1,1,100.0,1,1,100.0,0,0,0.0,0,0,0,0,0,0,0,0,0,2
../kbl_data/2021-2022,S39G01N231,서울 삼성,Home,아이제아 힉스,8,4,8,50.0,0,0,0.0,4,8,50.0,0,0,0.0,2,4,6,3,0,0,0,0,2,1
../kbl_data/2021-2022,S39G01N231,서울 삼성,Home,박민우,14,2,4,50.0,3,5,60.0,5,9,55.6,1,2,50.0,2,1,3,1,1,0,0,0,0,0
../kbl_data/2021-2022,S39G01N231,서울 삼성,Home,차민석,6,3,4,75.0,0,1,0.0,3,5,60.0,0,0,0.0,1,2,3,0,0,2,0,0,0,2
../kbl_data/2021-2022,S39G01N231,서울 삼성,Home,전형준,3,0,3,0.0,1,4,25.0,1,7,14.3,0,0,0.0,1,0,1,0,0,0,0,0,0,1
../kbl_data/2021-2022,S39G01N231,서울 삼성,Home,조우성,2,1,1,100.0,0,0,0.0,1,1,100.0,0,0,0.0,0,0,0,1,0,0,0,0,0,1
../kbl_data/2021-2022,S39G01N231,서울 삼성,Home,이원석,6,2,5,40.0,0,0,0.0,2,5,40.0,2,2,100.0,1,2,3,1,0,0,0,0,0,5
../kbl_data/2021-2022,S39G01N231,서울 삼성,Home,제키 카마이클,5,2,5,40.0,0,0,0.0,2,5,40.0,1,2,50.0,5,6,11,0,0,0,0,1,1,3
../kbl_data/2021-2022,S39G01N231,전주 KCC,Away,송창용,6,0,1,0.0,2,5,40.0,2,6,33.3,0,0,0.0,0,1,1,0,1,1,0,0,0,3
../kbl_data/2021-2022,S39G01N231,전주 KCC,Away,이정현,12,3,5,60.0,1,5,20.0,4,10,40.0,3,4,75.0,0,6,6,3,2,0,0,0,3,2
../kbl_data/2021-2022,S39G01N231,전주 KCC,Away,정창영,14,4,5,80.0,2,5,40.0,6,10,60.0,0,2,0.0,0,2,2,3,0,0,0,0,0,1
../kbl_data/2021-2022,S39G01N231,전주 KCC,Away,라건아,20,8,9,88.9,0,2,0.0,8,11,72.7,4,5,80.0,3,8,11,1,1,1,0,1,0,0
../kbl_data/2021-2022,S39G01N231,전주 KCC,Away,김지완,8,0,4,0.0,2,4,50.0,2,8,25.0,2,2,100.0,0,4,4,2,0,0,0,0,2,1
../kbl_data/2021-2022,S39G01N231,전주 KCC,Away,박재현,6,0,2,0.0,2,2,100.0,2,4,50.0,0,0,0.0,1,0,1,1,0,0,1,0,1,4
../kbl_data/2021-2022,S39G01N231,전주 KCC,Away,이진욱,0,0,0,0.0,0,0,0.0,0,0,0.0,0,0,0.0,0,0,0,0,0,0,0,0,0,0
../kbl_data/2021-2022,S39G01N231,전주 KCC,Away,김진용,2,1,4,25.0,0,0,0.0,1,4,25.0,0,0,0.0,1,2,3,0,0,0,0,0,0,4
../kbl_data/2021-2022,S39G01N231,전주 KCC,Away,유현준,13,1,3,33.3,3,3,100.0,4,6,66.7,2,2,100.0,0,2,2,6,1,0,0,0,1,2
../kbl_data/2021-2022,S39G01N231,전주 KCC,Away,라타비우스 윌리엄스,6,2,4,50.0,0,0,0.0,2,4,50.0,2,3,66.7,3,4,7,1,0,0,0,1,0,1
../kbl_data/2021-2022,S39G01N231,전주 KCC,Away,곽정훈,5,1,1,100.0,1,1,100.0,2,2,100.0,0,0,0.0,0,1,1,0,0,0,0,0,0,0
../kbl_data/2021-2022,S39G01N231,전주 KCC,Away,이근휘,3,1,1,100.0,0,1,0.0,1,2,50.0,1,2,50.0,0,0,0,0,0,0,0,0,0,0
../kbl_data/2021-2022,S39G01N232,서울 SK,Home,양우섭,0,0,1,0.0,0,1,0.0,0,2,0.0,0,0,0.0,0,0,0,1,0,0,0,0,0,0
../kbl_data/2021-2022,S39G01N232,서울 SK,Home,허일영,6,0,0,0.0,2,2,100.0,2,2,100.0,0,0,0.0,0,1,1,0,0,0,0,0,0,2
../kbl_data/2021-2022,S39G01N232,서울 SK,Home,최부경,4,2,5,40.0,0,1,0.0,2,6,33.3,0,0,0.0,1,0,1,1,0,0,1,0,0,1
../kbl_data/2021-2022,S39G01N232,서울 SK,Home,김승원,0,0,0,0.0,0,0,0.0,0,0,0.0,0,0,0.0,0,0,0,0,0,0,0,0,0,0
../kbl_data/2021-2022,S39G01N232,서울 SK,Home,리온 윌리엄스,22,10,13,76.9,0,1,0.0,10,14,71.4,2,2,100.0,4,7,11,3,0,0,0,0,1,4
../kbl_data/2021-2022,S39G01N232,서울 SK,Home,이원대,0,0,0,0.0,0,0,0.0,0,0,0.0,0,0,0.0,0,0,0,0,0,0,0,0,0,0
../kbl_data/2021-2022,S39G01N232,서울 SK,Home,이현석,0,0,0,0.0,0,1,0.0,0,1,0.0,0,0,0.0,1,2,3,2,0,0,0,0,0,3
../kbl_data/2021-2022,S39G01N232,서울 SK,Home,최원혁,1,0,0,0.0,0,2,0.0,0,2,0.0,1,2,50.0,1,3,4,2,0,0,0,0,2,2
../kbl_data/2021-2022,S39G01N232,서울 SK,Home,최준용,21,6,14,42.9,0,0,0.0,6,14,42.9,9,13,69.2,0,4,4,6,0,2,0,0,6,2
../kbl_data/2021-2022,S39G01N232,서울 SK,Home,안영준,20,6,15,40.0,2,5,40.0,8,20,40.0,2,2,100.0,2,4,6,2,3,0,0,0,3,2
../kbl_data/2021-2022,S39G01N232,서울 SK,Home,오재현,2,1,1,100.0,0,0,0.0,1,1,100.0,0,0,0.0,0,0,0,0,0,0,0,0,0,2
../kbl_data/2021-2022,S39G01N232,서울 SK,Home,선상혁,0,0,0,0.0,0,0,0.0,0,0,0.0,0,0,0.0,0,0,0,0,0,0,0,0,0,0
../kbl_data/2021-2022,S39G01N232,울산 현대모비스,Away,이현민,0,0,2,0.0,0,0,0.0,0,2,0.0,0,0,0.0,0,1,1,2,0,0,0,0,0,1
../kbl_data/2021-2022,S39G01N232,울산 현대모비스,Away,함지훈,12,3,5,60.0,1,1,100.0,4,6,66.7,3,6,50.0,5,4,9,5,1,0,0,0,3,3
../kbl_data/2021-2022,S39G01N232,울산 현대모비스,Away,최진수,1,0,3,0.0,0,3,0.0,0,6,0.0,1,2,50.0,2,5,7,1,0,0,0,0,0,3
../kbl_data/2021-2022,S39G01N232,울산 현대모비스,Away,박지훈,0,0,0,0.0,0,0,0.0,0,0,0.0,0,0,0.0,0,0,0,0,0,0,0,0,0,0
../kbl_data/2021-2022,S39G01N232,울산 현대모비스,Away,장재석,16,7,12,58.3,0,0,0.0,7,12,58.3,2,2,100.0,2,4,6,0,3,0,0,0,0,4
../kbl_data/2021-2022,S39G01N232,울산 현대모비스,Away,김영현,0,0,0,0.0,0,0,0.0,0,0,0.0,0,0,0.0,0,0,0,0,0,0,0,0,0,0
../kbl_data/2021-2022,S39G01N232,울산 현대모비스,Away,김국찬,8,1,3,33.3,2,7,28.6,3,10,30.0,0,0,0.0,0,1,1,2,2,0,0,0,0,1
../kbl_data/2021-2022,S39G01N232,울산 현대모비스,Away,서명진,23,5,10,50.0,3,4,75.0,8,14,57.1,4,4,100.0,0,2,2,7,0,0,0,0,0,2
../kbl_data/2021-2022,S39G01N232,울산 현대모비스,Away,이우석,10,5,10,50.0,0,2,0.0,5,12,41.7,0,0,0.0,1,3,4,4,4,0,0,0,2,2
../kbl_data/2021-2022,S39G01N232,울산 현대모비스,Away,신민석,0,0,0,0.0,0,0,0.0,0,0,0.0,0,0,0.0,0,0,0,0,0,0,0,0,0,0
../kbl_data/2021-2022,S39G01N232,울산 현대모비스,Away,김동준,0,0,0,0.0,0,0,0.0,0,0,0.0,0,0,0.0,0,0,0,0,0,0,0,0,0,0
../kbl_data/2021-2022,S39G01N232,울산 현대모비스,Away,에릭 버크너,12,5,7,71.4,0,0,0.0,5,7,71.4,2,4,50.0,4,7,11,3,1,2,0,0,1,4
../kbl_data/2021-2022,S39G01N233,원주 DB,Home,박찬희,13,5,8,62.5,1,3,33.3,6,11,54.5,0,0,0.0,1,2,3,4,5,0,0,0,2,3
../kbl_data/2021-2022,S39G01N233,원주 DB,Home,정준원,0,0,0,0.0,0,2,0.0,0,2,0.0,0,0,0.0,2,0,2,0,1,0,0,0,0,2
../kbl_data/2021-2022,S39G01N233,원주 DB,Home,김종규,11,4,9,44.4,1,2,50.0,5,11,45.5,0,1,0.0,1,6,7,1,0,3,0,1,1,3
../kbl_data/2021-2022,S39G01N233,원주 DB,Home,허웅,15,3,6,50.0,1,5,20.0,4,11,36.4,6,7,85.7,1,3,4,5,1,0,0,0,1,3
../kbl_data/2021-2022,S39G01N233,원주 DB,Home,김영훈,0,0,0,0.0,0,0,0.0,0,0,0.0,0,0,0.0,0,0,0,0,0,0,0,0,0,0
../kbl_data/2021-2022,S39G01N233,원주 DB,Home,강상재,6,3,6,50.0,0,0,0.0,3,6,50.0,0,0,0.0,1,2,3,4,1,0,1,0,3,2
../kbl_data/2021-2022,S39G01N233,원주 DB,Home,김철욱,0,0,2,0.0,0,1,0.0,0,3,0.0,0,0,0.0,0,0,0,0,0,0,0,0,1,0
../kbl_data/2021-2022,S39G01N233,원주 DB,Home,나카무라 타이치,0,0,0,0.0,0,0,0.0,0,0,0.0,0,0,0.0,0,0,0,0,0,0,0,0,0,0
../kbl_data/2021-2022,S39G01N233,원주 DB,Home,이용우,3,0,1,0.0,1,1,100.0,1,2,50.0,0,0,0.0,0,0,0,0,0,0,0,0,0,1
../kbl_data/2021-2022,S39G01N233,원주 DB,Home,이준희,7,3,3,100.0,0,0,0.0,3,3,100.0,1,2,50.0,0,1,1,1,1,0,0,0,2,2
../kbl_data/2021-2022,S39G01N233,원주 DB,Home,레나드 프리먼,2,0,0,0.0,0,0,0.0,0,0,0.0,2,2,100.0,0,4,4,0,1,0,0,0,0,2
../kbl_data/2021-2022,S39G01N233,원주 DB,Home,조니 오브라이언트,18,7,14,50.0,0,4,0.0,7,18,38.9,4,8,50.0,4,4,8,0,1,3,1,0,1,2
../kbl_data/2021-2022,S39G01N233,수원 KT,Away,김동욱,0,0,0,0.0,0,0,0.0,0,0,0.0,0,0,0.0,0,0,0,0,0,0,0,0,0,0
../kbl_data/2021-2022,S39G01N233,수원 KT,Away,김영환,6,0,2,0.0,2,5,40.0,2,7,28.6,0,0,0.0,0,2,2,3,1,0,0,0,1,5
../kbl_data/2021-2022,S39G01N233,수원 KT,Away,김현민,3,0,0,0.0,1,2,50.0,1,2,50.0,0,0,0.0,0,0,0,0,0,0,0,0,0,1
../kbl_data/2021-2022,S39G01N233,수원 KT,Away,정성우,9,1,1,100.0,1,3,33.3,2,4,50.0,4,4,100.0,1,2,3,2,0,0,0,0,3,3
../kbl_data/2021-2022,S39G01N233,수원 KT,Away,최성모,0,0,0,0.0,0,0,0.0,0,0,0.0,0,0,0.0,0,0,0,0,0,0,0,0,0,0
../kbl_data/2021-2022,S39G01N233,수원 KT,Away,허훈,17,3,8,37.5,2,6,33.3,5,14,35.7,5,5,100.0,2,1,3,2,0,0,1,0,2,2
../kbl_data/2021-2022,S39G01N233,수원 KT,Away,양홍석,12,3,8,37.5,2,4,50.0,5,12,41.7,0,0,0.0,3,5,8,0,2,0,0,0,3,2
../kbl_data/2021-2022,S39G01N233,수원 KT,Away,박준영,0,0,1,0.0,0,0,0.0,0,1,0.0,0,0,0.0,0,0,0,1,0,0,0,0,1,0
../kbl_data/2021-2022,S39G01N233,수원 KT,Away,캐디 라렌,4,2,8,25.0,0,1,0.0,2,9,22.2,0,0,0.0,2,4,6,0,1,0,1,0,3,0
../kbl_data/2021-2022,S39G01N233,수원 KT,Away,박지원,2,1,1,100.0,0,1,0.0,1,2,50.0,0,0,0.0,3,1,4,3,0,0,0,0,1,2
../kbl_data/2021-2022,S39G01N233,수원 KT,Away,마이크 마이어스,6,2,7,28.6,0,0,0.0,2,7,28.6,2,2,100.0,2,8,10,1,0,1,0,1,3,5
../kbl_data/2021-2022,S39G01N233,수원 KT,Away,하윤기,12,4,11,36.4,0,0,0.0,4,11,36.4,4,4,100.0,5,6,11,0,0,2,0,0,1,2
../kbl_data/2021-2022,S39G01N234,서울 SK,Home,양우섭,0,0,0,0.0,0,0,0.0,0,0,0.0,0,0,0.0,0,0,0,0,0,0,0,0,0,0
../kbl_data/2021-2022,S39G01N234,서울 SK,Home,허일영,9,3,4,75.0,1,4,25.0,4,8,50.0,0,0,0.0,1,3,4,2,0,0,0,0,0,1
../kbl_data/2021-2022,S39G01N234,서울 SK,Home,최부경,7,2,4,50.0,0,0,0.0,2,4,50.0,3,4,75.0,0,3,3,2,0,1,0,0,1,4
../kbl_data/2021-2022,S39G01N234,서울 SK,Home,김승원,0,0,0,0.0,0,0,0.0,0,0,0.0,0,0,0.0,0,0,0,0,0,0,0,0,0,0
../kbl_data/2021-2022,S39G01N234,서울 SK,Home,리온 윌리엄스,15,6,12,50.0,0,1,0.0,6,13,46.2,3,4,75.0,9,6,15,4,2,0,0,0,3,3
../kbl_data/2021-2022,S39G01N234,서울 SK,Home,이원대,0,0,0,0.0,0,0,0.0,0,0,0.0,0,0,0.0,0,0,0,0,0,0,0,0,0,0
../kbl_data/2021-2022,S39G01N234,서울 SK,Home,이현석,12,3,3,100.0,2,4,50.0,5,7,71.4,0,0,0.0,0,1,1,4,3,0,0,0,0,3
../kbl_data/2021-2022,S39G01N234,서울 SK,Home,최원혁,5,1,1,100.0,1,3,33.3,2,4,50.0,0,0,0.0,0,5,5,1,2,0,0,0,0,0
../kbl_data/2021-2022,S39G01N234,서울 SK,Home,최준용,15,3,7,42.9,2,6,33.3,5,13,38.5,3,6,50.0,0,5,5,9,0,2,0,0,2,1
../kbl_data/2021-2022,S39G01N234,서울 SK,Home,안영준,22,2,4,50.0,6,8,75.0,8,12,66.7,0,0,0.0,2,1,3,2,0,0,0,0,0,1
../kbl_data/2021-2022,S39G01N234,서울 SK,Home,오재현,8,1,1,100.0,2,5,40.0,3,6,50.0,0,0,0.0,0,1,1,2,0,0,0,0,1,3
../kbl_data/2021-2022,S39G01N234,서울 SK,Home,선상혁,4,2,5,40.0,0,0,0.0,2,5,40.0,0,0,0.0,0,2,2,0,0,0,0,0,0,0
../kbl_data/2021-2022,S39G01N234,대구 한국가스공사,Away,정영삼,0,0,0,0.0,0,0,0.0,0,0,0.0,0,0,0.0,0,0,0,0,0,0,0,0,1,0
../kbl_data/2021-2022,S39G01N234,대구 한국가스공사,Away,민성주,0,0,0,0.0,0,0,0.0,0,0,0.0,0,0,0.0,0,0,0,0,0,0,0,0,0,0
../kbl_data/2021-2022,S39G01N234,대구 한국가스공사,Away,홍경기,16,2,2,100.0,4,7,57.1,6,9,66.7,0,0,0.0,0,0,0,1,1,0,0,0,0,2
../kbl_data/2021-2022,S39G01N234,대구 한국가스공사,Away,차바위,5,1,1,100.0,1,2,50.0,2,3,66.7,0,0,0.0,1,3,4,3,0,0,0,0,0,1
../kbl_data/2021-2022,S39G01N234,대구 한국가스공사,Away,이대헌,18,5,6,83.3,2,2,100.0,7,8,87.5,2,2,100.0,3,5,8,2,1,0,0,0,3,4
../kbl_data/2021-2022,S39G01N234,대구 한국가스공사,Away,박봉진,0,0,0,0.0,0,0,0.0,0,0,0.0,0,0,0.0,1,0,1,0,0,0,0,0,0,0
../kbl_data/2021-2022,S39G01N234,대구 한국가스공사,Away,김낙현,14,3,8,37.5,1,5,20.0,4,13,30.8,5,5,100.0,0,4,4,6,0,0,0,0,3,2
../kbl_data/2021-2022,S39G01N234,대구 한국가스공사,Away,전현우,9,3,4,75.0,1,6,16.7,4,10,40.0,0,0,0.0,0,0,0,0,1,0,0,0,0,4
../kbl_data/2021-2022,S39G01N234,대구 한국가스공사,Away,양준우,2,1,2,50.0,0,1,0.0,1,3,33.3,0,0,0.0,0,0,0,3,1,0,0,0,0,0
../kbl_data/2021-2022,S39G01N234,대구 한국가스공사,Away,앤드류 니콜슨,8,4,8,50.0,0,2,0.0,4,10,40.0,0,0,0.0,0,8,8,1,1,0,0,0,0,0
../kbl_data/2021-2022,S39G01N234,대구 한국가스공사,Away,신승민,2,1,2,50.0,0,1,0.0,1,3,33.3,0,0,0.0,3,0,3,3,1,0,0,0,1,2
../kbl_data/2021-2022,S39G01N234,대구 한국가스공사,Away,디제이 화이트,12,3,7,42.9,1,4,25.0,4,11,36.4,3,5,60.0,1,3,4,1,0,1,0,0,0,0
../kbl_data/2021-2022,S39G01N235,서울 삼성,Home,김시래,17,3,5,60.0,3,6,50.0,6,11,54.5,2,2,100.0,2,4,6,5,1,0,0,0,2,0
../kbl_data/2021-2022,S39G01N235,서울 삼성,Home,임동섭,4,2,3,66.7,0,3,0.0,2,6,33.3,0,0,0.0,1,2,3,1,0,0,0,0,1,3
../kbl_data/2021-2022,S39G01N235,서울 삼성,Home,이동엽,5,1,3,33.3,0,0,0.0,1,3,33.3,3,4,75.0,0,2,2,1,2,0,0,0,0,3
../kbl_data/2021-2022,S39G01N235,서울 삼성,Home,배수용,0,0,0,0.0,0,0,0.0,0,0,0.0,0,0,0.0,0,0,0,0,0,0,0,0,0,1
../kbl_data/2021-2022,S39G01N235,서울 삼성,Home,이호현,0,0,2,0.0,0,0,0.0,0,2,0.0,0,0,0.0,0,0,0,3,0,0,0,0,2,0
../kbl_data/2021-2022,S39G01N235,서울 삼성,Home,강바일,6,1,2,50.0,1,3,33.3,2,5,40.0,1,1,100.0,2,0,2,0,0,0,0,0,0,0
../kbl_data/2021-2022,S39G01N235,서울 삼성,Home,아이제아 힉스,20,10,16,62.5,0,0,0.0,10,16,62.5,0,0,0.0,3,8,11,3,0,2,0,1,2,2
../kbl_data/2021-2022,S39G01N235,서울 삼성,Home,박민우,0,0,0,0.0,0,1,0.0,0,1,0.0,0,0,0.0,0,0,0,0,0,0,0,0,0,1
../kbl_data/2021-2022,S39G01N235,서울 삼성,Home,차민석,5,1,4,25.0,1,1,100.0,2,5,40.0,0,0,0.0,0,1,1,1,2,0,0,0,0,2
../kbl_data/2021-2022,S39G01N235,서울 삼성,Home,전형준,0,0,0,0.0,0,2,0.0,0,2,0.0,0,0,0.0,0,0,0,0,0,0,0,0,0,3
../kbl_data/2021-2022,S39G01N235,서울 삼성,Home,이원석,9,2,7,28.6,0,1,0.0,2,8,25.0,5,8,62.5,0,1,1,1,0,1,1,1,2,3
../kbl_data/2021-2022,S39G01N235,서울 삼성,Home,제키 카마이클,14,7,12,58.3,0,0,0.0,7,12,58.3,0,0,0.0,4,6,10,3,0,1,0,0,2,3
../kbl_data/2021-2022,S39G01N235,안양 KGC,Away,양희종,12,3,3,100.0,1,2,50.0,4,5,80.0,3,3,100.0,1,0,1,0,0,1,0,0,0,0
../kbl_data/2021-2022,S39G01N235,안양 KGC,Away,함준후,3,0,0,0.0,1,2,50.0,1,2,50.0,0,0,0.0,0,1,1,1,1,0,0,0,0,1
../kbl_data/2021-2022,S39G01N235,안양 KGC,Away,오세근,21,8,11,72.7,1,3,33.3,9,14,64.3,2,2,100.0,3,2,5,2,1,0,0,0,1,1
../kbl_data/2021-2022,S39G01N235,안양 KGC,Away,문성곤,0,0,1,0.0,0,2,0.0,0,3,0.0,0,0,0.0,1,4,5,2,0,1,0,0,1,3
../kbl_data/2021-2022,S39G01N235,안양 KGC,Away,전성현,21,2,2,100.0,4,13,30.8,6,15,40.0,5,5,100.0,2,1,3,1,1,0,0,0,0,0
../kbl_data/2021-2022,S39G01N235,안양 KGC,Away,박지훈,2,1,1,100.0,0,0,0.0,1,1,100.0,0,2,0.0,0,0,0,1,2,0,0,0,0,3
../kbl_data/2021-2022,S39G01N235,안양 KGC,Away,이우정,0,0,0,0.0,0,0,0.0,0,0,0.0,0,0,0.0,0,0,0,2,0,0,0,0,1,1
../kbl_data/2021-2022,S39G01N235,안양 KGC,Away,대릴 먼로,7,2,5,40.0,1,2,50.0,3,7,42.9,0,0,0.0,1,3,4,4,1,0,0,0,1,3
../kbl_data/2021-2022,S39G01N235,안양 KGC,Away,우동현,0,0,0,0.0,0,3,0.0,0,3,0.0,0,0,0.0,0,2,2,1,0,0,0,0,1,1
../kbl_data/2021-2022,S39G01N235,안양 KGC,Away,변준형,9,3,4,75.0,0,4,0.0,3,8,37.5,3,4,75.0,1,1,2,6,1,0,0,0,2,3
../kbl_data/2021-2022,S39G01N235,안양 KGC,Away,한승희,12,6,8,75.0,0,0,0.0,6,8,75.0,0,1,0.0,1,0,1,1,0,1,2,0,0,2
../kbl_data/2021-2022,S39G01N235,안양 KGC,Away,오마리 스펠맨,13,2,5,40.0,3,5,60.0,5,10,50.0,0,1,0.0,0,9,9,4,0,4,0,0,1,0
../kbl_data/2021-2022,S39G01N236,창원 LG,Home,강병현,2,1,1,100.0,0,0,0.0,1,1,100.0,0,0,0.0,0,1,1,0,0,0,0,0,0,1
../kbl_data/2021-2022,S39G01N236,창원 LG,Home,이관희,10,2,6,33.3,1,8,12.5,3,14,21.4,3,3,100.0,1,4,5,2,0,1,0,0,3,2
../kbl_data/2021-2022,S39G01N236,창원 LG,Home,정희재,9,1,1,100.0,2,6,33.3,3,7,42.9,1,2,50.0,0,0,0,1,0,0,1,0,0,5
../kbl_data/2021-2022,S39G01N236,창원 LG,Home,서민수,0,0,0,0.0,0,0,0.0,0,0,0.0,0,0,0.0,0,0,0,0,0,0,0,0,0,0
../kbl_data/2021-2022,S39G01N236,창원 LG,Home,한상혁,2,1,1,100.0,0,0,0.0,1,1,100.0,0,0,0.0,0,0,0,0,0,0,0,0,0,1
../kbl_data/2021-2022,S39G01N236,창원 LG,Home,이재도,9,3,7,42.9,1,6,16.7,4,13,30.8,0,0,0.0,0,3,3,3,0,0,0,0,1,0
../kbl_data/2021-2022,S39G01N236,창원 LG,Home,박인태,0,0,0,0.0,0,0,0.0,0,0,0.0,0,0,0.0,0,0,0,0,0,0,0,0,0,0
../kbl_data/2021-2022,S39G01N236,창원 LG,Home,박정현,6,2,3,66.7,0,2,0.0,2,5,40.0,2,3,66.7,1,1,2,0,0,0,0,0,1,0
../kbl_data/2021-2022,S39G01N236,창원 LG,Home,윤원상,0,0,0,0.0,0,0,0.0,0,0,0.0,0,0,0.0,0,0,0,0,0,0,0,0,0,0
../kbl_data/2021-2022,S39G01N236,창원 LG,Home,아셈 마레이,8,2,6,33.3,0,0,0.0,2,6,33.3,4,6,66.7,4,13,17,6,3,0,0,1,1,3
../kbl_data/2021-2022,S39G01N236,창원 LG,Home,이승우,22,11,13,84.6,0,2,0.0,11,15,73.3,0,4,0.0,0,5,5,2,3,0,0,0,1,5
../kbl_data/2021-2022,S39G01N236,창원 LG,Home,사마르도 사무엘스,0,0,0,0.0,0,0,0.0,0,0,0.0,0,0,0.0,0,0,0,0,0,0,0,0,0,0
../kbl_data/2021-2022,S39G01N236,전주 KCC,Away,이정현,16,1,6,16.7,2,8,25.0,3,14,21.4,8,8,100.0,0,2,2,8,0,0,0,0,1,3
../kbl_data/2021-2022,S39G01N236,전주 KCC,Away,정창영,15,4,5,80.0,2,4,50.0,6,9,66.7,1,4,25.0,1,2,3,4,2,0,0,0,2,4
../kbl_data/2021-2022,S39G01N236,전주 KCC,Away,라건아,26,10,12,83.3,1,2,50.0,11,14,78.6,3,3,100.0,3,19,22,0,0,1,0,1,1,4
../kbl_data/2021-2022,S39G01N236,전주 KCC,Away,김지완,2,1,5,20.0,0,4,0.0,1,9,11.1,0,0,0.0,0,1,1,1,0,0,0,0,1,2
../kbl_data/2021-2022,S39G01N236,전주 KCC,Away,김상규,5,2,3,66.7,0,2,0.0,2,5,40.0,1,1,100.0,1,2,3,1,0,1,0,0,0,2
../kbl_data/2021-2022,S39G01N236,전주 KCC,Away,전준범,0,0,0,0.0,0,0,0.0,0,0,0.0,0,0,0.0,0,0,0,0,0,0,0,0,0,0
../kbl_data/2021-2022,S39G01N236,전주 KCC,Away,박재현,0,0,0,0.0,0,0,0.0,0,0,0.0,0,0,0.0,0,0,0,0,0,0,0,0,0,0
../kbl_data/2021-2022,S39G01N236,전주 KCC,Away,송교창,8,4,7,57.1,0,0,0.0,4,7,57.1,0,0,0.0,1,3,4,3,0,0,0,0,1,2
../kbl_data/2021-2022,S39G01N236,전주 KCC,Away,이진욱,2,0,1,0.0,0,1,0.0,0,2,0.0,2,2,100.0,1,0,1,3,2,0,1,0,1,3
../kbl_data/2021-2022,S39G01N236,전주 KCC,Away,라타비우스 윌리엄스,0,0,0,0.0,0,0,0.0,0,0,0.0,0,0,0.0,0,0,0,0,0,0,0,0,0,0
../kbl_data/2021-2022,S39G01N236,전주 KCC,Away,이근휘,0,0,0,0.0,0,2,0.0,0,2,0.0,0,0,0.0,1,3,4,1,0,0,0,0,0,0
../kbl_data/2021-2022,S39G01N236,전주 KCC,Away,서정현,0,0,0,0.0,0,0,0.0,0,0,0.0,0,0,0.0,0,0,0,0,0,0,0,0,0,0
../kbl_data/2021-2022,S39G01N237,고양 오리온,Home,김강선,5,1,1,100.0,1,3,33.3,2,4,50.0,0,0,0.0,0,1,1,1,2,0,0,0,2,2
../kbl_data/2021-2022,S39G01N237,고양 오리온,Home,최현민,2,1,3,33.3,0,1,0.0,1,4,25.0,0,0,0.0,0,0,0,1,0,0,0,0,0,1
../kbl_data/2021-2022,S39G01N237,고양 오리온,Home,임종일,3,1,1,100.0,0,2,0.0,1,3,33.3,1,1,100.0,0,0,0,0,0,0,0,0,0,0
../kbl_data/2021-2022,S39G01N237,고양 오리온,Home,한호빈,14,1,3,33.3,4,6,66.7,5,9,55.6,0,0,0.0,1,0,1,2,0,0,0,0,1,1
../kbl_data/2021-2022,S39G01N237,고양 오리온,Home,이정제,0,0,2,0.0,0,0,0.0,0,2,0.0,0,0,0.0,0,0,0,0,0,0,0,0,1,3
../kbl_data/2021-2022,S39G01N237,고양 오리온,Home,최승욱,0,0,0,0.0,0,1,0.0,0,1,0.0,0,0,0.0,2,0,2,1,1,0,0,0,1,3
../kbl_data/2021-2022,S39G01N237,고양 오리온,Home,제임스 메이스,9,2,6,33.3,1,3,33.3,3,9,33.3,2,4,50.0,4,2,6,0,0,0,0,0,1,1
../kbl_data/2021-2022,S39G01N237,고양 오리온,Home,머피 할로웨이,12,5,6,83.3,0,1,0.0,5,7,71.4,2,4,50.0,0,8,8,4,1,0,0,1,1,2
../kbl_data/2021-2022,S39G01N237,고양 오리온,Home,조한진,7,1,2,50.0,1,5,20.0,2,7,28.6,2,4,50.0,2,1,3,1,2,0,1,0,1,0
../kbl_data/2021-2022,S39G01N237,고양 오리온,Home,김세창,3,0,0,0.0,1,4,25.0,1,4,25.0,0,0,0.0,0,0,0,1,0,0,0,0,0,0
../kbl_data/2021-2022,S39G01N237,고양 오리온,Home,박진철,2,1,1,100.0,0,0,0.0,1,1,100.0,0,0,0.0,1,2,3,0,0,1,0,0,1,2
../kbl_data/2021-2022,S39G01N237,고양 오리온,Home,이정현,15,5,7,71.4,0,3,0.0,5,10,50.0,5,6,83.3,0,3,3,0,1,0,0,0,3,2
../kbl_data/2021-2022,S39G01N237,수원 KT,Away,김동욱,9,2,2,100.0,1,2,50.0,3,4,75.0,2,2,100.0,0,0,0,5,0,0,0,0,0,0
../kbl_data/2021-2022,S39G01N237,수원 KT,Away,김영환,6,3,4,75.0,0,0,0.0,3,4,75.0,0,0,0.0,0,4,4,0,0,0,1,0,3,2
../kbl_data/2021-2022,S39G01N237,수원 KT,Away,김현민,2,1,1,100.0,0,0,0.0,1,1,100.0,0,0,0.0,0,0,0,0,0,0,0,0,0,1
../kbl_data/2021-2022,S39G01N237,수원 KT,Away,한희원,4,2,3,66.7,0,1,0.0,2,4,50.0,0,0,0.0,1,0,1,1,1,0,0,0,1,1
../kbl_data/2021-2022,S39G01N237,수원 KT,Away,정성우,3,0,2,0.0,1,2,50.0,1,4,25.0,0,0,0.0,0,0,0,4,1,0,0,0,1,3
../kbl_data/2021-2022,S39G01N237,수원 KT,Away,허훈,14,3,4,75.0,2,4,50.0,5,8,62.5,2,2,100.0,0,3,3,7,2,0,0,0,3,1
../kbl_data/2021-2022,S39G01N237,수원 KT,Away,양홍석,2,1,2,50.0,0,2,0.0,1,4,25.0,0,0,0.0,0,3,3,1,0,0,0,0,1,0
../kbl_data/2021-2022,S39G01N237,수원 KT,Away,박준영,2,1,1,100.0,0,0,0.0,1,1,100.0,0,0,0.0,0,1,1,0,0,0,0,0,1,0
../kbl_data/2021-2022,S39G01N237,수원 KT,Away,캐디 라렌,20,10,12,83.3,0,1,0.0,10,13,76.9,0,0,0.0,0,7,7,2,3,1,0,5,2,3
../kbl_data/2021-2022,S39G01N237,수원 KT,Away,박지원,3,0,2,0.0,1,2,50.0,1,4,25.0,0,0,0.0,1,3,4,3,2,0,0,0,1,3
../kbl_data/2021-2022,S39G01N237,수원 KT,Away,마이크 마이어스,10,4,5,80.0,0,0,0.0,4,5,80.0,2,5,40.0,2,1,3,1,1,1,0,2,1,4
../kbl_data/2021-2022,S39G01N237,수원 KT,Away,하윤기,12,4,5,80.0,0,0,0.0,4,5,80.0,4,6,66.7,0,4,4,2,0,0,0,1,0,0
../kbl_data/2021-2022,S39G01N238,울산 현대모비스,Home,이현민,0,0,1,0.0,0,2,0.0,0,3,0.0,0,0,0.0,2,4,6,4,0,0,0,0,1,2
../kbl_data/2021-2022,S39G01N238,울산 현대모비스,Home,함지훈,13,4,8,50.0,1,2,50.0,5,10,50.0,2,2,100.0,5,1,6,7,1,0,0,0,1,3
../kbl_data/2021-2022,S39G01N238,울산 현대모비스,Home,최진수,5,1,1,100.0,1,1,100.0,2,2,100.0,0,0,0.0,0,0,0,1,0,0,0,0,0,0
../kbl_data/2021-2022,S39G01N238,울산 현대모비스,Home,박지훈,0,0,0,0.0,0,0,0.0,0,0,0.0,0,0,0.0,1,0,1,0,0,0,0,0,1,0
../kbl_data/2021-2022,S39G01N238,울산 현대모비스,Home,장재석,12,6,7,85.7,0,0,0.0,6,7,85.7,0,0,0.0,1,1,2,1,0,1,0,0,0,2
../kbl_data/2021-2022,S39G01N238,울산 현대모비스,Home,김영현,0,0,0,0.0,0,0,0.0,0,0,0.0,0,0,0.0,0,0,0,0,0,0,0,0,0,0
../kbl_data/2021-2022,S39G01N238,울산 현대모비스,Home,김국찬,7,2,2,100.0,1,3,33.3,3,5,60.0,0,0,0.0,0,1,1,1,1,0,0,0,0,4
../kbl_data/2021-2022,S39G01N238,울산 현대모비스,Home,서명진,16,3,7,42.9,3,7,42.9,6,14,42.9,1,2,50.0,0,4,4,4,1,0,0,0,2,3
../kbl_data/2021-2022,S39G01N238,울산 현대모비스,Home,이우석,21,6,10,60.0,2,5,40.0,8,15,53.3,3,4,75.0,0,7,7,4,3,0,0,0,2,2
../kbl_data/2021-2022,S39G01N238,울산 현대모비스,Home,신민석,0,0,1,0.0,0,0,0.0,0,1,0.0,0,0,0.0,0,2,2,1,0,0,1,0,0,1
../kbl_data/2021-2022,S39G01N238,울산 현대모비스,Home,김동준,0,0,0,0.0,0,1,0.0,0,1,0.0,0,0,0.0,0,0,0,0,0,0,0,0,0,0
../kbl_data/2021-2022,S39G01N238,울산 현대모비스,Home,에릭 버크너,13,5,13,38.5,0,0,0.0,5,13,38.5,3,4,75.0,2,8,10,3,2,0,0,1,4,3
../kbl_data/2021-2022,S39G01N238,원주 DB,Away,박찬희,3,1,3,33.3,0,1,0.0,1,4,25.0,1,2,50.0,1,3,4,2,1,0,0,0,2,0
../kbl_data/2021-2022,S39G01N238,원주 DB,Away,정준원,5,1,1,100.0,1,1,100.0,2,2,100.0,0,0,0.0,0,0,0,0,0,0,0,0,0,2
../kbl_data/2021-2022,S39G01N238,원주 DB,Away,김종규,9,3,6,50.0,1,1,100.0,4,7,57.1,0,0,0.0,0,5,5,1,1,0,0,0,2,3
../kbl_data/2021-2022,S39G01N238,원주 DB,Away,허웅,16,4,8,50.0,2,5,40.0,6,13,46.2,2,2,100.0,0,0,0,3,0,0,0,0,0,1
../kbl_data/2021-2022,S39G01N238,원주 DB,Away,김영훈,2,1,1,100.0,0,1,0.0,1,2,50.0,0,0,0.0,0,0,0,0,0,0,1,0,0,1
../kbl_data/2021-2022,S39G01N238,원주 DB,Away,강상재,5,0,2,0.0,1,4,25.0,1,6,16.7,2,2,100.0,3,3,6,5,1,1,0,0,3,1
../kbl_data/2021-2022,S39G01N238,원주 DB,Away,김철욱,0,0,0,0.0,0,1,0.0,0,1,0.0,0,0,0.0,0,0,0,0,0,1,0,0,0,0
../kbl_data/2021-2022,S39G01N238,원주 DB,Away,나카무라 타이치,0,0,0,0.0,0,0,0.0,0,0,0.0,0,0,0.0,0,0,0,0,0,0,0,0,0,0
../kbl_data/2021-2022,S39G01N238,원주 DB,Away,이용우,2,1,3,33.3,0,3,0.0,1,6,16.7,0,0,0.0,1,1,2,0,0,0,0,0,1,1
../kbl_data/2021-2022,S39G01N238,원주 DB,Away,이준희,2,1,3,33.3,0,0,0.0,1,3,33.3,0,2,0.0,0,0,0,2,3,0,0,0,1,2
../kbl_data/2021-2022,S39G01N238,원주 DB,Away,레나드 프리먼,15,7,8,87.5,0,0,0.0,7,8,87.5,1,1,100.0,1,1,2,1,0,0,0,0,2,2
../kbl_data/2021-2022,S39G01N238,원주 DB,Away,조니 오브라이언트,10,4,8,50.0,0,6,0.0,4,14,28.6,2,2,100.0,3,7,10,0,1,0,0,0,4,0
../kbl_data/2021-2022,S39G01N239,서울 SK,Home,양우섭,0,0,0,0.0,0,0,0.0,0,0,0.0,0,0,0.0,0,0,0,0,0,0,0,0,0,0
../kbl_data/2021-2022,S39G01N239,서울 SK,Home,허일영,11,1,3,33.3,3,4,75.0,4,7,57.1,0,0,0.0,0,3,3,0,0,0,0,0,0,2
../kbl_data/2021-2022,S39G01N239,서울 SK,Home,최부경,7,0,1,0.0,0,0,0.0,0,1,0.0,7,8,87.5,1,1,2,1,1,2,1,0,0,3
../kbl_data/2021-2022,S39G01N239,서울 SK,Home,김승원,0,0,0,0.0,0,0,0.0,0,0,0.0,0,0,0.0,0,0,0,0,0,0,0,0,0,0
../kbl_data/2021-2022,S39G01N239,서울 SK,Home,리온 윌리엄스,16,6,9,66.7,0,0,0.0,6,9,66.7,4,6,66.7,2,8,10,2,4,0,0,1,2,4
../kbl_data/2021-2022,S39G01N239,서울 SK,Home,이원대,0,0,0,0.0,0,0,0.0,0,0,0.0,0,0,0.0,0,0,0,0,0,0,0,0,0,0
../kbl_data/2021-2022,S39G01N239,서울 SK,Home,이현석,6,0,0,0.0,2,3,66.7,2,3,66.7,0,0,0.0,0,0,0,4,1,0,0,0,1,2
../kbl_data/2021-2022,S39G01N239,서울 SK,Home,최원혁,3,0,0,0.0,0,1,0.0,0,1,0.0,3,4,75.0,1,4,5,3,1,0,0,0,1,4
../kbl_data/2021-2022,S39G01N239,서울 SK,Home,최준용,20,4,11,36.4,2,6,33.3,6,17,35.3,6,7,85.7,0,6,6,9,2,3,0,0,6,4
../kbl_data/2021-2022,S39G01N239,서울 SK,Home,안영준,25,1,4,25.0,7,9,77.8,8,13,61.5,2,2,100.0,1,5,6,4,1,0,0,0,3,1
../kbl_data/2021-2022,S39G01N239,서울 SK,Home,오재현,13,2,3,66.7,3,5,60.0,5,8,62.5,0,0,0.0,1,1,2,3,0,1,0,0,0,2
../kbl_data/2021-2022,S39G01N239,서울 SK,Home,선상혁,2,1,1,100.0,0,0,0.0,1,1,100.0,0,0,0.0,0,0,0,0,0,0,0,0,1,0
../kbl_data/2021-2022,S39G01N239,서울 삼성,Away,김동량,0,0,1,0.0,0,0,0.0,0,1,0.0,0,0,0.0,0,0,0,0,0,0,0,0,0,0
../kbl_data/2021-2022,S39G01N239,서울 삼성,Away,김시래,24,4,12,33.3,4,5,80.0,8,17,47.1,4,5,80.0,1,3,4,6,0,0,0,0,5,2
../kbl_data/2021-2022,S39G01N239,서울 삼성,Away,김현수,0,0,0,0.0,0,1,0.0,0,1,0.0,0,0,0.0,1,0,1,3,0,0,0,0,2,1
../kbl_data/2021-2022,S39G01N239,서울 삼성,Away,임동섭,3,0,1,0.0,1,7,14.3,1,8,12.5,0,0,0.0,0,1,1,0,0,0,0,0,0,1
../kbl_data/2021-2022,S39G01N239,서울 삼성,Away,이동엽,8,2,5,40.0,0,3,0.0,2,8,25.0,4,4,100.0,1,3,4,2,2,0,1,0,2,2
../kbl_data/2021-2022,S39G01N239,서울 삼성,Away,강바일,0,0,1,0.0,0,1,0.0,0,2,0.0,0,0,0.0,0,1,1,0,2,0,0,0,0,4
../kbl_data/2021-2022,S39G01N239,서울 삼성,Away,아이제아 힉스,22,8,11,72.7,0,0,0.0,8,11,72.7,6,8,75.0,4,6,10,3,0,0,0,1,1,3
../kbl_data/2021-2022,S39G01N239,서울 삼성,Away,박민우,0,0,0,0.0,0,2,0.0,0,2,0.0,0,0,0.0,1,3,4,0,2,0,1,0,0,2
../kbl_data/2021-2022,S39G01N239,서울 삼성,Away,차민석,6,2,3,66.7,0,1,0.0,2,4,50.0,2,3,66.7,1,0,1,0,0,0,0,0,0,1
../kbl_data/2021-2022,S39G01N239,서울 삼성,Away,전형준,0,0,1,0.0,0,1,0.0,0,2,0.0,0,0,0.0,0,0,0,0,0,0,0,0,0,0
../kbl_data/2021-2022,S39G01N239,서울 삼성,Away,이원석,15,6,8,75.0,1,2,50.0,7,10,70.0,0,0,0.0,3,4,7,1,0,0,0,0,0,3
../kbl_data/2021-2022,S39G01N239,서울 삼성,Away,제키 카마이클,8,3,5,60.0,0,0,0.0,3,5,60.0,2,2,100.0,0,3,3,0,1,0,0,0,3,5
../kbl_data/2021-2022,S39G01N240,창원 LG,Home,강병현,2,1,2,50.0,0,0,0.0,1,2,50.0,0,0,0.0,1,0,1,0,0,0,0,0,1,2
../kbl_data/2021-2022,S39G01N240,창원 LG,Home,이관희,13,2,6,33.3,3,11,27.3,5,17,29.4,0,0,0.0,1,8,9,7,3,0,0,0,3,3
../kbl_data/2021-2022,S39G01N240,창원 LG,Home,정희재,4,2,3,66.7,0,4,0.0,2,7,28.6,0,0,0.0,0,1,1,0,3,0,1,0,3,1
../kbl_data/2021-2022,S39G01N240,창원 LG,Home,서민수,0,0,0,0.0,0,0,0.0,0,0,0.0,0,0,0.0,0,0,0,0,0,0,0,0,0,0
../kbl_data/2021-2022,S39G01N240,창원 LG,Home,한상혁,0,0,1,0.0,0,0,0.0,0,1,0.0,0,0,0.0,1,0,1,1,0,0,0,0,0,1
../kbl_data/2021-2022,S39G01N240,창원 LG,Home,이재도,11,4,8,50.0,1,3,33.3,5,11,45.5,0,0,0.0,0,1,1,4,0,0,0,0,4,2
../kbl_data/2021-2022,S39G01N240,창원 LG,Home,박인태,0,0,0,0.0,0,0,0.0,0,0,0.0,0,0,0.0,1,2,3,0,0,0,0,0,0,0
../kbl_data/2021-2022,S39G01N240,창원 LG,Home,박정현,0,0,1,0.0,0,1,0.0,0,2,0.0,0,0,0.0,1,1,2,0,0,0,0,0,4,2
../kbl_data/2021-2022,S39G01N240,창원 LG,Home,윤원상,2,1,1,100.0,0,1,0.0,1,2,50.0,0,0,0.0,0,0,0,0,0,0,0,0,0,1
../kbl_data/2021-2022,S39G01N240,창원 LG,Home,아셈 마레이,26,9,15,60.0,0,0,0.0,9,15,60.0,8,10,80.0,9,13,22,1,1,0,0,1,3,2
../kbl_data/2021-2022,S39G01N240,창원 LG,Home,이승우,14,7,12,58.3,0,1,0.0,7,13,53.8,0,0,0.0,3,7,10,3,2,0,0,0,2,1
../kbl_data/2021-2022,S39G01N240,창원 LG,Home,사마르도 사무엘스,6,3,3,100.0,0,0,0.0,3,3,100.0,0,0,0.0,1,0,1,0,0,1,0,0,0,0
../kbl_data/2021-2022,S39G01N240,안양 KGC,Away,양희종,0,0,1,0.0,0,3,0.0,0,4,0.0,0,0,0.0,0,2,2,0,1,0,0,0,0,2
../kbl_data/2021-2022,S39G01N240,안양 KGC,Away,함준후,3,0,0,0.0,1,1,100.0,1,1,100.0,0,0,0.0,0,1,1,0,0,0,0,0,0,2
../kbl_data/2021-2022,S39G01N240,안양 KGC,Away,오세근,8,3,7,42.9,0,2,0.0,3,9,33.3,2,4,50.0,1,2,3,1,0,0,0,0,1,0
../kbl_data/2021-2022,S39G01N240,안양 KGC,Away,문성곤,10,3,3,100.0,1,6,16.7,4,9,44.4,1,2,50.0,2,2,4,0,4,0,0,0,1,2
../kbl_data/2021-2022,S39G01N240,안양 KGC,Away,전성현,11,2,2,100.0,2,6,33.3,4,8,50.0,1,3,33.3,0,1,1,1,2,0,0,0,1,1
../kbl_data/2021-2022,S39G01N240,안양 KGC,Away,박지훈,10,2,3,66.7,2,5,40.0,4,8,50.0,0,0,0.0,0,2,2,4,2,1,0,0,3,2
../kbl_data/2021-2022,S39G01N240,안양 KGC,Away,대릴 먼로,12,4,7,57.1,1,5,20.0,5,12,41.7,1,2,50.0,1,8,9,4,3,0,1,0,3,3
../kbl_data/2021-2022,S39G01N240,안양 KGC,Away,우동현,3,0,0,0.0,1,4,25.0,1,4,25.0,0,0,0.0,0,0,0,0,0,0,0,0,0,0
../kbl_data/2021-2022,S39G01N240,안양 KGC,Away,변준형,2,1,5,20.0,0,2,0.0,1,7,14.3,0,2,0.0,0,1,1,6,3,0,0,0,5,0
../kbl_data/2021-2022,S39G01N240,안양 KGC,Away,한승희,0,0,1,0.0,0,0,0.0,0,1,0.0,0,0,0.0,1,0,1,0,0,0,0,0,0,0
../kbl_data/2021-2022,S39G01N240,안양 KGC,Away,주현우,0,0,1,0.0,0,0,0.0,0,1,0.0,0,0,0.0,2,0,2,0,0,0,0,0,0,0
../kbl_data/2021-2022,S39G01N240,안양 KGC,Away,조은후,0,0,0,0.0,0,0,0.0,0,0,0.0,0,0,0.0,0,0,0,0,0,0,0,0,0,0
../kbl_data/2021-2022,S39G01N241,고양 오리온,Home,김강선,12,1,1,100.0,3,6,50.0,4,7,57.1,1,2,50.0,0,1,1,0,2,0,0,0,1,2
../kbl_data/2021-2022,S39G01N241,고양 오리온,Home,최현민,0,0,0,0.0,0,2,0.0,0,2,0.0,0,0,0.0,0,0,0,0,0,0,0,0,1,3
../kbl_data/2021-2022,S39G01N241,고양 오리온,Home,한호빈,13,2,2,100.0,3,7,42.9,5,9,55.6,0,0,0.0,0,1,1,4,3,0,1,0,2,2
../kbl_data/2021-2022,S39G01N241,고양 오리온,Home,이정제,4,1,2,50.0,0,0,0.0,1,2,50.0,2,3,66.7,2,3,5,1,0,0,0,0,0,2
../kbl_data/2021-2022,S39G01N241,고양 오리온,Home,최승욱,0,0,1,0.0,0,2,0.0,0,3,0.0,0,0,0.0,0,0,0,0,0,0,0,0,0,0
../kbl_data/2021-2022,S39G01N241,고양 오리온,Home,김진유,0,0,0,0.0,0,0,0.0,0,0,0.0,0,0,0.0,0,1,1,1,0,0,0,0,0,1
../kbl_data/2021-2022,S39G01N241,고양 오리온,Home,제임스 메이스,3,1,4,25.0,0,2,0.0,1,6,16.7,1,2,50.0,2,3,5,0,1,0,0,1,1,1
../kbl_data/2021-2022,S39G01N241,고양 오리온,Home,머피 할로웨이,14,6,12,50.0,0,0,0.0,6,12,50.0,2,2,100.0,4,12,16,3,0,1,0,0,4,3
../kbl_data/2021-2022,S39G01N241,고양 오리온,Home,조한진,0,0,0,0.0,0,0,0.0,0,0,0.0,0,0,0.0,0,0,0,0,0,0,0,0,0,1
../kbl_data/2021-2022,S39G01N241,고양 오리온,Home,김세창,0,0,1,0.0,0,0,0.0,0,1,0.0,0,0,0.0,0,0,0,0,0,0,0,0,0,0
../kbl_data/2021-2022,S39G01N241,고양 오리온,Home,박진철,10,5,6,83.3,0,0,0.0,5,6,83.3,0,4,0.0,3,1,4,0,1,1,0,2,0,4
../kbl_data/2021-2022,S39G01N241,고양 오리온,Home,이정현,15,6,10,60.0,1,9,11.1,7,19,36.8,0,0,0.0,1,3,4,4,2,0,1,0,2,4
../kbl_data/2021-2022,S39G01N241,대구 한국가스공사,Away,정영삼,3,0,0,0.0,1,2,50.0,1,2,50.0,0,0,0.0,0,1,1,1,0,0,1,0,2,1
../kbl_data/2021-2022,S39G01N241,대구 한국가스공사,Away,민성주,0,0,0,0.0,0,0,0.0,0,0,0.0,0,0,0.0,0,0,0,0,0,0,0,0,0,0
../kbl_data/2021-2022,S39G01N241,대구 한국가스공사,Away,홍경기,10,2,3,66.7,2,3,66.7,4,6,66.7,0,0,0.0,0,0,0,1,1,0,0,0,3,3
../kbl_data/2021-2022,S39G01N241,대구 한국가스공사,Away,차바위,8,2,2,100.0,1,1,100.0,3,3,100.0,1,2,50.0,0,2,2,4,1,1,0,0,2,2
../kbl_data/2021-2022,S39G01N241,대구 한국가스공사,Away,이대헌,19,7,13,53.8,0,0,0.0,7,13,53.8,5,6,83.3,2,6,8,3,2,0,0,0,1,4
../kbl_data/2021-2022,S39G01N241,대구 한국가스공사,Away,박봉진,0,0,0,0.0,0,0,0.0,0,0,0.0,0,0,0.0,0,0,0,0,0,0,0,0,0,0
../kbl_data/2021-2022,S39G01N241,대구 한국가스공사,Away,김낙현,9,2,6,33.3,1,2,50.0,3,8,37.5,2,2,100.0,0,4,4,5,2,0,0,0,1,3
../kbl_data/2021-2022,S39G01N241,대구 한국가스공사,Away,전현우,0,0,1,0.0,0,1,0.0,0,2,0.0,0,0,0.0,0,1,1,0,1,0,0,0,2,1
../kbl_data/2021-2022,S39G01N241,대구 한국가스공사,Away,양준우,0,0,1,0.0,0,1,0.0,0,2,0.0,0,0,0.0,1,0,1,1,1,0,0,0,0,3
../kbl_data/2021-2022,S39G01N241,대구 한국가스공사,Away,앤드류 니콜슨,4,2,4,50.0,0,0,0.0,2,4,50.0,0,0,0.0,0,1,1,0,0,0,0,0,0,1
../kbl_data/2021-2022,S39G01N241,대구 한국가스공사,Away,신승민,7,1,2,50.0,1,1,100.0,2,3,66.7,2,4,50.0,1,0,1,0,0,0,0,0,0,2
../kbl_data/2021-2022,S39G01N241,대구 한국가스공사,Away,디제이 화이트,14,1,6,16.7,3,6,50.0,4,12,33.3,3,4,75.0,0,7,7,0,1,2,0,0,0,1
../kbl_data/2021-2022,S39G01N242,전주 KCC,Home,송창용,0,0,0,0.0,0,0,0.0,0,0,0.0,0,0,0.0,0,0,0,0,0,0,0,0,0,0
../kbl_data/2021-2022,S39G01N242,전주 KCC,Home,이정현,23,6,11,54.5,2,8,25.0,8,19,42.1,5,5,100.0,1,2,3,3,0,1,0,0,2,4
../kbl_data/2021-2022,S39G01N242,전주 KCC,Home,정창영,7,1,1,100.0,1,4,25.0,2,5,40.0,2,2,100.0,0,4,4,4,3,0,0,0,0,4
../kbl_data/2021-2022,S39G01N242,전주 KCC,Home,라건아,14,7,15,46.7,0,2,0.0,7,17,41.2,0,0,0.0,6,9,15,0,1,1,0,1,0,1
../kbl_data/2021-2022,S39G01N242,전주 KCC,Home,김상규,9,3,6,50.0,1,2,50.0,4,8,50.0,0,0,0.0,2,3,5,0,1,0,0,0,1,3
../kbl_data/2021-2022,S39G01N242,전주 KCC,Home,전준범,0,0,0,0.0,0,1,0.0,0,1,0.0,0,0,0.0,0,0,0,0,0,0,0,0,2,0
../kbl_data/2021-2022,S39G01N242,전주 KCC,Home,박재현,0,0,0,0.0,0,0,0.0,0,0,0.0,0,0,0.0,0,0,0,0,0,0,0,0,0,1
../kbl_data/2021-2022,S39G01N242,전주 KCC,Home,송교창,12,4,7,57.1,1,5,20.0,5,12,41.7,1,2,50.0,3,5,8,2,0,0,0,0,4,2
../kbl_data/2021-2022,S39G01N242,전주 KCC,Home,이진욱,0,0,0,0.0,0,2,0.0,0,2,0.0,0,0,0.0,0,0,0,1,0,0,0,0,1,0
../kbl_data/2021-2022,S39G01N242,전주 KCC,Home,유현준,3,0,2,0.0,1,4,25.0,1,6,16.7,0,0,0.0,1,1,2,1,0,1,1,0,0,3
../kbl_data/2021-2022,S39G01N242,전주 KCC,Home,라타비우스 윌리엄스,0,0,0,0.0,0,0,0.0,0,0,0.0,0,0,0.0,0,0,0,0,0,0,0,0,0,0
../kbl_data/2021-2022,S39G01N242,전주 KCC,Home,이근휘,3,0,0,0.0,1,1,100.0,1,1,100.0,0,0,0.0,0,1,1,0,0,0,0,0,0,0
../kbl_data/2021-2022,S39G01N242,원주 DB,Away,박찬희,8,4,5,80.0,0,1,0.0,4,6,66.7,0,2,0.0,0,2,2,4,1,0,0,0,1,1
../kbl_data/2021-2022,S39G01N242,원주 DB,Away,정준원,0,0,0,0.0,0,1,0.0,0,1,0.0,0,0,0.0,0,0,0,0,0,0,0,0,0,1
../kbl_data/2021-2022,S39G01N242,원주 DB,Away,김종규,13,4,6,66.7,1,2,50.0,5,8,62.5,2,2,100.0,1,5,6,1,0,0,0,1,2,3
../kbl_data/2021-2022,S39G01N242,원주 DB,Away,허웅,15,2,5,40.0,3,6,50.0,5,11,45.5,2,2,100.0,0,2,2,7,0,0,0,0,2,2
../kbl_data/2021-2022,S39G01N242,원주 DB,Away,김영훈,3,0,0,0.0,1,5,20.0,1,5,20.0,0,0,0.0,1,0,1,0,0,0,1,0,1,5
../kbl_data/2021-2022,S39G01N242,원주 DB,Away,배강률,0,0,0,0.0,0,0,0.0,0,0,0.0,0,0,0.0,0,0,0,0,0,0,0,0,0,0
../kbl_data/2021-2022,S39G01N242,원주 DB,Away,강상재,8,4,8,50.0,0,3,0.0,4,11,36.4,0,0,0.0,1,8,9,1,1,1,0,0,1,1
../kbl_data/2021-2022,S39G01N242,원주 DB,Away,나카무라 타이치,0,0,0,0.0,0,0,0.0,0,0,0.0,0,0,0.0,0,0,0,0,0,0,0,0,0,0
../kbl_data/2021-2022,S39G01N242,원주 DB,Away,이용우,2,1,3,33.3,0,0,0.0,1,3,33.3,0,1,0.0,0,2,2,2,1,0,0,0,0,2
../kbl_data/2021-2022,S39G01N242,원주 DB,Away,이준희,4,2,3,66.7,0,2,0.0,2,5,40.0,0,2,0.0,0,2,2,2,1,0,0,0,1,0
../kbl_data/2021-2022,S39G01N242,원주 DB,Away,레나드 프리먼,2,1,1,100.0,0,0,0.0,1,1,100.0,0,0,0.0,1,0,1,0,1,0,0,0,2,1
../kbl_data/2021-2022,S39G01N242,원주 DB,Away,조니 오브라이언트,18,5,6,83.3,2,5,40.0,7,11,63.6,2,2,100.0,2,6,8,2,1,2,0,0,1,3
../kbl_data/2021-2022,S39G01N243,서울 SK,Home,양우섭,2,1,1,100.0,0,0,0.0,1,1,100.0,0,0,0.0,0,0,0,0,0,0,0,0,1,0
../kbl_data/2021-2022,S39G01N243,서울 SK,Home,허일영,7,0,1,0.0,2,3,66.7,2,4,50.0,1,2,50.0,2,1,3,0,1,0,0,0,0,3
../kbl_data/2021-2022,S39G01N243,서울 SK,Home,최부경,1,0,2,0.0,0,0,0.0,0,2,0.0,1,2,50.0,2,4,6,1,1,0,0,0,0,3
../kbl_data/2021-2022,S39G01N243,서울 SK,Home,김승원,0,0,0,0.0,0,0,0.0,0,0,0.0,0,0,0.0,0,0,0,0,0,0,0,0,0,0
../kbl_data/2021-2022,S39G01N243,서울 SK,Home,리온 윌리엄스,14,5,8,62.5,0,1,0.0,5,9,55.6,4,5,80.0,4,10,14,2,0,4,0,0,5,2
../kbl_data/2021-2022,S39G01N243,서울 SK,Home,이원대,0,0,0,0.0,0,0,0.0,0,0,0.0,0,0,0.0,0,0,0,0,0,0,0,0,0,0
../kbl_data/2021-2022,S39G01N243,서울 SK,Home,이현석,4,0,3,0.0,1,4,25.0,1,7,14.3,1,2,50.0,3,3,6,3,0,0,0,0,0,4
../kbl_data/2021-2022,S39G01N243,서울 SK,Home,최원혁,0,0,0,0.0,0,2,0.0,0,2,0.0,0,0,0.0,4,3,7,4,0,0,0,0,1,3
../kbl_data/2021-2022,S39G01N243,서울 SK,Home,최준용,24,9,18,50.0,1,6,16.7,10,24,41.7,3,3,100.0,0,4,4,3,1,1,0,0,6,4
../kbl_data/2021-2022,S39G01N243,서울 SK,Home,안영준,9,3,5,60.0,1,9,11.1,4,14,28.6,0,0,0.0,0,5,5,3,1,0,0,0,5,0
../kbl_data/2021-2022,S39G01N243,서울 SK,Home,오재현,2,1,1,100.0,0,0,0.0,1,1,100.0,0,0,0.0,0,0,0,1,1,0,0,0,1,1
../kbl_data/2021-2022,S39G01N243,서울 SK,Home,선상혁,0,0,0,0.0,0,0,0.0,0,0,0.0,0,0,0.0,0,0,0,0,0,0,0,0,0,0
../kbl_data/2021-2022,S39G01N243,고양 오리온,Away,오용준,5,1,1,100.0,1,1,100.0,2,2,100.0,0,0,0.0,0,0,0,0,0,0,0,0,0,4
../kbl_data/2021-2022,S39G01N243,고양 오리온,Away,김강선,12,0,3,0.0,4,6,66.7,4,9,44.4,0,0,0.0,0,1,1,0,1,1,0,0,0,5
../kbl_data/2021-2022,S39G01N243,고양 오리온,Away,최현민,5,0,4,0.0,1,2,50.0,1,6,16.7,2,4,50.0,0,4,4,0,2,0,0,0,2,2
../kbl_data/2021-2022,S39G01N243,고양 오리온,Away,한호빈,9,3,3,100.0,1,4,25.0,4,7,57.1,0,0,0.0,1,2,3,5,0,0,1,0,2,2
../kbl_data/2021-2022,S39G01N243,고양 오리온,Away,이정제,10,5,6,83.3,0,0,0.0,5,6,83.3,0,0,0.0,4,0,4,1,0,0,2,0,1,3
../kbl_data/2021-2022,S39G01N243,고양 오리온,Away,최승욱,0,0,0,0.0,0,2,0.0,0,2,0.0,0,0,0.0,0,0,0,0,0,0,0,0,0,1
../kbl_data/2021-2022,S39G01N243,고양 오리온,Away,이승현,5,1,7,14.3,1,2,50.0,2,9,22.2,0,0,0.0,0,2,2,5,1,0,0,0,0,0
../kbl_data/2021-2022,S39G01N243,고양 오리온,Away,김진유,0,0,1,0.0,0,0,0.0,0,1,0.0,0,0,0.0,1,0,1,0,0,0,0,0,0,0
../kbl_data/2021-2022,S39G01N243,고양 오리온,Away,머피 할로웨이,14,5,11,45.5,0,1,0.0,5,12,41.7,4,6,66.7,3,8,11,3,2,0,1,0,1,3
../kbl_data/2021-2022,S39G01N243,고양 오리온,Away,김세창,3,0,3,0.0,1,1,100.0,1,4,25.0,0,0,0.0,2,0,2,2,1,0,0,0,1,0
../kbl_data/2021-2022,S39G01N243,고양 오리온,Away,이정현,6,2,6,33.3,0,2,0.0,2,8,25.0,2,2,100.0,0,1,1,3,2,0,0,0,0,2
../kbl_data/2021-2022,S39G01N243,고양 오리온,Away,문시윤,2,1,2,50.0,0,2,0.0,1,4,25.0,0,0,0.0,2,0,2,0,0,0,0,0,0,0
../kbl_data/2021-2022,S39G01N244,대구 한국가스공사,Home,정영삼,0,0,0,0.0,0,0,0.0,0,0,0.0,0,0,0.0,0,0,0,1,0,0,0,0,0,0
../kbl_data/2021-2022,S39G01N244,대구 한국가스공사,Home,홍경기,10,4,6,66.7,0,3,0.0,4,9,44.4,2,2,100.0,0,0,0,3,1,0,0,0,0,3
../kbl_data/2021-2022,S39G01N244,대구 한국가스공사,Home,차바위,8,0,0,0.0,2,4,50.0,2,4,50.0,2,3,66.7,1,2,3,3,1,0,0,0,0,2
../kbl_data/2021-2022,S39G01N244,대구 한국가스공사,Home,조상열,0,0,0,0.0,0,0,0.0,0,0,0.0,0,0,0.0,0,0,0,0,0,0,0,0,1,2
../kbl_data/2021-2022,S39G01N244,대구 한국가스공사,Home,박봉진,8,1,1,100.0,2,3,66.7,3,4,75.0,0,0,0.0,2,0,2,1,1,0,0,0,0,1
../kbl_data/2021-2022,S39G01N244,대구 한국가스공사,Home,김낙현,19,6,6,100.0,2,6,33.3,8,12,66.7,1,1,100.0,1,1,2,7,1,0,0,0,1,2
../kbl_data/2021-2022,S39G01N244,대구 한국가스공사,Home,전현우,18,0,0,0.0,6,6,100.0,6,6,100.0,0,0,0.0,1,3,4,1,1,0,0,0,0,5
../kbl_data/2021-2022,S39G01N244,대구 한국가스공사,Home,양준우,7,2,2,100.0,1,2,50.0,3,4,75.0,0,0,0.0,0,1,1,3,0,0,0,0,0,2
../kbl_data/2021-2022,S39G01N244,대구 한국가스공사,Home,이도헌,2,1,2,50.0,0,2,0.0,1,4,25.0,0,0,0.0,1,0,1,0,0,0,0,0,0,0
../kbl_data/2021-2022,S39G01N244,대구 한국가스공사,Home,앤드류 니콜슨,22,8,10,80.0,2,4,50.0,10,14,71.4,0,0,0.0,0,4,4,1,0,0,0,0,3,0
../kbl_data/2021-2022,S39G01N244,대구 한국가스공사,Home,신승민,11,4,5,80.0,1,3,33.3,5,8,62.5,0,0,0.0,1,5,6,1,0,0,0,0,1,1
../kbl_data/2021-2022,S39G01N244,대구 한국가스공사,Home,디제이 화이트,11,4,4,100.0,1,2,50.0,5,6,83.3,0,0,0.0,0,2,2,3,0,0,0,0,0,1
../kbl_data/2021-2022,S39G01N244,전주 KCC,Away,송창용,4,2,4,50.0,0,2,0.0,2,6,33.3,0,0,0.0,1,1,2,1,0,0,0,0,0,0
../kbl_data/2021-2022,S39G01N244,전주 KCC,Away,이정현,17,4,5,80.0,2,6,33.3,6,11,54.5,3,4,75.0,0,1,1,6,1,0,0,0,1,3
../kbl_data/2021-2022,S39G01N244,전주 KCC,Away,정창영,4,2,2,100.0,0,2,0.0,2,4,50.0,0,0,0.0,0,0,0,2,1,0,0,0,3,1
../kbl_data/2021-2022,S39G01N244,전주 KCC,Away,라건아,10,3,6,50.0,1,3,33.3,4,9,44.4,1,1,100.0,2,0,2,1,1,0,0,0,0,0
../kbl_data/2021-2022,S39G01N244,전주 KCC,Away,김상규,13,2,2,100.0,2,4,50.0,4,6,66.7,3,3,100.0,0,2,2,1,0,2,0,0,0,0
../kbl_data/2021-2022,S39G01N244,전주 KCC,Away,전준범,3,0,0,0.0,1,1,100.0,1,1,100.0,0,0,0.0,0,2,2,1,0,0,0,0,1,0
../kbl_data/2021-2022,S39G01N244,전주 KCC,Away,박재현,6,0,0,0.0,1,3,33.3,1,3,33.3,3,4,75.0,0,0,0,3,0,0,0,0,0,3
../kbl_data/2021-2022,S39G01N244,전주 KCC,Away,송교창,11,4,5,80.0,1,1,100.0,5,6,83.3,0,0,0.0,1,2,3,2,1,0,0,0,1,3
../kbl_data/2021-2022,S39G01N244,전주 KCC,Away,이진욱,4,2,4,50.0,0,0,0.0,2,4,50.0,0,0,0.0,0,1,1,2,0,0,0,0,0,2
../kbl_data/2021-2022,S39G01N244,전주 KCC,Away,유현준,3,0,0,0.0,1,1,100.0,1,1,100.0,0,0,0.0,0,0,0,1,0,0,0,0,1,0
../kbl_data/2021-2022,S39G01N244,전주 KCC,Away,라타비우스 윌리엄스,10,4,4,100.0,0,0,0.0,4,4,100.0,2,2,100.0,0,5,5,0,0,0,0,2,1,0
../kbl_data/2021-2022,S39G01N244,전주 KCC,Away,이근휘,3,0,1,0.0,1,3,33.3,1,4,25.0,0,0,0.0,0,0,0,0,0,0,0,0,2,2
../kbl_data/2021-2022,S39G01N245,안양 KGC,Home,양희종,6,0,0,0.0,2,5,40.0,2,5,40.0,0,0,0.0,0,1,1,0,1,0,0,0,0,1
../kbl_data/2021-2022,S39G01N245,안양 KGC,Home,함준후,0,0,0,0.0,0,0,0.0,0,0,0.0,0,0,0.0,1,0,1,0,0,0,0,0,0,1
../kbl_data/2021-2022,S39G01N245,안양 KGC,Home,오세근,20,9,13,69.2,0,3,0.0,9,16,56.2,2,3,66.7,1,7,8,5,0,0,0,0,1,3
../kbl_data/2021-2022,S39G01N245,안양 KGC,Home,문성곤,12,1,2,50.0,2,5,40.0,3,7,42.9,4,5,80.0,1,7,8,2,3,1,0,0,1,2
../kbl_data/2021-2022,S39G01N245,안양 KGC,Home,전성현,19,2,5,40.0,5,8,62.5,7,13,53.8,0,0,0.0,0,1,1,0,1,0,0,0,1,0
../kbl_data/2021-2022,S39G01N245,안양 KGC,Home,박지훈,0,0,0,0.0,0,1,0.0,0,1,0.0,0,0,0.0,0,0,0,1,1,1,0,0,0,2
../kbl_data/2021-2022,S39G01N245,안양 KGC,Home,이우정,0,0,0,0.0,0,0,0.0,0,0,0.0,0,0,0.0,0,0,0,0,0,0,0,0,0,0
../kbl_data/2021-2022,S39G01N245,안양 KGC,Home,대릴 먼로,2,1,2,50.0,0,0,0.0,1,2,50.0,0,0,0.0,2,3,5,4,0,0,0,0,0,1
../kbl_data/2021-2022,S39G01N245,안양 KGC,Home,우동현,0,0,0,0.0,0,0,0.0,0,0,0.0,0,0,0.0,0,0,0,0,0,0,0,0,0,1
../kbl_data/2021-2022,S39G01N245,안양 KGC,Home,변준형,13,3,4,75.0,1,3,33.3,4,7,57.1,4,7,57.1,1,1,2,10,3,0,1,0,3,4
../kbl_data/2021-2022,S39G01N245,안양 KGC,Home,한승희,0,0,0,0.0,0,0,0.0,0,0,0.0,0,0,0.0,0,0,0,0,0,0,0,0,0,1
../kbl_data/2021-2022,S39G01N245,안양 KGC,Home,오마리 스펠맨,21,3,7,42.9,5,9,55.6,8,16,50.0,0,0,0.0,1,5,6,2,1,1,0,2,4,1
../kbl_data/2021-2022,S39G01N245,원주 DB,Away,박찬희,9,3,4,75.0,1,2,50.0,4,6,66.7,0,0,0.0,1,5,6,5,0,0,0,0,3,2
../kbl_data/2021-2022,S39G01N245,원주 DB,Away,정준원,0,0,0,0.0,0,0,0.0,0,0,0.0,0,0,0.0,0,0,0,0,0,0,0,0,1,1
../kbl_data/2021-2022,S39G01N245,원주 DB,Away,김종규,4,1,3,33.3,0,1,0.0,1,4,25.0,2,2,100.0,1,6,7,1,0,2,0,0,2,4
../kbl_data/2021-2022,S39G01N245,원주 DB,Away,허웅,26,4,8,50.0,3,4,75.0,7,12,58.3,9,11,81.8,1,3,4,6,0,0,0,0,4,1
../kbl_data/2021-2022,S39G01N245,원주 DB,Away,김영훈,0,0,0,0.0,0,1,0.0,0,1,0.0,0,0,0.0,0,1,1,0,0,0,0,0,0,0
../kbl_data/2021-2022,S39G01N245,원주 DB,Away,강상재,16,6,6,100.0,1,1,100.0,7,7,100.0,1,1,100.0,1,6,7,5,0,0,0,0,1,2
../kbl_data/2021-2022,S39G01N245,원주 DB,Away,김철욱,0,0,0,0.0,0,0,0.0,0,0,0.0,0,0,0.0,0,0,0,0,0,0,0,0,0,0
../kbl_data/2021-2022,S39G01N245,원주 DB,Away,이용우,0,0,1,0.0,0,3,0.0,0,4,0.0,0,0,0.0,0,0,0,0,0,0,0,0,0,0
../kbl_data/2021-2022,S39G01N245,원주 DB,Away,이준희,7,2,3,66.7,1,4,25.0,3,7,42.9,0,0,0.0,1,1,2,1,2,0,0,0,0,3
../kbl_data/2021-2022,S39G01N245,원주 DB,Away,레나드 프리먼,3,1,3,33.3,0,0,0.0,1,3,33.3,1,1,100.0,0,1,1,2,0,0,0,0,1,0
../kbl_data/2021-2022,S39G01N245,원주 DB,Away,정호영,0,0,0,0.0,0,2,0.0,0,2,0.0,0,0,0.0,0,0,0,0,0,0,0,0,1,1
../kbl_data/2021-2022,S39G01N245,원주 DB,Away,조니 오브라이언트,19,7,12,58.3,1,5,20.0,8,17,47.1,2,3,66.7,0,4,4,2,2,0,0,0,1,1
../kbl_data/2021-2022,S39G01N246,수원 KT,Home,김동욱,5,0,1,0.0,1,2,50.0,1,3,33.3,2,3,66.7,0,1,1,1,0,0,0,0,2,1
../kbl_data/2021-2022,S39G01N246,수원 KT,Home,김영환,2,1,1,100.0,0,2,0.0,1,3,33.3,0,0,0.0,0,2,2,2,0,0,0,0,1,2
../kbl_data/2021-2022,S39G01N246,수원 KT,Home,김현민,2,1,1,100.0,0,1,0.0,1,2,50.0,0,0,0.0,1,1,2,0,0,0,0,0,2,2
../kbl_data/2021-2022,S39G01N246,수원 KT,Home,한희원,2,1,1,100.0,0,1,0.0,1,2,50.0,0,0,0.0,0,0,0,0,0,0,0,0,0,0
../kbl_data/2021-2022,S39G01N246,수원 KT,Home,정성우,24,6,9,66.7,3,4,75.0,9,13,69.2,3,4,75.0,0,4,4,6,2,0,0,0,1,1
../kbl_data/2021-2022,S39G01N246,수원 KT,Home,허훈,10,2,4,50.0,2,5,40.0,4,9,44.4,0,0,0.0,0,0,0,5,1,0,1,0,1,3
../kbl_data/2021-2022,S39G01N246,수원 KT,Home,양홍석,5,1,2,50.0,1,1,100.0,2,3,66.7,0,0,0.0,1,2,3,0,1,0,0,0,1,1
../kbl_data/2021-2022,S39G01N246,수원 KT,Home,박준영,1,0,1,0.0,0,0,0.0,0,1,0.0,1,2,50.0,0,0,0,0,0,0,0,0,0,0
../kbl_data/2021-2022,S39G01N246,수원 KT,Home,캐디 라렌,17,7,12,58.3,1,4,25.0,8,16,50.0,0,0,0.0,6,4,10,3,2,0,0,1,2,1
../kbl_data/2021-2022,S39G01N246,수원 KT,Home,박지원,4,2,4,50.0,0,1,0.0,2,5,40.0,0,0,0.0,1,6,7,2,1,0,0,0,2,2
../kbl_data/2021-2022,S39G01N246,수원 KT,Home,마이크 마이어스,2,0,1,0.0,0,0,0.0,0,1,0.0,2,2,100.0,0,0,0,0,0,0,0,0,1,1
../kbl_data/2021-2022,S39G01N246,수원 KT,Home,하윤기,14,6,8,75.0,0,0,0.0,6,8,75.0,2,2,100.0,2,7,9,1,1,3,0,0,1,2
../kbl_data/2021-2022,S39G01N246,울산 현대모비스,Away,이현민,2,1,1,100.0,0,1,0.0,1,2,50.0,0,0,0.0,0,0,0,3,0,0,0,0,0,0
../kbl_data/2021-2022,S39G01N246,울산 현대모비스,Away,함지훈,2,1,3,33.3,0,4,0.0,1,7,14.3,0,0,0.0,1,6,7,3,1,0,0,0,0,2
../kbl_data/2021-2022,S39G01N246,울산 현대모비스,Away,박지훈,5,1,1,100.0,1,2,50.0,2,3,66.7,0,0,0.0,0,1,1,0,0,0,0,0,0,1
../kbl_data/2021-2022,S39G01N246,울산 현대모비스,Away,장재석,12,5,14,35.7,0,0,0.0,5,14,35.7,2,4,50.0,4,3,7,0,2,0,0,0,3,1
../kbl_data/2021-2022,S39G01N246,울산 현대모비스,Away,김영현,0,0,0,0.0,0,0,0.0,0,0,0.0,0,0,0.0,0,0,0,0,1,0,0,0,0,1
../kbl_data/2021-2022,S39G01N246,울산 현대모비스,Away,김국찬,12,2,4,50.0,2,6,33.3,4,10,40.0,2,2,100.0,2,1,3,1,0,0,0,0,1,3
../kbl_data/2021-2022,S39G01N246,울산 현대모비스,Away,서명진,8,1,7,14.3,1,4,25.0,2,11,18.2,3,5,60.0,1,2,3,2,2,1,0,0,0,4
../kbl_data/2021-2022,S39G01N246,울산 현대모비스,Away,이진석,0,0,1,0.0,0,0,0.0,0,1,0.0,0,0,0.0,0,1,1,0,0,0,0,0,0,0
../kbl_data/2021-2022,S39G01N246,울산 현대모비스,Away,이우석,10,3,9,33.3,1,3,33.3,4,12,33.3,1,2,50.0,1,2,3,0,2,0,0,0,4,3
../kbl_data/2021-2022,S39G01N246,울산 현대모비스,Away,신민석,2,0,0,0.0,0,1,0.0,0,1,0.0,2,4,50.0,0,2,2,0,0,0,0,0,1,0
../kbl_data/2021-2022,S39G01N246,울산 현대모비스,Away,김동준,2,1,2,50.0,0,0,0.0,1,2,50.0,0,0,0.0,0,0,0,2,0,0,0,0,0,1
../kbl_data/2021-2022,S39G01N246,울산 현대모비스,Away,에릭 버크너,14,6,10,60.0,0,0,0.0,6,10,60.0,2,3,66.7,8,1,9,2,1,3,1,1,3,1
../kbl_data/2021-2022,S39G01N247,창원 LG,Home,강병현,3,1,2,50.0,0,0,0.0,1,2,50.0,1,2,50.0,0,0,0,0,0,0,0,0,0,1
../kbl_data/2021-2022,S39G01N247,창원 LG,Home,이관희,16,3,8,37.5,2,6,33.3,5,14,35.7,4,4,100.0,0,3,3,7,1,0,0,0,2,1
../kbl_data/2021-2022,S39G01N247,창원 LG,Home,정희재,3,1,2,50.0,0,0,0.0,1,2,50.0,1,2,50.0,2,4,6,1,3,0,0,0,0,0
../kbl_data/2021-2022,S39G01N247,창원 LG,Home,서민수,3,0,0,0.0,1,2,50.0,1,2,50.0,0,0,0.0,0,0,0,1,0,1,1,0,0,1
../kbl_data/2021-2022,S39G01N247,창원 LG,Home,한상혁,5,0,1,0.0,1,1,100.0,1,2,50.0,2,2,100.0,0,2,2,3,1,0,0,0,3,3
../kbl_data/2021-2022,S39G01N247,창원 LG,Home,이재도,24,5,8,62.5,2,5,40.0,7,13,53.8,8,10,80.0,2,2,4,1,3,0,0,0,1,3
../kbl_data/2021-2022,S39G01N247,창원 LG,Home,박인태,4,0,3,0.0,0,1,0.0,0,4,0.0,4,6,66.7,3,3,6,0,0,0,0,0,0,1
../kbl_data/2021-2022,S39G01N247,창원 LG,Home,정해원,3,0,0,0.0,1,1,100.0,1,1,100.0,0,0,0.0,0,0,0,1,1,0,0,0,0,1
../kbl_data/2021-2022,S39G01N247,창원 LG,Home,박정현,15,6,18,33.3,1,2,50.0,7,20,35.0,0,0,0.0,5,5,10,0,0,1,0,0,0,4
../kbl_data/2021-2022,S39G01N247,창원 LG,Home,이승우,2,1,4,25.0,0,0,0.0,1,4,25.0,0,0,0.0,0,3,3,3,1,0,0,0,0,4
../kbl_data/2021-2022,S39G01N247,창원 LG,Home,김종호,0,0,0,0.0,0,0,0.0,0,0,0.0,0,0,0.0,0,0,0,0,0,0,0,0,0,0
../kbl_data/2021-2022,S39G01N247,창원 LG,Home,사마르도 사무엘스,1,0,0,0.0,0,0,0.0,0,0,0.0,1,2,50.0,0,0,0,0,0,0,0,0,0,1
../kbl_data/2021-2022,S39G01N247,서울 삼성,Away,김동량,2,1,2,50.0,0,0,0.0,1,2,50.0,0,0,0.0,0,1,1,0,1,0,0,0,0,2
../kbl_data/2021-2022,S39G01N247,서울 삼성,Away,김시래,16,4,5,80.0,1,6,16.7,5,11,45.5,5,6,83.3,2,3,5,7,0,0,0,0,5,4
../kbl_data/2021-2022,S39G01N247,서울 삼성,Away,김현수,0,0,0,0.0,0,0,0.0,0,0,0.0,0,0,0.0,0,1,1,1,0,0,0,0,1,2
../kbl_data/2021-2022,S39G01N247,서울 삼성,Away,임동섭,8,1,4,25.0,2,6,33.3,3,10,30.0,0,1,0.0,2,5,7,2,1,0,0,0,0,5
../kbl_data/2021-2022,S39G01N247,서울 삼성,Away,이동엽,5,1,4,25.0,1,4,25.0,2,8,25.0,0,0,0.0,0,1,1,0,1,0,1,0,1,4
../kbl_data/2021-2022,S39G01N247,서울 삼성,Away,이호현,0,0,0,0.0,0,0,0.0,0,0,0.0,0,0,0.0,0,1,1,0,0,0,0,0,0,0
../kbl_data/2021-2022,S39G01N247,서울 삼성,Away,아이제아 힉스,27,10,17,58.8,0,1,0.0,10,18,55.6,7,8,87.5,5,13,18,2,1,1,0,0,4,3
../kbl_data/2021-2022,S39G01N247,서울 삼성,Away,박민우,0,0,0,0.0,0,0,0.0,0,0,0.0,0,0,0.0,0,0,0,0,0,0,0,0,0,0
../kbl_data/2021-2022,S39G01N247,서울 삼성,Away,차민석,0,0,0,0.0,0,0,0.0,0,0,0.0,0,0,0.0,0,0,0,0,0,0,0,0,0,0
../kbl_data/2021-2022,S39G01N247,서울 삼성,Away,전형준,0,0,0,0.0,0,1,0.0,0,1,0.0,0,0,0.0,0,0,0,0,0,0,0,0,1,2
../kbl_data/2021-2022,S39G01N247,서울 삼성,Away,이원석,12,6,13,46.2,0,0,0.0,6,13,46.2,0,0,0.0,5,3,8,1,0,3,0,1,2,5
../kbl_data/2021-2022,S39G01N247,서울 삼성,Away,제키 카마이클,0,0,2,0.0,0,0,0.0,0,2,0.0,0,0,0.0,0,1,1,1,0,0,0,0,0,0
../kbl_data/2021-2022,S39G01N248,원주 DB,Home,박찬희,17,3,7,42.9,3,7,42.9,6,14,42.9,2,4,50.0,2,6,8,4,1,0,0,0,1,2
../kbl_data/2021-2022,S39G01N248,원주 DB,Home,정준원,3,0,0,0.0,1,1,100.0,1,1,100.0,0,0,0.0,0,0,0,0,0,0,0,0,1,0
../kbl_data/2021-2022,S39G01N248,원주 DB,Home,김종규,7,3,10,30.0,0,1,0.0,3,11,27.3,1,2,50.0,4,4,8,3,0,1,0,0,3,3
../kbl_data/2021-2022,S39G01N248,원주 DB,Home,허웅,4,1,3,33.3,0,3,0.0,1,6,16.7,2,2,100.0,0,3,3,1,1,0,0,0,4,1
../kbl_data/2021-2022,S39G01N248,원주 DB,Home,김영훈,3,0,0,0.0,1,2,50.0,1,2,50.0,0,0,0.0,0,1,1,0,0,0,1,0,0,1
../kbl_data/2021-2022,S39G01N248,원주 DB,Home,강상재,14,7,10,70.0,0,2,0.0,7,12,58.3,0,2,0.0,4,2,6,2,0,1,0,0,2,4
../kbl_data/2021-2022,S39G01N248,원주 DB,Home,나카무라 타이치,0,0,0,0.0,0,0,0.0,0,0,0.0,0,0,0.0,0,0,0,0,0,0,0,0,0,0
../kbl_data/2021-2022,S39G01N248,원주 DB,Home,이용우,3,0,1,0.0,1,2,50.0,1,3,33.3,0,0,0.0,0,0,0,0,0,0,0,0,0,2
../kbl_data/2021-2022,S39G01N248,원주 DB,Home,이준희,2,1,2,50.0,0,0,0.0,1,2,50.0,0,0,0.0,0,0,0,1,0,0,0,0,0,1
../kbl_data/2021-2022,S39G01N248,원주 DB,Home,레나드 프리먼,1,0,0,0.0,0,0,0.0,0,0,0.0,1,2,50.0,1,3,4,1,0,0,0,0,1,0
../kbl_data/2021-2022,S39G01N248,원주 DB,Home,정호영,0,0,0,0.0,0,0,0.0,0,0,0.0,0,0,0.0,1,2,3,1,0,0,0,0,0,2
../kbl_data/2021-2022,S39G01N248,원주 DB,Home,조니 오브라이언트,21,6,10,60.0,2,3,66.7,8,13,61.5,3,4,75.0,2,7,9,2,1,1,0,2,2,2
../kbl_data/2021-2022,S39G01N248,대구 한국가스공사,Away,정영삼,0,0,0,0.0,0,0,0.0,0,0,0.0,0,0,0.0,1,1,2,0,0,0,0,0,0,1
../kbl_data/2021-2022,S39G01N248,대구 한국가스공사,Away,민성주,0,0,0,0.0,0,0,0.0,0,0,0.0,0,0,0.0,0,0,0,0,0,0,0,0,0,0
../kbl_data/2021-2022,S39G01N248,대구 한국가스공사,Away,홍경기,4,2,4,50.0,0,0,0.0,2,4,50.0,0,0,0.0,0,0,0,0,0,0,0,0,0,1
../kbl_data/2021-2022,S39G01N248,대구 한국가스공사,Away,차바위,2,1,2,50.0,0,0,0.0,1,2,50.0,0,0,0.0,0,2,2,1,1,0,1,0,1,4
../kbl_data/2021-2022,S39G01N248,대구 한국가스공사,Away,조상열,0,0,0,0.0,0,3,0.0,0,3,0.0,0,0,0.0,0,0,0,1,1,0,0,0,0,1
../kbl_data/2021-2022,S39G01N248,대구 한국가스공사,Away,박봉진,3,0,0,0.0,1,2,50.0,1,2,50.0,0,0,0.0,1,1,2,0,0,0,0,0,0,3
../kbl_data/2021-2022,S39G01N248,대구 한국가스공사,Away,김낙현,14,4,10,40.0,2,5,40.0,6,15,40.0,0,0,0.0,0,2,2,11,0,0,0,0,1,1
../kbl_data/2021-2022,S39G01N248,대구 한국가스공사,Away,전현우,15,3,5,60.0,3,7,42.9,6,12,50.0,0,2,0.0,0,5,5,1,2,0,0,0,0,3
../kbl_data/2021-2022,S39G01N248,대구 한국가스공사,Away,양준우,0,0,1,0.0,0,1,0.0,0,2,0.0,0,0,0.0,0,0,0,0,0,0,0,0,0,1
../kbl_data/2021-2022,S39G01N248,대구 한국가스공사,Away,앤드류 니콜슨,10,5,9,55.6,0,2,0.0,5,11,45.5,0,0,0.0,1,1,2,0,0,0,0,0,3,0
../kbl_data/2021-2022,S39G01N248,대구 한국가스공사,Away,신승민,8,2,6,33.3,1,3,33.3,3,9,33.3,1,2,50.0,3,2,5,1,2,0,2,0,2,3
../kbl_data/2021-2022,S39G01N248,대구 한국가스공사,Away,디제이 화이트,20,5,9,55.6,3,5,60.0,8,14,57.1,1,1,100.0,3,7,10,1,0,0,0,0,0,2
../kbl_data/2021-2022,S39G01N249,서울 SK,Home,양우섭,0,0,1,0.0,0,1,0.0,0,2,0.0,0,0,0.0,0,0,0,1,1,0,0,0,0,0
../kbl_data/2021-2022,S39G01N249,서울 SK,Home,허일영,25,3,5,60.0,6,9,66.7,9,14,64.3,1,1,100.0,0,7,7,1,1,1,0,0,0,4
../kbl_data/2021-2022,S39G01N249,서울 SK,Home,최부경,7,2,3,66.7,1,1,100.0,3,4,75.0,0,0,0.0,1,1,2,1,0,0,0,0,1,4
../kbl_data/2021-2022,S39G01N249,서울 SK,Home,김승원,0,0,0,0.0,0,0,0.0,0,0,0.0,0,0,0.0,0,0,0,0,0,0,0,0,0,0
../kbl_data/2021-2022,S39G01N249,서울 SK,Home,리온 윌리엄스,13,6,10,60.0,0,1,0.0,6,11,54.5,1,2,50.0,5,3,8,2,6,1,0,0,1,3
../kbl_data/2021-2022,S39G01N249,서울 SK,Home,이원대,0,0,1,0.0,0,0,0.0,0,1,0.0,0,0,0.0,0,0,0,2,0,0,0,0,0,0
../kbl_data/2021-2022,S39G01N249,서울 SK,Home,이현석,5,1,3,33.3,1,2,50.0,2,5,40.0,0,0,0.0,0,0,0,1,1,0,0,0,1,3
../kbl_data/2021-2022,S39G01N249,서울 SK,Home,최원혁,11,1,3,33.3,3,5,60.0,4,8,50.0,0,0,0.0,2,4,6,7,2,0,0,0,0,2
../kbl_data/2021-2022,S39G01N249,서울 SK,Home,최준용,14,6,12,50.0,0,1,0.0,6,13,46.2,2,2,100.0,1,6,7,7,0,0,0,2,3,2
../kbl_data/2021-2022,S39G01N249,서울 SK,Home,안영준,12,2,6,33.3,2,5,40.0,4,11,36.4,2,2,100.0,2,4,6,3,0,0,0,0,2,3
../kbl_data/2021-2022,S39G01N249,서울 SK,Home,오재현,0,0,3,0.0,0,1,0.0,0,4,0.0,0,0,0.0,1,0,1,1,0,0,0,0,0,2
../kbl_data/2021-2022,S39G01N249,서울 SK,Home,선상혁,0,0,2,0.0,0,0,0.0,0,2,0.0,0,0,0.0,1,0,1,0,0,0,0,0,0,0
../kbl_data/2021-2022,S39G01N249,전주 KCC,Away,송창용,0,0,1,0.0,0,1,0.0,0,2,0.0,0,0,0.0,0,0,0,0,0,0,0,0,0,0
../kbl_data/2021-2022,S39G01N249,전주 KCC,Away,이정현,11,2,4,50.0,1,4,25.0,3,8,37.5,4,5,80.0,1,3,4,1,1,0,0,0,6,4
../kbl_data/2021-2022,S39G01N249,전주 KCC,Away,정창영,12,4,7,57.1,0,4,0.0,4,11,36.4,4,4,100.0,1,2,3,1,2,0,0,0,0,1
../kbl_data/2021-2022,S39G01N249,전주 KCC,Away,라건아,20,7,14,50.0,0,1,0.0,7,15,46.7,6,6,100.0,7,7,14,2,0,1,0,1,2,1
../kbl_data/2021-2022,S39G01N249,전주 KCC,Away,김지완,2,1,3,33.3,0,4,0.0,1,7,14.3,0,0,0.0,0,2,2,4,1,0,0,0,1,2
../kbl_data/2021-2022,S39G01N249,전주 KCC,Away,김상규,5,1,1,100.0,0,2,0.0,1,3,33.3,3,4,75.0,0,1,1,0,0,0,0,0,0,0
../kbl_data/2021-2022,S39G01N249,전주 KCC,Away,전준범,6,0,0,0.0,2,2,100.0,2,2,100.0,0,0,0.0,0,0,0,0,0,0,0,0,1,2
../kbl_data/2021-2022,S39G01N249,전주 KCC,Away,박재현,0,0,0,0.0,0,1,0.0,0,1,0.0,0,0,0.0,0,0,0,0,0,0,1,0,0,0
../kbl_data/2021-2022,S39G01N249,전주 KCC,Away,송교창,10,4,11,36.4,0,0,0.0,4,11,36.4,2,4,50.0,4,2,6,3,1,0,0,0,0,2
../kbl_data/2021-2022,S39G01N249,전주 KCC,Away,이진욱,0,0,0,0.0,0,0,0.0,0,0,0.0,0,0,0.0,0,0,0,0,0,0,0,0,0,0
../kbl_data/2021-2022,S39G01N249,전주 KCC,Away,유현준,0,0,0,0.0,0,0,0.0,0,0,0.0,0,0,0.0,0,2,2,1,0,0,0,0,2,0
../kbl_data/2021-2022,S39G01N249,전주 KCC,Away,라타비우스 윌리엄스,0,0,0,0.0,0,0,0.0,0,0,0.0,0,0,0.0,0,3,3,0,0,0,0,0,0,1
../kbl_data/2021-2022,S39G01N250,안양 KGC,Home,양희종,3,0,0,0.0,1,3,33.3,1,3,33.3,0,0,0.0,0,1,1,1,0,0,0,0,1,2
../kbl_data/2021-2022,S39G01N250,안양 KGC,Home,오세근,19,6,13,46.2,0,0,0.0,6,13,46.2,7,8,87.5,4,6,10,3,1,0,0,0,0,1
../kbl_data/2021-2022,S39G01N250,안양 KGC,Home,문성곤,4,0,0,0.0,1,7,14.3,1,7,14.3,1,2,50.0,1,7,8,3,1,0,0,0,0,3
../kbl_data/2021-2022,S39G01N250,안양 KGC,Home,전성현,19,1,4,25.0,4,9,44.4,5,13,38.5,5,5,100.0,0,0,0,3,1,0,0,0,2,2
../kbl_data/2021-2022,S39G01N250,안양 KGC,Home,박지훈,3,0,1,0.0,1,2,50.0,1,3,33.3,0,0,0.0,0,0,0,1,0,0,0,0,0,4
../kbl_data/2021-2022,S39G01N250,안양 KGC,Home,이우정,0,0,1,0.0,0,0,0.0,0,1,0.0,0,0,0.0,0,0,0,0,1,0,0,0,2,0
../kbl_data/2021-2022,S39G01N250,안양 KGC,Home,대릴 먼로,4,2,2,100.0,0,0,0.0,2,2,100.0,0,0,0.0,1,0,1,1,0,0,0,0,0,1
../kbl_data/2021-2022,S39G01N250,안양 KGC,Home,우동현,0,0,0,0.0,0,0,0.0,0,0,0.0,0,0,0.0,0,0,0,0,0,0,0,0,0,1
../kbl_data/2021-2022,S39G01N250,안양 KGC,Home,변준형,11,3,4,75.0,1,3,33.3,4,7,57.1,2,4,50.0,0,3,3,6,0,0,1,0,4,3
../kbl_data/2021-2022,S39G01N250,안양 KGC,Home,한승희,0,0,0,0.0,0,0,0.0,0,0,0.0,0,0,0.0,0,0,0,0,0,0,1,0,0,0
../kbl_data/2021-2022,S39G01N250,안양 KGC,Home,오마리 스펠맨,17,4,6,66.7,2,7,28.6,6,13,46.2,3,3,100.0,1,7,8,5,1,2,0,0,1,1
../kbl_data/2021-2022,S39G01N250,안양 KGC,Home,주현우,0,0,0,0.0,0,0,0.0,0,0,0.0,0,0,0.0,0,0,0,0,0,0,0,0,0,0
../kbl_data/2021-2022,S39G01N250,고양 오리온,Away,오용준,0,0,0,0.0,0,1,0.0,0,1,0.0,0,0,0.0,0,1,1,0,0,0,0,0,1,1
../kbl_data/2021-2022,S39G01N250,고양 오리온,Away,최현민,3,0,0,0.0,1,2,50.0,1,2,50.0,0,0,0.0,2,1,3,1,0,0,0,0,1,1
../kbl_data/2021-2022,S39G01N250,고양 오리온,Away,임종일,0,0,0,0.0,0,0,0.0,0,0,0.0,0,0,0.0,0,0,0,0,0,0,0,0,0,0
../kbl_data/2021-2022,S39G01N250,고양 오리온,Away,이대성,20,4,12,33.3,2,6,33.3,6,18,33.3,6,6,100.0,0,1,1,4,0,0,0,0,3,1
../kbl_data/2021-2022,S39G01N250,고양 오리온,Away,한호빈,8,1,4,25.0,2,4,50.0,3,8,37.5,0,0,0.0,1,0,1,2,2,0,0,0,0,4
../kbl_data/2021-2022,S39G01N250,고양 오리온,Away,이정제,4,2,5,40.0,0,0,0.0,2,5,40.0,0,0,0.0,1,3,4,0,0,0,0,0,0,3
../kbl_data/2021-2022,S39G01N250,고양 오리온,Away,김진유,2,1,1,100.0,0,0,0.0,1,1,100.0,0,0,0.0,0,0,0,0,1,0,0,0,0,0
../kbl_data/2021-2022,S39G01N250,고양 오리온,Away,머피 할로웨이,18,8,16,50.0,0,1,0.0,8,17,47.1,2,2,100.0,6,16,22,4,1,0,0,1,3,3
../kbl_data/2021-2022,S39G01N250,고양 오리온,Away,조한진,8,1,3,33.3,2,2,100.0,3,5,60.0,0,0,0.0,1,1,2,2,1,0,0,0,1,0
../kbl_data/2021-2022,S39G01N250,고양 오리온,Away,박진철,3,1,2,50.0,0,0,0.0,1,2,50.0,1,2,50.0,1,2,3,0,1,0,0,0,0,2
../kbl_data/2021-2022,S39G01N250,고양 오리온,Away,이정현,13,5,9,55.6,0,0,0.0,5,9,55.6,3,4,75.0,0,1,1,3,1,0,0,0,0,3
../kbl_data/2021-2022,S39G01N250,고양 오리온,Away,문시윤,0,0,0,0.0,0,0,0.0,0,0,0.0,0,0,0.0,0,0,0,0,0,0,0,0,0,0
../kbl_data/2021-2022,S39G01N251,대구 한국가스공사,Home,정영삼,0,0,1,0.0,0,0,0.0,0,1,0.0,0,0,0.0,1,0,1,1,0,0,0,0,0,0
../kbl_data/2021-2022,S39G01N251,대구 한국가스공사,Home,민성주,0,0,0,0.0,0,0,0.0,0,0,0.0,0,0,0.0,0,0,0,0,0,0,0,0,0,0
../kbl_data/2021-2022,S39G01N251,대구 한국가스공사,Home,홍경기,6,1,1,100.0,1,1,100.0,2,2,100.0,1,1,100.0,1,0,1,0,0,0,0,0,2,1
../kbl_data/2021-2022,S39G01N251,대구 한국가스공사,Home,차바위,7,1,3,33.3,1,2,50.0,2,5,40.0,2,4,50.0,1,3,4,1,1,0,2,0,0,2
../kbl_data/2021-2022,S39G01N251,대구 한국가스공사,Home,조상열,0,0,0,0.0,0,2,0.0,0,2,0.0,0,0,0.0,0,0,0,0,0,0,0,0,0,1
../kbl_data/2021-2022,S39G01N251,대구 한국가스공사,Home,박봉진,3,0,3,0.0,0,1,0.0,0,4,0.0,3,4,75.0,0,4,4,2,0,0,1,0,0,4
../kbl_data/2021-2022,S39G01N251,대구 한국가스공사,Home,김낙현,16,5,6,83.3,1,4,25.0,6,10,60.0,3,4,75.0,0,3,3,10,1,0,0,0,4,2
../kbl_data/2021-2022,S39G01N251,대구 한국가스공사,Home,전현우,8,2,2,100.0,1,5,20.0,3,7,42.9,1,2,50.0,2,3,5,0,0,0,0,0,0,1
../kbl_data/2021-2022,S39G01N251,대구 한국가스공사,Home,양준우,0,0,0,0.0,0,1,0.0,0,1,0.0,0,0,0.0,0,2,2,0,0,0,0,0,1,3
../kbl_data/2021-2022,S39G01N251,대구 한국가스공사,Home,앤드류 니콜슨,15,3,4,75.0,3,5,60.0,6,9,66.7,0,0,0.0,0,4,4,0,0,0,0,0,1,4
../kbl_data/2021-2022,S39G01N251,대구 한국가스공사,Home,신승민,13,4,5,80.0,0,0,0.0,4,5,80.0,5,5,100.0,0,2,2,2,2,0,0,0,1,4
../kbl_data/2021-2022,S39G01N251,대구 한국가스공사,Home,디제이 화이트,13,3,6,50.0,2,4,50.0,5,10,50.0,1,2,50.0,1,1,2,2,0,0,0,0,0,1
../kbl_data/2021-2022,S39G01N251,창원 LG,Away,강병현,0,0,0,0.0,0,1,0.0,0,1,0.0,0,0,0.0,0,0,0,0,0,0,0,0,0,2
../kbl_data/2021-2022,S39G01N251,창원 LG,Away,이관희,17,4,4,100.0,2,9,22.2,6,13,46.2,3,3,100.0,1,1,2,3,3,0,0,0,2,4
../kbl_data/2021-2022,S39G01N251,창원 LG,Away,정희재,13,1,2,50.0,3,6,50.0,4,8,50.0,2,3,66.7,2,3,5,0,0,0,0,0,2,3
../kbl_data/2021-2022,S39G01N251,창원 LG,Away,서민수,0,0,0,0.0,0,0,0.0,0,0,0.0,0,0,0.0,1,0,1,0,0,0,0,0,0,2
../kbl_data/2021-2022,S39G01N251,창원 LG,Away,한상혁,0,0,0,0.0,0,0,0.0,0,0,0.0,0,0,0.0,0,0,0,0,0,0,0,0,0,0
../kbl_data/2021-2022,S39G01N251,창원 LG,Away,이재도,15,6,9,66.7,0,4,0.0,6,13,46.2,3,4,75.0,0,3,3,6,0,0,0,0,0,3
../kbl_data/2021-2022,S39G01N251,창원 LG,Away,박인태,0,0,0,0.0,0,0,0.0,0,0,0.0,0,0,0.0,0,0,0,0,0,0,0,0,0,0
../kbl_data/2021-2022,S39G01N251,창원 LG,Away,정해원,0,0,0,0.0,0,2,0.0,0,2,0.0,0,0,0.0,1,0,1,0,0,0,0,0,0,0
../kbl_data/2021-2022,S39G01N251,창원 LG,Away,박정현,2,1,5,20.0,0,0,0.0,1,5,20.0,0,0,0.0,1,1,2,1,1,0,0,0,2,4
../kbl_data/2021-2022,S39G01N251,창원 LG,Away,아셈 마레이,24,10,16,62.5,0,1,0.0,10,17,58.8,4,8,50.0,2,9,11,2,0,0,0,1,2,2
../kbl_data/2021-2022,S39G01N251,창원 LG,Away,이승우,6,2,5,40.0,0,2,0.0,2,7,28.6,2,2,100.0,4,5,9,3,1,0,0,0,0,4
../kbl_data/2021-2022,S39G01N251,창원 LG,Away,사마르도 사무엘스,0,0,1,0.0,0,0,0.0,0,1,0.0,0,0,0.0,0,0,0,0,0,0,0,0,0,1
../kbl_data/2021-2022,S39G01N252,수원 KT,Home,김동욱,6,0,2,0.0,2,4,50.0,2,6,33.3,0,0,0.0,0,3,3,2,0,0,0,0,2,1
../kbl_data/2021-2022,S39G01N252,수원 KT,Home,김영환,14,0,1,0.0,4,5,80.0,4,6,66.7,2,2,100.0,0,1,1,2,0,0,0,0,0,1
../kbl_data/2021-2022,S39G01N252,수원 KT,Home,김현민,4,1,2,50.0,0,2,0.0,1,4,25.0,2,2,100.0,1,0,1,0,0,0,0,0,2,1
../kbl_data/2021-2022,S39G01N252,수원 KT,Home,한희원,4,2,4,50.0,0,3,0.0,2,7,28.6,0,0,0.0,4,1,5,0,0,0,0,0,1,2
../kbl_data/2021-2022,S39G01N252,수원 KT,Home,정성우,5,1,2,50.0,0,2,0.0,1,4,25.0,3,3,100.0,0,1,1,2,1,0,0,0,0,1
../kbl_data/2021-2022,S39G01N252,수원 KT,Home,허훈,8,1,5,20.0,2,3,66.7,3,8,37.5,0,0,0.0,0,0,0,9,1,0,0,0,1,0
../kbl_data/2021-2022,S39G01N252,수원 KT,Home,양홍석,17,1,2,50.0,5,7,71.4,6,9,66.7,0,0,0.0,1,4,5,1,0,0,0,0,1,0
../kbl_data/2021-2022,S39G01N252,수원 KT,Home,박준영,9,3,4,75.0,1,2,50.0,4,6,66.7,0,0,0.0,3,1,4,0,0,0,0,0,0,1
../kbl_data/2021-2022,S39G01N252,수원 KT,Home,캐디 라렌,10,3,5,60.0,1,2,50.0,4,7,57.1,1,1,100.0,2,3,5,1,0,3,0,0,1,1
../kbl_data/2021-2022,S39G01N252,수원 KT,Home,박지원,8,2,3,66.7,0,1,0.0,2,4,50.0,4,4,100.0,0,3,3,5,0,0,0,0,1,1
../kbl_data/2021-2022,S39G01N252,수원 KT,Home,마이크 마이어스,6,3,3,100.0,0,0,0.0,3,3,100.0,0,2,0.0,0,4,4,3,1,1,0,1,0,0
../kbl_data/2021-2022,S39G01N252,수원 KT,Home,하윤기,7,2,3,66.7,0,0,0.0,2,3,66.7,3,4,75.0,2,3,5,1,1,1,0,0,0,2
../kbl_data/2021-2022,S39G01N252,서울 삼성,Away,김동량,7,2,4,50.0,1,3,33.3,3,7,42.9,0,0,0.0,0,0,0,1,1,0,0,0,0,0
../kbl_data/2021-2022,S39G01N252,서울 삼성,Away,김시래,8,2,3,66.7,1,4,25.0,3,7,42.9,1,1,100.0,0,4,4,1,0,0,0,0,3,1
../kbl_data/2021-2022,S39G01N252,서울 삼성,Away,이동엽,6,3,5,60.0,0,0,0.0,3,5,60.0,0,0,0.0,2,1,3,4,1,0,0,0,0,3
../kbl_data/2021-2022,S39G01N252,서울 삼성,Away,배수용,2,1,1,100.0,0,2,0.0,1,3,33.3,0,0,0.0,0,1,1,0,1,0,0,1,0,0
../kbl_data/2021-2022,S39G01N252,서울 삼성,Away,이호현,11,4,8,50.0,1,2,50.0,5,10,50.0,0,0,0.0,1,3,4,6,1,0,0,0,2,2
../kbl_data/2021-2022,S39G01N252,서울 삼성,Away,강바일,6,0,2,0.0,2,3,66.7,2,5,40.0,0,0,0.0,1,1,2,0,0,0,0,0,0,2
../kbl_data/2021-2022,S39G01N252,서울 삼성,Away,아이제아 힉스,9,3,8,37.5,1,1,100.0,4,9,44.4,0,0,0.0,1,2,3,2,1,0,0,1,1,3
../kbl_data/2021-2022,S39G01N252,서울 삼성,Away,박민우,8,2,4,50.0,1,3,33.3,3,7,42.9,1,2,50.0,3,1,4,1,0,0,0,0,0,0
../kbl_data/2021-2022,S39G01N252,서울 삼성,Away,차민석,8,3,3,100.0,0,2,0.0,3,5,60.0,2,2,100.0,1,1,2,1,1,0,0,0,1,5
../kbl_data/2021-2022,S39G01N252,서울 삼성,Away,전형준,6,0,1,0.0,2,4,50.0,2,5,40.0,0,0,0.0,0,1,1,0,0,0,0,0,0,5
../kbl_data/2021-2022,S39G01N252,서울 삼성,Away,조우성,0,0,2,0.0,0,0,0.0,0,2,0.0,0,0,0.0,2,2,4,2,0,0,0,0,0,0
../kbl_data/2021-2022,S39G01N252,서울 삼성,Away,이원석,12,6,12,50.0,0,1,0.0,6,13,46.2,0,1,0.0,2,3,5,2,1,1,0,0,1,1
../kbl_data/2021-2022,S39G01N253,안양 KGC,Home,양희종,6,1,3,33.3,1,2,50.0,2,5,40.0,1,1,100.0,1,2,3,2,0,0,0,0,1,0
../kbl_data/2021-2022,S39G01N253,안양 KGC,Home,박형철,0,0,0,0.0,0,0,0.0,0,0,0.0,0,0,0.0,0,0,0,0,0,0,0,0,0,0
../kbl_data/2021-2022,S39G01N253,안양 KGC,Home,오세근,17,7,11,63.6,1,2,50.0,8,13,61.5,0,0,0.0,1,3,4,1,2,0,0,0,0,0
../kbl_data/2021-2022,S39G01N253,안양 KGC,Home,문성곤,9,4,6,66.7,0,0,0.0,4,6,66.7,1,4,25.0,3,1,4,0,2,0,0,0,1,3
../kbl_data/2021-2022,S39G01N253,안양 KGC,Home,전성현,26,4,5,80.0,4,12,33.3,8,17,47.1,6,6,100.0,1,3,4,2,0,0,0,0,3,2
../kbl_data/2021-2022,S39G01N253,안양 KGC,Home,박지훈,12,0,0,0.0,4,6,66.7,4,6,66.7,0,0,0.0,0,2,2,2,0,0,0,0,0,2
../kbl_data/2021-2022,S39G01N253,안양 KGC,Home,대릴 먼로,17,4,12,33.3,3,6,50.0,7,18,38.9,0,0,0.0,4,15,19,10,0,0,0,0,4,2
../kbl_data/2021-2022,S39G01N253,안양 KGC,Home,우동현,0,0,0,0.0,0,0,0.0,0,0,0.0,0,0,0.0,0,0,0,0,0,0,0,0,0,0
../kbl_data/2021-2022,S39G01N253,안양 KGC,Home,변준형,7,2,4,50.0,1,4,25.0,3,8,37.5,0,0,0.0,2,1,3,3,0,0,0,0,1,4
../kbl_data/2021-2022,S39G01N253,안양 KGC,Home,한승희,2,1,3,33.3,0,1,0.0,1,4,25.0,0,0,0.0,0,0,0,0,0,0,1,0,0,2
../kbl_data/2021-2022,S39G01N253,안양 KGC,Home,주현우,0,0,0,0.0,0,0,0.0,0,0,0.0,0,0,0.0,0,0,0,0,0,0,0,0,0,0
../kbl_data/2021-2022,S39G01N253,안양 KGC,Home,조은후,4,1,5,20.0,0,0,0.0,1,5,20.0,2,2,100.0,3,0,3,4,2,0,0,0,0,2
../kbl_data/2021-2022,S39G01N253,울산 현대모비스,Away,이현민,0,0,1,0.0,0,0,0.0,0,1,0.0,0,0,0.0,0,1,1,0,0,0,1,0,0,0
../kbl_data/2021-2022,S39G01N253,울산 현대모비스,Away,함지훈,2,1,3,33.3,0,2,0.0,1,5,20.0,0,0,0.0,2,3,5,2,0,0,0,0,1,1
../kbl_data/2021-2022,S39G01N253,울산 현대모비스,Away,박지훈,12,0,0,0.0,4,6,66.7,4,6,66.7,0,0,0.0,0,2,2,2,0,0,0,0,0,2
../kbl_data/2021-2022,S39G01N253,울산 현대모비스,Away,장재석,5,2,5,40.0,0,0,0.0,2,5,40.0,1,2,50.0,0,3,3,0,1,1,0,0,0,3
../kbl_data/2021-2022,S39G01N253,울산 현대모비스,Away,김영현,8,1,1,100.0,2,2,100.0,3,3,100.0,0,0,0.0,2,1,3,1,0,0,1,0,0,3
../kbl_data/2021-2022,S39G01N253,울산 현대모비스,Away,김국찬,12,1,1,100.0,3,11,27.3,4,12,33.3,1,2,50.0,2,2,4,2,0,2,1,0,0,0
../kbl_data/2021-2022,S39G01N253,울산 현대모비스,Away,서명진,12,1,3,33.3,2,4,50.0,3,7,42.9,4,5,80.0,0,2,2,6,0,0,0,0,4,3
../kbl_data/2021-2022,S39G01N253,울산 현대모비스,Away,이진석,0,0,0,0.0,0,0,0.0,0,0,0.0,0,0,0.0,0,0,0,0,0,0,0,0,0,0
../kbl_data/2021-2022,S39G01N253,울산 현대모비스,Away,이우석,23,6,8,75.0,3,7,42.9,9,15,60.0,2,2,100.0,0,2,2,6,2,0,0,0,2,4
../kbl_data/2021-2022,S39G01N253,울산 현대모비스,Away,신민석,6,2,2,100.0,0,2,0.0,2,4,50.0,2,2,100.0,0,0,0,0,1,0,0,0,0,0
../kbl_data/2021-2022,S39G01N253,울산 현대모비스,Away,김동준,3,0,1,0.0,1,1,100.0,1,2,50.0,0,0,0.0,1,2,3,3,1,0,0,0,2,0
../kbl_data/2021-2022,S39G01N253,울산 현대모비스,Away,에릭 버크너,7,3,6,50.0,0,0,0.0,3,6,50.0,1,2,50.0,0,7,7,3,0,0,0,0,0,2
../kbl_data/2021-2022,S39G01N254,고양 오리온,Home,김강선,3,1,1,100.0,0,1,0.0,1,2,50.0,1,1,100.0,0,0,0,0,1,0,0,0,0,0
../kbl_data/2021-2022,S39G01N254,고양 오리온,Home,최현민,2,1,2,50.0,0,0,0.0,1,2,50.0,0,0,0.0,0,1,1,0,0,1,0,0,0,0
../kbl_data/2021-2022,S39G01N254,고양 오리온,Home,이대성,24,9,18,50.0,1,6,16.7,10,24,41.7,3,3,100.0,2,2,4,5,0,0,0,0,3,2
../kbl_data/2021-2022,S39G01N254,고양 오리온,Home,한호빈,2,0,3,0.0,0,3,0.0,0,6,0.0,2,2,100.0,0,7,7,3,0,0,0,0,0,1
../kbl_data/2021-2022,S39G01N254,고양 오리온,Home,이정제,9,3,6,50.0,0,0,0.0,3,6,50.0,3,4,75.0,2,0,2,0,0,0,0,0,0,2
../kbl_data/2021-2022,S39G01N254,고양 오리온,Home,최승욱,3,0,0,0.0,1,1,100.0,1,1,100.0,0,0,0.0,4,2,6,2,2,0,0,0,0,2
../kbl_data/2021-2022,S39G01N254,고양 오리온,Home,김진유,0,0,0,0.0,0,0,0.0,0,0,0.0,0,0,0.0,0,0,0,0,0,0,0,0,0,0
../kbl_data/2021-2022,S39G01N254,고양 오리온,Home,머피 할로웨이,27,11,15,73.3,0,1,0.0,11,16,68.8,5,10,50.0,4,9,13,1,5,2,0,3,2,3
../kbl_data/2021-2022,S39G01N254,고양 오리온,Home,조한진,2,1,1,100.0,0,1,0.0,1,2,50.0,0,0,0.0,0,1,1,0,0,0,0,0,2,1
../kbl_data/2021-2022,S39G01N254,고양 오리온,Home,박진철,3,1,2,50.0,0,0,0.0,1,2,50.0,1,2,50.0,0,2,2,1,1,1,0,1,1,3
../kbl_data/2021-2022,S39G01N254,고양 오리온,Home,이정현,4,2,7,28.6,0,1,0.0,2,8,25.0,0,0,0.0,0,1,1,2,1,0,0,0,3,1
../kbl_data/2021-2022,S39G01N254,고양 오리온,Home,문시윤,0,0,1,0.0,0,0,0.0,0,1,0.0,0,0,0.0,0,0,0,0,0,0,0,0,0,0
../kbl_data/2021-2022,S39G01N254,원주 DB,Away,박찬희,7,3,6,50.0,0,3,0.0,3,9,33.3,1,2,50.0,1,3,4,5,0,0,0,0,3,0
../kbl_data/2021-2022,S39G01N254,원주 DB,Away,정준원,0,0,1,0.0,0,0,0.0,0,1,0.0,0,0,0.0,0,0,0,1,0,0,0,0,0,1
../kbl_data/2021-2022,S39G01N254,원주 DB,Away,김종규,17,7,9,77.8,1,1,100.0,8,10,80.0,0,0,0.0,2,5,7,0,0,2,0,2,3,4
../kbl_data/2021-2022,S39G01N254,원주 DB,Away,허웅,21,7,10,70.0,1,8,12.5,8,18,44.4,4,5,80.0,0,4,4,4,1,0,1,0,2,3
../kbl_data/2021-2022,S39G01N254,원주 DB,Away,김영훈,2,1,1,100.0,0,0,0.0,1,1,100.0,0,0,0.0,0,0,0,0,0,0,0,0,0,2
../kbl_data/2021-2022,S39G01N254,원주 DB,Away,강상재,8,4,6,66.7,0,3,0.0,4,9,44.4,0,2,0.0,1,5,6,3,1,1,0,0,2,0
../kbl_data/2021-2022,S39G01N254,원주 DB,Away,김철욱,0,0,0,0.0,0,0,0.0,0,0,0.0,0,0,0.0,0,0,0,0,0,0,0,0,0,0
../kbl_data/2021-2022,S39G01N254,원주 DB,Away,이용우,0,0,0,0.0,0,0,0.0,0,0,0.0,0,0,0.0,0,0,0,0,0,0,0,0,0,0
../kbl_data/2021-2022,S39G01N254,원주 DB,Away,이준희,6,1,1,100.0,0,1,0.0,1,2,50.0,4,4,100.0,0,1,1,4,0,0,0,0,1,1
../kbl_data/2021-2022,S39G01N254,원주 DB,Away,레나드 프리먼,2,1,2,50.0,0,0,0.0,1,2,50.0,0,0,0.0,0,1,1,0,0,0,0,0,0,1
../kbl_data/2021-2022,S39G01N254,원주 DB,Away,정호영,2,1,1,100.0,0,1,0.0,1,2,50.0,0,0,0.0,0,1,1,0,0,0,0,0,0,1
../kbl_data/2021-2022,S39G01N254,원주 DB,Away,조니 오브라이언트,8,4,6,66.7,0,5,0.0,4,11,36.4,0,0,0.0,2,6,8,1,5,0,0,0,3,4
../kbl_data/2021-2022,S39G01N255,서울 SK,Home,양우섭,0,0,0,0.0,0,0,0.0,0,0,0.0,0,0,0.0,0,0,0,0,0,0,0,0,0,0
../kbl_data/2021-2022,S39G01N255,서울 SK,Home,허일영,4,2,3,66.7,0,2,0.0,2,5,40.0,0,0,0.0,1,3,4,0,0,0,0,0,1,1
../kbl_data/2021-2022,S39G01N255,서울 SK,Home,김선형,9,3,8,37.5,0,3,0.0,3,11,27.3,3,4,75.0,2,0,2,3,1,0,0,0,1,0
../kbl_data/2021-2022,S39G01N255,서울 SK,Home,최부경,2,0,0,0.0,0,0,0.0,0,0,0.0,2,2,100.0,2,4,6,1,0,0,0,0,0,2
../kbl_data/2021-2022,S39G01N255,서울 SK,Home,리온 윌리엄스,20,8,10,80.0,1,3,33.3,9,13,69.2,1,1,100.0,2,6,8,0,2,1,0,1,1,3
../kbl_data/2021-2022,S39G01N255,서울 SK,Home,배병준,2,0,0,0.0,0,1,0.0,0,1,0.0,2,2,100.0,0,0,0,0,0,0,0,0,0,0
../kbl_data/2021-2022,S39G01N255,서울 SK,Home,이현석,0,0,0,0.0,0,2,0.0,0,2,0.0,0,0,0.0,0,0,0,1,0,0,0,0,1,0
../kbl_data/2021-2022,S39G01N255,서울 SK,Home,최원혁,2,1,1,100.0,0,1,0.0,1,2,50.0,0,0,0.0,2,1,3,6,0,0,0,0,2,2
../kbl_data/2021-2022,S39G01N255,서울 SK,Home,최준용,15,2,8,25.0,3,4,75.0,5,12,41.7,2,2,100.0,1,4,5,5,1,1,0,0,1,2
../kbl_data/2021-2022,S39G01N255,서울 SK,Home,안영준,14,3,6,50.0,1,6,16.7,4,12,33.3,5,5,100.0,0,1,1,3,2,0,0,0,3,5
../kbl_data/2021-2022,S39G01N255,서울 SK,Home,자밀 워니,13,5,11,45.5,1,3,33.3,6,14,42.9,0,0,0.0,4,3,7,2,2,0,0,1,0,0
../kbl_data/2021-2022,S39G01N255,서울 SK,Home,오재현,0,0,1,0.0,0,1,0.0,0,2,0.0,0,0,0.0,0,0,0,1,0,0,0,0,0,1
../kbl_data/2021-2022,S39G01N255,수원 KT,Away,김동욱,4,0,1,0.0,1,2,50.0,1,3,33.3,1,2,50.0,0,0,0,0,0,0,0,0,2,2
../kbl_data/2021-2022,S39G01N255,수원 KT,Away,김현민,6,3,3,100.0,0,1,0.0,3,4,75.0,0,0,0.0,1,6,7,0,0,0,0,0,1,3
../kbl_data/2021-2022,S39G01N255,수원 KT,Away,한희원,0,0,1,0.0,0,2,0.0,0,3,0.0,0,0,0.0,0,2,2,0,0,0,0,0,0,3
../kbl_data/2021-2022,S39G01N255,수원 KT,Away,정성우,2,1,5,20.0,0,1,0.0,1,6,16.7,0,0,0.0,0,0,0,6,2,0,0,0,3,0
../kbl_data/2021-2022,S39G01N255,수원 KT,Away,최성모,0,0,0,0.0,0,0,0.0,0,0,0.0,0,0,0.0,0,0,0,0,0,0,0,0,0,0
../kbl_data/2021-2022,S39G01N255,수원 KT,Away,허훈,27,5,7,71.4,5,10,50.0,10,17,58.8,2,2,100.0,0,2,2,4,1,0,0,0,2,3
../kbl_data/2021-2022,S39G01N255,수원 KT,Away,양홍석,14,4,9,44.4,2,4,50.0,6,13,46.2,0,1,0.0,3,7,10,2,1,0,0,0,1,3
../kbl_data/2021-2022,S39G01N255,수원 KT,Away,박준영,2,1,3,33.3,0,0,0.0,1,3,33.3,0,0,0.0,0,1,1,1,0,0,0,0,0,2
../kbl_data/2021-2022,S39G01N255,수원 KT,Away,캐디 라렌,19,7,13,53.8,0,1,0.0,7,14,50.0,5,7,71.4,5,6,11,2,0,1,0,1,1,1
../kbl_data/2021-2022,S39G01N255,수원 KT,Away,박지원,8,4,4,100.0,0,0,0.0,4,4,100.0,0,0,0.0,1,1,2,2,2,0,0,0,1,2
../kbl_data/2021-2022,S39G01N255,수원 KT,Away,마이크 마이어스,8,4,5,80.0,0,0,0.0,4,5,80.0,0,0,0.0,2,4,6,1,0,0,0,2,2,0
../kbl_data/2021-2022,S39G01N255,수원 KT,Away,하윤기,0,0,0,0.0,0,0,0.0,0,0,0.0,0,0,0.0,0,0,0,0,0,0,0,0,0,0
../kbl_data/2021-2022,S39G01N256,창원 LG,Home,강병현,0,0,0,0.0,0,1,0.0,0,1,0.0,0,0,0.0,0,0,0,0,0,0,0,0,0,2
../kbl_data/2021-2022,S39G01N256,창원 LG,Home,이관희,14,4,5,80.0,2,8,25.0,6,13,46.2,0,0,0.0,0,2,2,3,0,1,0,0,1,1
../kbl_data/2021-2022,S39G01N256,창원 LG,Home,정희재,14,4,6,66.7,1,3,33.3,5,9,55.6,3,3,100.0,0,4,4,1,1,0,1,0,1,3
../kbl_data/2021-2022,S39G01N256,창원 LG,Home,서민수,0,0,1,0.0,0,0,0.0,0,1,0.0,0,0,0.0,2,1,3,0,0,1,0,0,0,2
../kbl_data/2021-2022,S39G01N256,창원 LG,Home,한상혁,2,1,1,100.0,0,1,0.0,1,2,50.0,0,0,0.0,1,0,1,0,0,0,0,0,1,0
../kbl_data/2021-2022,S39G01N256,창원 LG,Home,이재도,16,4,11,36.4,2,6,33.3,6,17,35.3,2,2,100.0,0,4,4,6,3,0,0,0,2,0
../kbl_data/2021-2022,S39G01N256,창원 LG,Home,박인태,0,0,0,0.0,0,0,0.0,0,0,0.0,0,0,0.0,0,0,0,0,0,0,0,0,0,0
../kbl_data/2021-2022,S39G01N256,창원 LG,Home,정해원,0,0,0,0.0,0,0,0.0,0,0,0.0,0,0,0.0,0,0,0,0,0,0,0,0,0,0
../kbl_data/2021-2022,S39G01N256,창원 LG,Home,박정현,2,1,3,33.3,0,1,0.0,1,4,25.0,0,0,0.0,1,1,2,0,0,0,0,0,0,1
../kbl_data/2021-2022,S39G01N256,창원 LG,Home,아셈 마레이,0,0,3,0.0,0,0,0.0,0,3,0.0,0,0,0.0,1,3,4,1,1,0,0,0,1,5
../kbl_data/2021-2022,S39G01N256,창원 LG,Home,이승우,9,3,7,42.9,1,1,100.0,4,8,50.0,0,2,0.0,2,4,6,3,2,0,0,0,3,2
../kbl_data/2021-2022,S39G01N256,창원 LG,Home,사마르도 사무엘스,15,4,9,44.4,1,1,100.0,5,10,50.0,4,10,40.0,5,8,13,1,2,1,0,1,3,4
../kbl_data/2021-2022,S39G01N256,울산 현대모비스,Away,이현민,1,0,1,0.0,0,1,0.0,0,2,0.0,1,2,50.0,0,2,2,3,1,0,0,0,1,2
../kbl_data/2021-2022,S39G01N256,울산 현대모비스,Away,함지훈,9,1,2,50.0,1,3,33.3,2,5,40.0,4,5,80.0,0,4,4,7,0,1,1,0,4,0
../kbl_data/2021-2022,S39G01N256,울산 현대모비스,Away,박지훈,3,0,0,0.0,1,2,50.0,1,2,50.0,0,0,0.0,0,0,0,0,0,0,0,0,0,2
../kbl_data/2021-2022,S39G01N256,울산 현대모비스,Away,장재석,12,4,10,40.0,0,0,0.0,4,10,40.0,4,7,57.1,3,7,10,0,4,1,0,0,1,4
../kbl_data/2021-2022,S39G01N256,울산 현대모비스,Away,김영현,0,0,0,0.0,0,1,0.0,0,1,0.0,0,0,0.0,0,0,0,0,0,1,1,0,1,0
../kbl_data/2021-2022,S39G01N256,울산 현대모비스,Away,김국찬,7,3,5,60.0,0,5,0.0,3,10,30.0,1,2,50.0,1,1,2,2,0,0,0,0,0,1
../kbl_data/2021-2022,S39G01N256,울산 현대모비스,Away,서명진,19,2,5,40.0,5,8,62.5,7,13,53.8,0,0,0.0,0,4,4,4,0,0,1,0,3,4
../kbl_data/2021-2022,S39G01N256,울산 현대모비스,Away,이진석,0,0,0,0.0,0,0,0.0,0,0,0.0,0,0,0.0,0,0,0,0,0,0,0,0,0,0
../kbl_data/2021-2022,S39G01N256,울산 현대모비스,Away,이우석,6,3,5,60.0,0,1,0.0,3,6,50.0,0,0,0.0,1,1,2,0,1,1,0,0,3,2
../kbl_data/2021-2022,S39G01N256,울산 현대모비스,Away,신민석,2,0,0,0.0,0,1,0.0,0,1,0.0,2,2,100.0,0,0,0,0,0,0,0,0,0,0
../kbl_data/2021-2022,S39G01N256,울산 현대모비스,Away,김동준,0,0,0,0.0,0,0,0.0,0,0,0.0,0,0,0.0,0,0,0,1,0,0,0,0,1,1
../kbl_data/2021-2022,S39G01N256,울산 현대모비스,Away,에릭 버크너,6,3,5,60.0,0,0,0.0,3,5,60.0,0,0,0.0,0,5,5,0,1,1,0,1,3,5
../kbl_data/2021-2022,S39G01N257,서울 삼성,Home,김동량,4,2,3,66.7,0,1,0.0,2,4,50.0,0,0,0.0,1,1,2,0,1,0,0,0,4,3
../kbl_data/2021-2022,S39G01N257,서울 삼성,Home,김시래,9,0,0,0.0,1,5,20.0,1,5,20.0,6,9,66.7,0,5,5,2,0,0,1,0,4,0
../kbl_data/2021-2022,S39G01N257,서울 삼성,Home,이동엽,10,3,6,50.0,1,3,33.3,4,9,44.4,1,2,50.0,1,2,3,3,1,0,0,0,3,1
../kbl_data/2021-2022,S39G01N257,서울 삼성,Home,배수용,10,2,2,100.0,2,4,50.0,4,6,66.7,0,0,0.0,1,4,5,1,2,0,0,0,0,3
../kbl_data/2021-2022,S39G01N257,서울 삼성,Home,이호현,0,0,0,0.0,0,0,0.0,0,0,0.0,0,0,0.0,0,0,0,0,0,0,0,0,0,0
../kbl_data/2021-2022,S39G01N257,서울 삼성,Home,정희원,0,0,1,0.0,0,2,0.0,0,3,0.0,0,0,0.0,0,0,0,2,0,0,1,0,0,2
../kbl_data/2021-2022,S39G01N257,서울 삼성,Home,강바일,0,0,0,0.0,0,3,0.0,0,3,0.0,0,0,0.0,0,0,0,0,0,0,0,0,1,2
../kbl_data/2021-2022,S39G01N257,서울 삼성,Home,박민우,4,0,0,0.0,0,7,0.0,0,7,0.0,4,4,100.0,0,1,1,0,0,0,0,0,0,0
../kbl_data/2021-2022,S39G01N257,서울 삼성,Home,차민석,2,1,1,100.0,0,0,0.0,1,1,100.0,0,0,0.0,0,0,0,0,0,0,0,0,1,2
../kbl_data/2021-2022,S39G01N257,서울 삼성,Home,전형준,13,3,5,60.0,2,9,22.2,5,14,35.7,1,1,100.0,0,3,3,0,1,0,0,0,0,3
../kbl_data/2021-2022,S39G01N257,서울 삼성,Home,조우성,6,2,3,66.7,0,0,0.0,2,3,66.7,2,6,33.3,4,3,7,0,0,0,0,0,0,2
../kbl_data/2021-2022,S39G01N257,서울 삼성,Home,이원석,9,3,7,42.9,0,1,0.0,3,8,37.5,3,4,75.0,5,3,8,0,1,1,0,1,2,5
../kbl_data/2021-2022,S39G01N257,대구 한국가스공사,Away,정영삼,0,0,0,0.0,0,0,0.0,0,0,0.0,0,0,0.0,0,0,0,0,0,0,0,0,0,1
../kbl_data/2021-2022,S39G01N257,대구 한국가스공사,Away,홍경기,2,1,5,20.0,0,3,0.0,1,8,12.5,0,0,0.0,0,3,3,3,1,0,0,0,0,2
../kbl_data/2021-2022,S39G01N257,대구 한국가스공사,Away,차바위,6,2,2,100.0,0,1,0.0,2,3,66.7,2,2,100.0,0,4,4,1,1,0,1,0,0,5
../kbl_data/2021-2022,S39G01N257,대구 한국가스공사,Away,이대헌,5,2,3,66.7,0,0,0.0,2,3,66.7,1,1,100.0,1,3,4,2,0,0,0,0,0,3
../kbl_data/2021-2022,S39G01N257,대구 한국가스공사,Away,두경민,4,1,2,50.0,0,3,0.0,1,5,20.0,2,2,100.0,0,2,2,0,0,0,0,0,1,0
../kbl_data/2021-2022,S39G01N257,대구 한국가스공사,Away,박봉진,2,0,0,0.0,0,1,0.0,0,1,0.0,2,2,100.0,1,1,2,2,0,0,0,0,0,1
../kbl_data/2021-2022,S39G01N257,대구 한국가스공사,Away,김낙현,22,4,6,66.7,3,5,60.0,7,11,63.6,5,5,100.0,0,1,1,3,0,0,0,0,2,2
../kbl_data/2021-2022,S39G01N257,대구 한국가스공사,Away,전현우,11,2,2,100.0,2,6,33.3,4,8,50.0,1,1,100.0,0,2,2,0,0,0,1,0,1,4
../kbl_data/2021-2022,S39G01N257,대구 한국가스공사,Away,양준우,4,1,1,100.0,0,1,0.0,1,2,50.0,2,2,100.0,0,0,0,0,0,0,0,0,1,0
../kbl_data/2021-2022,S39G01N257,대구 한국가스공사,Away,앤드류 니콜슨,5,2,6,33.3,0,1,0.0,2,7,28.6,1,2,50.0,2,2,4,0,0,0,0,0,0,5
../kbl_data/2021-2022,S39G01N257,대구 한국가스공사,Away,신승민,11,3,4,75.0,1,4,25.0,4,8,50.0,2,2,100.0,1,3,4,2,1,0,0,0,3,4
../kbl_data/2021-2022,S39G01N257,대구 한국가스공사,Away,디제이 화이트,18,6,8,75.0,1,3,33.3,7,11,63.6,3,4,75.0,2,3,5,3,3,1,0,1,3,2
../kbl_data/2021-2022,S39G01N258,전주 KCC,Home,이정현,36,0,10,0.0,6,20,30.0,6,30,20.0,18,18,100.0,4,6,10,8,6,0,0,0,4,2
../kbl_data/2021-2022,S39G01N258,전주 KCC,Home,라건아,14,7,7,100.0,0,0,0.0,7,7,100.0,0,0,0.0,4,7,11,1,0,0,0,1,0,0
../kbl_data/2021-2022,S39G01N258,전주 KCC,Home,김지완,14,4,5,80.0,2,5,40.0,6,10,60.0,0,1,0.0,0,0,0,3,1,1,0,0,1,2
../kbl_data/2021-2022,S39G01N258,전주 KCC,Home,전준범,4,2,2,100.0,0,6,0.0,2,8,25.0,0,0,0.0,0,7,7,3,1,0,0,0,0,3
../kbl_data/2021-2022,S39G01N258,전주 KCC,Home,박재현,4,2,4,50.0,0,1,0.0,2,5,40.0,0,0,0.0,0,1,1,0,0,0,0,0,1,1
../kbl_data/2021-2022,S39G01N258,전주 KCC,Home,송교창,12,3,6,50.0,2,4,50.0,5,10,50.0,0,0,0.0,0,2,2,1,0,1,0,0,1,1
../kbl_data/2021-2022,S39G01N258,전주 KCC,Home,이진욱,0,0,1,0.0,0,0,0.0,0,1,0.0,0,0,0.0,0,0,0,0,0,0,0,0,1,3
../kbl_data/2021-2022,S39G01N258,전주 KCC,Home,곽동기,0,0,0,0.0,0,0,0.0,0,0,0.0,0,0,0.0,0,0,0,0,0,0,0,0,0,0
../kbl_data/2021-2022,S39G01N258,전주 KCC,Home,라타비우스 윌리엄스,10,4,9,44.4,0,1,0.0,4,10,40.0,2,3,66.7,3,5,8,0,0,1,0,0,1,2
../kbl_data/2021-2022,S39G01N258,전주 KCC,Home,곽정훈,0,0,0,0.0,0,0,0.0,0,0,0.0,0,0,0.0,0,0,0,0,0,0,0,0,0,0
../kbl_data/2021-2022,S39G01N258,전주 KCC,Home,이근휘,3,0,2,0.0,1,2,50.0,1,4,25.0,0,0,0.0,0,0,0,0,0,0,0,0,0,5
../kbl_data/2021-2022,S39G01N258,전주 KCC,Home,서정현,5,1,4,25.0,0,0,0.0,1,4,25.0,3,4,75.0,3,4,7,3,0,0,0,0,2,5
../kbl_data/2021-2022,S39G01N258,고양 오리온,Away,김강선,9,1,3,33.3,2,3,66.7,3,6,50.0,1,2,50.0,0,0,0,0,1,0,0,0,0,2
../kbl_data/2021-2022,S39G01N258,고양 오리온,Away,이대성,21,9,13,69.2,0,0,0.0,9,13,69.2,3,5,60.0,1,5,6,4,0,0,0,0,0,0
../kbl_data/2021-2022,S39G01N258,고양 오리온,Away,한호빈,5,1,2,50.0,1,4,25.0,2,6,33.3,0,0,0.0,0,1,1,3,0,0,0,0,0,1
../kbl_data/2021-2022,S39G01N258,고양 오리온,Away,이정제,0,0,0,0.0,0,0,0.0,0,0,0.0,0,0,0.0,0,0,0,1,0,0,0,0,0,4
../kbl_data/2021-2022,S39G01N258,고양 오리온,Away,최승욱,4,0,1,0.0,1,1,100.0,1,2,50.0,1,2,50.0,0,1,1,0,0,0,0,0,0,3
../kbl_data/2021-2022,S39G01N258,고양 오리온,Away,이승현,4,2,6,33.3,0,1,0.0,2,7,28.6,0,2,0.0,0,6,6,4,1,1,0,0,1,1
../kbl_data/2021-2022,S39G01N258,고양 오리온,Away,김진유,0,0,0,0.0,0,0,0.0,0,0,0.0,0,0,0.0,0,0,0,0,0,0,0,0,0,0
../kbl_data/2021-2022,S39G01N258,고양 오리온,Away,머피 할로웨이,16,4,12,33.3,0,0,0.0,4,12,33.3,8,10,80.0,4,10,14,2,2,1,0,1,1,4
../kbl_data/2021-2022,S39G01N258,고양 오리온,Away,조한진,0,0,1,0.0,0,2,0.0,0,3,0.0,0,0,0.0,1,0,1,0,0,0,0,0,0,1
../kbl_data/2021-2022,S39G01N258,고양 오리온,Away,김세창,0,0,0,0.0,0,0,0.0,0,0,0.0,0,0,0.0,0,0,0,0,0,0,0,0,0,0
../kbl_data/2021-2022,S39G01N258,고양 오리온,Away,박진철,2,1,1,100.0,0,0,0.0,1,1,100.0,0,0,0.0,3,0,3,0,0,0,0,0,0,2
../kbl_data/2021-2022,S39G01N258,고양 오리온,Away,이정현,36,0,10,0.0,6,20,30.0,6,30,20.0,18,18,100.0,4,6,10,8,6,0,0,0,4,2
../kbl_data/2021-2022,S39G01N259,수원 KT,Home,김동욱,0,0,0,0.0,0,0,0.0,0,0,0.0,0,0,0.0,0,0,0,0,0,0,0,0,0,0
../kbl_data/2021-2022,S39G01N259,수원 KT,Home,김영환,2,1,2,50.0,0,1,0.0,1,3,33.3,0,0,0.0,0,0,0,0,0,0,0,0,0,0
../kbl_data/2021-2022,S39G01N259,수원 KT,Home,김현민,4,2,3,66.7,0,1,0.0,2,4,50.0,0,0,0.0,1,1,2,2,0,0,0,0,0,3
../kbl_data/2021-2022,S39G01N259,수원 KT,Home,한희원,2,1,1,100.0,0,1,0.0,1,2,50.0,0,0,0.0,0,0,0,0,0,0,0,0,0,0
../kbl_data/2021-2022,S39G01N259,수원 KT,Home,정성우,19,6,8,75.0,1,4,25.0,7,12,58.3,4,4,100.0,1,2,3,7,2,0,0,0,0,1
../kbl_data/2021-2022,S39G01N259,수원 KT,Home,최성모,0,0,0,0.0,0,0,0.0,0,0,0.0,0,0,0.0,0,0,0,0,0,0,0,0,0,0
../kbl_data/2021-2022,S39G01N259,수원 KT,Home,허훈,18,3,6,50.0,3,6,50.0,6,12,50.0,3,4,75.0,2,1,3,4,0,0,1,0,2,2
../kbl_data/2021-2022,S39G01N259,수원 KT,Home,양홍석,18,4,5,80.0,3,6,50.0,7,11,63.6,1,1,100.0,0,5,5,3,1,0,0,0,0,1
../kbl_data/2021-2022,S39G01N259,수원 KT,Home,캐디 라렌,19,8,15,53.3,1,1,100.0,9,16,56.2,0,2,0.0,3,12,15,4,0,1,1,0,1,0
../kbl_data/2021-2022,S39G01N259,수원 KT,Home,박지원,3,0,2,0.0,1,2,50.0,1,4,25.0,0,0,0.0,1,1,2,2,0,0,0,0,1,3
../kbl_data/2021-2022,S39G01N259,수원 KT,Home,마이크 마이어스,2,1,1,100.0,0,0,0.0,1,1,100.0,0,2,0.0,1,5,6,1,0,0,0,0,0,0
../kbl_data/2021-2022,S39G01N259,수원 KT,Home,하윤기,8,3,7,42.9,0,0,0.0,3,7,42.9,2,2,100.0,3,1,4,0,0,0,0,1,1,2
../kbl_data/2021-2022,S39G01N259,안양 KGC,Away,양희종,3,0,0,0.0,1,2,50.0,1,2,50.0,0,0,0.0,2,0,2,2,1,0,0,0,0,1
../kbl_data/2021-2022,S39G01N259,안양 KGC,Away,함준후,0,0,0,0.0,0,0,0.0,0,0,0.0,0,0,0.0,0,0,0,0,0,0,0,0,0,0
../kbl_data/2021-2022,S39G01N259,안양 KGC,Away,오세근,16,3,8,37.5,3,5,60.0,6,13,46.2,1,2,50.0,0,3,3,1,0,0,0,0,0,2
../kbl_data/2021-2022,S39G01N259,안양 KGC,Away,문성곤,3,0,0,0.0,1,1,100.0,1,1,100.0,0,0,0.0,3,1,4,0,0,0,0,0,1,3
../kbl_data/2021-2022,S39G01N259,안양 KGC,Away,전성현,8,1,1,100.0,2,10,20.0,3,11,27.3,0,0,0.0,1,0,1,1,0,0,0,0,0,4
../kbl_data/2021-2022,S39G01N259,안양 KGC,Away,박지훈,2,1,1,100.0,0,2,0.0,1,3,33.3,0,0,0.0,0,0,0,1,0,0,0,0,0,1
../kbl_data/2021-2022,S39G01N259,안양 KGC,Away,대릴 먼로,0,0,0,0.0,0,0,0.0,0,0,0.0,0,0,0.0,0,0,0,0,0,0,0,0,0,0
../kbl_data/2021-2022,S39G01N259,안양 KGC,Away,우동현,6,0,0,0.0,2,3,66.7,2,3,66.7,0,0,0.0,0,0,0,0,0,0,0,0,0,2
../kbl_data/2021-2022,S39G01N259,안양 KGC,Away,변준형,9,3,4,75.0,1,7,14.3,4,11,36.4,0,0,0.0,0,1,1,7,0,0,0,0,2,0
../kbl_data/2021-2022,S39G01N259,안양 KGC,Away,한승희,9,3,6,50.0,1,3,33.3,4,9,44.4,0,0,0.0,1,2,3,0,0,0,0,0,1,2
../kbl_data/2021-2022,S39G01N259,안양 KGC,Away,오마리 스펠맨,15,3,9,33.3,2,8,25.0,5,17,29.4,3,4,75.0,2,14,16,5,0,2,0,2,2,2
../kbl_data/2021-2022,S39G01N259,안양 KGC,Away,조은후,0,0,0,0.0,0,1,0.0,0,1,0.0,0,0,0.0,0,0,0,0,0,0,0,0,0,1
../kbl_data/2021-2022,S39G01N260,창원 LG,Home,강병현,6,0,0,0.0,2,3,66.7,2,3,66.7,0,0,0.0,0,1,1,1,0,0,0,0,0,2
../kbl_data/2021-2022,S39G01N260,창원 LG,Home,이관희,14,3,5,60.0,2,11,18.2,5,16,31.2,2,2,100.0,0,3,3,5,1,0,0,0,2,1
../kbl_data/2021-2022,S39G01N260,창원 LG,Home,정희재,5,1,1,100.0,1,3,33.3,2,4,50.0,0,0,0.0,1,2,3,2,1,0,1,0,0,3
../kbl_data/2021-2022,S39G01N260,창원 LG,Home,서민수,0,0,0,0.0,0,0,0.0,0,0,0.0,0,0,0.0,0,0,0,0,0,0,0,0,0,0
../kbl_data/2021-2022,S39G01N260,창원 LG,Home,한상혁,0,0,0,0.0,0,1,0.0,0,1,0.0,0,0,0.0,0,0,0,0,0,0,0,0,0,0
../kbl_data/2021-2022,S39G01N260,창원 LG,Home,이재도,26,6,16,37.5,4,9,44.4,10,25,40.0,2,2,100.0,2,6,8,2,0,0,0,0,0,2
../kbl_data/2021-2022,S39G01N260,창원 LG,Home,박인태,0,0,0,0.0,0,0,0.0,0,0,0.0,0,0,0.0,0,0,0,0,0,0,0,0,0,0
../kbl_data/2021-2022,S39G01N260,창원 LG,Home,정해원,0,0,0,0.0,0,0,0.0,0,0,0.0,0,0,0.0,0,0,0,0,0,0,0,0,0,0
../kbl_data/2021-2022,S39G01N260,창원 LG,Home,박정현,10,5,6,83.3,0,2,0.0,5,8,62.5,0,0,0.0,2,1,3,1,1,1,0,0,2,5
../kbl_data/2021-2022,S39G01N260,창원 LG,Home,아셈 마레이,12,5,9,55.6,0,0,0.0,5,9,55.6,2,5,40.0,9,7,16,3,1,0,0,0,4,3
../kbl_data/2021-2022,S39G01N260,창원 LG,Home,이승우,7,2,6,33.3,1,4,25.0,3,10,30.0,0,2,0.0,2,4,6,5,0,0,1,0,2,4
../kbl_data/2021-2022,S39G01N260,창원 LG,Home,사마르도 사무엘스,0,0,1,0.0,0,0,0.0,0,1,0.0,0,0,0.0,1,0,1,1,0,0,0,0,1,0
../kbl_data/2021-2022,S39G01N260,서울 SK,Away,송창무,5,2,2,100.0,0,0,0.0,2,2,100.0,1,2,50.0,1,1,2,0,0,0,0,0,0,2
../kbl_data/2021-2022,S39G01N260,서울 SK,Away,최부경,7,3,5,60.0,0,0,0.0,3,5,60.0,1,2,50.0,3,2,5,0,0,0,0,0,2,4
../kbl_data/2021-2022,S39G01N260,서울 SK,Away,리온 윌리엄스,7,3,6,50.0,0,0,0.0,3,6,50.0,1,2,50.0,1,8,9,1,1,0,0,1,1,3
../kbl_data/2021-2022,S39G01N260,서울 SK,Away,배병준,7,2,4,50.0,1,2,50.0,3,6,50.0,0,0,0.0,3,0,3,1,1,0,0,0,0,1
../kbl_data/2021-2022,S39G01N260,서울 SK,Away,최준용,24,10,21,47.6,0,4,0.0,10,25,40.0,4,8,50.0,0,6,6,6,0,0,0,0,1,3
../kbl_data/2021-2022,S39G01N260,서울 SK,Away,안영준,16,2,6,33.3,4,10,40.0,6,16,37.5,0,0,0.0,1,3,4,2,3,2,0,0,3,3
../kbl_data/2021-2022,S39G01N260,서울 SK,Away,김형빈,0,0,0,0.0,0,0,0.0,0,0,0.0,0,0,0.0,0,0,0,0,0,0,0,0,0,2
../kbl_data/2021-2022,S39G01N260,서울 SK,Away,오재현,9,2,2,100.0,1,2,50.0,3,4,75.0,2,3,66.7,0,2,2,5,1,0,0,0,3,2
../kbl_data/2021-2022,S39G01N260,서울 SK,Away,김수환,0,0,0,0.0,0,0,0.0,0,0,0.0,0,0,0.0,0,0,0,0,0,0,0,0,0,0
../kbl_data/2021-2022,S39G01N261,울산 현대모비스,Home,이현민,0,0,1,0.0,0,0,0.0,0,1,0.0,0,1,0.0,0,1,1,0,0,0,0,0,1,1
../kbl_data/2021-2022,S39G01N261,울산 현대모비스,Home,함지훈,10,5,8,62.5,0,1,0.0,5,9,55.6,0,0,0.0,1,4,5,3,1,1,0,0,0,3
../kbl_data/2021-2022,S39G01N261,울산 현대모비스,Home,박지훈,7,1,3,33.3,1,5,20.0,2,8,25.0,2,2,100.0,0,1,1,0,0,0,0,0,0,0
../kbl_data/2021-2022,S39G01N261,울산 현대모비스,Home,장재석,13,6,7,85.7,0,0,0.0,6,7,85.7,1,3,33.3,3,1,4,2,1,0,0,0,0,3
../kbl_data/2021-2022,S39G01N261,울산 현대모비스,Home,김영현,0,0,0,0.0,0,0,0.0,0,0,0.0,0,0,0.0,0,0,0,0,0,0,0,0,0,0
../kbl_data/2021-2022,S39G01N261,울산 현대모비스,Home,김국찬,2,1,3,33.3,0,2,0.0,1,5,20.0,0,0,0.0,1,0,1,0,0,0,0,0,0,2
../kbl_data/2021-2022,S39G01N261,울산 현대모비스,Home,서명진,9,3,3,100.0,0,4,0.0,3,7,42.9,3,4,75.0,0,3,3,7,1,0,0,0,2,0
../kbl_data/2021-2022,S39G01N261,울산 현대모비스,Home,이진석,0,0,0,0.0,0,0,0.0,0,0,0.0,0,0,0.0,0,0,0,0,0,0,0,0,0,0
../kbl_data/2021-2022,S39G01N261,울산 현대모비스,Home,이우석,11,3,7,42.9,1,5,20.0,4,12,33.3,2,2,100.0,3,9,12,1,2,1,0,0,3,1
../kbl_data/2021-2022,S39G01N261,울산 현대모비스,Home,신민석,1,0,2,0.0,0,2,0.0,0,4,0.0,1,2,50.0,1,2,3,0,1,0,0,0,0,0
../kbl_data/2021-2022,S39G01N261,울산 현대모비스,Home,김동준,0,0,1,0.0,0,2,0.0,0,3,0.0,0,0,0.0,0,0,0,2,0,0,0,0,0,1
../kbl_data/2021-2022,S39G01N261,울산 현대모비스,Home,에릭 버크너,12,5,10,50.0,0,0,0.0,5,10,50.0,2,4,50.0,3,1,4,0,1,0,0,3,3,3
../kbl_data/2021-2022,S39G01N261,대구 한국가스공사,Away,정영삼,0,0,0,0.0,0,1,0.0,0,1,0.0,0,0,0.0,0,0,0,0,0,0,0,0,0,0
../kbl_data/2021-2022,S39G01N261,대구 한국가스공사,Away,민성주,2,1,1,100.0,0,0,0.0,1,1,100.0,0,0,0.0,0,2,2,1,0,0,0,0,0,3
../kbl_data/2021-2022,S39G01N261,대구 한국가스공사,Away,차바위,8,1,1,100.0,2,2,100.0,3,3,100.0,0,0,0.0,2,5,7,4,0,0,2,0,1,3
../kbl_data/2021-2022,S39G01N261,대구 한국가스공사,Away,조상열,5,1,2,50.0,1,2,50.0,2,4,50.0,0,0,0.0,2,0,2,0,0,1,0,0,0,3
../kbl_data/2021-2022,S39G01N261,대구 한국가스공사,Away,이대헌,13,5,8,62.5,1,2,50.0,6,10,60.0,0,0,0.0,2,2,4,1,0,0,0,1,1,4
../kbl_data/2021-2022,S39G01N261,대구 한국가스공사,Away,두경민,11,5,6,83.3,0,1,0.0,5,7,71.4,1,2,50.0,0,2,2,5,1,1,0,0,6,1
../kbl_data/2021-2022,S39G01N261,대구 한국가스공사,Away,김낙현,21,6,10,60.0,3,9,33.3,9,19,47.4,0,0,0.0,0,3,3,9,2,0,0,0,1,1
../kbl_data/2021-2022,S39G01N261,대구 한국가스공사,Away,전현우,0,0,0,0.0,0,1,0.0,0,1,0.0,0,0,0.0,0,0,0,0,0,0,0,0,0,1
../kbl_data/2021-2022,S39G01N261,대구 한국가스공사,Away,양준우,0,0,0,0.0,0,0,0.0,0,0,0.0,0,0,0.0,0,0,0,0,0,0,0,0,0,0
../kbl_data/2021-2022,S39G01N261,대구 한국가스공사,Away,앤드류 니콜슨,20,5,10,50.0,3,3,100.0,8,13,61.5,1,3,33.3,2,3,5,0,0,0,0,0,0,1
../kbl_data/2021-2022,S39G01N261,대구 한국가스공사,Away,신승민,0,0,1,0.0,0,0,0.0,0,1,0.0,0,0,0.0,0,1,1,0,0,0,0,0,0,0
../kbl_data/2021-2022,S39G01N261,대구 한국가스공사,Away,디제이 화이트,6,1,2,50.0,1,3,33.3,2,5,40.0,1,2,50.0,0,5,5,0,1,2,0,0,1,1
../kbl_data/2021-2022,S39G01N262,서울 삼성,Home,김동량,12,4,8,50.0,1,2,50.0,5,10,50.0,1,1,100.0,4,6,10,0,0,0,0,0,2,1
../kbl_data/2021-2022,S39G01N262,서울 삼성,Home,김시래,22,6,14,42.9,2,3,66.7,8,17,47.1,4,7,57.1,0,2,2,6,1,0,0,0,1,2
../kbl_data/2021-2022,S39G01N262,서울 삼성,Home,이동엽,0,0,4,0.0,0,0,0.0,0,4,0.0,0,0,0.0,2,3,5,1,1,0,0,0,0,1
../kbl_data/2021-2022,S39G01N262,서울 삼성,Home,배수용,0,0,0,0.0,0,1,0.0,0,1,0.0,0,0,0.0,0,0,0,1,0,0,0,0,0,1
../kbl_data/2021-2022,S39G01N262,서울 삼성,Home,이호현,23,5,10,50.0,3,3,100.0,8,13,61.5,4,4,100.0,1,1,2,2,2,0,0,0,1,2
../kbl_data/2021-2022,S39G01N262,서울 삼성,Home,정희원,0,0,0,0.0,0,1,0.0,0,1,0.0,0,0,0.0,0,0,0,0,0,0,0,0,2,2
../kbl_data/2021-2022,S39G01N262,서울 삼성,Home,강바일,0,0,0,0.0,0,0,0.0,0,0,0.0,0,0,0.0,0,0,0,0,0,0,0,0,0,0
../kbl_data/2021-2022,S39G01N262,서울 삼성,Home,박민우,2,1,2,50.0,0,3,0.0,1,5,20.0,0,0,0.0,1,1,2,0,0,0,0,0,0,1
../kbl_data/2021-2022,S39G01N262,서울 삼성,Home,차민석,0,0,0,0.0,0,2,0.0,0,2,0.0,0,0,0.0,0,0,0,0,0,0,0,0,0,0
../kbl_data/2021-2022,S39G01N262,서울 삼성,Home,전형준,2,1,1,100.0,0,4,0.0,1,5,20.0,0,0,0.0,0,2,2,1,0,0,0,0,1,2
../kbl_data/2021-2022,S39G01N262,서울 삼성,Home,조우성,2,0,2,0.0,0,0,0.0,0,2,0.0,2,2,100.0,2,5,7,0,0,0,0,0,1,5
../kbl_data/2021-2022,S39G01N262,서울 삼성,Home,이원석,12,4,9,44.4,0,0,0.0,4,9,44.4,4,4,100.0,2,4,6,0,0,1,0,0,1,5
../kbl_data/2021-2022,S39G01N262,원주 DB,Away,정준원,9,3,5,60.0,0,1,0.0,3,6,50.0,3,4,75.0,2,3,5,1,0,1,0,0,0,1
../kbl_data/2021-2022,S39G01N262,원주 DB,Away,김종규,14,2,4,50.0,3,4,75.0,5,8,62.5,1,2,50.0,1,4,5,1,0,0,0,0,1,2
../kbl_data/2021-2022,S39G01N262,원주 DB,Away,허웅,26,5,7,71.4,3,6,50.0,8,13,61.5,7,7,100.0,0,2,2,0,0,0,1,0,3,0
../kbl_data/2021-2022,S39G01N262,원주 DB,Away,김영훈,0,0,1,0.0,0,0,0.0,0,1,0.0,0,0,0.0,0,1,1,0,0,0,1,0,0,2
../kbl_data/2021-2022,S39G01N262,원주 DB,Away,강상재,2,1,6,16.7,0,2,0.0,1,8,12.5,0,0,0.0,0,5,5,1,0,1,0,0,1,3
../kbl_data/2021-2022,S39G01N262,원주 DB,Away,김철욱,0,0,0,0.0,0,0,0.0,0,0,0.0,0,0,0.0,0,0,0,0,0,0,0,0,0,0
../kbl_data/2021-2022,S39G01N262,원주 DB,Away,나카무라 타이치,0,0,0,0.0,0,0,0.0,0,0,0.0,0,0,0.0,0,0,0,0,0,0,0,0,0,0
../kbl_data/2021-2022,S39G01N262,원주 DB,Away,이용우,0,0,0,0.0,0,0,0.0,0,0,0.0,0,0,0.0,0,0,0,0,0,0,0,0,0,0
../kbl_data/2021-2022,S39G01N262,원주 DB,Away,이준희,4,2,6,33.3,0,2,0.0,2,8,25.0,0,1,0.0,3,2,5,1,1,0,0,0,1,3
../kbl_data/2021-2022,S39G01N262,원주 DB,Away,레나드 프리먼,0,0,0,0.0,0,0,0.0,0,0,0.0,0,0,0.0,0,0,0,0,0,0,0,0,2,1
../kbl_data/2021-2022,S39G01N262,원주 DB,Away,정호영,11,4,7,57.1,1,2,50.0,5,9,55.6,0,0,0.0,1,4,5,3,2,0,0,1,1,3
../kbl_data/2021-2022,S39G01N262,원주 DB,Away,조니 오브라이언트,16,4,8,50.0,0,1,0.0,4,9,44.4,8,8,100.0,1,7,8,6,0,1,0,0,0,4
../kbl_data/2021-2022,S39G01N263,울산 현대모비스,Home,이현민,4,2,2,100.0,0,2,0.0,2,4,50.0,0,0,0.0,0,0,0,2,0,0,0,0,1,2
../kbl_data/2021-2022,S39G01N263,울산 현대모비스,Home,함지훈,12,4,6,66.7,1,1,100.0,5,7,71.4,1,1,100.0,2,2,4,2,1,0,0,0,1,0
../kbl_data/2021-2022,S39G01N263,울산 현대모비스,Home,박지훈,13,3,5,60.0,2,4,50.0,5,9,55.6,1,2,50.0,1,2,3,2,1,0,0,0,1,1
../kbl_data/2021-2022,S39G01N263,울산 현대모비스,Home,장재석,5,2,4,50.0,0,0,0.0,2,4,50.0,1,2,50.0,2,3,5,1,0,0,0,0,3,4
../kbl_data/2021-2022,S39G01N263,울산 현대모비스,Home,김영현,0,0,0,0.0,0,1,0.0,0,1,0.0,0,0,0.0,0,0,0,0,1,0,0,0,0,1
../kbl_data/2021-2022,S39G01N263,울산 현대모비스,Home,김국찬,0,0,0,0.0,0,0,0.0,0,0,0.0,0,0,0.0,0,0,0,0,0,0,0,0,0,2
../kbl_data/2021-2022,S39G01N263,울산 현대모비스,Home,서명진,11,2,3,66.7,2,5,40.0,4,8,50.0,1,2,50.0,0,2,2,3,1,0,0,0,2,3
../kbl_data/2021-2022,S39G01N263,울산 현대모비스,Home,이진석,0,0,0,0.0,0,0,0.0,0,0,0.0,0,0,0.0,0,0,0,0,0,0,0,0,0,0
../kbl_data/2021-2022,S39G01N263,울산 현대모비스,Home,이우석,13,6,11,54.5,0,3,0.0,6,14,42.9,1,2,50.0,0,3,3,7,1,1,0,0,2,3
../kbl_data/2021-2022,S39G01N263,울산 현대모비스,Home,신민석,0,0,0,0.0,0,0,0.0,0,0,0.0,0,0,0.0,0,0,0,0,0,0,0,0,0,0
../kbl_data/2021-2022,S39G01N263,울산 현대모비스,Home,김동준,0,0,0,0.0,0,0,0.0,0,0,0.0,0,0,0.0,0,0,0,0,0,0,0,0,0,1
../kbl_data/2021-2022,S39G01N263,울산 현대모비스,Home,에릭 버크너,13,6,12,50.0,0,0,0.0,6,12,50.0,1,2,50.0,1,11,12,3,0,1,0,0,3,2
../kbl_data/2021-2022,S39G01N263,고양 오리온,Away,김강선,4,1,2,50.0,0,1,0.0,1,3,33.3,2,3,66.7,1,0,1,0,2,0,0,0,0,0
../kbl_data/2021-2022,S39G01N263,고양 오리온,Away,이대성,21,6,13,46.2,2,3,66.7,8,16,50.0,3,3,100.0,1,1,2,5,3,0,0,0,2,1
../kbl_data/2021-2022,S39G01N263,고양 오리온,Away,한호빈,12,1,3,33.3,3,5,60.0,4,8,50.0,1,3,33.3,0,2,2,6,1,0,0,0,0,3
../kbl_data/2021-2022,S39G01N263,고양 오리온,Away,이정제,2,1,3,33.3,0,0,0.0,1,3,33.3,0,1,0.0,0,0,0,0,0,0,0,0,1,3
../kbl_data/2021-2022,S39G01N263,고양 오리온,Away,최승욱,0,0,0,0.0,0,0,0.0,0,0,0.0,0,0,0.0,0,1,1,1,1,0,0,0,0,0
../kbl_data/2021-2022,S39G01N263,고양 오리온,Away,이승현,8,4,8,50.0,0,1,0.0,4,9,44.4,0,0,0.0,3,2,5,4,0,0,0,0,1,1
../kbl_data/2021-2022,S39G01N263,고양 오리온,Away,김진유,0,0,0,0.0,0,0,0.0,0,0,0.0,0,0,0.0,0,1,1,0,0,0,0,0,0,0
../kbl_data/2021-2022,S39G01N263,고양 오리온,Away,머피 할로웨이,21,10,19,52.6,0,0,0.0,10,19,52.6,1,2,50.0,10,9,19,1,1,0,0,1,2,3
../kbl_data/2021-2022,S39G01N263,고양 오리온,Away,조한진,7,2,2,100.0,1,2,50.0,3,4,75.0,0,0,0.0,0,1,1,0,2,1,0,0,1,2
../kbl_data/2021-2022,S39G01N263,고양 오리온,Away,김세창,3,0,1,0.0,1,1,100.0,1,2,50.0,0,0,0.0,0,0,0,0,1,0,0,0,0,0
../kbl_data/2021-2022,S39G01N263,고양 오리온,Away,이정현,6,0,3,0.0,2,4,50.0,2,7,28.6,0,0,0.0,0,2,2,3,0,0,0,0,1,1
../kbl_data/2021-2022,S39G01N263,고양 오리온,Away,문시윤,2,1,1,100.0,0,0,0.0,1,1,100.0,0,0,0.0,0,0,0,0,0,0,0,0,0,0
../kbl_data/2021-2022,S39G01N264,전주 KCC,Home,이정현,11,2,4,50.0,1,2,50.0,3,6,50.0,4,4,100.0,0,6,6,6,0,0,0,0,0,1
../kbl_data/2021-2022,S39G01N264,전주 KCC,Home,라건아,22,6,8,75.0,2,3,66.7,8,11,72.7,4,4,100.0,0,5,5,0,1,0,0,1,1,0
../kbl_data/2021-2022,S39G01N264,전주 KCC,Home,김지완,5,1,2,50.0,1,5,20.0,2,7,28.6,0,0,0.0,0,4,4,6,0,0,0,0,3,3
../kbl_data/2021-2022,S39G01N264,전주 KCC,Home,전준범,2,0,1,0.0,0,4,0.0,0,5,0.0,2,2,100.0,0,2,2,1,0,0,0,0,0,1
../kbl_data/2021-2022,S39G01N264,전주 KCC,Home,박재현,7,2,4,50.0,1,3,33.3,3,7,42.9,0,0,0.0,0,3,3,2,1,0,0,0,0,2
../kbl_data/2021-2022,S39G01N264,전주 KCC,Home,송교창,0,0,0,0.0,0,0,0.0,0,0,0.0,0,0,0.0,0,0,0,0,0,0,0,0,0,0
../kbl_data/2021-2022,S39G01N264,전주 KCC,Home,이진욱,4,2,3,66.7,0,0,0.0,2,3,66.7,0,0,0.0,0,0,0,0,0,0,0,0,1,0
../kbl_data/2021-2022,S39G01N264,전주 KCC,Home,곽동기,8,2,4,50.0,1,1,100.0,3,5,60.0,1,1,100.0,2,2,4,2,0,0,0,0,1,4
../kbl_data/2021-2022,S39G01N264,전주 KCC,Home,라타비우스 윌리엄스,9,4,6,66.7,0,0,0.0,4,6,66.7,1,2,50.0,1,9,10,0,0,0,0,1,1,0
../kbl_data/2021-2022,S39G01N264,전주 KCC,Home,곽정훈,2,1,1,100.0,0,0,0.0,1,1,100.0,0,0,0.0,1,0,1,0,0,0,0,0,0,0
../kbl_data/2021-2022,S39G01N264,전주 KCC,Home,이근휘,12,3,4,75.0,2,5,40.0,5,9,55.6,0,0,0.0,0,3,3,2,1,0,0,0,0,0
../kbl_data/2021-2022,S39G01N264,전주 KCC,Home,서정현,6,3,5,60.0,0,1,0.0,3,6,50.0,0,0,0.0,2,1,3,1,0,1,0,0,1,2
../kbl_data/2021-2022,S39G01N264,안양 KGC,Away,양희종,2,1,4,25.0,0,4,0.0,1,8,12.5,0,0,0.0,2,1,3,1,0,0,0,0,0,3
../kbl_data/2021-2022,S39G01N264,안양 KGC,Away,함준후,3,0,1,0.0,1,1,100.0,1,2,50.0,0,0,0.0,0,1,1,0,0,0,0,0,0,1
../kbl_data/2021-2022,S39G01N264,안양 KGC,Away,오세근,20,5,9,55.6,3,3,100.0,8,12,66.7,1,1,100.0,0,4,4,1,0,0,0,0,0,1
../kbl_data/2021-2022,S39G01N264,안양 KGC,Away,문성곤,0,0,1,0.0,0,3,0.0,0,4,0.0,0,0,0.0,0,1,1,0,0,0,0,0,0,0
../kbl_data/2021-2022,S39G01N264,안양 KGC,Away,전성현,14,1,1,100.0,4,16,25.0,5,17,29.4,0,0,0.0,0,1,1,0,1,0,0,0,0,3
../kbl_data/2021-2022,S39G01N264,안양 KGC,Away,박지훈,10,2,3,66.7,2,5,40.0,4,8,50.0,0,0,0.0,4,1,5,3,2,0,0,0,1,1
../kbl_data/2021-2022,S39G01N264,안양 KGC,Away,대릴 먼로,0,0,2,0.0,0,1,0.0,0,3,0.0,0,0,0.0,2,7,9,2,1,0,0,0,3,1
../kbl_data/2021-2022,S39G01N264,안양 KGC,Away,우동현,0,0,0,0.0,0,0,0.0,0,0,0.0,0,0,0.0,0,0,0,0,0,0,0,0,0,0
../kbl_data/2021-2022,S39G01N264,안양 KGC,Away,변준형,13,3,5,60.0,2,6,33.3,5,11,45.5,1,1,100.0,2,0,2,7,0,0,0,0,0,0
../kbl_data/2021-2022,S39G01N264,안양 KGC,Away,한승희,0,0,2,0.0,0,0,0.0,0,2,0.0,0,0,0.0,0,0,0,0,1,0,0,0,0,1
../kbl_data/2021-2022,S39G01N264,안양 KGC,Away,오마리 스펠맨,10,0,1,0.0,3,7,42.9,3,8,37.5,1,2,50.0,1,8,9,0,0,0,0,0,5,1
../kbl_data/2021-2022,S39G01N264,안양 KGC,Away,조은후,2,1,1,100.0,0,0,0.0,1,1,100.0,0,0,0.0,0,0,0,0,0,0,0,0,0,1
../kbl_data/2021-2022,S39G01N265,수원 KT,Home,김동욱,12,0,1,0.0,4,4,100.0,4,5,80.0,0,0,0.0,0,2,2,1,1,0,0,0,2,2
../kbl_data/2021-2022,S39G01N265,수원 KT,Home,김영환,7,2,3,66.7,1,2,50.0,3,5,60.0,0,0,0.0,0,1,1,0,1,0,0,0,0,1
../kbl_data/2021-2022,S39G01N265,수원 KT,Home,김현민,0,0,0,0.0,0,0,0.0,0,0,0.0,0,0,0.0,0,0,0,0,0,0,0,0,0,0
../kbl_data/2021-2022,S39G01N265,수원 KT,Home,한희원,0,0,0,0.0,0,0,0.0,0,0,0.0,0,0,0.0,0,0,0,0,0,0,0,0,0,0
../kbl_data/2021-2022,S39G01N265,수원 KT,Home,정성우,14,4,5,80.0,2,3,66.7,6,8,75.0,0,0,0.0,1,2,3,5,1,0,1,0,4,3
../kbl_data/2021-2022,S39G01N265,수원 KT,Home,최성모,0,0,0,0.0,0,0,0.0,0,0,0.0,0,0,0.0,0,0,0,0,0,0,0,0,0,0
../kbl_data/2021-2022,S39G01N265,수원 KT,Home,허훈,13,4,9,44.4,1,4,25.0,5,13,38.5,2,2,100.0,1,3,4,7,1,0,0,0,3,0
../kbl_data/2021-2022,S39G01N265,수원 KT,Home,양홍석,11,1,4,25.0,3,7,42.9,4,11,36.4,0,0,0.0,2,4,6,2,1,0,0,0,3,1
../kbl_data/2021-2022,S39G01N265,수원 KT,Home,캐디 라렌,19,8,13,61.5,1,3,33.3,9,16,56.2,0,1,0.0,5,9,14,1,0,4,0,1,2,4
../kbl_data/2021-2022,S39G01N265,수원 KT,Home,박지원,4,2,2,100.0,0,1,0.0,2,3,66.7,0,0,0.0,1,0,1,1,0,0,1,0,0,2
../kbl_data/2021-2022,S39G01N265,수원 KT,Home,마이크 마이어스,6,1,1,100.0,0,0,0.0,1,1,100.0,4,8,50.0,0,0,0,1,1,1,0,1,0,3
../kbl_data/2021-2022,S39G01N265,수원 KT,Home,하윤기,2,1,1,100.0,0,0,0.0,1,1,100.0,0,0,0.0,1,2,3,0,0,1,0,1,2,3
../kbl_data/2021-2022,S39G01N265,창원 LG,Away,강병현,0,0,0,0.0,0,0,0.0,0,0,0.0,0,0,0.0,0,0,0,0,0,0,0,0,0,0
../kbl_data/2021-2022,S39G01N265,창원 LG,Away,이관희,8,4,9,44.4,0,6,0.0,4,15,26.7,0,0,0.0,0,1,1,3,1,0,0,0,2,0
../kbl_data/2021-2022,S39G01N265,창원 LG,Away,정희재,8,4,4,100.0,0,3,0.0,4,7,57.1,0,0,0.0,1,1,2,2,1,0,0,0,2,3
../kbl_data/2021-2022,S39G01N265,창원 LG,Away,서민수,0,0,0,0.0,0,0,0.0,0,0,0.0,0,0,0.0,0,0,0,0,0,0,0,0,0,0
../kbl_data/2021-2022,S39G01N265,창원 LG,Away,한상혁,2,0,3,0.0,0,1,0.0,0,4,0.0,2,2,100.0,1,0,1,1,0,0,1,0,0,0
../kbl_data/2021-2022,S39G01N265,창원 LG,Away,이재도,25,4,5,80.0,4,8,50.0,8,13,61.5,5,6,83.3,2,3,5,5,2,0,0,0,2,3
../kbl_data/2021-2022,S39G01N265,창원 LG,Away,박인태,0,0,0,0.0,0,0,0.0,0,0,0.0,0,0,0.0,0,0,0,0,0,0,0,0,0,0
../kbl_data/2021-2022,S39G01N265,창원 LG,Away,정해원,3,0,0,0.0,1,1,100.0,1,1,100.0,0,0,0.0,0,0,0,0,0,0,0,0,1,3
../kbl_data/2021-2022,S39G01N265,창원 LG,Away,박정현,7,3,4,75.0,0,0,0.0,3,4,75.0,1,2,50.0,0,0,0,1,0,0,0,0,0,1
../kbl_data/2021-2022,S39G01N265,창원 LG,Away,아셈 마레이,25,9,17,52.9,0,0,0.0,9,17,52.9,7,12,58.3,7,5,12,2,4,1,0,1,2,4
../kbl_data/2021-2022,S39G01N265,창원 LG,Away,이승우,7,3,5,60.0,0,3,0.0,3,8,37.5,1,2,50.0,4,2,6,2,2,0,0,0,1,3
../kbl_data/2021-2022,S39G01N265,창원 LG,Away,사마르도 사무엘스,0,0,1,0.0,0,1,0.0,0,2,0.0,0,0,0.0,0,1,1,0,0,0,0,0,0,1
../kbl_data/2021-2022,S39G01N266,안양 KGC,Home,양희종,9,4,5,80.0,0,7,0.0,4,12,33.3,1,2,50.0,0,1,1,2,3,0,0,0,0,4
../kbl_data/2021-2022,S39G01N266,안양 KGC,Home,함준후,5,1,3,33.3,1,1,100.0,2,4,50.0,0,0,0.0,1,0,1,0,1,0,0,0,0,2
../kbl_data/2021-2022,S39G01N266,안양 KGC,Home,오세근,13,5,7,71.4,1,1,100.0,6,8,75.0,0,0,0.0,0,1,1,3,0,0,0,0,2,1
../kbl_data/2021-2022,S39G01N266,안양 KGC,Home,문성곤,13,2,2,100.0,3,7,42.9,5,9,55.6,0,0,0.0,1,3,4,1,0,1,0,0,0,0
../kbl_data/2021-2022,S39G01N266,안양 KGC,Home,전성현,17,1,1,100.0,5,10,50.0,6,11,54.5,0,0,0.0,0,2,2,0,0,0,0,0,1,0
../kbl_data/2021-2022,S39G01N266,안양 KGC,Home,박지훈,5,1,1,100.0,1,1,100.0,2,2,100.0,0,0,0.0,0,1,1,3,2,0,0,0,0,3
../kbl_data/2021-2022,S39G01N266,안양 KGC,Home,대릴 먼로,11,4,7,57.1,1,2,50.0,5,9,55.6,0,0,0.0,1,15,16,11,2,0,0,0,4,3
../kbl_data/2021-2022,S39G01N266,안양 KGC,Home,우동현,2,1,2,50.0,0,1,0.0,1,3,33.3,0,0,0.0,0,1,1,0,1,0,0,0,0,0
../kbl_data/2021-2022,S39G01N266,안양 KGC,Home,변준형,10,4,5,80.0,0,7,0.0,4,12,33.3,2,4,50.0,0,1,1,7,2,1,0,0,1,1
../kbl_data/2021-2022,S39G01N266,안양 KGC,Home,한승희,0,0,0,0.0,0,0,0.0,0,0,0.0,0,0,0.0,0,1,1,0,0,0,0,0,0,0
../kbl_data/2021-2022,S39G01N266,안양 KGC,Home,주현우,0,0,0,0.0,0,0,0.0,0,0,0.0,0,0,0.0,0,0,0,0,0,0,0,0,0,0
../kbl_data/2021-2022,S39G01N266,안양 KGC,Home,조은후,6,2,3,66.7,0,1,0.0,2,4,50.0,2,4,50.0,1,0,1,3,1,1,0,0,0,0
../kbl_data/2021-2022,S39G01N266,서울 SK,Away,양우섭,6,3,5,60.0,0,0,0.0,3,5,60.0,0,0,0.0,0,3,3,3,0,1,0,0,0,0
../kbl_data/2021-2022,S39G01N266,서울 SK,Away,허일영,9,2,4,50.0,1,3,33.3,3,7,42.9,2,2,100.0,1,3,4,0,0,0,0,0,2,0
../kbl_data/2021-2022,S39G01N266,서울 SK,Away,김선형,10,2,4,50.0,2,4,50.0,4,8,50.0,0,0,0.0,0,0,0,3,1,0,0,0,2,1
../kbl_data/2021-2022,S39G01N266,서울 SK,Away,최부경,2,1,4,25.0,0,2,0.0,1,6,16.7,0,0,0.0,0,5,5,2,1,0,0,0,2,2
../kbl_data/2021-2022,S39G01N266,서울 SK,Away,리온 윌리엄스,12,6,6,100.0,0,1,0.0,6,7,85.7,0,2,0.0,0,5,5,3,0,0,0,0,1,3
../kbl_data/2021-2022,S39G01N266,서울 SK,Away,배병준,2,1,3,33.3,0,3,0.0,1,6,16.7,0,0,0.0,1,0,1,0,0,0,0,0,1,3
../kbl_data/2021-2022,S39G01N266,서울 SK,Away,이현석,13,3,5,60.0,2,4,50.0,5,9,55.6,1,2,50.0,2,8,10,2,1,0,0,0,3,1
../kbl_data/2021-2022,S39G01N266,서울 SK,Away,최원혁,3,0,1,0.0,1,1,100.0,1,2,50.0,0,0,0.0,0,0,0,1,0,0,0,0,1,1
../kbl_data/2021-2022,S39G01N266,서울 SK,Away,최준용,5,2,4,50.0,0,2,0.0,2,6,33.3,1,2,50.0,2,2,4,3,0,2,0,1,0,0
../kbl_data/2021-2022,S39G01N266,서울 SK,Away,안영준,15,4,4,100.0,2,5,40.0,6,9,66.7,1,1,100.0,0,2,2,2,0,0,0,1,1,1
../kbl_data/2021-2022,S39G01N266,서울 SK,Away,오재현,0,0,1,0.0,0,0,0.0,0,1,0.0,0,0,0.0,0,1,1,0,1,0,0,0,0,2
../kbl_data/2021-2022,S39G01N266,서울 SK,Away,선상혁,7,2,3,66.7,0,0,0.0,2,3,66.7,3,4,75.0,2,5,7,1,0,0,0,0,4,0
../kbl_data/2021-2022,S39G01N267,원주 DB,Home,박찬희,0,0,2,0.0,0,0,0.0,0,2,0.0,0,0,0.0,0,0,0,3,0,0,0,0,0,0
../kbl_data/2021-2022,S39G01N267,원주 DB,Home,정준원,6,3,4,75.0,0,1,0.0,3,5,60.0,0,0,0.0,0,0,0,2,0,0,0,0,0,0
../kbl_data/2021-2022,S39G01N267,원주 DB,Home,김종규,20,4,5,80.0,3,4,75.0,7,9,77.8,3,4,75.0,0,7,7,2,0,0,0,2,3,3
../kbl_data/2021-2022,S39G01N267,원주 DB,Home,허웅,22,5,8,62.5,2,6,33.3,7,14,50.0,6,7,85.7,1,2,3,3,1,0,0,0,3,0
../kbl_data/2021-2022,S39G01N267,원주 DB,Home,김영훈,3,0,1,0.0,1,2,50.0,1,3,33.3,0,0,0.0,0,0,0,0,0,0,0,0,0,1
../kbl_data/2021-2022,S39G01N267,원주 DB,Home,강상재,16,7,9,77.8,0,1,0.0,7,10,70.0,2,2,100.0,5,6,11,2,2,0,0,0,1,2
../kbl_data/2021-2022,S39G01N267,원주 DB,Home,김철욱,2,1,1,100.0,0,1,0.0,1,2,50.0,0,0,0.0,1,0,1,0,0,0,0,0,0,0
../kbl_data/2021-2022,S39G01N267,원주 DB,Home,이용우,0,0,1,0.0,0,1,0.0,0,2,0.0,0,0,0.0,1,0,1,0,0,0,0,0,0,0
../kbl_data/2021-2022,S39G01N267,원주 DB,Home,이준희,4,2,4,50.0,0,1,0.0,2,5,40.0,0,0,0.0,1,3,4,3,1,0,0,0,1,3
../kbl_data/2021-2022,S39G01N267,원주 DB,Home,레나드 프리먼,4,1,2,50.0,0,0,0.0,1,2,50.0,2,2,100.0,0,0,0,0,1,0,0,0,0,0
../kbl_data/2021-2022,S39G01N267,원주 DB,Home,정호영,3,0,3,0.0,1,1,100.0,1,4,25.0,0,0,0.0,0,0,0,1,1,0,0,0,1,2
../kbl_data/2021-2022,S39G01N267,원주 DB,Home,조니 오브라이언트,20,7,8,87.5,2,3,66.7,9,11,81.8,0,0,0.0,1,9,10,3,1,1,0,0,2,2
../kbl_data/2021-2022,S39G01N267,창원 LG,Away,강병현,3,0,1,0.0,1,2,50.0,1,3,33.3,0,0,0.0,1,0,1,0,0,0,0,0,2,4
../kbl_data/2021-2022,S39G01N267,창원 LG,Away,이관희,7,2,5,40.0,1,6,16.7,3,11,27.3,0,0,0.0,0,4,4,5,1,0,0,0,1,1
../kbl_data/2021-2022,S39G01N267,창원 LG,Away,정희재,3,0,0,0.0,1,1,100.0,1,1,100.0,0,0,0.0,0,0,0,0,0,0,0,0,0,1
../kbl_data/2021-2022,S39G01N267,창원 LG,Away,서민수,0,0,0,0.0,0,1,0.0,0,1,0.0,0,0,0.0,0,0,0,0,0,1,0,0,0,1
../kbl_data/2021-2022,S39G01N267,창원 LG,Away,한상혁,2,1,1,100.0,0,0,0.0,1,1,100.0,0,0,0.0,0,0,0,1,0,0,0,0,0,0
../kbl_data/2021-2022,S39G01N267,창원 LG,Away,이재도,20,4,7,57.1,3,7,42.9,7,14,50.0,3,3,100.0,1,0,1,7,1,0,1,0,1,0
../kbl_data/2021-2022,S39G01N267,창원 LG,Away,박인태,16,2,3,66.7,4,6,66.7,6,9,66.7,0,0,0.0,0,1,1,2,0,0,1,1,0,1
../kbl_data/2021-2022,S39G01N267,창원 LG,Away,박정현,7,2,5,40.0,1,1,100.0,3,6,50.0,0,0,0.0,2,1,3,0,1,0,0,0,1,2
../kbl_data/2021-2022,S39G01N267,창원 LG,Away,윤원상,2,1,1,100.0,0,3,0.0,1,4,25.0,0,0,0.0,1,1,2,1,2,0,0,0,0,0
../kbl_data/2021-2022,S39G01N267,창원 LG,Away,아셈 마레이,17,7,14,50.0,1,3,33.3,8,17,47.1,0,0,0.0,2,6,8,0,1,1,0,0,2,3
../kbl_data/2021-2022,S39G01N267,창원 LG,Away,이승우,6,3,6,50.0,0,0,0.0,3,6,50.0,0,0,0.0,1,3,4,3,1,0,0,0,0,1
../kbl_data/2021-2022,S39G01N267,창원 LG,Away,사마르도 사무엘스,6,3,3,100.0,0,1,0.0,3,4,75.0,0,0,0.0,0,2,2,2,0,1,0,1,1,2
../kbl_data/2021-2022,S39G01N268,서울 삼성,Home,김동량,4,2,8,25.0,0,1,0.0,2,9,22.2,0,0,0.0,2,6,8,2,1,0,0,0,1,2
../kbl_data/2021-2022,S39G01N268,서울 삼성,Home,김시래,19,4,8,50.0,3,8,37.5,7,16,43.8,2,2,100.0,2,3,5,7,2,0,0,0,5,4
../kbl_data/2021-2022,S39G01N268,서울 삼성,Home,이동엽,10,5,7,71.4,0,0,0.0,5,7,71.4,0,0,0.0,1,2,3,2,0,0,0,0,1,1
../kbl_data/2021-2022,S39G01N268,서울 삼성,Home,배수용,0,0,1,0.0,0,2,0.0,0,3,0.0,0,0,0.0,0,0,0,1,0,0,0,0,0,0
../kbl_data/2021-2022,S39G01N268,서울 삼성,Home,이호현,10,2,6,33.3,1,2,50.0,3,8,37.5,3,4,75.0,1,3,4,2,2,0,0,0,3,0
../kbl_data/2021-2022,S39G01N268,서울 삼성,Home,정희원,3,0,0,0.0,1,2,50.0,1,2,50.0,0,0,0.0,1,0,1,0,0,0,0,0,0,1
../kbl_data/2021-2022,S39G01N268,서울 삼성,Home,강바일,1,0,1,0.0,0,2,0.0,0,3,0.0,1,2,50.0,0,1,1,1,0,0,0,0,1,2
../kbl_data/2021-2022,S39G01N268,서울 삼성,Home,박민우,0,0,1,0.0,0,1,0.0,0,2,0.0,0,0,0.0,0,1,1,1,0,0,0,0,0,1
../kbl_data/2021-2022,S39G01N268,서울 삼성,Home,차민석,0,0,1,0.0,0,2,0.0,0,3,0.0,0,0,0.0,2,0,2,0,0,0,0,0,1,0
../kbl_data/2021-2022,S39G01N268,서울 삼성,Home,전형준,6,0,2,0.0,2,6,33.3,2,8,25.0,0,0,0.0,1,1,2,1,1,0,0,0,0,2
../kbl_data/2021-2022,S39G01N268,서울 삼성,Home,조우성,10,5,7,71.4,0,0,0.0,5,7,71.4,0,1,0.0,3,5,8,0,1,0,0,0,1,5
../kbl_data/2021-2022,S39G01N268,서울 삼성,Home,이원석,9,4,7,57.1,0,1,0.0,4,8,50.0,1,2,50.0,2,0,2,1,0,0,0,1,0,2
../kbl_data/2021-2022,S39G01N268,고양 오리온,Away,오용준,6,0,0,0.0,2,5,40.0,2,5,40.0,0,0,0.0,0,2,2,1,0,0,0,0,1,1
../kbl_data/2021-2022,S39G01N268,고양 오리온,Away,김강선,8,1,1,100.0,2,2,100.0,3,3,100.0,0,0,0.0,0,2,2,0,1,0,0,0,0,0
../kbl_data/2021-2022,S39G01N268,고양 오리온,Away,최현민,9,0,0,0.0,3,6,50.0,3,6,50.0,0,0,0.0,0,2,2,1,2,0,0,0,1,0
../kbl_data/2021-2022,S39G01N268,고양 오리온,Away,이대성,23,8,12,66.7,0,0,0.0,8,12,66.7,7,8,87.5,0,3,3,2,0,1,0,0,0,2
../kbl_data/2021-2022,S39G01N268,고양 오리온,Away,한호빈,8,0,0,0.0,2,5,40.0,2,5,40.0,2,2,100.0,0,1,1,1,0,0,0,0,1,3
../kbl_data/2021-2022,S39G01N268,고양 오리온,Away,이정제,1,0,1,0.0,0,0,0.0,0,1,0.0,1,2,50.0,2,3,5,0,0,0,0,0,0,1
../kbl_data/2021-2022,S39G01N268,고양 오리온,Away,이승현,14,4,10,40.0,2,4,50.0,6,14,42.9,0,0,0.0,2,2,4,4,1,0,0,0,0,1
../kbl_data/2021-2022,S39G01N268,고양 오리온,Away,김진유,0,0,0,0.0,0,0,0.0,0,0,0.0,0,0,0.0,0,1,1,0,1,0,0,0,0,1
../kbl_data/2021-2022,S39G01N268,고양 오리온,Away,제임스 메이스,9,2,5,40.0,1,2,50.0,3,7,42.9,2,2,100.0,4,4,8,4,1,0,0,0,2,2
../kbl_data/2021-2022,S39G01N268,고양 오리온,Away,머피 할로웨이,16,6,6,100.0,0,0,0.0,6,6,100.0,4,7,57.1,1,7,8,5,4,1,0,1,3,1
../kbl_data/2021-2022,S39G01N268,고양 오리온,Away,김세창,2,1,1,100.0,0,1,0.0,1,2,50.0,0,0,0.0,0,0,0,2,0,0,0,0,0,1
../kbl_data/2021-2022,S39G01N268,고양 오리온,Away,이정현,5,2,2,100.0,0,3,0.0,2,5,40.0,1,2,50.0,0,3,3,2,0,2,0,0,1,3
../kbl_data/2021-2022,S39G01N269,울산 현대모비스,Home,이현민,2,1,1,100.0,0,3,0.0,1,4,25.0,0,0,0.0,0,2,2,3,0,0,0,0,2,1
../kbl_data/2021-2022,S39G01N269,울산 현대모비스,Home,함지훈,13,6,10,60.0,0,0,0.0,6,10,60.0,1,2,50.0,8,2,10,10,1,1,0,0,1,1
../kbl_data/2021-2022,S39G01N269,울산 현대모비스,Home,최진수,6,3,4,75.0,0,3,0.0,3,7,42.9,0,0,0.0,2,1,3,1,0,0,0,0,0,2
../kbl_data/2021-2022,S39G01N269,울산 현대모비스,Home,박지훈,3,1,2,50.0,0,0,0.0,1,2,50.0,1,3,33.3,0,2,2,1,0,0,1,0,0,1
../kbl_data/2021-2022,S39G01N269,울산 현대모비스,Home,장재석,2,1,3,33.3,0,0,0.0,1,3,33.3,0,0,0.0,2,6,8,2,0,0,0,0,0,3
../kbl_data/2021-2022,S39G01N269,울산 현대모비스,Home,김영현,0,0,0,0.0,0,4,0.0,0,4,0.0,0,0,0.0,3,1,4,2,0,0,0,0,1,4
../kbl_data/2021-2022,S39G01N269,울산 현대모비스,Home,김국찬,8,0,0,0.0,2,5,40.0,2,5,40.0,2,2,100.0,0,0,0,2,0,0,0,0,0,3
../kbl_data/2021-2022,S39G01N269,울산 현대모비스,Home,서명진,12,2,5,40.0,2,5,40.0,4,10,40.0,2,2,100.0,1,1,2,6,1,0,0,0,2,0
../kbl_data/2021-2022,S39G01N269,울산 현대모비스,Home,이우석,19,5,7,71.4,3,7,42.9,8,14,57.1,0,1,0.0,0,4,4,1,0,0,0,0,1,2
../kbl_data/2021-2022,S39G01N269,울산 현대모비스,Home,신민석,7,2,3,66.7,1,4,25.0,3,7,42.9,0,0,0.0,0,1,1,0,1,0,0,0,1,1
../kbl_data/2021-2022,S39G01N269,울산 현대모비스,Home,김동준,0,0,0,0.0,0,0,0.0,0,0,0.0,0,0,0.0,0,0,0,0,0,0,0,0,0,0
../kbl_data/2021-2022,S39G01N269,울산 현대모비스,Home,에릭 버크너,17,8,9,88.9,0,0,0.0,8,9,88.9,1,3,33.3,2,5,7,4,1,1,0,3,0,1
../kbl_data/2021-2022,S39G01N269,전주 KCC,Away,이정현,3,0,3,0.0,1,3,33.3,1,6,16.7,0,0,0.0,1,2,3,8,0,0,0,0,1,2
../kbl_data/2021-2022,S39G01N269,전주 KCC,Away,라건아,8,3,3,100.0,0,1,0.0,3,4,75.0,2,3,66.7,0,2,2,2,0,0,0,1,0,0
../kbl_data/2021-2022,S39G01N269,전주 KCC,Away,김지완,0,0,0,0.0,0,1,0.0,0,1,0.0,0,0,0.0,0,1,1,1,1,0,0,0,0,0
../kbl_data/2021-2022,S39G01N269,전주 KCC,Away,김상규,4,2,3,66.7,0,1,0.0,2,4,50.0,0,0,0.0,0,1,1,1,0,0,0,0,0,0
../kbl_data/2021-2022,S39G01N269,전주 KCC,Away,전준범,5,1,4,25.0,1,3,33.3,2,7,28.6,0,0,0.0,0,2,2,3,1,0,0,0,1,3
../kbl_data/2021-2022,S39G01N269,전주 KCC,Away,박재현,5,1,2,50.0,1,1,100.0,2,3,66.7,0,0,0.0,1,0,1,1,2,0,0,0,0,1
../kbl_data/2021-2022,S39G01N269,전주 KCC,Away,송교창,0,0,1,0.0,0,1,0.0,0,2,0.0,0,0,0.0,0,0,0,1,0,0,0,0,0,2
../kbl_data/2021-2022,S39G01N269,전주 KCC,Away,이진욱,2,1,1,100.0,0,0,0.0,1,1,100.0,0,0,0.0,1,0,1,1,0,0,0,0,1,0
../kbl_data/2021-2022,S39G01N269,전주 KCC,Away,라타비우스 윌리엄스,14,5,6,83.3,0,0,0.0,5,6,83.3,4,6,66.7,1,8,9,1,0,0,0,1,0,2
../kbl_data/2021-2022,S39G01N269,전주 KCC,Away,곽정훈,2,0,0,0.0,0,0,0.0,0,0,0.0,2,2,100.0,0,0,0,0,0,0,1,0,0,0
../kbl_data/2021-2022,S39G01N269,전주 KCC,Away,이근휘,16,1,3,33.3,4,9,44.4,5,12,41.7,2,2,100.0,1,1,2,1,1,0,0,0,3,2
../kbl_data/2021-2022,S39G01N269,전주 KCC,Away,서정현,11,5,10,50.0,0,0,0.0,5,10,50.0,1,4,25.0,1,3,4,1,0,2,1,0,2,3
../kbl_data/2021-2022,S39G01N270,대구 한국가스공사,Home,정영삼,7,1,2,50.0,1,1,100.0,2,3,66.7,2,2,100.0,2,1,3,0,0,0,0,0,0,1
../kbl_data/2021-2022,S39G01N270,대구 한국가스공사,Home,민성주,0,0,0,0.0,0,0,0.0,0,0,0.0,0,0,0.0,0,0,0,0,0,0,0,0,0,0
../kbl_data/2021-2022,S39G01N270,대구 한국가스공사,Home,홍경기,6,3,4,75.0,0,3,0.0,3,7,42.9,0,0,0.0,2,1,3,0,2,0,0,0,2,0
../kbl_data/2021-2022,S39G01N270,대구 한국가스공사,Home,조상열,0,0,0,0.0,0,0,0.0,0,0,0.0,0,0,0.0,0,0,0,0,0,0,0,0,0,1
../kbl_data/2021-2022,S39G01N270,대구 한국가스공사,Home,이대헌,12,6,8,75.0,0,0,0.0,6,8,75.0,0,0,0.0,1,6,7,4,0,0,1,0,2,0
../kbl_data/2021-2022,S39G01N270,대구 한국가스공사,Home,두경민,18,3,6,50.0,3,3,100.0,6,9,66.7,3,3,100.0,1,2,3,3,1,0,0,0,0,1
../kbl_data/2021-2022,S39G01N270,대구 한국가스공사,Home,전현우,13,6,8,75.0,0,7,0.0,6,15,40.0,1,1,100.0,1,4,5,1,1,0,0,0,0,4
../kbl_data/2021-2022,S39G01N270,대구 한국가스공사,Home,양준우,0,0,0,0.0,0,1,0.0,0,1,0.0,0,0,0.0,0,0,0,1,0,0,1,0,1,2
../kbl_data/2021-2022,S39G01N270,대구 한국가스공사,Home,이도헌,3,1,1,100.0,0,0,0.0,1,1,100.0,1,2,50.0,0,2,2,6,1,0,1,0,2,1
../kbl_data/2021-2022,S39G01N270,대구 한국가스공사,Home,앤드류 니콜슨,16,5,13,38.5,1,8,12.5,6,21,28.6,3,4,75.0,5,4,9,0,0,0,0,0,0,0
../kbl_data/2021-2022,S39G01N270,대구 한국가스공사,Home,신승민,6,3,6,50.0,0,1,0.0,3,7,42.9,0,0,0.0,2,1,3,1,1,0,1,0,1,1
../kbl_data/2021-2022,S39G01N270,대구 한국가스공사,Home,디제이 화이트,2,1,4,25.0,0,0,0.0,1,4,25.0,0,0,0.0,0,7,7,1,0,0,0,0,2,1
../kbl_data/2021-2022,S39G01N270,수원 KT,Away,김현민,12,3,4,75.0,2,5,40.0,5,9,55.6,0,0,0.0,0,5,5,0,1,0,0,0,1,3
../kbl_data/2021-2022,S39G01N270,수원 KT,Away,한희원,24,5,5,100.0,4,5,80.0,9,10,90.0,2,3,66.7,0,3,3,0,0,0,0,0,3,3
../kbl_data/2021-2022,S39G01N270,수원 KT,Away,최창진,11,4,5,80.0,0,4,0.0,4,9,44.4,3,3,100.0,1,2,3,3,2,0,0,0,4,3
../kbl_data/2021-2022,S39G01N270,수원 KT,Away,정성우,7,2,2,100.0,0,0,0.0,2,2,100.0,3,3,100.0,0,0,0,2,2,0,0,0,0,0
../kbl_data/2021-2022,S39G01N270,수원 KT,Away,최성모,2,1,3,33.3,0,3,0.0,1,6,16.7,0,0,0.0,0,3,3,3,0,0,0,0,0,2
../kbl_data/2021-2022,S39G01N270,수원 KT,Away,양홍석,2,1,2,50.0,0,1,0.0,1,3,33.3,0,0,0.0,0,4,4,4,2,0,0,0,1,0
../kbl_data/2021-2022,S39G01N270,수원 KT,Away,박준영,3,1,3,33.3,0,3,0.0,1,6,16.7,1,2,50.0,1,1,2,1,1,0,0,0,1,3
../kbl_data/2021-2022,S39G01N270,수원 KT,Away,캐디 라렌,0,0,0,0.0,0,0,0.0,0,0,0.0,0,0,0.0,0,0,0,0,0,0,0,0,0,0
../kbl_data/2021-2022,S39G01N270,수원 KT,Away,문상옥,2,1,3,33.3,0,1,0.0,1,4,25.0,0,0,0.0,0,0,0,0,0,0,0,0,0,0
../kbl_data/2021-2022,S39G01N270,수원 KT,Away,박지원,5,1,4,25.0,1,2,50.0,2,6,33.3,0,0,0.0,1,4,5,1,0,0,0,0,1,1
../kbl_data/2021-2022,S39G01N270,수원 KT,Away,마이크 마이어스,11,5,9,55.6,0,0,0.0,5,9,55.6,1,1,100.0,1,3,4,2,1,0,0,3,1,0
../kbl_data/2021-2022,S39G01N270,수원 KT,Away,김준환,2,1,1,100.0,0,1,0.0,1,2,50.0,0,0,0.0,1,2,3,1,0,0,0,0,1,2
../kbl_data/2022-2023,S41G01N1,서울 SK,Home,허일영,9,3,4,75.0,1,3,33.3,4,7,57.1,0,0,0.0,0,4,4,1,1,0,0,0,0,2
../kbl_data/2022-2023,S41G01N1,서울 SK,Home,김선형,18,5,10,50.0,2,6,33.3,7,16,43.8,2,4,50.0,1,1,2,7,3,0,0,0,5,3
../kbl_data/2022-2023,S41G01N1,서울 SK,Home,홍경기,7,1,1,100.0,1,2,50.0,2,3,66.7,2,3,66.7,0,0,0,1,0,0,1,0,0,0
../kbl_data/2022-2023,S41G01N1,서울 SK,Home,최부경,4,2,6,33.3,0,0,0.0,2,6,33.3,0,0,0.0,2,6,8,0,4,0,0,0,0,3
../kbl_data/2022-2023,S41G01N1,서울 SK,Home,김건우,0,0,0,0.0,0,0,0.0,0,0,0.0,0,0,0.0,0,0,0,0,0,0,0,0,0,0
../kbl_data/2022-2023,S41G01N1,서울 SK,Home,김승원,1,0,0,0.0,0,0,0.0,0,0,0.0,1,2,50.0,0,0,0,0,1,0,0,0,0,2
../kbl_data/2022-2023,S41G01N1,서울 SK,Home,리온 윌리엄스,4,1,1,100.0,0,1,0.0,1,2,50.0,2,2,100.0,0,1,1,0,0,0,0,0,0,3
../kbl_data/2022-2023,S41G01N1,서울 SK,Home,장문호,0,0,0,0.0,0,1,0.0,0,1,0.0,0,0,0.0,0,1,1,0,0,0,0,0,0,0
../kbl_data/2022-2023,S41G01N1,서울 SK,Home,자밀 워니,23,8,18,44.4,2,4,50.0,10,22,45.5,1,3,33.3,2,11,13,3,1,1,0,1,2,3
../kbl_data/2022-2023,S41G01N1,서울 SK,Home,김형빈,0,0,0,0.0,0,0,0.0,0,0,0.0,0,0,0.0,0,0,0,0,0,0,0,0,0,0
../kbl_data/2022-2023,S41G01N1,서울 SK,Home,오재현,9,1,3,33.3,2,7,28.6,3,10,30.0,1,2,50.0,2,3,5,2,1,0,0,0,4,4
../kbl_data/2022-2023,S41G01N1,서울 SK,Home,김수환,0,0,0,0.0,0,0,0.0,0,0,0.0,0,0,0.0,0,0,0,0,0,0,0,0,0,0
../kbl_data/2022-2023,S41G01N1,안양 KGC,Away,양희종,0,0,0,0.0,0,0,0.0,0,0,0.0,0,0,0.0,0,4,4,0,0,0,0,0,1,1
../kbl_data/2022-2023,S41G01N1,안양 KGC,Away,오세근,17,7,13,53.8,0,0,0.0,7,13,53.8,3,4,75.0,0,4,4,6,0,0,0,0,1,2
../kbl_data/2022-2023,S41G01N1,안양 KGC,Away,정준원,0,0,1,0.0,0,1,0.0,0,2,0.0,0,0,0.0,0,0,0,1,0,0,0,0,0,0
../kbl_data/2022-2023,S41G01N1,안양 KGC,Away,배병준,13,3,4,75.0,2,3,66.7,5,7,71.4,1,2,50.0,0,4,4,3,1,0,0,0,1,4
../kbl_data/2022-2023,S41G01N1,안양 KGC,Away,문성곤,17,2,3,66.7,4,6,66.7,6,9,66.7,1,2,50.0,3,2,5,1,2,0,0,0,2,2
../kbl_data/2022-2023,S41G01N1,안양 KGC,Away,김철욱,0,0,0,0.0,0,0,0.0,0,0,0.0,0,0,0.0,0,0,0,0,0,0,0,0,0,0
../kbl_data/2022-2023,S41G01N1,안양 KGC,Away,박지훈,2,1,2,50.0,0,1,0.0,1,3,33.3,0,0,0.0,0,1,1,1,2,0,0,0,2,1
../kbl_data/2022-2023,S41G01N1,안양 KGC,Away,이우정,0,0,0,0.0,0,0,0.0,0,0,0.0,0,0,0.0,0,0,0,0,0,0,0,0,0,0
../kbl_data/2022-2023,S41G01N1,안양 KGC,Away,대릴 먼로,1,0,1,0.0,0,0,0.0,0,1,0.0,1,2,50.0,0,2,2,1,0,0,0,0,0,1
../kbl_data/2022-2023,S41G01N1,안양 KGC,Away,변준형,11,2,4,50.0,2,5,40.0,4,9,44.4,1,2,50.0,2,2,4,8,1,0,0,0,4,2
../kbl_data/2022-2023,S41G01N1,안양 KGC,Away,한승희,0,0,1,0.0,0,0,0.0,0,1,0.0,0,0,0.0,1,1,2,0,0,0,0,0,0,3
../kbl_data/2022-2023,S41G01N1,안양 KGC,Away,오마리 스펠맨,27,7,12,58.3,2,8,25.0,9,20,45.0,7,8,87.5,2,12,14,3,1,1,0,0,3,1
../kbl_data/2022-2023,S41G01N2,수원 KT,Home,김동욱,0,0,0,0.0,0,0,0.0,0,0,0.0,0,0,0.0,0,0,0,0,0,0,0,0,0,0
../kbl_data/2022-2023,S41G01N2,수원 KT,Home,김영환,3,1,2,50.0,0,1,0.0,1,3,33.3,1,1,100.0,1,1,2,3,0,0,1,0,0,1
../kbl_data/2022-2023,S41G01N2,수원 KT,Home,김민욱,10,2,3,66.7,2,6,33.3,4,9,44.4,0,0,0.0,1,4,5,0,0,2,0,0,0,0
../kbl_data/2022-2023,S41G01N2,수원 KT,Home,최창진,4,1,1,100.0,0,3,0.0,1,4,25.0,2,4,50.0,0,1,1,2,0,0,0,0,1,2
../kbl_data/2022-2023,S41G01N2,수원 KT,Home,이현석,0,0,0,0.0,0,0,0.0,0,0,0.0,0,0,0.0,0,1,1,0,0,0,0,0,1,1
../kbl_data/2022-2023,S41G01N2,수원 KT,Home,정성우,8,2,5,40.0,0,0,0.0,2,5,40.0,4,5,80.0,0,2,2,2,3,0,0,0,3,2
../kbl_data/2022-2023,S41G01N2,수원 KT,Home,최성모,5,1,2,50.0,1,2,50.0,2,4,50.0,0,0,0.0,0,1,1,0,1,0,0,0,0,2
../kbl_data/2022-2023,S41G01N2,수원 KT,Home,양홍석,14,3,6,50.0,2,7,28.6,5,13,38.5,2,2,100.0,0,6,6,3,1,0,0,0,0,1
../kbl_data/2022-2023,S41G01N2,수원 KT,Home,박지원,2,1,2,50.0,0,1,0.0,1,3,33.3,0,0,0.0,1,0,1,1,0,0,0,0,1,0
../kbl_data/2022-2023,S41G01N2,수원 KT,Home,하윤기,4,2,8,25.0,0,0,0.0,2,8,25.0,0,0,0.0,2,3,5,0,0,0,0,0,0,3
../kbl_data/2022-2023,S41G01N2,수원 KT,Home,이제이 아노시케,20,9,18,50.0,0,2,0.0,9,20,45.0,2,4,50.0,5,4,9,1,0,0,0,1,2,1
../kbl_data/2022-2023,S41G01N2,수원 KT,Home,랜드리 은노코,6,3,6,50.0,0,0,0.0,3,6,50.0,0,0,0.0,4,2,6,0,0,0,0,1,2,4
../kbl_data/2022-2023,S41G01N2,울산 현대모비스,Away,함지훈,6,1,2,50.0,0,1,0.0,1,3,33.3,4,4,100.0,1,2,3,1,0,1,0,0,0,3
../kbl_data/2022-2023,S41G01N2,울산 현대모비스,Away,김현민,3,0,0,0.0,1,2,50.0,1,2,50.0,0,0,0.0,0,0,0,0,0,0,0,0,0,0
../kbl_data/2022-2023,S41G01N2,울산 현대모비스,Away,장재석,12,3,5,60.0,0,0,0.0,3,5,60.0,6,8,75.0,2,1,3,0,0,0,0,0,0,1
../kbl_data/2022-2023,S41G01N2,울산 현대모비스,Away,김영현,5,1,2,50.0,1,3,33.3,2,5,40.0,0,0,0.0,0,1,1,0,0,1,0,0,0,3
../kbl_data/2022-2023,S41G01N2,울산 현대모비스,Away,김국찬,6,0,1,0.0,2,2,100.0,2,3,66.7,0,0,0.0,0,3,3,1,0,0,0,0,0,4
../kbl_data/2022-2023,S41G01N2,울산 현대모비스,Away,서명진,4,2,3,66.7,0,0,0.0,2,3,66.7,0,0,0.0,1,0,1,1,2,0,0,0,0,1
../kbl_data/2022-2023,S41G01N2,울산 현대모비스,Away,저스틴 녹스,10,5,5,100.0,0,2,0.0,5,7,71.4,0,1,0.0,2,3,5,0,0,1,0,1,2,1
../kbl_data/2022-2023,S41G01N2,울산 현대모비스,Away,이우석,6,3,7,42.9,0,2,0.0,3,9,33.3,0,0,0.0,2,2,4,3,1,0,0,0,3,2
../kbl_data/2022-2023,S41G01N2,울산 현대모비스,Away,신민석,0,0,0,0.0,0,0,0.0,0,0,0.0,0,0,0.0,0,0,0,0,0,0,0,0,0,0
../kbl_data/2022-2023,S41G01N2,울산 현대모비스,Away,김동준,3,0,3,0.0,1,3,33.3,1,6,16.7,0,0,0.0,0,1,1,3,0,0,0,0,3,2
../kbl_data/2022-2023,S41G01N2,울산 현대모비스,Away,론제이 아바리엔토스,13,2,4,50.0,3,11,27.3,5,15,33.3,0,0,0.0,0,7,7,7,1,0,1,0,0,2
../kbl_data/2022-2023,S41G01N2,울산 현대모비스,Away,게이지 프림,17,8,12,66.7,0,0,0.0,8,12,66.7,1,1,100.0,5,8,13,0,2,0,0,2,3,1
../kbl_data/2022-2023,S41G01N3,고양 캐롯,Home,김강선,0,0,0,0.0,0,1,0.0,0,1,0.0,0,0,0.0,1,0,1,0,1,0,0,0,0,2
../kbl_data/2022-2023,S41G01N3,고양 캐롯,Home,데이비드 사이먼,15,5,9,55.6,1,2,50.0,6,11,54.5,2,4,50.0,1,6,7,1,0,1,0,0,1,1
../kbl_data/2022-2023,S41G01N3,고양 캐롯,Home,최현민,3,1,2,50.0,0,0,0.0,1,2,50.0,1,2,50.0,1,1,2,0,0,0,0,0,0,2
../kbl_data/2022-2023,S41G01N3,고양 캐롯,Home,한호빈,15,1,2,50.0,3,4,75.0,4,6,66.7,4,4,100.0,2,1,3,5,0,0,0,0,0,5
../kbl_data/2022-2023,S41G01N3,고양 캐롯,Home,전성현,23,6,9,66.7,3,11,27.3,9,20,45.0,2,3,66.7,0,0,0,0,3,0,0,0,3,1
../kbl_data/2022-2023,S41G01N3,고양 캐롯,Home,이종현,4,2,3,66.7,0,0,0.0,2,3,66.7,0,0,0.0,2,6,8,3,0,2,0,0,2,2
../kbl_data/2022-2023,S41G01N3,고양 캐롯,Home,정해원,0,0,0,0.0,0,0,0.0,0,0,0.0,0,0,0.0,0,0,0,0,0,0,0,0,0,0
../kbl_data/2022-2023,S41G01N3,고양 캐롯,Home,조한진,0,0,0,0.0,0,1,0.0,0,1,0.0,0,0,0.0,0,0,0,0,0,0,0,0,0,2
../kbl_data/2022-2023,S41G01N3,고양 캐롯,Home,디드릭 로슨,17,5,7,71.4,1,6,16.7,6,13,46.2,4,6,66.7,3,9,12,1,1,1,0,0,1,2
../kbl_data/2022-2023,S41G01N3,고양 캐롯,Home,박진철,0,0,0,0.0,0,0,0.0,0,0,0.0,0,0,0.0,0,0,0,0,0,0,0,0,0,0
../kbl_data/2022-2023,S41G01N3,고양 캐롯,Home,이정현,10,2,10,20.0,2,7,28.6,4,17,23.5,0,0,0.0,1,3,4,5,5,0,1,0,0,1
../kbl_data/2022-2023,S41G01N3,고양 캐롯,Home,조재우,0,0,0,0.0,0,0,0.0,0,0,0.0,0,0,0.0,0,0,0,0,0,0,0,0,0,0
../kbl_data/2022-2023,S41G01N3,원주 DB,Away,윤호영,0,0,0,0.0,0,0,0.0,0,0,0.0,0,0,0.0,0,0,0,0,0,0,0,0,0,0
../kbl_data/2022-2023,S41G01N3,원주 DB,Away,김현호,9,0,1,0.0,3,3,100.0,3,4,75.0,0,0,0.0,1,2,3,2,1,0,0,0,0,3
../kbl_data/2022-2023,S41G01N3,원주 DB,Away,김종규,16,4,5,80.0,2,3,66.7,6,8,75.0,2,2,100.0,1,9,10,2,0,0,0,2,3,4
../kbl_data/2022-2023,S41G01N3,원주 DB,Away,최승욱,4,1,1,100.0,0,1,0.0,1,2,50.0,2,2,100.0,3,2,5,1,0,0,0,0,0,4
../kbl_data/2022-2023,S41G01N3,원주 DB,Away,강상재,2,1,2,50.0,0,2,0.0,1,4,25.0,0,0,0.0,0,1,1,0,0,1,0,0,0,1
../kbl_data/2022-2023,S41G01N3,원주 DB,Away,원종훈,0,0,0,0.0,0,0,0.0,0,0,0.0,0,0,0.0,0,0,0,0,0,0,0,0,0,0
../kbl_data/2022-2023,S41G01N3,원주 DB,Away,이준희,0,0,1,0.0,0,4,0.0,0,5,0.0,0,0,0.0,1,2,3,1,0,0,0,0,0,2
../kbl_data/2022-2023,S41G01N3,원주 DB,Away,레나드 프리먼,6,1,5,20.0,0,0,0.0,1,5,20.0,4,4,100.0,2,1,3,0,0,0,0,1,2,2
../kbl_data/2022-2023,S41G01N3,원주 DB,Away,정호영,0,0,2,0.0,0,1,0.0,0,3,0.0,0,0,0.0,0,0,0,0,0,0,0,0,1,1
../kbl_data/2022-2023,S41G01N3,원주 DB,Away,이선 알바노,18,7,9,77.8,1,6,16.7,8,15,53.3,1,2,50.0,0,4,4,10,1,2,1,0,4,2
../kbl_data/2022-2023,S41G01N3,원주 DB,Away,드완 에르난데스,16,6,17,35.3,0,1,0.0,6,18,33.3,4,7,57.1,3,6,9,1,1,0,0,3,2,1
../kbl_data/2022-2023,S41G01N3,원주 DB,Away,박인웅,9,1,2,50.0,2,4,50.0,3,6,50.0,1,2,50.0,2,4,6,1,0,0,0,0,1,1
../kbl_data/2022-2023,S41G01N4,창원 LG,Home,이관희,5,1,4,25.0,1,4,25.0,2,8,25.0,0,0,0.0,0,1,1,1,1,0,0,0,2,1
../kbl_data/2022-2023,S41G01N4,창원 LG,Home,정희재,0,0,0,0.0,0,1,0.0,0,1,0.0,0,0,0.0,1,0,1,0,0,0,0,0,1,0
../kbl_data/2022-2023,S41G01N4,창원 LG,Home,서민수,5,1,4,25.0,1,3,33.3,2,7,28.6,0,0,0.0,0,1,1,3,1,0,1,0,0,3
../kbl_data/2022-2023,S41G01N4,창원 LG,Home,한상혁,4,2,2,100.0,0,1,0.0,2,3,66.7,0,0,0.0,0,1,1,0,1,0,0,0,0,4
../kbl_data/2022-2023,S41G01N4,창원 LG,Home,이재도,4,2,6,33.3,0,6,0.0,2,12,16.7,0,0,0.0,4,3,7,7,0,0,1,0,1,4
../kbl_data/2022-2023,S41G01N4,창원 LG,Home,김준일,2,1,4,25.0,0,0,0.0,1,4,25.0,0,0,0.0,0,1,1,0,0,1,0,0,1,0
../kbl_data/2022-2023,S41G01N4,창원 LG,Home,박인태,0,0,0,0.0,0,0,0.0,0,0,0.0,0,0,0.0,0,0,0,0,0,0,0,0,0,0
../kbl_data/2022-2023,S41G01N4,창원 LG,Home,정인덕,0,0,0,0.0,0,0,0.0,0,0,0.0,0,0,0.0,0,0,0,0,0,0,0,0,0,0
../kbl_data/2022-2023,S41G01N4,창원 LG,Home,윤원상,2,0,3,0.0,0,4,0.0,0,7,0.0,2,2,100.0,1,1,2,1,0,0,0,0,1,0
../kbl_data/2022-2023,S41G01N4,창원 LG,Home,아셈 마레이,21,9,11,81.8,0,0,0.0,9,11,81.8,3,8,37.5,3,9,12,1,4,0,0,1,6,5
../kbl_data/2022-2023,S41G01N4,창원 LG,Home,이승우,13,5,9,55.6,1,2,50.0,6,11,54.5,0,0,0.0,3,2,5,4,6,0,1,0,2,1
../kbl_data/2022-2023,S41G01N4,창원 LG,Home,단테 커닝햄,6,3,6,50.0,0,0,0.0,3,6,50.0,0,0,0.0,1,3,4,1,0,2,0,0,2,1
../kbl_data/2022-2023,S41G01N4,서울 삼성,Away,이정현,4,0,8,0.0,0,3,0.0,0,11,0.0,4,4,100.0,1,2,3,4,1,1,0,0,2,2
../kbl_data/2022-2023,S41G01N4,서울 삼성,Away,장민국,12,2,3,66.7,2,2,100.0,4,5,80.0,2,2,100.0,0,2,2,0,2,0,0,0,2,2
../kbl_data/2022-2023,S41G01N4,서울 삼성,Away,김시래,11,3,6,50.0,1,3,33.3,4,9,44.4,2,2,100.0,1,1,2,2,1,0,1,0,2,2
../kbl_data/2022-2023,S41G01N4,서울 삼성,Away,김현수,0,0,0,0.0,0,0,0.0,0,0,0.0,0,0,0.0,0,0,0,0,0,0,0,0,0,0
../kbl_data/2022-2023,S41G01N4,서울 삼성,Away,임동섭,7,2,2,100.0,1,2,50.0,3,4,75.0,0,0,0.0,4,2,6,2,0,0,0,0,2,4
../kbl_data/2022-2023,S41G01N4,서울 삼성,Away,이동엽,0,0,2,0.0,0,1,0.0,0,3,0.0,0,0,0.0,1,2,3,0,0,0,0,0,5,2
../kbl_data/2022-2023,S41G01N4,서울 삼성,Away,이호현,2,1,2,50.0,0,0,0.0,1,2,50.0,0,0,0.0,0,1,1,1,0,0,0,0,1,0
../kbl_data/2022-2023,S41G01N4,서울 삼성,Away,마커스 데릭슨,9,3,5,60.0,0,1,0.0,3,6,50.0,3,4,75.0,2,4,6,1,1,0,0,0,3,2
../kbl_data/2022-2023,S41G01N4,서울 삼성,Away,조우성,0,0,0,0.0,0,0,0.0,0,0,0.0,0,0,0.0,0,0,0,0,0,0,0,0,0,0
../kbl_data/2022-2023,S41G01N4,서울 삼성,Away,이원석,8,3,8,37.5,0,0,0.0,3,8,37.5,2,2,100.0,0,6,6,0,2,1,0,0,2,2
../kbl_data/2022-2023,S41G01N4,서울 삼성,Away,이매뉴얼 테리,12,6,10,60.0,0,0,0.0,6,10,60.0,0,1,0.0,3,8,11,1,2,1,0,0,3,5
../kbl_data/2022-2023,S41G01N4,서울 삼성,Away,신동혁,0,0,0,0.0,0,1,0.0,0,1,0.0,0,0,0.0,0,0,0,1,0,0,0,0,0,1
../kbl_data/2022-2023,S41G01N5,대구 한국가스공사,Home,박지훈,0,0,1,0.0,0,2,0.0,0,3,0.0,0,0,0.0,0,1,1,0,0,0,0,0,0,2
../kbl_data/2022-2023,S41G01N5,대구 한국가스공사,Home,조상열,0,0,0,0.0,0,0,0.0,0,0,0.0,0,0,0.0,0,0,0,0,0,0,0,0,0,0
../kbl_data/2022-2023,S41G01N5,대구 한국가스공사,Home,이원대,2,1,3,33.3,0,2,0.0,1,5,20.0,0,0,0.0,0,1,1,4,2,0,0,0,1,1
../kbl_data/2022-2023,S41G01N5,대구 한국가스공사,Home,이대헌,8,4,5,80.0,0,1,0.0,4,6,66.7,0,0,0.0,2,1,3,2,0,0,0,0,0,3
../kbl_data/2022-2023,S41G01N5,대구 한국가스공사,Home,이대성,25,11,15,73.3,0,3,0.0,11,18,61.1,3,3,100.0,1,2,3,2,4,0,0,0,4,1
../kbl_data/2022-2023,S41G01N5,대구 한국가스공사,Home,정효근,4,1,3,33.3,0,3,0.0,1,6,16.7,2,2,100.0,0,1,1,3,1,0,0,0,1,2
../kbl_data/2022-2023,S41G01N5,대구 한국가스공사,Home,머피 할로웨이,6,3,4,75.0,0,0,0.0,3,4,75.0,0,2,0.0,0,1,1,0,0,0,0,0,1,0
../kbl_data/2022-2023,S41G01N5,대구 한국가스공사,Home,우동현,0,0,0,0.0,0,0,0.0,0,0,0.0,0,0,0.0,0,0,0,1,1,0,0,0,1,3
../kbl_data/2022-2023,S41G01N5,대구 한국가스공사,Home,전현우,0,0,1,0.0,0,4,0.0,0,5,0.0,0,0,0.0,3,0,3,0,1,0,0,0,0,0
../kbl_data/2022-2023,S41G01N5,대구 한국가스공사,Home,신승민,4,1,2,50.0,0,1,0.0,1,3,33.3,2,2,100.0,1,2,3,1,1,0,0,0,0,4
../kbl_data/2022-2023,S41G01N5,대구 한국가스공사,Home,샘조세프 벨란겔,10,1,3,33.3,2,4,50.0,3,7,42.9,2,2,100.0,0,2,2,2,0,0,1,0,0,2
../kbl_data/2022-2023,S41G01N5,대구 한국가스공사,Home,유슈 은도예,13,6,8,75.0,0,0,0.0,6,8,75.0,1,2,50.0,1,5,6,0,1,1,0,0,2,2
../kbl_data/2022-2023,S41G01N5,전주 KCC,Away,정창영,6,3,7,42.9,0,1,0.0,3,8,37.5,0,0,0.0,2,2,4,6,2,0,0,0,1,3
../kbl_data/2022-2023,S41G01N5,전주 KCC,Away,라건아,18,8,10,80.0,0,2,0.0,8,12,66.7,2,3,66.7,4,8,12,4,3,1,0,2,4,4
../kbl_data/2022-2023,S41G01N5,전주 KCC,Away,박경상,12,3,4,75.0,2,4,50.0,5,8,62.5,0,0,0.0,0,1,1,0,1,0,0,0,3,1
../kbl_data/2022-2023,S41G01N5,전주 KCC,Away,김지완,17,3,4,75.0,3,4,75.0,6,8,75.0,2,3,66.7,0,1,1,1,0,0,0,0,1,2
../kbl_data/2022-2023,S41G01N5,전주 KCC,Away,김상규,0,0,0,0.0,0,0,0.0,0,0,0.0,0,0,0.0,0,1,1,0,0,0,0,0,1,1
../kbl_data/2022-2023,S41G01N5,전주 KCC,Away,허웅,19,1,3,33.3,3,6,50.0,4,9,44.4,8,8,100.0,0,4,4,2,0,0,0,0,4,2
../kbl_data/2022-2023,S41G01N5,전주 KCC,Away,이승현,9,3,4,75.0,1,1,100.0,4,5,80.0,0,0,0.0,1,3,4,5,2,1,0,0,2,3
../kbl_data/2022-2023,S41G01N5,전주 KCC,Away,이진욱,0,0,0,0.0,0,0,0.0,0,0,0.0,0,0,0.0,0,0,0,0,0,0,0,0,1,1
../kbl_data/2022-2023,S41G01N5,전주 KCC,Away,이근휘,0,0,0,0.0,0,3,0.0,0,3,0.0,0,0,0.0,0,0,0,0,0,0,0,0,0,0
../kbl_data/2022-2023,S41G01N5,전주 KCC,Away,김동현,0,0,0,0.0,0,0,0.0,0,0,0.0,0,0,0.0,0,0,0,0,0,0,0,0,0,0
../kbl_data/2022-2023,S41G01N5,전주 KCC,Away,서정현,0,0,0,0.0,0,0,0.0,0,0,0.0,0,0,0.0,0,0,0,0,0,0,0,0,0,0
../kbl_data/2022-2023,S41G01N5,전주 KCC,Away,론데 홀리스 제퍼슨,0,0,2,0.0,0,0,0.0,0,2,0.0,0,0,0.0,1,2,3,0,0,0,0,0,0,1
../kbl_data/2022-2023,S41G01N6,안양 KGC,Home,양희종,0,0,0,0.0,0,4,0.0,0,4,0.0,0,0,0.0,0,0,0,0,0,0,0,0,0,2
../kbl_data/2022-2023,S41G01N6,안양 KGC,Home,오세근,9,3,6,50.0,0,1,0.0,3,7,42.9,3,4,75.0,3,7,10,3,1,0,0,0,1,0
../kbl_data/2022-2023,S41G01N6,안양 KGC,Home,정준원,0,0,0,0.0,0,0,0.0,0,0,0.0,0,0,0.0,0,0,0,0,0,0,0,0,0,0
../kbl_data/2022-2023,S41G01N6,안양 KGC,Home,배병준,13,2,4,50.0,3,8,37.5,5,12,41.7,0,0,0.0,1,4,5,1,0,0,0,0,1,1
../kbl_data/2022-2023,S41G01N6,안양 KGC,Home,문성곤,6,1,5,20.0,1,5,20.0,2,10,20.0,1,2,50.0,4,4,8,4,0,0,0,0,2,2
../kbl_data/2022-2023,S41G01N6,안양 KGC,Home,김철욱,0,0,0,0.0,0,0,0.0,0,0,0.0,0,0,0.0,0,0,0,0,0,0,0,0,0,0
../kbl_data/2022-2023,S41G01N6,안양 KGC,Home,박지훈,12,1,3,33.3,3,8,37.5,4,11,36.4,1,2,50.0,1,0,1,3,1,1,0,0,1,3
../kbl_data/2022-2023,S41G01N6,안양 KGC,Home,이우정,0,0,0,0.0,0,0,0.0,0,0,0.0,0,0,0.0,0,0,0,0,0,0,0,0,0,0
../kbl_data/2022-2023,S41G01N6,안양 KGC,Home,대릴 먼로,3,0,1,0.0,1,1,100.0,1,2,50.0,0,0,0.0,0,7,7,2,0,0,0,0,1,0
../kbl_data/2022-2023,S41G01N6,안양 KGC,Home,변준형,7,2,2,100.0,1,3,33.3,3,5,60.0,0,0,0.0,0,3,3,6,1,0,0,0,2,4
../kbl_data/2022-2023,S41G01N6,안양 KGC,Home,한승희,4,2,3,66.7,0,0,0.0,2,3,66.7,0,0,0.0,1,5,6,0,0,0,0,0,0,2
../kbl_data/2022-2023,S41G01N6,안양 KGC,Home,오마리 스펠맨,19,4,6,66.7,3,6,50.0,7,12,58.3,2,2,100.0,0,6,6,4,1,2,0,2,1,3
../kbl_data/2022-2023,S41G01N6,고양 캐롯,Away,김강선,0,0,0,0.0,0,1,0.0,0,1,0.0,0,0,0.0,0,2,2,1,0,0,0,0,0,1
../kbl_data/2022-2023,S41G01N6,고양 캐롯,Away,데이비드 사이먼,9,4,9,44.4,0,1,0.0,4,10,40.0,1,2,50.0,1,5,6,1,0,1,0,0,0,0
../kbl_data/2022-2023,S41G01N6,고양 캐롯,Away,최현민,10,2,3,66.7,2,3,66.7,4,6,66.7,0,0,0.0,6,1,7,1,1,0,0,0,0,2
../kbl_data/2022-2023,S41G01N6,고양 캐롯,Away,한호빈,5,1,4,25.0,1,5,20.0,2,9,22.2,0,0,0.0,1,1,2,5,1,0,0,0,1,1
../kbl_data/2022-2023,S41G01N6,고양 캐롯,Away,전성현,7,1,5,20.0,1,3,33.3,2,8,25.0,2,3,66.7,0,1,1,1,0,0,0,0,2,2
../kbl_data/2022-2023,S41G01N6,고양 캐롯,Away,이종현,2,1,1,100.0,0,0,0.0,1,1,100.0,0,2,0.0,0,1,1,0,0,0,0,0,0,1
../kbl_data/2022-2023,S41G01N6,고양 캐롯,Away,정해원,0,0,0,0.0,0,2,0.0,0,2,0.0,0,0,0.0,0,1,1,0,0,0,0,0,0,1
../kbl_data/2022-2023,S41G01N6,고양 캐롯,Away,조한진,0,0,0,0.0,0,1,0.0,0,1,0.0,0,0,0.0,0,0,0,0,0,0,0,0,1,1
../kbl_data/2022-2023,S41G01N6,고양 캐롯,Away,디드릭 로슨,20,8,15,53.3,1,8,12.5,9,23,39.1,1,2,50.0,2,8,10,2,0,0,0,2,0,1
../kbl_data/2022-2023,S41G01N6,고양 캐롯,Away,박진철,2,0,0,0.0,0,0,0.0,0,0,0.0,2,2,100.0,0,2,2,0,0,0,0,0,0,0
../kbl_data/2022-2023,S41G01N6,고양 캐롯,Away,이정현,7,2,3,66.7,1,7,14.3,3,10,30.0,0,2,0.0,0,5,5,2,3,0,0,0,0,3
../kbl_data/2022-2023,S41G01N6,고양 캐롯,Away,조재우,0,0,0,0.0,0,0,0.0,0,0,0.0,0,0,0.0,0,0,0,0,0,0,0,0,0,0
../kbl_data/2022-2023,S41G01N7,창원 LG,Home,이관희,0,0,3,0.0,0,0,0.0,0,3,0.0,0,2,0.0,0,1,1,3,0,0,0,0,0,0
../kbl_data/2022-2023,S41G01N7,창원 LG,Home,정희재,4,2,2,100.0,0,0,0.0,2,2,100.0,0,0,0.0,0,0,0,0,0,0,0,0,0,1
../kbl_data/2022-2023,S41G01N7,창원 LG,Home,서민수,8,1,2,50.0,2,3,66.7,3,5,60.0,0,0,0.0,0,0,0,1,0,0,0,0,1,1
../kbl_data/2022-2023,S41G01N7,창원 LG,Home,한상혁,5,1,2,50.0,1,3,33.3,2,5,40.0,0,0,0.0,0,1,1,1,1,0,0,0,1,1
../kbl_data/2022-2023,S41G01N7,창원 LG,Home,이재도,18,6,9,66.7,2,3,66.7,8,12,66.7,0,0,0.0,0,3,3,7,3,0,0,0,1,2
../kbl_data/2022-2023,S41G01N7,창원 LG,Home,김준일,10,5,7,71.4,0,0,0.0,5,7,71.4,0,1,0.0,0,4,4,1,1,2,0,0,1,5
../kbl_data/2022-2023,S41G01N7,창원 LG,Home,박인태,0,0,0,0.0,0,0,0.0,0,0,0.0,0,0,0.0,0,0,0,0,0,0,0,0,0,1
../kbl_data/2022-2023,S41G01N7,창원 LG,Home,정인덕,0,0,1,0.0,0,0,0.0,0,1,0.0,0,0,0.0,0,1,1,0,0,0,0,0,0,1
../kbl_data/2022-2023,S41G01N7,창원 LG,Home,윤원상,14,1,3,33.3,4,8,50.0,5,11,45.5,0,0,0.0,1,1,2,2,0,0,0,0,0,2
../kbl_data/2022-2023,S41G01N7,창원 LG,Home,아셈 마레이,7,3,5,60.0,0,0,0.0,3,5,60.0,1,4,25.0,2,9,11,1,1,0,0,0,0,1
../kbl_data/2022-2023,S41G01N7,창원 LG,Home,이승우,9,3,4,75.0,1,1,100.0,4,5,80.0,0,0,0.0,0,7,7,4,1,1,0,0,2,1
../kbl_data/2022-2023,S41G01N7,창원 LG,Home,단테 커닝햄,12,5,11,45.5,0,0,0.0,5,11,45.5,2,5,40.0,4,3,7,2,1,2,0,1,2,2
../kbl_data/2022-2023,S41G01N7,전주 KCC,Away,정창영,11,4,6,66.7,0,0,0.0,4,6,66.7,3,5,60.0,0,3,3,2,2,0,0,0,0,4
../kbl_data/2022-2023,S41G01N7,전주 KCC,Away,라건아,6,3,8,37.5,0,2,0.0,3,10,30.0,0,0,0.0,2,8,10,1,0,1,0,0,2,1
../kbl_data/2022-2023,S41G01N7,전주 KCC,Away,박경상,0,0,0,0.0,0,0,0.0,0,0,0.0,0,0,0.0,0,1,1,0,0,0,0,0,0,0
../kbl_data/2022-2023,S41G01N7,전주 KCC,Away,김지완,4,2,5,40.0,0,2,0.0,2,7,28.6,0,0,0.0,0,1,1,1,1,1,0,0,1,2
../kbl_data/2022-2023,S41G01N7,전주 KCC,Away,김상규,12,2,5,40.0,2,2,100.0,4,7,57.1,2,2,100.0,1,1,2,0,0,0,0,0,0,3
../kbl_data/2022-2023,S41G01N7,전주 KCC,Away,허웅,11,2,5,40.0,2,4,50.0,4,9,44.4,1,1,100.0,0,1,1,2,0,0,0,0,2,1
../kbl_data/2022-2023,S41G01N7,전주 KCC,Away,이승현,9,2,8,25.0,1,1,100.0,3,9,33.3,2,2,100.0,4,2,6,3,0,1,0,0,2,1
../kbl_data/2022-2023,S41G01N7,전주 KCC,Away,이진욱,4,2,2,100.0,0,1,0.0,2,3,66.7,0,0,0.0,0,1,1,2,0,0,0,0,1,0
../kbl_data/2022-2023,S41G01N7,전주 KCC,Away,이근휘,0,0,0,0.0,0,1,0.0,0,1,0.0,0,0,0.0,0,1,1,0,1,0,0,0,0,2
../kbl_data/2022-2023,S41G01N7,전주 KCC,Away,김동현,0,0,2,0.0,0,1,0.0,0,3,0.0,0,0,0.0,0,0,0,0,0,0,0,0,1,1
../kbl_data/2022-2023,S41G01N7,전주 KCC,Away,서정현,0,0,0,0.0,0,0,0.0,0,0,0.0,0,0,0.0,0,0,0,0,0,0,0,0,0,0
../kbl_data/2022-2023,S41G01N7,전주 KCC,Away,론데 홀리스 제퍼슨,13,4,10,40.0,0,1,0.0,4,11,36.4,5,7,71.4,3,6,9,3,1,1,0,1,2,0
../kbl_data/2022-2023,S41G01N8,대구 한국가스공사,Home,박지훈,0,0,0,0.0,0,0,0.0,0,0,0.0,0,0,0.0,0,0,0,1,0,0,0,0,1,0
../kbl_data/2022-2023,S41G01N8,대구 한국가스공사,Home,조상열,0,0,0,0.0,0,0,0.0,0,0,0.0,0,0,0.0,0,0,0,0,0,0,0,0,0,0
../kbl_data/2022-2023,S41G01N8,대구 한국가스공사,Home,이원대,9,3,5,60.0,1,3,33.3,4,8,50.0,0,0,0.0,0,0,0,4,2,0,1,0,0,2
../kbl_data/2022-2023,S41G01N8,대구 한국가스공사,Home,이대헌,6,1,3,33.3,1,1,100.0,2,4,50.0,1,2,50.0,0,0,0,0,0,0,0,0,2,0
../kbl_data/2022-2023,S41G01N8,대구 한국가스공사,Home,이대성,5,1,5,20.0,1,3,33.3,2,8,25.0,0,0,0.0,0,2,2,0,1,0,0,0,5,2
../kbl_data/2022-2023,S41G01N8,대구 한국가스공사,Home,정효근,17,4,5,80.0,3,5,60.0,7,10,70.0,0,1,0.0,2,4,6,8,2,0,0,0,1,3
../kbl_data/2022-2023,S41G01N8,대구 한국가스공사,Home,머피 할로웨이,6,3,5,60.0,0,0,0.0,3,5,60.0,0,0,0.0,1,3,4,0,0,0,0,0,2,2
../kbl_data/2022-2023,S41G01N8,대구 한국가스공사,Home,우동현,0,0,0,0.0,0,0,0.0,0,0,0.0,0,0,0.0,0,0,0,0,0,0,0,0,0,0
../kbl_data/2022-2023,S41G01N8,대구 한국가스공사,Home,전현우,3,0,1,0.0,1,6,16.7,1,7,14.3,0,0,0.0,0,0,0,1,0,0,0,0,0,0
../kbl_data/2022-2023,S41G01N8,대구 한국가스공사,Home,신승민,16,2,2,100.0,2,4,50.0,4,6,66.7,6,8,75.0,2,6,8,2,0,0,0,0,1,2
../kbl_data/2022-2023,S41G01N8,대구 한국가스공사,Home,샘조세프 벨란겔,14,4,4,100.0,2,5,40.0,6,9,66.7,0,0,0.0,1,5,6,8,0,0,0,0,1,3
../kbl_data/2022-2023,S41G01N8,대구 한국가스공사,Home,유슈 은도예,22,8,10,80.0,0,0,0.0,8,10,80.0,6,8,75.0,2,15,17,3,1,3,1,4,0,3
../kbl_data/2022-2023,S41G01N8,원주 DB,Away,윤호영,0,0,0,0.0,0,0,0.0,0,0,0.0,0,0,0.0,0,0,0,0,0,0,0,0,0,0
../kbl_data/2022-2023,S41G01N8,원주 DB,Away,김현호,3,0,0,0.0,1,2,50.0,1,2,50.0,0,0,0.0,0,1,1,0,0,0,0,0,1,0
../kbl_data/2022-2023,S41G01N8,원주 DB,Away,김종규,2,1,1,100.0,0,2,0.0,1,3,33.3,0,0,0.0,1,3,4,0,0,0,0,0,1,4
../kbl_data/2022-2023,S41G01N8,원주 DB,Away,최승욱,8,4,5,80.0,0,2,0.0,4,7,57.1,0,0,0.0,1,1,2,3,2,0,0,0,1,0
../kbl_data/2022-2023,S41G01N8,원주 DB,Away,윤성원,10,2,3,66.7,2,4,50.0,4,7,57.1,0,0,0.0,0,3,3,0,0,0,0,0,0,5
../kbl_data/2022-2023,S41G01N8,원주 DB,Away,박상권,2,1,1,100.0,0,0,0.0,1,1,100.0,0,0,0.0,0,0,0,0,0,0,0,0,0,1
../kbl_data/2022-2023,S41G01N8,원주 DB,Away,이준희,8,3,4,75.0,0,4,0.0,3,8,37.5,2,2,100.0,0,0,0,3,0,0,0,0,1,0
../kbl_data/2022-2023,S41G01N8,원주 DB,Away,레나드 프리먼,12,5,7,71.4,0,0,0.0,5,7,71.4,2,4,50.0,2,6,8,0,3,0,0,0,0,2
../kbl_data/2022-2023,S41G01N8,원주 DB,Away,정호영,6,2,3,66.7,0,2,0.0,2,5,40.0,2,2,100.0,0,3,3,2,1,0,0,0,0,2
../kbl_data/2022-2023,S41G01N8,원주 DB,Away,이선 알바노,14,4,8,50.0,2,5,40.0,6,13,46.2,0,0,0.0,0,3,3,5,1,0,0,0,3,1
../kbl_data/2022-2023,S41G01N8,원주 DB,Away,드완 에르난데스,7,3,12,25.0,0,0,0.0,3,12,25.0,1,1,100.0,0,3,3,0,1,0,0,1,2,2
../kbl_data/2022-2023,S41G01N8,원주 DB,Away,박인웅,6,2,3,66.7,0,3,0.0,2,6,33.3,2,2,100.0,0,2,2,2,0,0,0,0,1,3
../kbl_data/2022-2023,S41G01N9,안양 KGC,Home,양희종,0,0,0,0.0,0,0,0.0,0,0,0.0,0,0,0.0,0,0,0,0,0,0,0,0,0,0
../kbl_data/2022-2023,S41G01N9,안양 KGC,Home,오세근,19,4,7,57.1,3,6,50.0,7,13,53.8,2,2,100.0,0,3,3,2,1,0,0,0,2,3
../kbl_data/2022-2023,S41G01N9,안양 KGC,Home,정준원,0,0,2,0.0,0,0,0.0,0,2,0.0,0,0,0.0,0,3,3,0,0,0,0,0,0,1
../kbl_data/2022-2023,S41G01N9,안양 KGC,Home,배병준,9,2,6,33.3,1,2,50.0,3,8,37.5,2,2,100.0,0,2,2,1,1,0,2,0,0,0
../kbl_data/2022-2023,S41G01N9,안양 KGC,Home,문성곤,15,2,3,66.7,3,8,37.5,5,11,45.5,2,2,100.0,3,4,7,1,1,0,0,0,1,1
../kbl_data/2022-2023,S41G01N9,안양 KGC,Home,김철욱,0,0,0,0.0,0,0,0.0,0,0,0.0,0,0,0.0,0,0,0,0,0,0,0,0,0,0
../kbl_data/2022-2023,S41G01N9,안양 KGC,Home,박지훈,16,5,6,83.3,2,3,66.7,7,9,77.8,0,0,0.0,3,2,5,3,2,0,0,0,1,1
../kbl_data/2022-2023,S41G01N9,안양 KGC,Home,이우정,0,0,0,0.0,0,0,0.0,0,0,0.0,0,0,0.0,0,0,0,0,0,0,0,0,0,0
../kbl_data/2022-2023,S41G01N9,안양 KGC,Home,대릴 먼로,2,1,2,50.0,0,0,0.0,1,2,50.0,0,0,0.0,1,0,1,0,0,0,0,0,1,1
../kbl_data/2022-2023,S41G01N9,안양 KGC,Home,변준형,14,4,6,66.7,2,4,50.0,6,10,60.0,0,2,0.0,1,1,2,4,0,0,1,0,1,2
../kbl_data/2022-2023,S41G01N9,안양 KGC,Home,한승희,3,0,2,0.0,1,2,50.0,1,4,25.0,0,0,0.0,1,3,4,0,0,0,0,0,1,5
../kbl_data/2022-2023,S41G01N9,안양 KGC,Home,오마리 스펠맨,15,3,5,60.0,2,6,33.3,5,11,45.5,3,4,75.0,2,7,9,7,0,1,0,1,2,1
../kbl_data/2022-2023,S41G01N9,울산 현대모비스,Away,함지훈,6,2,3,66.7,0,0,0.0,2,3,66.7,2,5,40.0,1,1,2,4,0,0,0,0,2,0
../kbl_data/2022-2023,S41G01N9,울산 현대모비스,Away,김현민,2,1,1,100.0,0,0,0.0,1,1,100.0,0,0,0.0,0,0,0,0,1,0,0,0,0,1
../kbl_data/2022-2023,S41G01N9,울산 현대모비스,Away,장재석,10,5,5,100.0,0,0,0.0,5,5,100.0,0,3,0.0,0,4,4,2,0,0,0,1,1,2
../kbl_data/2022-2023,S41G01N9,울산 현대모비스,Away,김영현,3,0,0,0.0,1,1,100.0,1,1,100.0,0,0,0.0,0,0,0,1,0,0,0,0,0,4
../kbl_data/2022-2023,S41G01N9,울산 현대모비스,Away,김국찬,5,1,2,50.0,1,2,50.0,2,4,50.0,0,0,0.0,2,1,3,0,0,0,0,0,1,0
../kbl_data/2022-2023,S41G01N9,울산 현대모비스,Away,서명진,3,0,4,0.0,1,3,33.3,1,7,14.3,0,0,0.0,0,2,2,1,1,0,0,0,2,0
../kbl_data/2022-2023,S41G01N9,울산 현대모비스,Away,저스틴 녹스,14,4,11,36.4,2,3,66.7,6,14,42.9,0,0,0.0,6,7,13,2,1,0,0,3,1,4
../kbl_data/2022-2023,S41G01N9,울산 현대모비스,Away,이우석,21,6,7,85.7,2,4,50.0,8,11,72.7,3,6,50.0,3,4,7,2,1,0,0,0,2,3
../kbl_data/2022-2023,S41G01N9,울산 현대모비스,Away,신민석,3,0,0,0.0,1,2,50.0,1,2,50.0,0,0,0.0,0,0,0,0,0,0,0,0,0,0
../kbl_data/2022-2023,S41G01N9,울산 현대모비스,Away,김동준,1,0,2,0.0,0,0,0.0,0,2,0.0,1,2,50.0,1,0,1,0,0,0,0,0,0,0
../kbl_data/2022-2023,S41G01N9,울산 현대모비스,Away,론제이 아바리엔토스,12,3,5,60.0,2,9,22.2,5,14,35.7,0,0,0.0,0,1,1,9,2,0,0,0,2,2
../kbl_data/2022-2023,S41G01N9,울산 현대모비스,Away,게이지 프림,4,2,6,33.3,0,0,0.0,2,6,33.3,0,0,0.0,3,3,6,2,0,0,0,0,1,3
../kbl_data/2022-2023,S41G01N10,수원 KT,Home,김동욱,12,0,0,0.0,4,4,100.0,4,4,100.0,0,0,0.0,1,0,1,0,2,0,1,0,3,1
../kbl_data/2022-2023,S41G01N10,수원 KT,Home,김영환,3,0,0,0.0,1,1,100.0,1,1,100.0,0,0,0.0,0,1,1,1,1,0,0,0,1,0
../kbl_data/2022-2023,S41G01N10,수원 KT,Home,김민욱,0,0,1,0.0,0,0,0.0,0,1,0.0,0,0,0.0,0,0,0,0,0,0,0,0,0,0
../kbl_data/2022-2023,S41G01N10,수원 KT,Home,이현석,0,0,0,0.0,0,2,0.0,0,2,0.0,0,0,0.0,0,0,0,0,0,0,0,0,0,2
../kbl_data/2022-2023,S41G01N10,수원 KT,Home,정성우,21,3,4,75.0,5,8,62.5,8,12,66.7,0,2,0.0,1,3,4,5,0,0,0,0,0,1
../kbl_data/2022-2023,S41G01N10,수원 KT,Home,최성모,0,0,0,0.0,0,1,0.0,0,1,0.0,0,0,0.0,0,0,0,1,0,0,0,0,0,2
../kbl_data/2022-2023,S41G01N10,수원 KT,Home,양홍석,19,4,7,57.1,1,5,20.0,5,12,41.7,8,9,88.9,0,6,6,2,0,0,0,0,3,3
../kbl_data/2022-2023,S41G01N10,수원 KT,Home,박지원,3,1,1,100.0,0,1,0.0,1,2,50.0,1,1,100.0,0,0,0,1,1,0,1,0,0,4
../kbl_data/2022-2023,S41G01N10,수원 KT,Home,김준환,3,0,1,0.0,1,2,50.0,1,3,33.3,0,0,0.0,0,0,0,0,1,0,1,0,0,4
../kbl_data/2022-2023,S41G01N10,수원 KT,Home,하윤기,13,4,5,80.0,0,0,0.0,4,5,80.0,5,8,62.5,0,2,2,0,3,1,0,1,1,1
../kbl_data/2022-2023,S41G01N10,수원 KT,Home,이제이 아노시케,2,0,7,0.0,0,2,0.0,0,9,0.0,2,2,100.0,0,2,2,1,0,1,0,0,1,2
../kbl_data/2022-2023,S41G01N10,수원 KT,Home,랜드리 은노코,9,3,6,50.0,0,0,0.0,3,6,50.0,3,4,75.0,4,1,5,3,0,0,0,1,0,1
../kbl_data/2022-2023,S41G01N10,서울 삼성,Away,이정현,8,1,3,33.3,2,5,40.0,3,8,37.5,0,0,0.0,0,1,1,2,1,0,1,0,3,4
../kbl_data/2022-2023,S41G01N10,서울 삼성,Away,장민국,3,0,0,0.0,1,4,25.0,1,4,25.0,0,0,0.0,0,0,0,1,0,0,0,0,1,4
../kbl_data/2022-2023,S41G01N10,서울 삼성,Away,김현수,5,0,1,0.0,1,2,50.0,1,3,33.3,2,2,100.0,0,0,0,0,0,0,0,0,0,0
../kbl_data/2022-2023,S41G01N10,서울 삼성,Away,임동섭,5,1,1,100.0,1,4,25.0,2,5,40.0,0,0,0.0,3,3,6,4,0,0,0,0,0,3
../kbl_data/2022-2023,S41G01N10,서울 삼성,Away,이동엽,15,3,7,42.9,3,4,75.0,6,11,54.5,0,0,0.0,2,1,3,5,1,0,0,0,1,1
../kbl_data/2022-2023,S41G01N10,서울 삼성,Away,이호현,11,4,4,100.0,1,2,50.0,5,6,83.3,0,0,0.0,0,3,3,4,0,0,0,0,2,1
../kbl_data/2022-2023,S41G01N10,서울 삼성,Away,마커스 데릭슨,17,6,7,85.7,1,2,50.0,7,9,77.8,2,3,66.7,3,7,10,0,1,1,0,0,2,1
../kbl_data/2022-2023,S41G01N10,서울 삼성,Away,전형준,0,0,0,0.0,0,0,0.0,0,0,0.0,0,0,0.0,0,0,0,0,0,0,0,0,0,0
../kbl_data/2022-2023,S41G01N10,서울 삼성,Away,조우성,3,1,1,100.0,0,0,0.0,1,1,100.0,1,2,50.0,1,1,2,1,0,0,0,0,0,0
../kbl_data/2022-2023,S41G01N10,서울 삼성,Away,이원석,6,2,3,66.7,0,1,0.0,2,4,50.0,2,2,100.0,0,3,3,0,1,1,0,0,0,4
../kbl_data/2022-2023,S41G01N10,서울 삼성,Away,이매뉴얼 테리,8,4,5,80.0,0,0,0.0,4,5,80.0,0,2,0.0,0,4,4,0,0,0,0,1,6,5
../kbl_data/2022-2023,S41G01N10,서울 삼성,Away,신동혁,2,1,1,100.0,0,1,0.0,1,2,50.0,0,0,0.0,0,0,0,1,2,0,0,0,0,2
../kbl_data/2022-2023,S41G01N11,고양 캐롯,Home,김강선,2,0,0,0.0,0,2,0.0,0,2,0.0,2,2,100.0,0,3,3,1,1,0,0,0,0,2
../kbl_data/2022-2023,S41G01N11,고양 캐롯,Home,데이비드 사이먼,8,1,6,16.7,1,2,50.0,2,8,25.0,3,4,75.0,0,6,6,3,0,0,0,0,0,3
../kbl_data/2022-2023,S41G01N11,고양 캐롯,Home,최현민,9,3,3,100.0,1,1,100.0,4,4,100.0,0,0,0.0,2,2,4,0,0,1,1,0,0,2
../kbl_data/2022-2023,S41G01N11,고양 캐롯,Home,한호빈,7,3,4,75.0,0,2,0.0,3,6,50.0,1,2,50.0,1,2,3,7,2,0,0,0,1,4
../kbl_data/2022-2023,S41G01N11,고양 캐롯,Home,전성현,19,1,3,33.3,3,10,30.0,4,13,30.8,8,9,88.9,0,2,2,4,1,0,0,0,0,1
../kbl_data/2022-2023,S41G01N11,고양 캐롯,Home,이종현,7,2,2,100.0,0,0,0.0,2,2,100.0,3,4,75.0,3,1,4,0,0,1,0,0,4,4
../kbl_data/2022-2023,S41G01N11,고양 캐롯,Home,정해원,0,0,0,0.0,0,0,0.0,0,0,0.0,0,0,0.0,0,0,0,0,0,0,0,0,0,0
../kbl_data/2022-2023,S41G01N11,고양 캐롯,Home,조한진,0,0,0,0.0,0,0,0.0,0,0,0.0,0,0,0.0,0,0,0,0,0,0,0,0,0,0
../kbl_data/2022-2023,S41G01N11,고양 캐롯,Home,김세창,0,0,0,0.0,0,0,0.0,0,0,0.0,0,0,0.0,0,0,0,0,0,0,0,0,0,0
../kbl_data/2022-2023,S41G01N11,고양 캐롯,Home,디드릭 로슨,20,10,15,66.7,0,1,0.0,10,16,62.5,0,1,0.0,1,7,8,1,2,0,0,1,5,0
../kbl_data/2022-2023,S41G01N11,고양 캐롯,Home,박진철,0,0,0,0.0,0,0,0.0,0,0,0.0,0,0,0.0,0,0,0,0,0,0,0,0,0,0
../kbl_data/2022-2023,S41G01N11,고양 캐롯,Home,이정현,17,3,7,42.9,3,5,60.0,6,12,50.0,2,2,100.0,1,4,5,2,4,0,2,0,3,4
../kbl_data/2022-2023,S41G01N11,창원 LG,Away,이관희,7,2,4,50.0,1,5,20.0,3,9,33.3,0,0,0.0,0,2,2,1,1,0,0,0,2,1
../kbl_data/2022-2023,S41G01N11,창원 LG,Away,정희재,0,0,1,0.0,0,0,0.0,0,1,0.0,0,0,0.0,0,0,0,0,0,0,0,0,0,1
../kbl_data/2022-2023,S41G01N11,창원 LG,Away,서민수,0,0,2,0.0,0,3,0.0,0,5,0.0,0,0,0.0,0,0,0,2,0,0,0,0,0,3
../kbl_data/2022-2023,S41G01N11,창원 LG,Away,한상혁,0,0,0,0.0,0,0,0.0,0,0,0.0,0,2,0.0,0,0,0,1,1,0,0,0,0,1
../kbl_data/2022-2023,S41G01N11,창원 LG,Away,이재도,24,3,5,60.0,6,10,60.0,9,15,60.0,0,0,0.0,1,5,6,5,3,0,0,0,5,1
../kbl_data/2022-2023,S41G01N11,창원 LG,Away,김준일,4,2,4,50.0,0,0,0.0,2,4,50.0,0,0,0.0,1,0,1,1,1,0,0,1,1,2
../kbl_data/2022-2023,S41G01N11,창원 LG,Away,박인태,0,0,0,0.0,0,0,0.0,0,0,0.0,0,0,0.0,0,0,0,0,0,0,0,0,0,0
../kbl_data/2022-2023,S41G01N11,창원 LG,Away,정인덕,0,0,0,0.0,0,0,0.0,0,0,0.0,0,0,0.0,0,0,0,0,0,0,0,0,0,2
../kbl_data/2022-2023,S41G01N11,창원 LG,Away,윤원상,19,2,5,40.0,4,5,80.0,6,10,60.0,3,3,100.0,0,1,1,1,2,0,0,0,1,5
../kbl_data/2022-2023,S41G01N11,창원 LG,Away,아셈 마레이,15,5,8,62.5,0,0,0.0,5,8,62.5,5,6,83.3,3,6,9,1,0,0,0,0,1,2
../kbl_data/2022-2023,S41G01N11,창원 LG,Away,이승우,6,2,3,66.7,0,1,0.0,2,4,50.0,2,7,28.6,0,4,4,1,1,0,0,0,5,5
../kbl_data/2022-2023,S41G01N11,창원 LG,Away,단테 커닝햄,7,2,4,50.0,0,1,0.0,2,5,40.0,3,3,100.0,1,6,7,6,3,1,0,0,2,2
../kbl_data/2022-2023,S41G01N12,대구 한국가스공사,Home,박지훈,9,1,2,50.0,1,3,33.3,2,5,40.0,4,5,80.0,0,3,3,1,0,0,0,0,0,3
../kbl_data/2022-2023,S41G01N12,대구 한국가스공사,Home,조상열,0,0,0,0.0,0,0,0.0,0,0,0.0,0,0,0.0,0,0,0,0,0,0,0,0,0,0
../kbl_data/2022-2023,S41G01N12,대구 한국가스공사,Home,이원대,4,2,4,50.0,0,1,0.0,2,5,40.0,0,0,0.0,1,0,1,4,0,0,0,0,2,2
../kbl_data/2022-2023,S41G01N12,대구 한국가스공사,Home,이대헌,14,5,7,71.4,1,2,50.0,6,9,66.7,1,1,100.0,2,2,4,1,2,0,0,0,2,2
../kbl_data/2022-2023,S41G01N12,대구 한국가스공사,Home,이대성,24,7,12,58.3,2,5,40.0,9,17,52.9,4,4,100.0,0,0,0,5,5,0,0,0,2,2
../kbl_data/2022-2023,S41G01N12,대구 한국가스공사,Home,정효근,7,3,5,60.0,0,4,0.0,3,9,33.3,1,2,50.0,2,1,3,2,0,0,0,0,0,0
../kbl_data/2022-2023,S41G01N12,대구 한국가스공사,Home,머피 할로웨이,3,1,4,25.0,0,0,0.0,1,4,25.0,1,2,50.0,2,2,4,1,0,1,0,1,0,1
../kbl_data/2022-2023,S41G01N12,대구 한국가스공사,Home,우동현,0,0,0,0.0,0,0,0.0,0,0,0.0,0,0,0.0,0,0,0,0,0,0,0,0,0,0
../kbl_data/2022-2023,S41G01N12,대구 한국가스공사,Home,전현우,0,0,0,0.0,0,1,0.0,0,1,0.0,0,0,0.0,0,0,0,0,1,0,0,0,0,0
../kbl_data/2022-2023,S41G01N12,대구 한국가스공사,Home,신승민,4,0,0,0.0,0,1,0.0,0,1,0.0,4,5,80.0,0,2,2,1,0,0,0,0,0,1
../kbl_data/2022-2023,S41G01N12,대구 한국가스공사,Home,샘조세프 벨란겔,10,4,6,66.7,0,3,0.0,4,9,44.4,2,2,100.0,0,3,3,2,0,0,0,0,4,4
../kbl_data/2022-2023,S41G01N12,대구 한국가스공사,Home,유슈 은도예,15,6,6,100.0,0,0,0.0,6,6,100.0,3,4,75.0,5,2,7,3,0,0,1,2,4,4
../kbl_data/2022-2023,S41G01N12,서울 SK,Away,양우섭,4,1,1,100.0,0,0,0.0,1,1,100.0,2,2,100.0,0,0,0,2,0,0,0,0,1,1
../kbl_data/2022-2023,S41G01N12,서울 SK,Away,허일영,13,5,5,100.0,1,1,100.0,6,6,100.0,0,0,0.0,1,3,4,2,1,0,0,0,1,4
../kbl_data/2022-2023,S41G01N12,서울 SK,Away,송창용,8,1,1,100.0,2,2,100.0,3,3,100.0,0,0,0.0,0,1,1,1,0,0,0,0,1,1
../kbl_data/2022-2023,S41G01N12,서울 SK,Away,김선형,22,9,11,81.8,0,2,0.0,9,13,69.2,4,4,100.0,1,0,1,6,4,0,0,0,2,2
../kbl_data/2022-2023,S41G01N12,서울 SK,Away,홍경기,3,0,0,0.0,1,3,33.3,1,3,33.3,0,0,0.0,0,0,0,1,0,0,0,0,1,0
../kbl_data/2022-2023,S41G01N12,서울 SK,Away,최부경,10,5,6,83.3,0,0,0.0,5,6,83.3,0,0,0.0,2,7,9,6,1,1,1,0,2,3
../kbl_data/2022-2023,S41G01N12,서울 SK,Away,김승원,0,0,0,0.0,0,0,0.0,0,0,0.0,0,0,0.0,0,0,0,2,0,0,0,0,0,3
../kbl_data/2022-2023,S41G01N12,서울 SK,Away,리온 윌리엄스,6,2,2,100.0,0,0,0.0,2,2,100.0,2,2,100.0,0,3,3,1,0,0,0,0,0,0
../kbl_data/2022-2023,S41G01N12,서울 SK,Away,최원혁,6,1,1,100.0,1,4,25.0,2,5,40.0,1,2,50.0,2,0,2,0,2,0,0,0,0,3
../kbl_data/2022-2023,S41G01N12,서울 SK,Away,장문호,0,0,0,0.0,0,0,0.0,0,0,0.0,0,0,0.0,0,0,0,0,0,0,0,0,0,0
../kbl_data/2022-2023,S41G01N12,서울 SK,Away,자밀 워니,18,7,14,50.0,0,2,0.0,7,16,43.8,4,5,80.0,3,4,7,5,1,1,0,0,5,3
../kbl_data/2022-2023,S41G01N12,서울 SK,Away,오재현,15,3,3,100.0,3,7,42.9,6,10,60.0,0,0,0.0,0,1,1,1,0,0,0,0,2,1
../kbl_data/2022-2023,S41G01N13,원주 DB,Home,박찬희,2,1,3,33.3,0,1,0.0,1,4,25.0,0,0,0.0,1,1,2,3,0,0,0,0,1,4
../kbl_data/2022-2023,S41G01N13,원주 DB,Home,김현호,7,2,3,66.7,1,5,20.0,3,8,37.5,0,0,0.0,0,3,3,2,1,0,0,0,0,3
../kbl_data/2022-2023,S41G01N13,원주 DB,Home,두경민,7,2,4,50.0,0,6,0.0,2,10,20.0,3,3,100.0,1,2,3,1,2,0,0,0,2,3
../kbl_data/2022-2023,S41G01N13,원주 DB,Home,김종규,2,1,2,50.0,0,0,0.0,1,2,50.0,0,0,0.0,0,3,3,1,1,1,0,0,0,2
../kbl_data/2022-2023,S41G01N13,원주 DB,Home,최승욱,20,5,6,83.3,3,3,100.0,8,9,88.9,1,1,100.0,2,1,3,0,2,1,0,0,1,1
../kbl_data/2022-2023,S41G01N13,원주 DB,Home,강상재,10,3,5,60.0,1,3,33.3,4,8,50.0,1,2,50.0,1,4,5,1,0,0,0,0,3,2
../kbl_data/2022-2023,S41G01N13,원주 DB,Home,윤성원,0,0,0,0.0,0,0,0.0,0,0,0.0,0,0,0.0,0,0,0,0,0,0,0,0,0,0
../kbl_data/2022-2023,S41G01N13,원주 DB,Home,이준희,2,1,1,100.0,0,0,0.0,1,1,100.0,0,0,0.0,1,1,2,1,0,0,0,0,2,2
../kbl_data/2022-2023,S41G01N13,원주 DB,Home,레나드 프리먼,16,7,13,53.8,0,0,0.0,7,13,53.8,2,2,100.0,3,7,10,2,2,0,0,0,1,3
../kbl_data/2022-2023,S41G01N13,원주 DB,Home,이선 알바노,11,3,6,50.0,1,2,50.0,4,8,50.0,2,2,100.0,1,4,5,6,1,0,0,0,3,2
../kbl_data/2022-2023,S41G01N13,원주 DB,Home,드완 에르난데스,4,2,7,28.6,0,0,0.0,2,7,28.6,0,0,0.0,0,4,4,0,0,1,1,0,1,0
../kbl_data/2022-2023,S41G01N13,원주 DB,Home,박인웅,0,0,0,0.0,0,0,0.0,0,0,0.0,0,0,0.0,0,2,2,1,0,0,0,0,0,1
../kbl_data/2022-2023,S41G01N13,수원 KT,Away,김동욱,3,0,0,0.0,1,5,20.0,1,5,20.0,0,0,0.0,0,0,0,1,0,0,0,0,0,1
../kbl_data/2022-2023,S41G01N13,수원 KT,Away,김영환,0,0,2,0.0,0,0,0.0,0,2,0.0,0,0,0.0,0,0,0,0,0,0,0,0,0,0
../kbl_data/2022-2023,S41G01N13,수원 KT,Away,김민욱,0,0,1,0.0,0,0,0.0,0,1,0.0,0,0,0.0,0,2,2,0,0,0,0,0,0,0
../kbl_data/2022-2023,S41G01N13,수원 KT,Away,한희원,7,0,1,0.0,1,4,25.0,1,5,20.0,4,7,57.1,0,0,0,2,2,0,0,0,0,3
../kbl_data/2022-2023,S41G01N13,수원 KT,Away,정성우,13,3,6,50.0,1,3,33.3,4,9,44.4,4,4,100.0,0,2,2,0,1,0,1,0,1,1
../kbl_data/2022-2023,S41G01N13,수원 KT,Away,최성모,4,0,2,0.0,1,2,50.0,1,4,25.0,1,5,20.0,2,0,2,4,1,1,0,0,2,1
../kbl_data/2022-2023,S41G01N13,수원 KT,Away,양홍석,7,1,2,50.0,1,5,20.0,2,7,28.6,2,2,100.0,0,2,2,0,1,0,0,0,3,2
../kbl_data/2022-2023,S41G01N13,수원 KT,Away,박지원,2,1,1,100.0,0,1,0.0,1,2,50.0,0,0,0.0,1,0,1,4,0,0,0,0,0,2
../kbl_data/2022-2023,S41G01N13,수원 KT,Away,김준환,0,0,0,0.0,0,1,0.0,0,1,0.0,0,0,0.0,0,0,0,0,0,0,0,0,0,0
../kbl_data/2022-2023,S41G01N13,수원 KT,Away,하윤기,16,8,13,61.5,0,0,0.0,8,13,61.5,0,0,0.0,5,2,7,1,2,3,0,2,2,2
../kbl_data/2022-2023,S41G01N13,수원 KT,Away,이제이 아노시케,7,2,5,40.0,1,4,25.0,3,9,33.3,0,0,0.0,0,2,2,0,1,0,0,0,1,0
../kbl_data/2022-2023,S41G01N13,수원 KT,Away,랜드리 은노코,12,4,9,44.4,0,0,0.0,4,9,44.4,4,7,57.1,5,9,14,0,1,2,0,3,2,2
../kbl_data/2022-2023,S41G01N14,서울 삼성,Home,이정현,15,3,6,50.0,2,8,25.0,5,14,35.7,3,5,60.0,3,2,5,5,0,1,0,0,2,3
../kbl_data/2022-2023,S41G01N14,서울 삼성,Home,장민국,8,1,2,50.0,2,2,100.0,3,4,75.0,0,0,0.0,0,2,2,0,0,0,0,0,0,4
../kbl_data/2022-2023,S41G01N14,서울 삼성,Home,김시래,14,2,7,28.6,2,3,66.7,4,10,40.0,4,4,100.0,0,3,3,4,0,0,0,0,1,3
../kbl_data/2022-2023,S41G01N14,서울 삼성,Home,김현수,0,0,0,0.0,0,0,0.0,0,0,0.0,0,0,0.0,0,0,0,0,0,0,0,0,0,0
../kbl_data/2022-2023,S41G01N14,서울 삼성,Home,임동섭,2,1,1,100.0,0,1,0.0,1,2,50.0,0,0,0.0,0,0,0,0,0,0,0,0,2,2
../kbl_data/2022-2023,S41G01N14,서울 삼성,Home,이동엽,5,0,2,0.0,1,2,50.0,1,4,25.0,2,2,100.0,2,3,5,1,0,0,0,0,0,3
../kbl_data/2022-2023,S41G01N14,서울 삼성,Home,이호현,4,2,3,66.7,0,1,0.0,2,4,50.0,0,0,0.0,0,0,0,5,1,0,0,0,0,2
../kbl_data/2022-2023,S41G01N14,서울 삼성,Home,마커스 데릭슨,10,2,4,50.0,2,5,40.0,4,9,44.4,0,0,0.0,0,3,3,2,0,0,0,0,0,1
../kbl_data/2022-2023,S41G01N14,서울 삼성,Home,조우성,0,0,0,0.0,0,0,0.0,0,0,0.0,0,0,0.0,0,1,1,0,0,0,0,0,0,0
../kbl_data/2022-2023,S41G01N14,서울 삼성,Home,이원석,7,3,4,75.0,0,0,0.0,3,4,75.0,1,2,50.0,1,1,2,0,1,1,0,0,0,4
../kbl_data/2022-2023,S41G01N14,서울 삼성,Home,이매뉴얼 테리,16,6,9,66.7,0,0,0.0,6,9,66.7,4,5,80.0,2,3,5,0,3,1,0,1,0,3
../kbl_data/2022-2023,S41G01N14,서울 삼성,Home,신동혁,0,0,0,0.0,0,0,0.0,0,0,0.0,0,0,0.0,0,0,0,0,0,0,0,0,0,0
../kbl_data/2022-2023,S41G01N14,안양 KGC,Away,양희종,8,1,1,100.0,1,4,25.0,2,5,40.0,3,4,75.0,0,2,2,2,0,0,0,0,0,1
../kbl_data/2022-2023,S41G01N14,안양 KGC,Away,함준후,0,0,0,0.0,0,0,0.0,0,0,0.0,0,0,0.0,0,0,0,0,0,0,0,0,0,0
../kbl_data/2022-2023,S41G01N14,안양 KGC,Away,오세근,23,10,16,62.5,0,1,0.0,10,17,58.8,3,4,75.0,3,3,6,1,0,0,0,0,2,0
../kbl_data/2022-2023,S41G01N14,안양 KGC,Away,정준원,2,1,1,100.0,0,0,0.0,1,1,100.0,0,0,0.0,0,0,0,0,0,0,0,0,0,0
../kbl_data/2022-2023,S41G01N14,안양 KGC,Away,배병준,13,2,3,66.7,3,3,100.0,5,6,83.3,0,0,0.0,1,1,2,2,1,0,0,0,1,2
../kbl_data/2022-2023,S41G01N14,안양 KGC,Away,문성곤,3,0,0,0.0,1,3,33.3,1,3,33.3,0,0,0.0,2,2,4,0,1,0,0,0,1,5
../kbl_data/2022-2023,S41G01N14,안양 KGC,Away,김철욱,0,0,0,0.0,0,0,0.0,0,0,0.0,0,0,0.0,0,0,0,0,0,0,0,0,0,0
../kbl_data/2022-2023,S41G01N14,안양 KGC,Away,박지훈,4,1,3,33.3,0,2,0.0,1,5,20.0,2,2,100.0,2,3,5,3,0,0,0,0,1,4
../kbl_data/2022-2023,S41G01N14,안양 KGC,Away,대릴 먼로,7,1,4,25.0,1,2,50.0,2,6,33.3,2,2,100.0,0,8,8,2,1,0,0,0,2,1
../kbl_data/2022-2023,S41G01N14,안양 KGC,Away,변준형,7,0,3,0.0,0,1,0.0,0,4,0.0,7,8,87.5,1,2,3,3,0,0,0,0,0,3
../kbl_data/2022-2023,S41G01N14,안양 KGC,Away,한승희,2,1,1,100.0,0,0,0.0,1,1,100.0,0,0,0.0,0,0,0,0,0,0,0,0,0,0
../kbl_data/2022-2023,S41G01N14,안양 KGC,Away,오마리 스펠맨,13,2,3,66.7,2,7,28.6,4,10,40.0,3,3,100.0,0,2,2,1,0,1,0,0,1,3
../kbl_data/2022-2023,S41G01N15,전주 KCC,Home,정창영,4,2,3,66.7,0,0,0.0,2,3,66.7,0,0,0.0,0,0,0,0,0,0,0,0,1,0
../kbl_data/2022-2023,S41G01N15,전주 KCC,Home,라건아,23,8,16,50.0,2,3,66.7,10,19,52.6,1,3,33.3,6,7,13,1,0,0,0,1,1,4
../kbl_data/2022-2023,S41G01N15,전주 KCC,Home,박경상,2,0,3,0.0,0,1,0.0,0,4,0.0,2,2,100.0,1,2,3,1,1,0,0,0,0,1
../kbl_data/2022-2023,S41G01N15,전주 KCC,Home,김지완,0,0,1,0.0,0,1,0.0,0,2,0.0,0,0,0.0,0,0,0,1,0,0,0,0,0,0
../kbl_data/2022-2023,S41G01N15,전주 KCC,Home,김상규,4,2,2,100.0,0,1,0.0,2,3,66.7,0,0,0.0,2,0,2,1,0,0,0,0,0,0
../kbl_data/2022-2023,S41G01N15,전주 KCC,Home,전준범,0,0,0,0.0,0,0,0.0,0,0,0.0,0,0,0.0,0,0,0,0,0,0,0,0,0,0
../kbl_data/2022-2023,S41G01N15,전주 KCC,Home,허웅,15,1,3,33.3,3,6,50.0,4,9,44.4,4,5,80.0,0,2,2,5,0,0,0,0,1,3
../kbl_data/2022-2023,S41G01N15,전주 KCC,Home,이승현,17,4,5,80.0,1,5,20.0,5,10,50.0,6,7,85.7,4,2,6,4,0,0,1,0,6,3
../kbl_data/2022-2023,S41G01N15,전주 KCC,Home,이근휘,13,1,1,100.0,3,5,60.0,4,6,66.7,2,2,100.0,0,2,2,2,1,0,0,0,0,2
../kbl_data/2022-2023,S41G01N15,전주 KCC,Home,김동현,0,0,0,0.0,0,0,0.0,0,0,0.0,0,0,0.0,0,0,0,0,0,0,0,0,0,0
../kbl_data/2022-2023,S41G01N15,전주 KCC,Home,론데 홀리스 제퍼슨,3,1,6,16.7,0,0,0.0,1,6,16.7,1,1,100.0,0,3,3,0,0,1,0,0,0,1
../kbl_data/2022-2023,S41G01N15,전주 KCC,Home,송동훈,7,2,2,100.0,1,4,25.0,3,6,50.0,0,0,0.0,1,2,3,6,2,0,0,0,1,5
../kbl_data/2022-2023,S41G01N15,울산 현대모비스,Away,함지훈,12,4,8,50.0,1,2,50.0,5,10,50.0,1,1,100.0,4,2,6,3,1,0,0,0,2,1
../kbl_data/2022-2023,S41G01N15,울산 현대모비스,Away,김현민,0,0,0,0.0,0,0,0.0,0,0,0.0,0,0,0.0,0,0,0,0,0,0,0,0,0,0
../kbl_data/2022-2023,S41G01N15,울산 현대모비스,Away,장재석,8,4,8,50.0,0,0,0.0,4,8,50.0,0,0,0.0,4,0,4,2,0,0,0,0,0,3
../kbl_data/2022-2023,S41G01N15,울산 현대모비스,Away,김영현,9,0,1,0.0,3,7,42.9,3,8,37.5,0,0,0.0,0,0,0,1,1,0,0,0,0,5
../kbl_data/2022-2023,S41G01N15,울산 현대모비스,Away,김국찬,0,0,0,0.0,0,1,0.0,0,1,0.0,0,0,0.0,0,0,0,0,0,0,1,0,0,1
../kbl_data/2022-2023,S41G01N15,울산 현대모비스,Away,서명진,0,0,1,0.0,0,1,0.0,0,2,0.0,0,0,0.0,0,0,0,2,0,0,0,0,1,2
../kbl_data/2022-2023,S41G01N15,울산 현대모비스,Away,저스틴 녹스,13,6,11,54.5,0,1,0.0,6,12,50.0,1,2,50.0,7,5,12,1,0,0,0,0,2,1
../kbl_data/2022-2023,S41G01N15,울산 현대모비스,Away,이우석,14,4,8,50.0,2,3,66.7,6,11,54.5,0,0,0.0,2,8,10,1,0,1,0,0,1,4
../kbl_data/2022-2023,S41G01N15,울산 현대모비스,Away,신민석,0,0,0,0.0,0,2,0.0,0,2,0.0,0,0,0.0,0,1,1,0,0,0,0,0,0,0
../kbl_data/2022-2023,S41G01N15,울산 현대모비스,Away,김동준,0,0,3,0.0,0,0,0.0,0,3,0.0,0,2,0.0,0,1,1,2,0,0,0,0,0,1
../kbl_data/2022-2023,S41G01N15,울산 현대모비스,Away,론제이 아바리엔토스,21,3,3,100.0,5,10,50.0,8,13,61.5,0,1,0.0,0,3,3,8,4,0,0,0,1,1
../kbl_data/2022-2023,S41G01N15,울산 현대모비스,Away,게이지 프림,12,4,7,57.1,0,0,0.0,4,7,57.1,4,5,80.0,1,2,3,1,1,0,0,0,1,4
../kbl_data/2022-2023,S41G01N16,원주 DB,Home,박찬희,0,0,2,0.0,0,0,0.0,0,2,0.0,0,0,0.0,0,0,0,0,0,0,0,0,1,1
../kbl_data/2022-2023,S41G01N16,원주 DB,Home,김현호,2,1,1,100.0,0,0,0.0,1,1,100.0,0,0,0.0,0,0,0,1,0,0,0,0,0,3
../kbl_data/2022-2023,S41G01N16,원주 DB,Home,두경민,27,2,4,50.0,7,12,58.3,9,16,56.2,2,2,100.0,1,1,2,2,0,0,0,0,0,1
../kbl_data/2022-2023,S41G01N16,원주 DB,Home,김종규,6,3,7,42.9,0,2,0.0,3,9,33.3,0,0,0.0,3,3,6,4,2,0,0,0,0,1
../kbl_data/2022-2023,S41G01N16,원주 DB,Home,최승욱,7,2,4,50.0,1,1,100.0,3,5,60.0,0,0,0.0,2,3,5,2,0,0,0,0,1,2
../kbl_data/2022-2023,S41G01N16,원주 DB,Home,강상재,12,1,2,50.0,3,3,100.0,4,5,80.0,1,2,50.0,1,4,5,3,1,1,0,0,2,2
../kbl_data/2022-2023,S41G01N16,원주 DB,Home,윤성원,0,0,0,0.0,0,0,0.0,0,0,0.0,0,0,0.0,0,0,0,0,0,0,0,0,0,0
../kbl_data/2022-2023,S41G01N16,원주 DB,Home,이준희,0,0,0,0.0,0,0,0.0,0,0,0.0,0,0,0.0,0,0,0,0,0,0,0,0,0,1
../kbl_data/2022-2023,S41G01N16,원주 DB,Home,레나드 프리먼,11,5,11,45.5,0,0,0.0,5,11,45.5,1,2,50.0,1,6,7,3,2,0,0,1,1,1
../kbl_data/2022-2023,S41G01N16,원주 DB,Home,이선 알바노,13,3,12,25.0,2,4,50.0,5,16,31.2,1,1,100.0,2,4,6,3,1,0,0,0,1,1
../kbl_data/2022-2023,S41G01N16,원주 DB,Home,드완 에르난데스,9,3,7,42.9,0,0,0.0,3,7,42.9,3,6,50.0,2,3,5,3,0,1,0,0,1,2
../kbl_data/2022-2023,S41G01N16,원주 DB,Home,박인웅,5,0,0,0.0,1,1,100.0,1,1,100.0,2,2,100.0,1,2,3,0,0,0,0,0,1,3
../kbl_data/2022-2023,S41G01N16,서울 SK,Away,양우섭,0,0,1,0.0,0,1,0.0,0,2,0.0,0,0,0.0,0,2,2,1,0,0,0,0,1,1
../kbl_data/2022-2023,S41G01N16,서울 SK,Away,허일영,11,2,3,66.7,1,2,50.0,3,5,60.0,4,4,100.0,0,9,9,0,1,0,0,0,1,4
../kbl_data/2022-2023,S41G01N16,서울 SK,Away,송창용,11,1,3,33.3,2,3,66.7,3,6,50.0,3,3,100.0,1,1,2,0,0,0,0,0,0,0
../kbl_data/2022-2023,S41G01N16,서울 SK,Away,김선형,16,5,12,41.7,1,1,100.0,6,13,46.2,3,5,60.0,1,0,1,7,1,0,0,0,3,2
../kbl_data/2022-2023,S41G01N16,서울 SK,Away,홍경기,0,0,0,0.0,0,0,0.0,0,0,0.0,0,0,0.0,0,0,0,0,0,0,0,0,0,0
../kbl_data/2022-2023,S41G01N16,서울 SK,Away,최부경,4,1,3,33.3,0,0,0.0,1,3,33.3,2,2,100.0,2,4,6,2,1,0,0,0,2,3
../kbl_data/2022-2023,S41G01N16,서울 SK,Away,김승원,2,1,2,50.0,0,0,0.0,1,2,50.0,0,0,0.0,2,4,6,0,0,0,0,0,0,2
../kbl_data/2022-2023,S41G01N16,서울 SK,Away,리온 윌리엄스,5,2,4,50.0,0,1,0.0,2,5,40.0,1,1,100.0,2,2,4,0,1,0,0,0,1,0
../kbl_data/2022-2023,S41G01N16,서울 SK,Away,최원혁,2,1,1,100.0,0,1,0.0,1,2,50.0,0,2,0.0,0,1,1,2,1,0,0,0,1,2
../kbl_data/2022-2023,S41G01N16,서울 SK,Away,장문호,0,0,0,0.0,0,0,0.0,0,0,0.0,0,0,0.0,0,0,0,0,0,0,0,0,0,0
../kbl_data/2022-2023,S41G01N16,서울 SK,Away,자밀 워니,28,12,22,54.5,1,2,50.0,13,24,54.2,1,6,16.7,4,5,9,3,0,1,0,1,3,3
../kbl_data/2022-2023,S41G01N16,서울 SK,Away,오재현,4,2,5,40.0,0,0,0.0,2,5,40.0,0,0,0.0,1,0,1,0,0,0,0,0,0,1
../kbl_data/2022-2023,S41G01N17,서울 삼성,Home,이정현,7,1,4,25.0,0,4,0.0,1,8,12.5,5,6,83.3,2,0,2,5,3,0,0,0,1,2
../kbl_data/2022-2023,S41G01N17,서울 삼성,Home,장민국,5,0,0,0.0,1,1,100.0,1,1,100.0,2,3,66.7,1,0,1,1,1,0,0,0,0,4
../kbl_data/2022-2023,S41G01N17,서울 삼성,Home,김시래,6,1,4,25.0,1,5,20.0,2,9,22.2,1,2,50.0,1,3,4,5,1,0,1,0,2,3
../kbl_data/2022-2023,S41G01N17,서울 삼성,Home,김현수,0,0,0,0.0,0,0,0.0,0,0,0.0,0,0,0.0,0,0,0,0,0,0,0,0,0,0
../kbl_data/2022-2023,S41G01N17,서울 삼성,Home,임동섭,8,1,3,33.3,2,3,66.7,3,6,50.0,0,0,0.0,0,0,0,0,1,0,0,0,1,0
../kbl_data/2022-2023,S41G01N17,서울 삼성,Home,이동엽,9,3,5,60.0,1,4,25.0,4,9,44.4,0,0,0.0,5,3,8,5,2,0,0,0,2,4
../kbl_data/2022-2023,S41G01N17,서울 삼성,Home,이호현,11,4,5,80.0,1,2,50.0,5,7,71.4,0,0,0.0,0,0,0,2,0,0,0,0,0,0
../kbl_data/2022-2023,S41G01N17,서울 삼성,Home,마커스 데릭슨,25,5,10,50.0,3,4,75.0,8,14,57.1,6,9,66.7,1,8,9,0,0,0,0,0,0,2
../kbl_data/2022-2023,S41G01N17,서울 삼성,Home,조우성,0,0,0,0.0,0,0,0.0,0,0,0.0,0,0,0.0,0,2,2,0,0,0,0,0,0,3
../kbl_data/2022-2023,S41G01N17,서울 삼성,Home,이원석,6,3,5,60.0,0,0,0.0,3,5,60.0,0,0,0.0,3,2,5,2,0,2,0,0,0,4
../kbl_data/2022-2023,S41G01N17,서울 삼성,Home,이매뉴얼 테리,2,0,0,0.0,0,0,0.0,0,0,0.0,2,2,100.0,0,2,2,0,0,1,0,0,1,1
../kbl_data/2022-2023,S41G01N17,서울 삼성,Home,신동혁,2,1,1,100.0,0,3,0.0,1,4,25.0,0,0,0.0,0,0,0,0,0,0,0,0,1,1
../kbl_data/2022-2023,S41G01N17,대구 한국가스공사,Away,박지훈,0,0,0,0.0,0,1,0.0,0,1,0.0,0,0,0.0,1,1,2,2,0,0,0,0,0,3
../kbl_data/2022-2023,S41G01N17,대구 한국가스공사,Away,이원대,3,0,3,0.0,1,1,100.0,1,4,25.0,0,0,0.0,0,2,2,1,0,0,0,0,2,0
../kbl_data/2022-2023,S41G01N17,대구 한국가스공사,Away,이대헌,2,0,2,0.0,0,1,0.0,0,3,0.0,2,2,100.0,0,1,1,0,0,0,0,0,1,1
../kbl_data/2022-2023,S41G01N17,대구 한국가스공사,Away,이대성,19,7,14,50.0,1,3,33.3,8,17,47.1,2,2,100.0,0,3,3,1,1,0,0,0,3,3
../kbl_data/2022-2023,S41G01N17,대구 한국가스공사,Away,정효근,16,2,6,33.3,1,6,16.7,3,12,25.0,9,11,81.8,1,1,2,1,0,1,0,0,2,1
../kbl_data/2022-2023,S41G01N17,대구 한국가스공사,Away,박봉진,0,0,0,0.0,0,0,0.0,0,0,0.0,0,0,0.0,0,0,0,0,0,0,0,0,0,0
../kbl_data/2022-2023,S41G01N17,대구 한국가스공사,Away,머피 할로웨이,10,5,7,71.4,0,0,0.0,5,7,71.4,0,0,0.0,6,1,7,1,0,1,0,0,2,2
../kbl_data/2022-2023,S41G01N17,대구 한국가스공사,Away,우동현,0,0,0,0.0,0,0,0.0,0,0,0.0,0,0,0.0,0,0,0,0,0,0,0,0,0,1
../kbl_data/2022-2023,S41G01N17,대구 한국가스공사,Away,전현우,0,0,0,0.0,0,1,0.0,0,1,0.0,0,0,0.0,0,0,0,0,0,0,0,0,0,0
../kbl_data/2022-2023,S41G01N17,대구 한국가스공사,Away,신승민,2,0,0,0.0,0,0,0.0,0,0,0.0,2,2,100.0,2,1,3,1,0,0,1,0,2,4
../kbl_data/2022-2023,S41G01N17,대구 한국가스공사,Away,샘조세프 벨란겔,6,3,5,60.0,0,2,0.0,3,7,42.9,0,2,0.0,0,7,7,2,3,0,0,0,1,2
../kbl_data/2022-2023,S41G01N17,대구 한국가스공사,Away,유슈 은도예,12,5,8,62.5,0,0,0.0,5,8,62.5,2,4,50.0,4,7,11,2,1,1,0,2,2,4
../kbl_data/2022-2023,S41G01N18,전주 KCC,Home,정창영,14,1,5,20.0,4,6,66.7,5,11,45.5,0,0,0.0,1,2,3,7,1,0,0,0,4,4
../kbl_data/2022-2023,S41G01N18,전주 KCC,Home,라건아,15,7,13,53.8,0,1,0.0,7,14,50.0,1,1,100.0,8,5,13,2,0,0,0,1,1,2
../kbl_data/2022-2023,S41G01N18,전주 KCC,Home,박경상,9,2,2,100.0,1,2,50.0,3,4,75.0,2,2,100.0,1,1,2,2,2,0,2,0,1,3
../kbl_data/2022-2023,S41G01N18,전주 KCC,Home,김상규,2,1,2,50.0,0,0,0.0,1,2,50.0,0,1,0.0,2,2,4,1,0,0,0,0,1,0
../kbl_data/2022-2023,S41G01N18,전주 KCC,Home,유병훈,0,0,0,0.0,0,0,0.0,0,0,0.0,0,0,0.0,0,0,0,0,0,0,0,0,0,0
../kbl_data/2022-2023,S41G01N18,전주 KCC,Home,허웅,15,4,8,50.0,2,9,22.2,6,17,35.3,1,2,50.0,1,6,7,6,1,0,0,0,1,2
../kbl_data/2022-2023,S41G01N18,전주 KCC,Home,이승현,5,2,10,20.0,0,1,0.0,2,11,18.2,1,2,50.0,5,4,9,2,0,0,0,0,0,3
../kbl_data/2022-2023,S41G01N18,전주 KCC,Home,이진욱,0,0,0,0.0,0,0,0.0,0,0,0.0,0,0,0.0,0,0,0,0,0,0,0,0,0,0
../kbl_data/2022-2023,S41G01N18,전주 KCC,Home,이근휘,23,1,3,33.3,7,12,58.3,8,15,53.3,0,0,0.0,3,2,5,1,1,0,0,0,0,1
../kbl_data/2022-2023,S41G01N18,전주 KCC,Home,김동현,0,0,0,0.0,0,0,0.0,0,0,0.0,0,0,0.0,0,0,0,0,0,0,0,0,0,0
../kbl_data/2022-2023,S41G01N18,전주 KCC,Home,론데 홀리스 제퍼슨,13,6,12,50.0,0,0,0.0,6,12,50.0,1,1,100.0,2,3,5,1,1,0,0,0,2,0
../kbl_data/2022-2023,S41G01N18,전주 KCC,Home,송동훈,3,0,2,0.0,1,2,50.0,1,4,25.0,0,0,0.0,0,1,1,1,0,0,0,0,0,1
../kbl_data/2022-2023,S41G01N18,안양 KGC,Away,양희종,0,0,2,0.0,0,1,0.0,0,3,0.0,0,0,0.0,0,1,1,1,0,0,0,0,0,2
../kbl_data/2022-2023,S41G01N18,안양 KGC,Away,함준후,0,0,0,0.0,0,0,0.0,0,0,0.0,0,0,0.0,0,0,0,0,0,0,0,0,0,0
../kbl_data/2022-2023,S41G01N18,안양 KGC,Away,오세근,10,5,12,41.7,0,1,0.0,5,13,38.5,0,1,0.0,4,8,12,3,1,1,0,0,4,1
../kbl_data/2022-2023,S41G01N18,안양 KGC,Away,정준원,0,0,0,0.0,0,0,0.0,0,0,0.0,0,0,0.0,0,1,1,0,0,0,0,0,0,0
../kbl_data/2022-2023,S41G01N18,안양 KGC,Away,배병준,9,2,2,100.0,1,1,100.0,3,3,100.0,2,3,66.7,1,2,3,2,1,0,0,0,1,2
../kbl_data/2022-2023,S41G01N18,안양 KGC,Away,문성곤,13,2,3,66.7,3,11,27.3,5,14,35.7,0,0,0.0,3,4,7,5,1,0,1,0,0,3
../kbl_data/2022-2023,S41G01N18,안양 KGC,Away,김철욱,0,0,0,0.0,0,0,0.0,0,0,0.0,0,0,0.0,0,0,0,0,0,0,0,0,0,0
../kbl_data/2022-2023,S41G01N18,안양 KGC,Away,박지훈,9,3,3,100.0,1,2,50.0,4,5,80.0,0,0,0.0,0,2,2,4,1,0,0,0,1,3
../kbl_data/2022-2023,S41G01N18,안양 KGC,Away,대릴 먼로,0,0,0,0.0,0,1,0.0,0,1,0.0,0,0,0.0,0,0,0,0,0,0,0,0,0,0
../kbl_data/2022-2023,S41G01N18,안양 KGC,Away,변준형,17,5,7,71.4,2,3,66.7,7,10,70.0,1,2,50.0,0,2,2,6,0,0,2,0,3,4
../kbl_data/2022-2023,S41G01N18,안양 KGC,Away,한승희,3,1,1,100.0,0,0,0.0,1,1,100.0,1,2,50.0,0,0,0,0,0,0,1,0,1,1
../kbl_data/2022-2023,S41G01N18,안양 KGC,Away,오마리 스펠맨,32,4,7,57.1,8,14,57.1,12,21,57.1,0,2,0.0,1,8,9,2,1,1,0,1,2,2
../kbl_data/2022-2023,S41G01N19,창원 LG,Home,이관희,0,0,0,0.0,0,1,0.0,0,1,0.0,0,0,0.0,0,2,2,2,0,0,0,0,0,1
../kbl_data/2022-2023,S41G01N19,창원 LG,Home,정희재,2,0,0,0.0,0,0,0.0,0,0,0.0,2,2,100.0,1,0,1,1,0,0,0,0,1,4
../kbl_data/2022-2023,S41G01N19,창원 LG,Home,서민수,7,2,5,40.0,1,4,25.0,3,9,33.3,0,0,0.0,0,0,0,1,0,1,0,0,2,4
../kbl_data/2022-2023,S41G01N19,창원 LG,Home,한상혁,8,3,3,100.0,0,0,0.0,3,3,100.0,2,2,100.0,1,0,1,1,1,0,0,0,0,0
../kbl_data/2022-2023,S41G01N19,창원 LG,Home,이재도,24,7,13,53.8,3,5,60.0,10,18,55.6,1,1,100.0,1,3,4,5,2,0,0,0,0,0
../kbl_data/2022-2023,S41G01N19,창원 LG,Home,김준일,3,1,1,100.0,0,0,0.0,1,1,100.0,1,4,25.0,0,1,1,0,0,0,0,0,0,0
../kbl_data/2022-2023,S41G01N19,창원 LG,Home,박인태,0,0,0,0.0,0,0,0.0,0,0,0.0,0,0,0.0,1,1,2,1,0,0,0,0,0,0
../kbl_data/2022-2023,S41G01N19,창원 LG,Home,정인덕,0,0,0,0.0,0,1,0.0,0,1,0.0,0,0,0.0,0,1,1,0,0,0,0,0,0,1
../kbl_data/2022-2023,S41G01N19,창원 LG,Home,윤원상,7,2,4,50.0,1,4,25.0,3,8,37.5,0,0,0.0,0,1,1,2,0,0,0,0,0,3
../kbl_data/2022-2023,S41G01N19,창원 LG,Home,아셈 마레이,19,8,16,50.0,0,0,0.0,8,16,50.0,3,5,60.0,3,10,13,4,3,1,0,0,1,2
../kbl_data/2022-2023,S41G01N19,창원 LG,Home,이승우,10,2,4,50.0,1,1,100.0,3,5,60.0,3,4,75.0,3,7,10,1,0,0,0,0,2,3
../kbl_data/2022-2023,S41G01N19,창원 LG,Home,단테 커닝햄,5,2,4,50.0,0,0,0.0,2,4,50.0,1,2,50.0,0,1,1,2,1,0,0,0,0,2
../kbl_data/2022-2023,S41G01N19,수원 KT,Away,김동욱,6,0,0,0.0,2,4,50.0,2,4,50.0,0,0,0.0,0,0,0,3,1,0,0,0,0,1
../kbl_data/2022-2023,S41G01N19,수원 KT,Away,김영환,0,0,0,0.0,0,0,0.0,0,0,0.0,0,0,0.0,0,0,0,0,0,0,0,0,0,1
../kbl_data/2022-2023,S41G01N19,수원 KT,Away,김민욱,0,0,0,0.0,0,0,0.0,0,0,0.0,0,0,0.0,0,0,0,0,0,0,0,0,0,0
../kbl_data/2022-2023,S41G01N19,수원 KT,Away,한희원,1,0,1,0.0,0,1,0.0,0,2,0.0,1,2,50.0,0,0,0,0,0,0,0,0,0,2
../kbl_data/2022-2023,S41G01N19,수원 KT,Away,정성우,8,1,5,20.0,2,4,50.0,3,9,33.3,0,0,0.0,0,3,3,2,1,0,1,0,3,2
../kbl_data/2022-2023,S41G01N19,수원 KT,Away,최성모,11,1,2,50.0,2,2,100.0,3,4,75.0,3,4,75.0,2,2,4,0,0,0,0,0,2,0
../kbl_data/2022-2023,S41G01N19,수원 KT,Away,양홍석,6,3,8,37.5,0,4,0.0,3,12,25.0,0,1,0.0,2,6,8,2,2,0,0,0,2,2
../kbl_data/2022-2023,S41G01N19,수원 KT,Away,박지원,3,1,3,33.3,0,1,0.0,1,4,25.0,1,2,50.0,1,1,2,3,0,0,0,0,0,5
../kbl_data/2022-2023,S41G01N19,수원 KT,Away,김준환,4,2,2,100.0,0,2,0.0,2,4,50.0,0,0,0.0,0,1,1,0,0,0,0,0,2,0
../kbl_data/2022-2023,S41G01N19,수원 KT,Away,하윤기,10,5,11,45.5,0,0,0.0,5,11,45.5,0,1,0.0,2,5,7,1,0,1,0,0,0,3
../kbl_data/2022-2023,S41G01N19,수원 KT,Away,이제이 아노시케,5,1,6,16.7,0,1,0.0,1,7,14.3,3,5,60.0,2,3,5,0,1,0,0,0,1,2
../kbl_data/2022-2023,S41G01N19,수원 KT,Away,랜드리 은노코,12,5,7,71.4,0,0,0.0,5,7,71.4,2,5,40.0,6,4,10,0,0,1,0,3,4,4
../kbl_data/2022-2023,S41G01N20,서울 SK,Home,양우섭,3,1,1,100.0,0,1,0.0,1,2,50.0,1,1,100.0,0,1,1,3,0,0,0,0,0,0
../kbl_data/2022-2023,S41G01N20,서울 SK,Home,허일영,13,2,4,50.0,2,6,33.3,4,10,40.0,3,4,75.0,1,2,3,0,2,0,0,0,0,2
../kbl_data/2022-2023,S41G01N20,서울 SK,Home,송창용,0,0,0,0.0,0,1,0.0,0,1,0.0,0,0,0.0,0,1,1,0,0,0,0,0,1,0
../kbl_data/2022-2023,S41G01N20,서울 SK,Home,김선형,8,4,8,50.0,0,2,0.0,4,10,40.0,0,0,0.0,0,3,3,11,1,0,0,0,1,1
../kbl_data/2022-2023,S41G01N20,서울 SK,Home,홍경기,2,1,1,100.0,0,1,0.0,1,2,50.0,0,0,0.0,0,0,0,0,0,0,0,0,0,1
../kbl_data/2022-2023,S41G01N20,서울 SK,Home,최부경,6,3,5,60.0,0,1,0.0,3,6,50.0,0,0,0.0,1,3,4,0,2,0,0,0,3,4
../kbl_data/2022-2023,S41G01N20,서울 SK,Home,김승원,1,0,0,0.0,0,0,0.0,0,0,0.0,1,2,50.0,3,2,5,0,0,0,0,0,1,5
../kbl_data/2022-2023,S41G01N20,서울 SK,Home,리온 윌리엄스,14,1,2,50.0,4,4,100.0,5,6,83.3,0,0,0.0,1,2,3,2,0,1,0,0,0,3
../kbl_data/2022-2023,S41G01N20,서울 SK,Home,최원혁,0,0,0,0.0,0,0,0.0,0,0,0.0,0,0,0.0,0,0,0,3,1,0,0,0,0,0
../kbl_data/2022-2023,S41G01N20,서울 SK,Home,장문호,0,0,0,0.0,0,0,0.0,0,0,0.0,0,0,0.0,0,0,0,0,0,0,0,0,0,0
../kbl_data/2022-2023,S41G01N20,서울 SK,Home,자밀 워니,29,8,18,44.4,1,4,25.0,9,22,40.9,10,12,83.3,1,6,7,0,1,1,0,1,1,1
../kbl_data/2022-2023,S41G01N20,서울 SK,Home,오재현,8,4,6,66.7,0,1,0.0,4,7,57.1,0,0,0.0,0,1,1,2,0,1,0,0,1,1
../kbl_data/2022-2023,S41G01N20,울산 현대모비스,Away,함지훈,8,4,4,100.0,0,0,0.0,4,4,100.0,0,0,0.0,1,2,3,3,0,0,0,0,0,1
../kbl_data/2022-2023,S41G01N20,울산 현대모비스,Away,김현민,0,0,0,0.0,0,0,0.0,0,0,0.0,0,0,0.0,0,0,0,0,0,0,0,0,0,0
../kbl_data/2022-2023,S41G01N20,울산 현대모비스,Away,장재석,7,3,3,100.0,0,0,0.0,3,3,100.0,1,2,50.0,0,3,3,2,1,0,0,0,0,2
../kbl_data/2022-2023,S41G01N20,울산 현대모비스,Away,김영현,0,0,1,0.0,0,2,0.0,0,3,0.0,0,0,0.0,0,3,3,2,1,0,0,0,1,2
../kbl_data/2022-2023,S41G01N20,울산 현대모비스,Away,김국찬,2,0,0,0.0,0,1,0.0,0,1,0.0,2,2,100.0,0,1,1,0,0,0,0,0,1,0
../kbl_data/2022-2023,S41G01N20,울산 현대모비스,Away,서명진,18,4,6,66.7,3,7,42.9,7,13,53.8,1,2,50.0,0,2,2,5,0,0,0,0,1,3
../kbl_data/2022-2023,S41G01N20,울산 현대모비스,Away,저스틴 녹스,10,5,6,83.3,0,0,0.0,5,6,83.3,0,0,0.0,1,2,3,2,0,0,0,1,1,3
../kbl_data/2022-2023,S41G01N20,울산 현대모비스,Away,이우석,0,0,8,0.0,0,2,0.0,0,10,0.0,0,0,0.0,2,2,4,1,0,0,0,0,1,1
../kbl_data/2022-2023,S41G01N20,울산 현대모비스,Away,신민석,0,0,0,0.0,0,0,0.0,0,0,0.0,0,0,0.0,0,0,0,0,0,0,0,0,0,0
../kbl_data/2022-2023,S41G01N20,울산 현대모비스,Away,김동준,3,0,1,0.0,1,2,50.0,1,3,33.3,0,0,0.0,0,1,1,0,0,0,0,0,0,0
../kbl_data/2022-2023,S41G01N20,울산 현대모비스,Away,론제이 아바리엔토스,23,2,3,66.7,6,7,85.7,8,10,80.0,1,1,100.0,0,6,6,4,3,0,0,0,3,4
../kbl_data/2022-2023,S41G01N20,울산 현대모비스,Away,게이지 프림,26,11,16,68.8,0,0,0.0,11,16,68.8,4,4,100.0,4,3,7,3,1,0,0,0,1,4
../kbl_data/2022-2023,S41G01N21,전주 KCC,Home,정창영,16,3,4,75.0,3,4,75.0,6,8,75.0,1,3,33.3,1,2,3,2,2,0,0,0,0,1
../kbl_data/2022-2023,S41G01N21,전주 KCC,Home,라건아,20,8,10,80.0,0,3,0.0,8,13,61.5,4,5,80.0,5,8,13,0,0,1,0,1,3,0
../kbl_data/2022-2023,S41G01N21,전주 KCC,Home,박경상,7,1,1,100.0,1,5,20.0,2,6,33.3,2,2,100.0,3,4,7,4,2,0,0,0,2,4
../kbl_data/2022-2023,S41G01N21,전주 KCC,Home,김상규,2,0,1,0.0,0,0,0.0,0,1,0.0,2,4,50.0,0,0,0,0,0,0,0,0,0,0
../kbl_data/2022-2023,S41G01N21,전주 KCC,Home,유병훈,0,0,0,0.0,0,0,0.0,0,0,0.0,0,0,0.0,0,0,0,0,0,0,0,0,0,0
../kbl_data/2022-2023,S41G01N21,전주 KCC,Home,허웅,23,7,10,70.0,2,8,25.0,9,18,50.0,3,4,75.0,0,1,1,7,1,0,0,0,3,2
../kbl_data/2022-2023,S41G01N21,전주 KCC,Home,이승현,6,2,9,22.2,0,0,0.0,2,9,22.2,2,2,100.0,3,5,8,2,2,0,0,0,1,3
../kbl_data/2022-2023,S41G01N21,전주 KCC,Home,이진욱,0,0,0,0.0,0,0,0.0,0,0,0.0,0,0,0.0,0,0,0,0,0,0,0,0,0,0
../kbl_data/2022-2023,S41G01N21,전주 KCC,Home,이근휘,11,1,1,100.0,3,10,30.0,4,11,36.4,0,0,0.0,0,2,2,1,1,0,0,0,1,2
../kbl_data/2022-2023,S41G01N21,전주 KCC,Home,김동현,0,0,0,0.0,0,0,0.0,0,0,0.0,0,0,0.0,0,0,0,0,0,0,0,0,0,0
../kbl_data/2022-2023,S41G01N21,전주 KCC,Home,론데 홀리스 제퍼슨,2,1,3,33.3,0,1,0.0,1,4,25.0,0,0,0.0,1,2,3,0,1,0,0,0,0,0
../kbl_data/2022-2023,S41G01N21,전주 KCC,Home,송동훈,3,0,1,0.0,1,1,100.0,1,2,50.0,0,0,0.0,0,1,1,2,0,0,0,0,0,2
../kbl_data/2022-2023,S41G01N21,고양 캐롯,Away,김강선,12,0,0,0.0,4,5,80.0,4,5,80.0,0,0,0.0,1,1,2,0,0,0,0,0,0,4
../kbl_data/2022-2023,S41G01N21,고양 캐롯,Away,데이비드 사이먼,15,5,8,62.5,1,1,100.0,6,9,66.7,2,2,100.0,0,6,6,1,2,0,0,1,0,2
../kbl_data/2022-2023,S41G01N21,고양 캐롯,Away,최현민,0,0,1,0.0,0,1,0.0,0,2,0.0,0,0,0.0,0,1,1,0,0,0,0,0,0,1
../kbl_data/2022-2023,S41G01N21,고양 캐롯,Away,한호빈,12,2,2,100.0,2,7,28.6,4,9,44.4,2,2,100.0,0,5,5,5,0,0,0,0,4,3
../kbl_data/2022-2023,S41G01N21,고양 캐롯,Away,전성현,30,4,8,50.0,6,13,46.2,10,21,47.6,4,4,100.0,1,2,3,8,3,0,0,0,5,1
../kbl_data/2022-2023,S41G01N21,고양 캐롯,Away,이종현,4,2,4,50.0,0,0,0.0,2,4,50.0,0,0,0.0,1,3,4,2,1,2,0,0,0,2
../kbl_data/2022-2023,S41G01N21,고양 캐롯,Away,정해원,0,0,0,0.0,0,0,0.0,0,0,0.0,0,0,0.0,0,0,0,0,0,0,0,0,0,0
../kbl_data/2022-2023,S41G01N21,고양 캐롯,Away,조한진,0,0,0,0.0,0,1,0.0,0,1,0.0,0,0,0.0,0,0,0,0,0,0,0,0,0,1
../kbl_data/2022-2023,S41G01N21,고양 캐롯,Away,김세창,0,0,0,0.0,0,0,0.0,0,0,0.0,0,0,0.0,0,0,0,0,0,0,0,0,0,0
../kbl_data/2022-2023,S41G01N21,고양 캐롯,Away,디드릭 로슨,2,1,2,50.0,0,1,0.0,1,3,33.3,0,0,0.0,0,3,3,0,2,1,0,0,2,1
../kbl_data/2022-2023,S41G01N21,고양 캐롯,Away,박진철,0,0,0,0.0,0,0,0.0,0,0,0.0,0,0,0.0,0,0,0,0,0,0,0,0,0,2
../kbl_data/2022-2023,S41G01N21,고양 캐롯,Away,이정현,18,4,7,57.1,2,4,50.0,6,11,54.5,4,4,100.0,2,1,3,4,0,0,0,0,0,3
../kbl_data/2022-2023,S41G01N22,원주 DB,Home,박찬희,5,1,1,100.0,1,2,50.0,2,3,66.7,0,0,0.0,4,0,4,6,2,0,0,0,1,0
../kbl_data/2022-2023,S41G01N22,원주 DB,Home,김현호,0,0,0,0.0,0,0,0.0,0,0,0.0,0,0,0.0,0,0,0,0,0,0,0,0,0,3
../kbl_data/2022-2023,S41G01N22,원주 DB,Home,두경민,15,4,7,57.1,2,9,22.2,6,16,37.5,1,1,100.0,0,2,2,3,1,0,1,0,1,4
../kbl_data/2022-2023,S41G01N22,원주 DB,Home,김종규,8,3,3,100.0,0,0,0.0,3,3,100.0,2,2,100.0,0,3,3,1,0,0,0,0,0,2
../kbl_data/2022-2023,S41G01N22,원주 DB,Home,최승욱,14,5,6,83.3,1,2,50.0,6,8,75.0,1,1,100.0,1,2,3,2,0,0,0,0,0,4
../kbl_data/2022-2023,S41G01N22,원주 DB,Home,강상재,10,2,2,100.0,2,4,50.0,4,6,66.7,0,0,0.0,0,5,5,2,1,0,0,0,0,2
../kbl_data/2022-2023,S41G01N22,원주 DB,Home,윤성원,0,0,0,0.0,0,0,0.0,0,0,0.0,0,0,0.0,0,0,0,0,0,0,0,0,0,0
../kbl_data/2022-2023,S41G01N22,원주 DB,Home,정호영,0,0,0,0.0,0,0,0.0,0,0,0.0,0,0,0.0,0,0,0,0,0,0,0,0,0,0
../kbl_data/2022-2023,S41G01N22,원주 DB,Home,이선 알바노,8,4,11,36.4,0,1,0.0,4,12,33.3,0,0,0.0,0,0,0,11,1,0,0,0,1,3
../kbl_data/2022-2023,S41G01N22,원주 DB,Home,드완 에르난데스,30,14,23,60.9,0,0,0.0,14,23,60.9,2,2,100.0,1,5,6,2,0,2,0,6,3,2
../kbl_data/2022-2023,S41G01N22,원주 DB,Home,박인웅,4,1,2,50.0,0,0,0.0,1,2,50.0,2,2,100.0,1,1,2,0,1,0,0,0,0,1
../kbl_data/2022-2023,S41G01N22,원주 DB,Home,인승찬,0,0,0,0.0,0,0,0.0,0,0,0.0,0,0,0.0,0,0,0,0,0,0,0,0,0,0
../kbl_data/2022-2023,S41G01N22,서울 삼성,Away,이정현,17,4,7,57.1,1,7,14.3,5,14,35.7,6,7,85.7,0,1,1,5,0,0,0,0,4,3
../kbl_data/2022-2023,S41G01N22,서울 삼성,Away,장민국,2,0,0,0.0,0,2,0.0,0,2,0.0,2,2,100.0,1,1,2,0,0,0,0,0,0,0
../kbl_data/2022-2023,S41G01N22,서울 삼성,Away,김시래,12,2,4,50.0,2,5,40.0,4,9,44.4,2,3,66.7,1,1,2,1,0,0,0,0,3,3
../kbl_data/2022-2023,S41G01N22,서울 삼성,Away,김현수,0,0,0,0.0,0,0,0.0,0,0,0.0,0,0,0.0,0,0,0,0,0,0,0,0,0,0
../kbl_data/2022-2023,S41G01N22,서울 삼성,Away,임동섭,0,0,1,0.0,0,2,0.0,0,3,0.0,0,0,0.0,2,3,5,0,0,0,0,0,0,1
../kbl_data/2022-2023,S41G01N22,서울 삼성,Away,이동엽,2,1,3,33.3,0,2,0.0,1,5,20.0,0,0,0.0,0,2,2,1,0,0,0,0,1,1
../kbl_data/2022-2023,S41G01N22,서울 삼성,Away,이호현,8,3,6,50.0,0,0,0.0,3,6,50.0,2,3,66.7,1,1,2,3,1,0,0,0,0,4
../kbl_data/2022-2023,S41G01N22,서울 삼성,Away,마커스 데릭슨,2,1,1,100.0,0,2,0.0,1,3,33.3,0,0,0.0,0,0,0,0,0,0,0,0,1,1
../kbl_data/2022-2023,S41G01N22,서울 삼성,Away,조우성,6,2,2,100.0,0,0,0.0,2,2,100.0,2,2,100.0,1,0,1,2,0,0,0,0,0,1
../kbl_data/2022-2023,S41G01N22,서울 삼성,Away,이원석,9,2,3,66.7,1,1,100.0,3,4,75.0,2,2,100.0,3,3,6,1,0,1,1,0,0,1
../kbl_data/2022-2023,S41G01N22,서울 삼성,Away,이매뉴얼 테리,16,8,16,50.0,0,0,0.0,8,16,50.0,0,0,0.0,8,7,15,1,1,0,0,4,1,0
../kbl_data/2022-2023,S41G01N22,서울 삼성,Away,신동혁,7,2,2,100.0,1,4,25.0,3,6,50.0,0,0,0.0,0,0,0,0,0,0,0,0,1,1
../kbl_data/2022-2023,S41G01N23,대구 한국가스공사,Home,박지훈,1,0,2,0.0,0,0,0.0,0,2,0.0,1,2,50.0,2,1,3,0,3,0,0,0,0,2
../kbl_data/2022-2023,S41G01N23,대구 한국가스공사,Home,조상열,0,0,0,0.0,0,0,0.0,0,0,0.0,0,0,0.0,0,0,0,0,0,0,0,0,0,0
../kbl_data/2022-2023,S41G01N23,대구 한국가스공사,Home,이대헌,6,2,3,66.7,0,1,0.0,2,4,50.0,2,2,100.0,0,1,1,0,0,0,0,0,1,1
../kbl_data/2022-2023,S41G01N23,대구 한국가스공사,Home,이대성,19,5,11,45.5,1,6,16.7,6,17,35.3,6,7,85.7,0,5,5,9,1,0,0,0,4,5
../kbl_data/2022-2023,S41G01N23,대구 한국가스공사,Home,정효근,7,1,5,20.0,1,2,50.0,2,7,28.6,2,2,100.0,0,1,1,2,3,0,0,1,1,1
../kbl_data/2022-2023,S41G01N23,대구 한국가스공사,Home,머피 할로웨이,7,3,7,42.9,0,0,0.0,3,7,42.9,1,1,100.0,3,7,10,0,1,1,0,1,1,5
../kbl_data/2022-2023,S41G01N23,대구 한국가스공사,Home,우동현,0,0,2,0.0,0,1,0.0,0,3,0.0,0,0,0.0,0,0,0,0,0,0,0,0,3,1
../kbl_data/2022-2023,S41G01N23,대구 한국가스공사,Home,전현우,2,1,1,100.0,0,0,0.0,1,1,100.0,0,0,0.0,0,0,0,0,0,0,0,0,0,0
../kbl_data/2022-2023,S41G01N23,대구 한국가스공사,Home,양준우,0,0,0,0.0,0,0,0.0,0,0,0.0,0,0,0.0,0,0,0,0,0,0,0,0,0,0
../kbl_data/2022-2023,S41G01N23,대구 한국가스공사,Home,신승민,2,1,2,50.0,0,1,0.0,1,3,33.3,0,0,0.0,1,0,1,0,0,0,0,0,1,1
../kbl_data/2022-2023,S41G01N23,대구 한국가스공사,Home,샘조세프 벨란겔,13,4,7,57.1,1,3,33.3,5,10,50.0,2,3,66.7,0,1,1,1,0,0,0,0,1,1
../kbl_data/2022-2023,S41G01N23,대구 한국가스공사,Home,유슈 은도예,14,5,9,55.6,0,0,0.0,5,9,55.6,4,6,66.7,2,10,12,1,0,0,0,2,1,2
../kbl_data/2022-2023,S41G01N23,울산 현대모비스,Away,함지훈,6,2,3,66.7,0,0,0.0,2,3,66.7,2,2,100.0,2,4,6,5,0,0,0,0,0,2
../kbl_data/2022-2023,S41G01N23,울산 현대모비스,Away,김현민,0,0,0,0.0,0,0,0.0,0,0,0.0,0,0,0.0,0,0,0,0,0,0,0,0,0,0
../kbl_data/2022-2023,S41G01N23,울산 현대모비스,Away,장재석,4,1,5,20.0,0,0,0.0,1,5,20.0,2,2,100.0,3,2,5,3,1,2,0,0,0,1
../kbl_data/2022-2023,S41G01N23,울산 현대모비스,Away,김영현,11,1,1,100.0,3,3,100.0,4,4,100.0,0,0,0.0,0,1,1,0,0,0,1,0,0,2
../kbl_data/2022-2023,S41G01N23,울산 현대모비스,Away,김국찬,0,0,0,0.0,0,1,0.0,0,1,0.0,0,0,0.0,0,0,0,0,0,0,0,0,0,0
../kbl_data/2022-2023,S41G01N23,울산 현대모비스,Away,서명진,8,1,3,33.3,2,4,50.0,3,7,42.9,0,0,0.0,0,2,2,3,0,0,0,0,1,4
../kbl_data/2022-2023,S41G01N23,울산 현대모비스,Away,저스틴 녹스,7,3,7,42.9,0,1,0.0,3,8,37.5,1,1,100.0,3,5,8,0,1,1,0,1,1,2
../kbl_data/2022-2023,S41G01N23,울산 현대모비스,Away,이우석,13,5,9,55.6,1,6,16.7,6,15,40.0,0,2,0.0,1,7,8,2,0,0,0,0,1,2
../kbl_data/2022-2023,S41G01N23,울산 현대모비스,Away,신민석,0,0,2,0.0,0,1,0.0,0,3,0.0,0,0,0.0,2,0,2,0,1,0,0,0,0,1
../kbl_data/2022-2023,S41G01N23,울산 현대모비스,Away,김동준,0,0,2,0.0,0,1,0.0,0,3,0.0,0,0,0.0,0,0,0,1,1,0,0,0,0,1
../kbl_data/2022-2023,S41G01N23,울산 현대모비스,Away,론제이 아바리엔토스,17,4,6,66.7,3,10,30.0,7,16,43.8,0,1,0.0,0,3,3,3,1,0,0,0,3,3
../kbl_data/2022-2023,S41G01N23,울산 현대모비스,Away,게이지 프림,15,6,10,60.0,0,0,0.0,6,10,60.0,3,4,75.0,1,4,5,1,3,0,0,0,3,1
../kbl_data/2022-2023,S41G01N24,창원 LG,Home,이관희,9,3,5,60.0,1,3,33.3,4,8,50.0,0,1,0.0,0,5,5,1,1,1,0,0,1,1
../kbl_data/2022-2023,S41G01N24,창원 LG,Home,정희재,1,0,0,0.0,0,0,0.0,0,0,0.0,1,2,50.0,1,0,1,0,1,0,0,0,1,2
../kbl_data/2022-2023,S41G01N24,창원 LG,Home,서민수,5,1,6,16.7,1,4,25.0,2,10,20.0,0,0,0.0,3,1,4,3,1,0,0,0,3,5
../kbl_data/2022-2023,S41G01N24,창원 LG,Home,한상혁,3,0,2,0.0,1,1,100.0,1,3,33.3,0,0,0.0,0,0,0,0,0,0,0,0,2,0
../kbl_data/2022-2023,S41G01N24,창원 LG,Home,이재도,22,6,10,60.0,2,9,22.2,8,19,42.1,4,5,80.0,2,4,6,4,1,0,0,0,2,5
../kbl_data/2022-2023,S41G01N24,창원 LG,Home,김준일,0,0,1,0.0,0,0,0.0,0,1,0.0,0,0,0.0,1,4,5,0,0,1,0,0,3,2
../kbl_data/2022-2023,S41G01N24,창원 LG,Home,박인태,0,0,0,0.0,0,0,0.0,0,0,0.0,0,0,0.0,0,0,0,0,0,0,0,0,0,0
../kbl_data/2022-2023,S41G01N24,창원 LG,Home,정인덕,0,0,0,0.0,0,0,0.0,0,0,0.0,0,0,0.0,0,0,0,0,0,0,0,0,0,0
../kbl_data/2022-2023,S41G01N24,창원 LG,Home,윤원상,10,0,1,0.0,2,5,40.0,2,6,33.3,4,4,100.0,0,1,1,0,1,0,0,0,1,2
../kbl_data/2022-2023,S41G01N24,창원 LG,Home,아셈 마레이,15,5,10,50.0,0,0,0.0,5,10,50.0,5,7,71.4,4,8,12,0,1,2,0,0,2,3
../kbl_data/2022-2023,S41G01N24,창원 LG,Home,이승우,6,3,5,60.0,0,1,0.0,3,6,50.0,0,0,0.0,1,2,3,5,0,0,0,0,3,2
../kbl_data/2022-2023,S41G01N24,창원 LG,Home,단테 커닝햄,8,3,4,75.0,0,0,0.0,3,4,75.0,2,4,50.0,1,2,3,0,2,2,0,1,1,3
../kbl_data/2022-2023,S41G01N24,안양 KGC,Away,양희종,0,0,1,0.0,0,3,0.0,0,4,0.0,0,0,0.0,0,2,2,1,4,3,0,0,1,2
../kbl_data/2022-2023,S41G01N24,안양 KGC,Away,오세근,6,1,4,25.0,1,3,33.3,2,7,28.6,1,2,50.0,0,4,4,2,0,0,0,0,2,1
../kbl_data/2022-2023,S41G01N24,안양 KGC,Away,정준원,3,0,1,0.0,1,1,100.0,1,2,50.0,0,0,0.0,0,0,0,1,0,0,0,0,1,3
../kbl_data/2022-2023,S41G01N24,안양 KGC,Away,배병준,9,1,3,33.3,1,2,50.0,2,5,40.0,4,4,100.0,1,3,4,1,0,0,0,0,0,2
../kbl_data/2022-2023,S41G01N24,안양 KGC,Away,문성곤,6,2,4,50.0,0,4,0.0,2,8,25.0,2,2,100.0,2,3,5,1,1,0,0,0,1,4
../kbl_data/2022-2023,S41G01N24,안양 KGC,Away,박지훈,9,3,5,60.0,1,3,33.3,4,8,50.0,0,0,0.0,0,2,2,2,2,0,1,0,3,3
../kbl_data/2022-2023,S41G01N24,안양 KGC,Away,이우정,0,0,0,0.0,0,0,0.0,0,0,0.0,0,0,0.0,0,0,0,0,0,0,0,0,0,0
../kbl_data/2022-2023,S41G01N24,안양 KGC,Away,대릴 먼로,17,5,7,71.4,1,1,100.0,6,8,75.0,4,4,100.0,1,5,6,2,2,0,0,0,1,2
../kbl_data/2022-2023,S41G01N24,안양 KGC,Away,변준형,10,4,5,80.0,0,4,0.0,4,9,44.4,2,5,40.0,1,0,1,4,0,0,4,0,3,4
../kbl_data/2022-2023,S41G01N24,안양 KGC,Away,한승희,0,0,1,0.0,0,0,0.0,0,1,0.0,0,0,0.0,0,1,1,0,0,0,0,0,1,0
../kbl_data/2022-2023,S41G01N24,안양 KGC,Away,오마리 스펠맨,23,4,7,57.1,3,6,50.0,7,13,53.8,6,6,100.0,5,5,10,1,0,1,0,1,1,4
../kbl_data/2022-2023,S41G01N24,안양 KGC,Away,고찬혁,0,0,0,0.0,0,0,0.0,0,0,0.0,0,0,0.0,0,0,0,0,0,0,0,0,0,0
../kbl_data/2022-2023,S41G01N25,전주 KCC,Home,정창영,11,3,6,50.0,1,2,50.0,4,8,50.0,2,3,66.7,0,2,2,5,2,0,0,0,2,3
../kbl_data/2022-2023,S41G01N25,전주 KCC,Home,라건아,21,8,13,61.5,1,3,33.3,9,16,56.2,2,4,50.0,5,10,15,0,0,0,0,1,1,4
../kbl_data/2022-2023,S41G01N25,전주 KCC,Home,박경상,0,0,0,0.0,0,2,0.0,0,2,0.0,0,0,0.0,0,0,0,1,0,0,0,0,0,0
../kbl_data/2022-2023,S41G01N25,전주 KCC,Home,김상규,0,0,0,0.0,0,0,0.0,0,0,0.0,0,0,0.0,0,0,0,0,0,0,0,0,0,0
../kbl_data/2022-2023,S41G01N25,전주 KCC,Home,유병훈,0,0,0,0.0,0,0,0.0,0,0,0.0,0,0,0.0,0,0,0,0,0,0,0,0,0,0
../kbl_data/2022-2023,S41G01N25,전주 KCC,Home,허웅,27,3,5,60.0,4,9,44.4,7,14,50.0,9,9,100.0,0,2,2,5,0,0,0,0,3,1
../kbl_data/2022-2023,S41G01N25,전주 KCC,Home,이승현,6,3,11,27.3,0,1,0.0,3,12,25.0,0,0,0.0,4,2,6,3,3,0,1,0,1,2
../kbl_data/2022-2023,S41G01N25,전주 KCC,Home,이진욱,4,2,2,100.0,0,0,0.0,2,2,100.0,0,0,0.0,1,1,2,0,0,0,0,0,0,2
../kbl_data/2022-2023,S41G01N25,전주 KCC,Home,이근휘,3,0,3,0.0,1,5,20.0,1,8,12.5,0,0,0.0,1,1,2,0,0,0,0,0,1,2
../kbl_data/2022-2023,S41G01N25,전주 KCC,Home,김동현,0,0,0,0.0,0,0,0.0,0,0,0.0,0,0,0.0,0,0,0,0,0,0,0,0,0,0
../kbl_data/2022-2023,S41G01N25,전주 KCC,Home,론데 홀리스 제퍼슨,10,3,8,37.5,0,1,0.0,3,9,33.3,4,6,66.7,2,6,8,2,1,1,0,0,1,1
../kbl_data/2022-2023,S41G01N25,전주 KCC,Home,송동훈,0,0,0,0.0,0,2,0.0,0,2,0.0,0,0,0.0,2,0,2,1,0,0,0,0,0,4
../kbl_data/2022-2023,S41G01N25,원주 DB,Away,박찬희,0,0,1,0.0,0,1,0.0,0,2,0.0,0,0,0.0,2,1,3,2,0,0,0,0,0,1
../kbl_data/2022-2023,S41G01N25,원주 DB,Away,김현호,0,0,1,0.0,0,1,0.0,0,2,0.0,0,0,0.0,0,1,1,0,0,0,1,0,0,2
../kbl_data/2022-2023,S41G01N25,원주 DB,Away,두경민,15,2,3,66.7,3,8,37.5,5,11,45.5,2,3,66.7,0,2,2,5,1,1,0,0,1,3
../kbl_data/2022-2023,S41G01N25,원주 DB,Away,김종규,4,2,2,100.0,0,1,0.0,2,3,66.7,0,0,0.0,1,2,3,0,0,0,0,0,2,2
../kbl_data/2022-2023,S41G01N25,원주 DB,Away,최승욱,9,4,5,80.0,0,0,0.0,4,5,80.0,1,2,50.0,1,3,4,2,2,1,0,0,0,3
../kbl_data/2022-2023,S41G01N25,원주 DB,Away,강상재,13,5,6,83.3,1,1,100.0,6,7,85.7,0,1,0.0,2,5,7,5,2,1,0,0,1,3
../kbl_data/2022-2023,S41G01N25,원주 DB,Away,윤성원,0,0,0,0.0,0,0,0.0,0,0,0.0,0,0,0.0,0,0,0,0,0,0,0,0,0,0
../kbl_data/2022-2023,S41G01N25,원주 DB,Away,레나드 프리먼,2,1,2,50.0,0,0,0.0,1,2,50.0,0,0,0.0,0,5,5,0,0,0,0,0,1,4
../kbl_data/2022-2023,S41G01N25,원주 DB,Away,정호영,0,0,0,0.0,0,0,0.0,0,0,0.0,0,0,0.0,0,0,0,0,0,0,0,0,0,0
../kbl_data/2022-2023,S41G01N25,원주 DB,Away,이선 알바노,26,7,12,58.3,3,7,42.9,10,19,52.6,3,3,100.0,0,1,1,4,1,1,0,0,2,3
../kbl_data/2022-2023,S41G01N25,원주 DB,Away,드완 에르난데스,17,8,14,57.1,0,1,0.0,8,15,53.3,1,2,50.0,0,8,8,1,0,2,0,2,2,4
../kbl_data/2022-2023,S41G01N25,원주 DB,Away,박인웅,1,0,1,0.0,0,0,0.0,0,1,0.0,1,2,50.0,1,0,1,1,0,0,0,0,0,0
../kbl_data/2022-2023,S41G01N26,수원 KT,Home,김동욱,6,0,2,0.0,2,4,50.0,2,6,33.3,0,0,0.0,0,4,4,2,0,0,0,0,2,1
../kbl_data/2022-2023,S41G01N26,수원 KT,Home,김영환,0,0,0,0.0,0,0,0.0,0,0,0.0,0,0,0.0,0,0,0,0,0,0,0,0,0,0
../kbl_data/2022-2023,S41G01N26,수원 KT,Home,김민욱,9,2,3,66.7,1,4,25.0,3,7,42.9,2,2,100.0,1,1,2,1,0,1,0,0,0,1
../kbl_data/2022-2023,S41G01N26,수원 KT,Home,한희원,0,0,0,0.0,0,0,0.0,0,0,0.0,0,0,0.0,0,0,0,0,0,0,0,0,0,0
../kbl_data/2022-2023,S41G01N26,수원 KT,Home,최창진,8,1,4,25.0,1,1,100.0,2,5,40.0,3,3,100.0,0,2,2,2,0,0,1,0,1,2
../kbl_data/2022-2023,S41G01N26,수원 KT,Home,이현석,9,0,0,0.0,3,6,50.0,3,6,50.0,0,0,0.0,1,2,3,0,0,0,1,0,1,2
../kbl_data/2022-2023,S41G01N26,수원 KT,Home,정성우,7,2,5,40.0,1,4,25.0,3,9,33.3,0,0,0.0,0,1,1,6,0,1,0,0,5,2
../kbl_data/2022-2023,S41G01N26,수원 KT,Home,양홍석,12,3,8,37.5,1,5,20.0,4,13,30.8,3,3,100.0,1,6,7,6,1,0,0,0,2,3
../kbl_data/2022-2023,S41G01N26,수원 KT,Home,박지원,2,1,2,50.0,0,1,0.0,1,3,33.3,0,0,0.0,0,2,2,0,0,0,0,0,0,2
../kbl_data/2022-2023,S41G01N26,수원 KT,Home,하윤기,2,1,2,50.0,0,0,0.0,1,2,50.0,0,0,0.0,0,1,1,1,1,0,0,0,0,0
../kbl_data/2022-2023,S41G01N26,수원 KT,Home,이제이 아노시케,2,0,2,0.0,0,2,0.0,0,4,0.0,2,2,100.0,0,0,0,0,1,0,0,0,0,0
../kbl_data/2022-2023,S41G01N26,수원 KT,Home,랜드리 은노코,12,5,7,71.4,0,0,0.0,5,7,71.4,2,2,100.0,1,6,7,0,1,1,0,1,1,1
../kbl_data/2022-2023,S41G01N26,고양 캐롯,Away,김강선,0,0,0,0.0,0,0,0.0,0,0,0.0,0,0,0.0,0,0,0,0,0,0,0,0,0,0
../kbl_data/2022-2023,S41G01N26,고양 캐롯,Away,데이비드 사이먼,0,0,1,0.0,0,0,0.0,0,1,0.0,0,0,0.0,0,0,0,0,0,0,0,0,1,1
../kbl_data/2022-2023,S41G01N26,고양 캐롯,Away,최현민,2,1,3,33.3,0,1,0.0,1,4,25.0,0,0,0.0,1,1,2,1,3,0,0,0,1,5
../kbl_data/2022-2023,S41G01N26,고양 캐롯,Away,한호빈,7,2,3,66.7,1,3,33.3,3,6,50.0,0,0,0.0,0,2,2,5,1,0,0,0,2,1
../kbl_data/2022-2023,S41G01N26,고양 캐롯,Away,전성현,11,0,1,0.0,3,9,33.3,3,10,30.0,2,2,100.0,0,4,4,1,0,0,0,0,1,0
../kbl_data/2022-2023,S41G01N26,고양 캐롯,Away,이종현,8,3,5,60.0,0,0,0.0,3,5,60.0,2,2,100.0,2,1,3,1,0,2,1,0,0,2
../kbl_data/2022-2023,S41G01N26,고양 캐롯,Away,김진유,5,1,1,100.0,1,1,100.0,2,2,100.0,0,0,0.0,0,2,2,0,0,0,0,0,1,2
../kbl_data/2022-2023,S41G01N26,고양 캐롯,Away,정해원,0,0,0,0.0,0,0,0.0,0,0,0.0,0,0,0.0,0,0,0,0,0,0,0,0,0,0
../kbl_data/2022-2023,S41G01N26,고양 캐롯,Away,조한진,6,0,0,0.0,2,3,66.7,2,3,66.7,0,0,0.0,0,1,1,1,0,1,0,0,0,2
../kbl_data/2022-2023,S41G01N26,고양 캐롯,Away,디드릭 로슨,16,6,16,37.5,1,4,25.0,7,20,35.0,1,1,100.0,3,14,17,7,0,2,0,1,2,1
../kbl_data/2022-2023,S41G01N26,고양 캐롯,Away,박진철,0,0,0,0.0,0,0,0.0,0,0,0.0,0,0,0.0,0,0,0,0,0,0,0,0,0,0
../kbl_data/2022-2023,S41G01N26,고양 캐롯,Away,이정현,20,3,5,60.0,4,7,57.1,7,12,58.3,2,2,100.0,0,1,1,3,4,1,0,0,0,3
../kbl_data/2022-2023,S41G01N27,서울 SK,Home,양우섭,4,1,2,50.0,0,2,0.0,1,4,25.0,2,2,100.0,0,0,0,2,0,0,0,0,1,2
../kbl_data/2022-2023,S41G01N27,서울 SK,Home,허일영,16,4,8,50.0,2,5,40.0,6,13,46.2,2,2,100.0,0,6,6,0,1,0,0,0,0,3
../kbl_data/2022-2023,S41G01N27,서울 SK,Home,송창용,3,0,1,0.0,0,0,0.0,0,1,0.0,3,3,100.0,2,0,2,0,0,0,0,0,2,3
../kbl_data/2022-2023,S41G01N27,서울 SK,Home,김선형,17,4,11,36.4,1,3,33.3,5,14,35.7,6,7,85.7,1,1,2,8,0,1,0,0,1,1
../kbl_data/2022-2023,S41G01N27,서울 SK,Home,홍경기,0,0,0,0.0,0,0,0.0,0,0,0.0,0,0,0.0,0,0,0,0,0,0,0,0,0,1
../kbl_data/2022-2023,S41G01N27,서울 SK,Home,최부경,2,0,4,0.0,0,0,0.0,0,4,0.0,2,2,100.0,3,2,5,3,0,0,0,0,3,5
../kbl_data/2022-2023,S41G01N27,서울 SK,Home,김승원,0,0,0,0.0,0,0,0.0,0,0,0.0,0,0,0.0,0,0,0,0,0,0,0,0,0,0
../kbl_data/2022-2023,S41G01N27,서울 SK,Home,리온 윌리엄스,4,2,3,66.7,0,0,0.0,2,3,66.7,0,0,0.0,0,1,1,0,1,0,0,0,1,2
../kbl_data/2022-2023,S41G01N27,서울 SK,Home,최원혁,2,1,1,100.0,0,1,0.0,1,2,50.0,0,0,0.0,1,1,2,1,0,0,0,0,0,2
../kbl_data/2022-2023,S41G01N27,서울 SK,Home,자밀 워니,27,12,24,50.0,0,1,0.0,12,25,48.0,3,4,75.0,5,11,16,3,0,5,0,2,1,2
../kbl_data/2022-2023,S41G01N27,서울 SK,Home,김형빈,0,0,3,0.0,0,2,0.0,0,5,0.0,0,0,0.0,2,2,4,0,1,1,0,0,0,4
../kbl_data/2022-2023,S41G01N27,서울 SK,Home,오재현,11,4,7,57.1,1,1,100.0,5,8,62.5,0,0,0.0,0,2,2,2,1,1,0,0,0,2
../kbl_data/2022-2023,S41G01N27,서울 삼성,Away,이정현,14,0,6,0.0,2,5,40.0,2,11,18.2,8,8,100.0,0,4,4,1,0,0,0,0,1,2
../kbl_data/2022-2023,S41G01N27,서울 삼성,Away,장민국,0,0,1,0.0,0,1,0.0,0,2,0.0,0,0,0.0,1,0,1,0,0,1,0,0,0,0
../kbl_data/2022-2023,S41G01N27,서울 삼성,Away,김시래,12,2,3,66.7,0,3,0.0,2,6,33.3,8,10,80.0,2,3,5,5,0,0,0,0,0,2
../kbl_data/2022-2023,S41G01N27,서울 삼성,Away,김현수,0,0,0,0.0,0,0,0.0,0,0,0.0,0,0,0.0,0,0,0,0,0,0,0,0,0,0
../kbl_data/2022-2023,S41G01N27,서울 삼성,Away,임동섭,5,1,5,20.0,1,3,33.3,2,8,25.0,0,0,0.0,0,3,3,0,1,0,0,0,0,1
../kbl_data/2022-2023,S41G01N27,서울 삼성,Away,이동엽,0,0,4,0.0,0,1,0.0,0,5,0.0,0,0,0.0,0,1,1,2,0,0,0,0,1,1
../kbl_data/2022-2023,S41G01N27,서울 삼성,Away,이호현,11,4,8,50.0,1,1,100.0,5,9,55.6,0,0,0.0,2,0,2,5,0,0,0,0,2,2
../kbl_data/2022-2023,S41G01N27,서울 삼성,Away,마커스 데릭슨,14,1,5,20.0,4,6,66.7,5,11,45.5,0,0,0.0,2,5,7,2,0,0,0,0,0,0
../kbl_data/2022-2023,S41G01N27,서울 삼성,Away,조우성,4,1,2,50.0,0,0,0.0,1,2,50.0,2,2,100.0,1,1,2,0,0,0,0,0,0,2
../kbl_data/2022-2023,S41G01N27,서울 삼성,Away,이원석,9,4,7,57.1,0,1,0.0,4,8,50.0,1,2,50.0,2,2,4,0,3,1,1,0,1,5
../kbl_data/2022-2023,S41G01N27,서울 삼성,Away,이매뉴얼 테리,19,7,11,63.6,0,0,0.0,7,11,63.6,5,7,71.4,5,9,14,0,0,3,0,1,1,4
../kbl_data/2022-2023,S41G01N27,서울 삼성,Away,신동혁,2,1,2,50.0,0,1,0.0,1,3,33.3,0,0,0.0,0,0,0,0,0,0,0,0,0,1
../kbl_data/2022-2023,S41G01N28,안양 KGC,Home,양희종,10,2,3,66.7,2,5,40.0,4,8,50.0,0,0,0.0,1,5,6,1,1,2,0,0,1,5
../kbl_data/2022-2023,S41G01N28,안양 KGC,Home,오세근,9,2,4,50.0,1,3,33.3,3,7,42.9,2,2,100.0,0,0,0,0,0,0,0,0,1,1
../kbl_data/2022-2023,S41G01N28,안양 KGC,Home,정준원,0,0,0,0.0,0,1,0.0,0,1,0.0,0,0,0.0,0,1,1,0,0,0,0,0,0,0
../kbl_data/2022-2023,S41G01N28,안양 KGC,Home,배병준,4,2,6,33.3,0,2,0.0,2,8,25.0,0,1,0.0,0,3,3,2,0,0,0,0,0,0
../kbl_data/2022-2023,S41G01N28,안양 KGC,Home,문성곤,6,0,1,0.0,2,7,28.6,2,8,25.0,0,0,0.0,0,3,3,2,4,0,0,0,3,1
../kbl_data/2022-2023,S41G01N28,안양 KGC,Home,박지훈,10,2,4,50.0,2,3,66.7,4,7,57.1,0,0,0.0,3,5,8,6,1,0,0,0,1,3
../kbl_data/2022-2023,S41G01N28,안양 KGC,Home,이우정,0,0,0,0.0,0,0,0.0,0,0,0.0,0,0,0.0,0,0,0,0,0,0,0,0,0,0
../kbl_data/2022-2023,S41G01N28,안양 KGC,Home,대릴 먼로,2,1,1,100.0,0,1,0.0,1,2,50.0,0,0,0.0,0,3,3,5,1,0,0,0,1,2
../kbl_data/2022-2023,S41G01N28,안양 KGC,Home,변준형,2,1,3,33.3,0,2,0.0,1,5,20.0,0,0,0.0,0,1,1,4,0,0,1,0,0,2
../kbl_data/2022-2023,S41G01N28,안양 KGC,Home,한승희,0,0,1,0.0,0,0,0.0,0,1,0.0,0,0,0.0,0,0,0,0,0,0,0,0,0,2
../kbl_data/2022-2023,S41G01N28,안양 KGC,Home,오마리 스펠맨,21,2,5,40.0,3,5,60.0,5,10,50.0,8,9,88.9,1,6,7,1,0,3,0,1,1,2
../kbl_data/2022-2023,S41G01N28,안양 KGC,Home,렌즈 아반도,6,3,5,60.0,0,2,0.0,3,7,42.9,0,0,0.0,1,3,4,0,0,0,0,0,1,1
../kbl_data/2022-2023,S41G01N28,수원 KT,Away,김동욱,3,0,2,0.0,1,2,50.0,1,4,25.0,0,0,0.0,0,1,1,1,1,0,0,0,2,0
../kbl_data/2022-2023,S41G01N28,수원 KT,Away,김영환,3,0,1,0.0,1,4,25.0,1,5,20.0,0,0,0.0,1,0,1,0,0,0,0,0,0,1
../kbl_data/2022-2023,S41G01N28,수원 KT,Away,김민욱,0,0,0,0.0,0,0,0.0,0,0,0.0,0,0,0.0,0,0,0,0,0,0,0,0,0,0
../kbl_data/2022-2023,S41G01N28,수원 KT,Away,한희원,0,0,0,0.0,0,0,0.0,0,0,0.0,0,0,0.0,0,0,0,0,0,0,0,0,0,0
../kbl_data/2022-2023,S41G01N28,수원 KT,Away,최창진,0,0,0,0.0,0,1,0.0,0,1,0.0,0,0,0.0,0,0,0,0,0,0,0,0,1,1
../kbl_data/2022-2023,S41G01N28,수원 KT,Away,이현석,0,0,0,0.0,0,0,0.0,0,0,0.0,0,0,0.0,0,0,0,0,0,0,0,0,0,2
../kbl_data/2022-2023,S41G01N28,수원 KT,Away,정성우,9,2,7,28.6,1,4,25.0,3,11,27.3,2,3,66.7,0,2,2,5,0,0,1,0,2,2
../kbl_data/2022-2023,S41G01N28,수원 KT,Away,최성모,0,0,0,0.0,0,3,0.0,0,3,0.0,0,0,0.0,1,1,2,1,1,0,0,0,0,3
../kbl_data/2022-2023,S41G01N28,수원 KT,Away,양홍석,10,1,5,20.0,2,5,40.0,3,10,30.0,2,3,66.7,1,2,3,1,0,0,0,0,0,0
../kbl_data/2022-2023,S41G01N28,수원 KT,Away,하윤기,19,8,18,44.4,0,0,0.0,8,18,44.4,3,4,75.0,10,7,17,0,3,1,0,2,1,4
../kbl_data/2022-2023,S41G01N28,수원 KT,Away,이제이 아노시케,16,4,9,44.4,1,11,9.1,5,20,25.0,5,7,71.4,6,10,16,2,0,0,0,1,0,5
../kbl_data/2022-2023,S41G01N28,수원 KT,Away,랜드리 은노코,8,3,8,37.5,0,0,0.0,3,8,37.5,2,2,100.0,2,6,8,0,0,1,0,0,2,2
../kbl_data/2022-2023,S41G01N29,고양 캐롯,Home,김강선,0,0,0,0.0,0,0,0.0,0,0,0.0,0,0,0.0,0,0,0,2,0,0,0,0,0,0
../kbl_data/2022-2023,S41G01N29,고양 캐롯,Home,데이비드 사이먼,18,5,9,55.6,1,3,33.3,6,12,50.0,5,6,83.3,1,6,7,1,0,0,0,1,1,0
../kbl_data/2022-2023,S41G01N29,고양 캐롯,Home,최현민,13,2,5,40.0,3,7,42.9,5,12,41.7,0,0,0.0,2,3,5,1,0,0,0,0,1,3
../kbl_data/2022-2023,S41G01N29,고양 캐롯,Home,한호빈,9,3,3,100.0,1,5,20.0,4,8,50.0,0,0,0.0,1,1,2,4,2,0,0,0,1,4
../kbl_data/2022-2023,S41G01N29,고양 캐롯,Home,전성현,16,1,2,50.0,4,7,57.1,5,9,55.6,2,2,100.0,0,1,1,4,3,0,0,0,7,0
../kbl_data/2022-2023,S41G01N29,고양 캐롯,Home,이종현,2,1,1,100.0,0,0,0.0,1,1,100.0,0,0,0.0,0,0,0,1,0,0,0,0,0,1
../kbl_data/2022-2023,S41G01N29,고양 캐롯,Home,김진유,3,0,0,0.0,1,2,50.0,1,2,50.0,0,0,0.0,2,3,5,1,2,0,1,0,0,2
../kbl_data/2022-2023,S41G01N29,고양 캐롯,Home,정해원,0,0,0,0.0,0,0,0.0,0,0,0.0,0,0,0.0,0,0,0,0,0,0,0,0,0,0
../kbl_data/2022-2023,S41G01N29,고양 캐롯,Home,조한진,3,0,0,0.0,1,5,20.0,1,5,20.0,0,0,0.0,1,0,1,1,1,0,0,0,0,2
../kbl_data/2022-2023,S41G01N29,고양 캐롯,Home,디드릭 로슨,7,2,4,50.0,1,3,33.3,3,7,42.9,0,0,0.0,0,1,1,1,0,1,0,0,1,0
../kbl_data/2022-2023,S41G01N29,고양 캐롯,Home,박진철,0,0,0,0.0,0,0,0.0,0,0,0.0,0,0,0.0,0,0,0,0,0,0,0,0,0,0
../kbl_data/2022-2023,S41G01N29,고양 캐롯,Home,이정현,12,3,5,60.0,0,2,0.0,3,7,42.9,6,8,75.0,0,1,1,4,1,0,0,0,1,3
../kbl_data/2022-2023,S41G01N29,대구 한국가스공사,Away,박지훈,0,0,1,0.0,0,2,0.0,0,3,0.0,0,0,0.0,3,0,3,0,0,0,0,0,0,3
../kbl_data/2022-2023,S41G01N29,대구 한국가스공사,Away,이대헌,16,5,6,83.3,2,5,40.0,7,11,63.6,0,0,0.0,5,4,9,2,0,0,0,1,3,1
../kbl_data/2022-2023,S41G01N29,대구 한국가스공사,Away,이대성,20,8,10,80.0,0,3,0.0,8,13,61.5,4,6,66.7,1,2,3,5,2,1,0,0,3,2
../kbl_data/2022-2023,S41G01N29,대구 한국가스공사,Away,정효근,12,3,6,50.0,2,4,50.0,5,10,50.0,0,2,0.0,0,4,4,4,2,1,0,0,0,2
../kbl_data/2022-2023,S41G01N29,대구 한국가스공사,Away,박봉진,0,0,0,0.0,0,0,0.0,0,0,0.0,0,0,0.0,0,0,0,0,0,0,0,0,0,0
../kbl_data/2022-2023,S41G01N29,대구 한국가스공사,Away,머피 할로웨이,17,8,13,61.5,0,0,0.0,8,13,61.5,1,2,50.0,2,12,14,8,5,1,0,1,2,2
../kbl_data/2022-2023,S41G01N29,대구 한국가스공사,Away,우동현,0,0,0,0.0,0,0,0.0,0,0,0.0,0,0,0.0,0,0,0,0,0,0,0,0,0,0
../kbl_data/2022-2023,S41G01N29,대구 한국가스공사,Away,전현우,0,0,0,0.0,0,0,0.0,0,0,0.0,0,0,0.0,0,0,0,1,0,0,0,0,0,0
../kbl_data/2022-2023,S41G01N29,대구 한국가스공사,Away,양준우,0,0,0,0.0,0,0,0.0,0,0,0.0,0,0,0.0,0,0,0,0,0,0,0,0,0,0
../kbl_data/2022-2023,S41G01N29,대구 한국가스공사,Away,신승민,2,1,2,50.0,0,0,0.0,1,2,50.0,0,0,0.0,0,0,0,0,0,0,0,0,0,1
../kbl_data/2022-2023,S41G01N29,대구 한국가스공사,Away,샘조세프 벨란겔,25,3,5,60.0,6,10,60.0,9,15,60.0,1,1,100.0,0,2,2,3,1,0,0,0,1,3
../kbl_data/2022-2023,S41G01N29,대구 한국가스공사,Away,유슈 은도예,0,0,1,0.0,0,0,0.0,0,1,0.0,0,0,0.0,0,1,1,0,0,0,0,0,1,1
../kbl_data/2022-2023,S41G01N30,창원 LG,Home,이관희,8,0,3,0.0,2,6,33.3,2,9,22.2,2,3,66.7,0,3,3,0,1,0,0,0,3,3
../kbl_data/2022-2023,S41G01N30,창원 LG,Home,정희재,0,0,0,0.0,0,0,0.0,0,0,0.0,0,0,0.0,0,0,0,0,0,0,0,0,0,0
../kbl_data/2022-2023,S41G01N30,창원 LG,Home,서민수,7,1,3,33.3,1,4,25.0,2,7,28.6,2,2,100.0,3,1,4,2,0,0,1,0,1,3
../kbl_data/2022-2023,S41G01N30,창원 LG,Home,한상혁,0,0,1,0.0,0,0,0.0,0,1,0.0,0,0,0.0,0,1,1,3,0,0,0,0,0,0
../kbl_data/2022-2023,S41G01N30,창원 LG,Home,이재도,18,1,1,100.0,4,10,40.0,5,11,45.5,4,4,100.0,0,2,2,7,0,0,0,0,3,3
../kbl_data/2022-2023,S41G01N30,창원 LG,Home,김준일,8,4,9,44.4,0,0,0.0,4,9,44.4,0,0,0.0,2,6,8,2,0,1,0,0,0,4
../kbl_data/2022-2023,S41G01N30,창원 LG,Home,박인태,0,0,0,0.0,0,0,0.0,0,0,0.0,0,0,0.0,0,0,0,0,0,0,0,0,0,0
../kbl_data/2022-2023,S41G01N30,창원 LG,Home,윤원상,7,1,2,50.0,1,4,25.0,2,6,33.3,2,2,100.0,1,4,5,1,1,0,1,0,1,1
../kbl_data/2022-2023,S41G01N30,창원 LG,Home,아셈 마레이,14,4,6,66.7,0,0,0.0,4,6,66.7,6,8,75.0,3,10,13,2,2,0,0,2,2,3
../kbl_data/2022-2023,S41G01N30,창원 LG,Home,이승우,10,3,6,50.0,1,2,50.0,4,8,50.0,1,3,33.3,2,4,6,1,0,0,0,0,1,5
../kbl_data/2022-2023,S41G01N30,창원 LG,Home,저스틴 구탕,0,0,0,0.0,0,0,0.0,0,0,0.0,0,0,0.0,0,0,0,0,0,0,0,0,0,0
../kbl_data/2022-2023,S41G01N30,창원 LG,Home,단테 커닝햄,7,2,9,22.2,1,1,100.0,3,10,30.0,0,0,0.0,2,1,3,0,1,0,0,0,0,1
../kbl_data/2022-2023,S41G01N30,울산 현대모비스,Away,함지훈,4,1,5,20.0,0,1,0.0,1,6,16.7,2,2,100.0,3,1,4,4,0,0,0,0,2,3
../kbl_data/2022-2023,S41G01N30,울산 현대모비스,Away,김현민,5,1,1,100.0,1,1,100.0,2,2,100.0,0,0,0.0,1,1,2,0,0,0,0,0,0,2
../kbl_data/2022-2023,S41G01N30,울산 현대모비스,Away,장재석,2,1,2,50.0,0,0,0.0,1,2,50.0,0,0,0.0,0,0,0,0,0,0,0,0,2,4
../kbl_data/2022-2023,S41G01N30,울산 현대모비스,Away,김영현,0,0,1,0.0,0,3,0.0,0,4,0.0,0,0,0.0,1,1,2,0,0,0,0,0,0,2
../kbl_data/2022-2023,S41G01N30,울산 현대모비스,Away,김국찬,8,2,3,66.7,1,2,50.0,3,5,60.0,1,1,100.0,0,3,3,0,1,0,1,0,1,2
../kbl_data/2022-2023,S41G01N30,울산 현대모비스,Away,서명진,10,3,7,42.9,0,1,0.0,3,8,37.5,4,5,80.0,0,2,2,4,2,0,0,0,1,2
../kbl_data/2022-2023,S41G01N30,울산 현대모비스,Away,저스틴 녹스,17,7,10,70.0,0,2,0.0,7,12,58.3,3,4,75.0,0,9,9,1,3,1,0,2,1,3
../kbl_data/2022-2023,S41G01N30,울산 현대모비스,Away,이우석,11,5,11,45.5,0,1,0.0,5,12,41.7,1,5,20.0,2,2,4,0,0,0,0,0,1,1
../kbl_data/2022-2023,S41G01N30,울산 현대모비스,Away,신민석,0,0,0,0.0,0,0,0.0,0,0,0.0,0,0,0.0,0,1,1,0,1,0,0,0,1,1
../kbl_data/2022-2023,S41G01N30,울산 현대모비스,Away,김동준,0,0,3,0.0,0,0,0.0,0,3,0.0,0,0,0.0,1,1,2,0,0,0,0,0,0,0
../kbl_data/2022-2023,S41G01N30,울산 현대모비스,Away,론제이 아바리엔토스,9,1,3,33.3,1,4,25.0,2,7,28.6,4,4,100.0,0,4,4,5,0,0,0,0,1,1
../kbl_data/2022-2023,S41G01N30,울산 현대모비스,Away,게이지 프림,2,1,4,25.0,0,0,0.0,1,4,25.0,0,2,0.0,2,2,4,2,1,1,0,0,0,5
../kbl_data/2022-2023,S41G01N31,전주 KCC,Home,정창영,8,1,5,20.0,0,0,0.0,1,5,20.0,6,6,100.0,0,4,4,3,0,0,0,0,1,2
../kbl_data/2022-2023,S41G01N31,전주 KCC,Home,라건아,15,5,12,41.7,1,2,50.0,6,14,42.9,2,2,100.0,5,10,15,0,0,2,0,1,1,0
../kbl_data/2022-2023,S41G01N31,전주 KCC,Home,박경상,2,1,1,100.0,0,3,0.0,1,4,25.0,0,0,0.0,1,0,1,2,0,0,0,0,0,3
../kbl_data/2022-2023,S41G01N31,전주 KCC,Home,김상규,0,0,0,0.0,0,0,0.0,0,0,0.0,0,0,0.0,0,1,1,1,0,0,0,0,0,1
../kbl_data/2022-2023,S41G01N31,전주 KCC,Home,유병훈,0,0,0,0.0,0,0,0.0,0,0,0.0,0,0,0.0,0,0,0,0,0,0,0,0,0,0
../kbl_data/2022-2023,S41G01N31,전주 KCC,Home,허웅,12,2,3,66.7,2,8,25.0,4,11,36.4,2,3,66.7,1,1,2,4,0,0,0,0,4,4
../kbl_data/2022-2023,S41G01N31,전주 KCC,Home,이승현,22,11,15,73.3,0,2,0.0,11,17,64.7,0,1,0.0,1,3,4,2,1,1,1,0,0,1
../kbl_data/2022-2023,S41G01N31,전주 KCC,Home,이진욱,0,0,0,0.0,0,0,0.0,0,0,0.0,0,0,0.0,0,0,0,0,0,0,0,0,0,1
../kbl_data/2022-2023,S41G01N31,전주 KCC,Home,이근휘,3,0,1,0.0,1,3,33.3,1,4,25.0,0,0,0.0,0,1,1,2,1,0,0,0,0,2
../kbl_data/2022-2023,S41G01N31,전주 KCC,Home,김동현,0,0,1,0.0,0,1,0.0,0,2,0.0,0,0,0.0,0,1,1,0,0,0,0,0,1,2
../kbl_data/2022-2023,S41G01N31,전주 KCC,Home,론데 홀리스 제퍼슨,7,2,4,50.0,0,1,0.0,2,5,40.0,3,4,75.0,1,3,4,0,0,1,0,0,0,1
../kbl_data/2022-2023,S41G01N31,전주 KCC,Home,송동훈,0,0,2,0.0,0,0,0.0,0,2,0.0,0,0,0.0,0,1,1,5,0,1,0,0,2,5
../kbl_data/2022-2023,S41G01N31,서울 SK,Away,양우섭,5,2,3,66.7,0,0,0.0,2,3,66.7,1,1,100.0,0,0,0,0,0,0,0,0,1,0
../kbl_data/2022-2023,S41G01N31,서울 SK,Away,허일영,8,1,3,33.3,0,2,0.0,1,5,20.0,6,6,100.0,2,4,6,0,1,0,0,0,0,3
../kbl_data/2022-2023,S41G01N31,서울 SK,Away,송창용,2,1,2,50.0,0,1,0.0,1,3,33.3,0,0,0.0,0,3,3,0,1,0,0,0,0,1
../kbl_data/2022-2023,S41G01N31,서울 SK,Away,김선형,17,5,10,50.0,0,3,0.0,5,13,38.5,7,9,77.8,1,5,6,10,2,0,0,0,2,2
../kbl_data/2022-2023,S41G01N31,서울 SK,Away,홍경기,0,0,0,0.0,0,1,0.0,0,1,0.0,0,0,0.0,1,1,2,0,0,0,0,0,0,3
../kbl_data/2022-2023,S41G01N31,서울 SK,Away,최부경,8,4,8,50.0,0,0,0.0,4,8,50.0,0,0,0.0,2,3,5,1,1,0,1,0,0,3
../kbl_data/2022-2023,S41G01N31,서울 SK,Away,김승원,0,0,0,0.0,0,0,0.0,0,0,0.0,0,0,0.0,0,0,0,0,0,0,0,0,0,0
../kbl_data/2022-2023,S41G01N31,서울 SK,Away,리온 윌리엄스,11,4,5,80.0,1,1,100.0,5,6,83.3,0,0,0.0,0,2,2,0,0,0,0,0,0,3
../kbl_data/2022-2023,S41G01N31,서울 SK,Away,최원혁,0,0,0,0.0,0,2,0.0,0,2,0.0,0,0,0.0,1,0,1,0,0,0,0,0,1,0
../kbl_data/2022-2023,S41G01N31,서울 SK,Away,자밀 워니,15,6,14,42.9,1,3,33.3,7,17,41.2,0,0,0.0,1,7,8,3,1,0,0,0,0,1
../kbl_data/2022-2023,S41G01N31,서울 SK,Away,김형빈,0,0,0,0.0,0,1,0.0,0,1,0.0,0,0,0.0,0,0,0,0,0,0,0,0,0,1
../kbl_data/2022-2023,S41G01N31,서울 SK,Away,오재현,9,1,4,25.0,2,2,100.0,3,6,50.0,1,2,50.0,0,4,4,3,0,1,0,0,3,3
../kbl_data/2022-2023,S41G01N32,창원 LG,Home,이관희,23,2,6,33.3,6,10,60.0,8,16,50.0,1,2,50.0,1,2,3,2,0,0,0,0,1,1
../kbl_data/2022-2023,S41G01N32,창원 LG,Home,정희재,7,1,1,100.0,1,2,50.0,2,3,66.7,2,2,100.0,1,3,4,1,0,0,0,0,0,3
../kbl_data/2022-2023,S41G01N32,창원 LG,Home,서민수,2,1,2,50.0,0,3,0.0,1,5,20.0,0,0,0.0,1,1,2,1,0,0,0,0,0,2
../kbl_data/2022-2023,S41G01N32,창원 LG,Home,한상혁,8,4,5,80.0,0,0,0.0,4,5,80.0,0,0,0.0,0,0,0,1,0,0,0,0,0,0
../kbl_data/2022-2023,S41G01N32,창원 LG,Home,이재도,3,0,5,0.0,1,5,20.0,1,10,10.0,0,0,0.0,2,0,2,4,0,0,0,0,2,2
../kbl_data/2022-2023,S41G01N32,창원 LG,Home,김준일,2,1,4,25.0,0,0,0.0,1,4,25.0,0,0,0.0,1,0,1,0,0,1,0,0,1,0
../kbl_data/2022-2023,S41G01N32,창원 LG,Home,이광진,0,0,0,0.0,0,0,0.0,0,0,0.0,0,0,0.0,0,0,0,0,0,0,0,0,0,0
../kbl_data/2022-2023,S41G01N32,창원 LG,Home,윤원상,6,0,0,0.0,2,8,25.0,2,8,25.0,0,0,0.0,1,1,2,0,0,0,1,0,0,4
../kbl_data/2022-2023,S41G01N32,창원 LG,Home,아셈 마레이,27,11,15,73.3,0,0,0.0,11,15,73.3,5,8,62.5,5,8,13,0,3,1,0,0,2,4
../kbl_data/2022-2023,S41G01N32,창원 LG,Home,이승우,12,4,6,66.7,1,2,50.0,5,8,62.5,1,1,100.0,3,6,9,1,0,0,0,0,2,4
../kbl_data/2022-2023,S41G01N32,창원 LG,Home,저스틴 구탕,0,0,0,0.0,0,0,0.0,0,0,0.0,0,0,0.0,0,0,0,0,0,0,0,0,0,0
../kbl_data/2022-2023,S41G01N32,창원 LG,Home,단테 커닝햄,4,2,4,50.0,0,0,0.0,2,4,50.0,0,0,0.0,2,1,3,0,0,0,0,0,0,0
../kbl_data/2022-2023,S41G01N32,원주 DB,Away,박찬희,5,1,3,33.3,1,3,33.3,2,6,33.3,0,0,0.0,0,2,2,1,0,0,0,0,2,4
../kbl_data/2022-2023,S41G01N32,원주 DB,Away,김현호,3,0,0,0.0,1,2,50.0,1,2,50.0,0,0,0.0,1,1,2,0,0,1,0,0,0,1
../kbl_data/2022-2023,S41G01N32,원주 DB,Away,두경민,23,5,8,62.5,3,7,42.9,8,15,53.3,4,5,80.0,1,1,2,1,1,0,0,0,1,3
../kbl_data/2022-2023,S41G01N32,원주 DB,Away,최승욱,6,2,3,66.7,0,1,0.0,2,4,50.0,2,2,100.0,1,3,4,2,0,1,0,0,0,2
../kbl_data/2022-2023,S41G01N32,원주 DB,Away,강상재,20,1,7,14.3,4,4,100.0,5,11,45.5,6,6,100.0,4,6,10,3,1,0,0,0,0,2
../kbl_data/2022-2023,S41G01N32,원주 DB,Away,윤성원,0,0,0,0.0,0,0,0.0,0,0,0.0,0,0,0.0,0,0,0,0,0,0,0,0,0,0
../kbl_data/2022-2023,S41G01N32,원주 DB,Away,원종훈,0,0,0,0.0,0,0,0.0,0,0,0.0,0,0,0.0,0,0,0,0,0,0,0,0,0,0
../kbl_data/2022-2023,S41G01N32,원주 DB,Away,레나드 프리먼,0,0,0,0.0,0,0,0.0,0,0,0.0,0,0,0.0,0,1,1,0,1,0,0,0,0,1
../kbl_data/2022-2023,S41G01N32,원주 DB,Away,이선 알바노,11,2,3,66.7,1,4,25.0,3,7,42.9,4,5,80.0,0,1,1,2,1,0,0,0,2,3
../kbl_data/2022-2023,S41G01N32,원주 DB,Away,드완 에르난데스,29,10,17,58.8,2,2,100.0,12,19,63.2,3,4,75.0,1,6,7,4,1,1,0,0,1,3
../kbl_data/2022-2023,S41G01N32,원주 DB,Away,박인웅,5,1,2,50.0,1,1,100.0,2,3,66.7,0,0,0.0,0,0,0,0,0,0,0,0,0,0
../kbl_data/2022-2023,S41G01N32,원주 DB,Away,인승찬,0,0,0,0.0,0,0,0.0,0,0,0.0,0,0,0.0,0,0,0,0,0,0,0,0,0,0
../kbl_data/2022-2023,S41G01N33,서울 삼성,Home,이정현,3,1,3,33.3,0,3,0.0,1,6,16.7,1,2,50.0,0,1,1,2,0,0,0,0,0,1
../kbl_data/2022-2023,S41G01N33,서울 삼성,Home,장민국,1,0,1,0.0,0,1,0.0,0,2,0.0,1,2,50.0,1,0,1,0,0,0,0,0,0,2
../kbl_data/2022-2023,S41G01N33,서울 삼성,Home,김시래,3,0,2,0.0,1,2,50.0,1,4,25.0,0,0,0.0,0,3,3,1,1,0,0,0,4,0
../kbl_data/2022-2023,S41G01N33,서울 삼성,Home,김현수,0,0,1,0.0,0,0,0.0,0,1,0.0,0,0,0.0,0,0,0,1,2,0,1,0,0,1
../kbl_data/2022-2023,S41G01N33,서울 삼성,Home,임동섭,0,0,2,0.0,0,1,0.0,0,3,0.0,0,0,0.0,3,0,3,1,0,0,0,0,0,5
../kbl_data/2022-2023,S41G01N33,서울 삼성,Home,이동엽,3,1,4,25.0,0,0,0.0,1,4,25.0,1,2,50.0,1,1,2,4,1,0,0,0,3,1
../kbl_data/2022-2023,S41G01N33,서울 삼성,Home,이호현,10,3,4,75.0,1,3,33.3,4,7,57.1,1,2,50.0,0,2,2,2,1,0,0,0,1,0
../kbl_data/2022-2023,S41G01N33,서울 삼성,Home,마커스 데릭슨,8,1,3,33.3,1,3,33.3,2,6,33.3,3,4,75.0,0,4,4,2,1,2,0,0,2,2
../kbl_data/2022-2023,S41G01N33,서울 삼성,Home,조우성,2,1,3,33.3,0,0,0.0,1,3,33.3,0,0,0.0,1,1,2,0,0,0,0,0,0,1
../kbl_data/2022-2023,S41G01N33,서울 삼성,Home,이원석,12,5,12,41.7,0,1,0.0,5,13,38.5,2,2,100.0,2,2,4,0,0,1,0,1,2,4
../kbl_data/2022-2023,S41G01N33,서울 삼성,Home,이매뉴얼 테리,17,7,15,46.7,0,0,0.0,7,15,46.7,3,4,75.0,3,3,6,1,1,2,0,1,1,4
../kbl_data/2022-2023,S41G01N33,서울 삼성,Home,신동혁,5,2,3,66.7,0,3,0.0,2,6,33.3,1,2,50.0,1,1,2,2,1,0,0,0,0,0
../kbl_data/2022-2023,S41G01N33,울산 현대모비스,Away,함지훈,14,6,7,85.7,0,1,0.0,6,8,75.0,2,2,100.0,0,1,1,3,1,1,0,0,1,3
../kbl_data/2022-2023,S41G01N33,울산 현대모비스,Away,김현민,0,0,0,0.0,0,1,0.0,0,1,0.0,0,0,0.0,0,1,1,0,0,0,0,0,0,2
../kbl_data/2022-2023,S41G01N33,울산 현대모비스,Away,장재석,4,2,6,33.3,0,0,0.0,2,6,33.3,0,0,0.0,1,1,2,3,0,0,0,0,0,1
../kbl_data/2022-2023,S41G01N33,울산 현대모비스,Away,김영현,10,2,4,50.0,2,4,50.0,4,8,50.0,0,0,0.0,0,3,3,1,1,0,0,0,1,2
../kbl_data/2022-2023,S41G01N33,울산 현대모비스,Away,박재한,0,0,0,0.0,0,0,0.0,0,0,0.0,0,0,0.0,0,0,0,0,0,0,0,0,0,0
../kbl_data/2022-2023,S41G01N33,울산 현대모비스,Away,김국찬,2,1,2,50.0,0,1,0.0,1,3,33.3,0,0,0.0,0,1,1,1,0,0,0,0,1,2
../kbl_data/2022-2023,S41G01N33,울산 현대모비스,Away,서명진,16,2,6,33.3,2,6,33.3,4,12,33.3,6,6,100.0,1,1,2,3,4,1,0,0,3,2
../kbl_data/2022-2023,S41G01N33,울산 현대모비스,Away,저스틴 녹스,18,6,11,54.5,0,1,0.0,6,12,50.0,6,8,75.0,4,15,19,1,0,0,0,1,5,3
../kbl_data/2022-2023,S41G01N33,울산 현대모비스,Away,이우석,2,1,1,100.0,0,0,0.0,1,1,100.0,0,0,0.0,0,1,1,1,0,1,0,0,2,1
../kbl_data/2022-2023,S41G01N33,울산 현대모비스,Away,신민석,0,0,0,0.0,0,1,0.0,0,1,0.0,0,0,0.0,0,0,0,0,1,1,0,0,0,0
../kbl_data/2022-2023,S41G01N33,울산 현대모비스,Away,김동준,11,4,6,66.7,1,1,100.0,5,7,71.4,0,0,0.0,0,2,2,1,2,0,0,0,0,0
../kbl_data/2022-2023,S41G01N33,울산 현대모비스,Away,게이지 프림,4,2,3,66.7,0,0,0.0,2,3,66.7,0,0,0.0,2,4,6,2,1,0,0,0,0,5
../kbl_data/2022-2023,S41G01N34,대구 한국가스공사,Home,차바위,10,2,2,100.0,1,3,33.3,3,5,60.0,3,4,75.0,0,0,0,2,1,0,0,0,0,2
../kbl_data/2022-2023,S41G01N34,대구 한국가스공사,Home,박지훈,3,0,1,0.0,1,2,50.0,1,3,33.3,0,0,0.0,2,0,2,2,0,0,0,0,0,1
../kbl_data/2022-2023,S41G01N34,대구 한국가스공사,Home,이대헌,0,0,3,0.0,0,2,0.0,0,5,0.0,0,0,0.0,2,0,2,0,0,0,0,0,0,2
../kbl_data/2022-2023,S41G01N34,대구 한국가스공사,Home,이대성,20,6,10,60.0,1,3,33.3,7,13,53.8,5,6,83.3,1,1,2,3,0,0,0,0,3,2
../kbl_data/2022-2023,S41G01N34,대구 한국가스공사,Home,정효근,14,2,5,40.0,3,3,100.0,5,8,62.5,1,3,33.3,0,4,4,2,2,0,0,0,2,3
../kbl_data/2022-2023,S41G01N34,대구 한국가스공사,Home,박봉진,0,0,0,0.0,0,0,0.0,0,0,0.0,0,0,0.0,0,0,0,0,0,0,0,0,0,0
../kbl_data/2022-2023,S41G01N34,대구 한국가스공사,Home,머피 할로웨이,15,7,13,53.8,0,0,0.0,7,13,53.8,1,2,50.0,3,5,8,3,0,1,0,0,1,2
../kbl_data/2022-2023,S41G01N34,대구 한국가스공사,Home,우동현,3,0,1,0.0,1,2,50.0,1,3,33.3,0,0,0.0,0,0,0,0,0,0,0,0,0,2
../kbl_data/2022-2023,S41G01N34,대구 한국가스공사,Home,전현우,0,0,0,0.0,0,0,0.0,0,0,0.0,0,0,0.0,0,0,0,0,0,0,0,0,0,0
../kbl_data/2022-2023,S41G01N34,대구 한국가스공사,Home,신승민,4,2,2,100.0,0,2,0.0,2,4,50.0,0,0,0.0,1,3,4,0,0,0,0,0,1,2
../kbl_data/2022-2023,S41G01N34,대구 한국가스공사,Home,샘조세프 벨란겔,9,2,6,33.3,0,5,0.0,2,11,18.2,5,5,100.0,0,2,2,3,0,0,0,0,0,2
../kbl_data/2022-2023,S41G01N34,대구 한국가스공사,Home,유슈 은도예,3,1,1,100.0,0,0,0.0,1,1,100.0,1,2,50.0,2,4,6,1,1,0,0,0,2,1
../kbl_data/2022-2023,S41G01N34,수원 KT,Away,김동욱,0,0,0,0.0,0,0,0.0,0,0,0.0,0,0,0.0,0,0,0,0,0,0,0,0,0,0
../kbl_data/2022-2023,S41G01N34,수원 KT,Away,김영환,12,2,3,66.7,2,4,50.0,4,7,57.1,2,2,100.0,0,1,1,3,0,0,0,0,0,1
../kbl_data/2022-2023,S41G01N34,수원 KT,Away,김민욱,0,0,0,0.0,0,0,0.0,0,0,0.0,0,0,0.0,1,1,2,0,0,0,0,0,0,3
../kbl_data/2022-2023,S41G01N34,수원 KT,Away,한희원,9,3,4,75.0,0,0,0.0,3,4,75.0,3,4,75.0,0,2,2,1,2,1,0,0,0,3
../kbl_data/2022-2023,S41G01N34,수원 KT,Away,최창진,3,0,0,0.0,1,2,50.0,1,2,50.0,0,0,0.0,0,1,1,2,0,0,0,0,1,5
../kbl_data/2022-2023,S41G01N34,수원 KT,Away,이현석,3,0,0,0.0,1,1,100.0,1,1,100.0,0,0,0.0,0,0,0,2,2,0,0,0,1,1
../kbl_data/2022-2023,S41G01N34,수원 KT,Away,정성우,16,3,6,50.0,3,7,42.9,6,13,46.2,1,2,50.0,1,1,2,7,0,0,0,0,2,3
../kbl_data/2022-2023,S41G01N34,수원 KT,Away,최성모,0,0,0,0.0,0,0,0.0,0,0,0.0,0,0,0.0,0,1,1,1,0,0,0,0,0,2
../kbl_data/2022-2023,S41G01N34,수원 KT,Away,양홍석,7,2,2,100.0,1,6,16.7,3,8,37.5,0,0,0.0,0,3,3,0,2,2,0,0,2,1
../kbl_data/2022-2023,S41G01N34,수원 KT,Away,하윤기,12,5,9,55.6,0,0,0.0,5,9,55.6,2,2,100.0,3,6,9,1,0,0,0,0,1,2
../kbl_data/2022-2023,S41G01N34,수원 KT,Away,이제이 아노시케,34,3,6,50.0,7,11,63.6,10,17,58.8,7,7,100.0,1,7,8,2,0,0,0,0,1,2
../kbl_data/2022-2023,S41G01N34,수원 KT,Away,랜드리 은노코,1,0,0,0.0,0,0,0.0,0,0,0.0,1,2,50.0,1,0,1,0,0,0,0,0,0,0
../kbl_data/2022-2023,S41G01N35,원주 DB,Home,박찬희,0,0,1,0.0,0,1,0.0,0,2,0.0,0,0,0.0,3,1,4,2,2,0,0,0,1,2
../kbl_data/2022-2023,S41G01N35,원주 DB,Home,김현호,3,0,0,0.0,1,2,50.0,1,2,50.0,0,0,0.0,0,1,1,0,0,0,1,0,0,3
../kbl_data/2022-2023,S41G01N35,원주 DB,Home,두경민,14,1,4,25.0,4,9,44.4,5,13,38.5,0,0,0.0,0,1,1,4,1,0,0,0,2,2
../kbl_data/2022-2023,S41G01N35,원주 DB,Home,김종규,6,3,4,75.0,0,2,0.0,3,6,50.0,0,4,0.0,0,3,3,1,0,3,0,2,1,1
../kbl_data/2022-2023,S41G01N35,원주 DB,Home,최승욱,8,4,5,80.0,0,2,0.0,4,7,57.1,0,0,0.0,2,1,3,0,0,0,0,0,0,1
../kbl_data/2022-2023,S41G01N35,원주 DB,Home,강상재,4,1,4,25.0,0,5,0.0,1,9,11.1,2,2,100.0,1,5,6,0,1,1,0,0,2,0
../kbl_data/2022-2023,S41G01N35,원주 DB,Home,윤성원,0,0,0,0.0,0,0,0.0,0,0,0.0,0,0,0.0,0,0,0,0,0,0,0,0,0,0
../kbl_data/2022-2023,S41G01N35,원주 DB,Home,이준희,3,0,0,0.0,1,1,100.0,1,1,100.0,0,0,0.0,0,0,0,0,0,0,0,0,1,0
../kbl_data/2022-2023,S41G01N35,원주 DB,Home,레나드 프리먼,8,4,5,80.0,0,0,0.0,4,5,80.0,0,0,0.0,0,2,2,3,0,0,0,0,2,2
../kbl_data/2022-2023,S41G01N35,원주 DB,Home,이선 알바노,22,2,6,33.3,5,7,71.4,7,13,53.8,3,5,60.0,0,3,3,3,0,0,0,0,2,5
../kbl_data/2022-2023,S41G01N35,원주 DB,Home,드완 에르난데스,16,6,9,66.7,0,0,0.0,6,9,66.7,4,6,66.7,0,4,4,3,0,0,0,2,1,0
../kbl_data/2022-2023,S41G01N35,원주 DB,Home,박인웅,0,0,1,0.0,0,0,0.0,0,1,0.0,0,0,0.0,1,2,3,1,0,0,0,0,0,0
../kbl_data/2022-2023,S41G01N35,안양 KGC,Away,양희종,4,2,2,100.0,0,4,0.0,2,6,33.3,0,0,0.0,1,0,1,1,2,0,0,0,0,1
../kbl_data/2022-2023,S41G01N35,안양 KGC,Away,오세근,19,6,9,66.7,1,2,50.0,7,11,63.6,4,6,66.7,3,4,7,4,1,0,0,0,2,2
../kbl_data/2022-2023,S41G01N35,안양 KGC,Away,정준원,0,0,0,0.0,0,0,0.0,0,0,0.0,0,0,0.0,0,0,0,0,0,0,0,0,0,0
../kbl_data/2022-2023,S41G01N35,안양 KGC,Away,배병준,12,2,5,40.0,2,3,66.7,4,8,50.0,2,2,100.0,2,6,8,4,1,0,0,0,0,0
../kbl_data/2022-2023,S41G01N35,안양 KGC,Away,문성곤,11,2,2,100.0,2,6,33.3,4,8,50.0,1,2,50.0,0,8,8,3,2,1,1,0,1,0
../kbl_data/2022-2023,S41G01N35,안양 KGC,Away,박지훈,10,5,5,100.0,0,0,0.0,5,5,100.0,0,0,0.0,1,2,3,3,1,0,0,0,1,4
../kbl_data/2022-2023,S41G01N35,안양 KGC,Away,이우정,0,0,1,0.0,0,0,0.0,0,1,0.0,0,0,0.0,0,0,0,0,0,0,0,0,0,0
../kbl_data/2022-2023,S41G01N35,안양 KGC,Away,대릴 먼로,2,0,2,0.0,0,0,0.0,0,2,0.0,2,2,100.0,1,4,5,0,0,0,0,0,0,0
../kbl_data/2022-2023,S41G01N35,안양 KGC,Away,변준형,13,4,7,57.1,1,4,25.0,5,11,45.5,2,3,66.7,1,0,1,5,2,0,1,0,2,3
../kbl_data/2022-2023,S41G01N35,안양 KGC,Away,한승희,3,0,2,0.0,1,3,33.3,1,5,20.0,0,0,0.0,0,0,0,0,0,0,0,0,1,2
../kbl_data/2022-2023,S41G01N35,안양 KGC,Away,오마리 스펠맨,25,2,7,28.6,7,10,70.0,9,17,52.9,0,0,0.0,3,8,11,3,0,1,0,1,1,2
../kbl_data/2022-2023,S41G01N35,안양 KGC,Away,렌즈 아반도,0,0,2,0.0,0,1,0.0,0,3,0.0,0,0,0.0,1,0,1,2,0,1,0,0,0,1
../kbl_data/2022-2023,S41G01N36,서울 삼성,Home,이정현,88,12,22,54.5,12,30,40.0,24,52,46.2,28,34,82.4,2,10,12,16,6,0,4,0,10,16
../kbl_data/2022-2023,S41G01N36,서울 삼성,Home,장민국,0,0,2,0.0,0,3,0.0,0,5,0.0,0,0,0.0,0,2,2,0,0,0,0,0,0,0
../kbl_data/2022-2023,S41G01N36,서울 삼성,Home,김시래,13,2,4,50.0,1,1,100.0,3,5,60.0,6,6,100.0,2,1,3,4,0,0,0,0,3,3
../kbl_data/2022-2023,S41G01N36,서울 삼성,Home,김현수,0,0,0,0.0,0,1,0.0,0,1,0.0,0,0,0.0,0,0,0,0,0,0,0,0,1,1
../kbl_data/2022-2023,S41G01N36,서울 삼성,Home,임동섭,0,0,0,0.0,0,0,0.0,0,0,0.0,0,0,0.0,2,0,2,0,0,0,0,0,0,1
../kbl_data/2022-2023,S41G01N36,서울 삼성,Home,이동엽,9,2,4,50.0,1,4,25.0,3,8,37.5,2,2,100.0,3,1,4,3,1,0,0,0,0,3
../kbl_data/2022-2023,S41G01N36,서울 삼성,Home,이호현,3,0,2,0.0,1,2,50.0,1,4,25.0,0,0,0.0,1,1,2,2,0,0,0,0,2,1
../kbl_data/2022-2023,S41G01N36,서울 삼성,Home,마커스 데릭슨,10,3,7,42.9,1,3,33.3,4,10,40.0,1,2,50.0,1,5,6,2,1,0,0,0,3,2
../kbl_data/2022-2023,S41G01N36,서울 삼성,Home,조우성,0,0,0,0.0,0,0,0.0,0,0,0.0,0,0,0.0,0,0,0,0,0,0,0,0,0,1
../kbl_data/2022-2023,S41G01N36,서울 삼성,Home,이원석,14,6,8,75.0,0,0,0.0,6,8,75.0,2,2,100.0,4,17,21,0,2,0,0,1,0,1
../kbl_data/2022-2023,S41G01N36,서울 삼성,Home,이매뉴얼 테리,6,3,5,60.0,0,0,0.0,3,5,60.0,0,0,0.0,2,3,5,0,0,1,0,2,1,0
../kbl_data/2022-2023,S41G01N36,서울 삼성,Home,신동혁,0,0,1,0.0,0,0,0.0,0,1,0.0,0,0,0.0,0,0,0,0,0,0,0,0,1,2
../kbl_data/2022-2023,S41G01N36,고양 캐롯,Away,김강선,0,0,1,0.0,0,2,0.0,0,3,0.0,0,0,0.0,0,0,0,0,0,0,0,0,0,1
../kbl_data/2022-2023,S41G01N36,고양 캐롯,Away,데이비드 사이먼,12,3,12,25.0,2,3,66.7,5,15,33.3,0,2,0.0,2,5,7,1,0,0,0,0,0,3
../kbl_data/2022-2023,S41G01N36,고양 캐롯,Away,최현민,9,0,1,0.0,3,4,75.0,3,5,60.0,0,0,0.0,0,1,1,0,1,0,0,0,2,1
../kbl_data/2022-2023,S41G01N36,고양 캐롯,Away,한호빈,2,1,1,100.0,0,3,0.0,1,4,25.0,0,0,0.0,1,1,2,5,0,0,0,0,2,1
../kbl_data/2022-2023,S41G01N36,고양 캐롯,Away,전성현,6,1,4,25.0,1,7,14.3,2,11,18.2,1,1,100.0,0,3,3,4,3,0,0,0,1,1
../kbl_data/2022-2023,S41G01N36,고양 캐롯,Away,이종현,2,1,1,100.0,0,0,0.0,1,1,100.0,0,0,0.0,0,0,0,3,1,0,0,0,0,2
../kbl_data/2022-2023,S41G01N36,고양 캐롯,Away,김진유,2,0,0,0.0,0,0,0.0,0,0,0.0,2,2,100.0,0,0,0,0,1,0,1,0,0,5
../kbl_data/2022-2023,S41G01N36,고양 캐롯,Away,조한진,4,2,2,100.0,0,3,0.0,2,5,40.0,0,0,0.0,1,1,2,0,1,0,0,0,0,1
../kbl_data/2022-2023,S41G01N36,고양 캐롯,Away,김세창,0,0,0,0.0,0,0,0.0,0,0,0.0,0,0,0.0,0,1,1,0,0,0,0,0,0,1
../kbl_data/2022-2023,S41G01N36,고양 캐롯,Away,디드릭 로슨,17,6,11,54.5,1,4,25.0,7,15,46.7,2,2,100.0,3,6,9,2,0,0,0,1,2,1
../kbl_data/2022-2023,S41G01N36,고양 캐롯,Away,박진철,0,0,0,0.0,0,0,0.0,0,0,0.0,0,0,0.0,0,0,0,0,0,0,0,0,0,0
../kbl_data/2022-2023,S41G01N36,고양 캐롯,Away,이정현,88,12,22,54.5,12,30,40.0,24,52,46.2,28,34,82.4,2,10,12,16,6,0,4,0,10,16
../kbl_data/2022-2023,S41G01N37,안양 KGC,Home,양희종,0,0,0,0.0,0,1,0.0,0,1,0.0,0,0,0.0,0,0,0,0,0,0,1,0,2,1
../kbl_data/2022-2023,S41G01N37,안양 KGC,Home,오세근,10,4,8,50.0,0,1,0.0,4,9,44.4,2,2,100.0,0,5,5,2,0,0,0,0,1,1
../kbl_data/2022-2023,S41G01N37,안양 KGC,Home,정준원,0,0,0,0.0,0,0,0.0,0,0,0.0,0,0,0.0,0,0,0,0,0,0,0,0,0,0
../kbl_data/2022-2023,S41G01N37,안양 KGC,Home,배병준,2,1,1,100.0,0,3,0.0,1,4,25.0,0,0,0.0,0,2,2,1,1,0,0,0,2,2
../kbl_data/2022-2023,S41G01N37,안양 KGC,Home,문성곤,8,1,3,33.3,2,9,22.2,3,12,25.0,0,0,0.0,0,5,5,3,3,0,0,0,0,2
../kbl_data/2022-2023,S41G01N37,안양 KGC,Home,박지훈,12,2,8,25.0,2,8,25.0,4,16,25.0,2,4,50.0,10,0,10,8,2,0,2,0,4,10
../kbl_data/2022-2023,S41G01N37,안양 KGC,Home,이우정,0,0,0,0.0,0,0,0.0,0,0,0.0,0,0,0.0,0,0,0,0,0,0,0,0,0,0
../kbl_data/2022-2023,S41G01N37,안양 KGC,Home,대릴 먼로,0,0,0,0.0,0,0,0.0,0,0,0.0,0,0,0.0,0,0,0,0,0,0,0,0,0,1
../kbl_data/2022-2023,S41G01N37,안양 KGC,Home,변준형,17,5,6,83.3,2,4,50.0,7,10,70.0,1,2,50.0,0,1,1,4,1,0,1,0,2,4
../kbl_data/2022-2023,S41G01N37,안양 KGC,Home,한승희,0,0,0,0.0,0,1,0.0,0,1,0.0,0,0,0.0,0,0,0,0,0,0,0,0,0,0
../kbl_data/2022-2023,S41G01N37,안양 KGC,Home,오마리 스펠맨,24,6,11,54.5,3,8,37.5,9,19,47.4,3,7,42.9,5,15,20,4,1,1,0,4,4,3
../kbl_data/2022-2023,S41G01N37,안양 KGC,Home,렌즈 아반도,6,1,3,33.3,1,2,50.0,2,5,40.0,1,2,50.0,2,0,2,0,0,1,0,1,0,2
../kbl_data/2022-2023,S41G01N37,대구 한국가스공사,Away,차바위,0,0,0,0.0,0,4,0.0,0,4,0.0,0,0,0.0,2,1,3,0,0,0,1,0,2,2
../kbl_data/2022-2023,S41G01N37,대구 한국가스공사,Away,박지훈,12,2,8,25.0,2,8,25.0,4,16,25.0,2,4,50.0,10,0,10,8,2,0,2,0,4,10
../kbl_data/2022-2023,S41G01N37,대구 한국가스공사,Away,이대헌,10,4,5,80.0,0,1,0.0,4,6,66.7,2,2,100.0,1,5,6,2,0,0,0,0,0,3
../kbl_data/2022-2023,S41G01N37,대구 한국가스공사,Away,이대성,8,4,11,36.4,0,2,0.0,4,13,30.8,0,0,0.0,0,0,0,5,2,0,0,0,2,4
../kbl_data/2022-2023,S41G01N37,대구 한국가스공사,Away,정효근,18,4,10,40.0,3,9,33.3,7,19,36.8,1,1,100.0,0,5,5,1,3,0,0,0,1,3
../kbl_data/2022-2023,S41G01N37,대구 한국가스공사,Away,박봉진,0,0,0,0.0,0,0,0.0,0,0,0.0,0,0,0.0,0,0,0,0,0,0,0,0,0,0
../kbl_data/2022-2023,S41G01N37,대구 한국가스공사,Away,머피 할로웨이,23,9,19,47.4,0,1,0.0,9,20,45.0,5,5,100.0,7,12,19,5,3,1,0,0,3,4
../kbl_data/2022-2023,S41G01N37,대구 한국가스공사,Away,우동현,0,0,0,0.0,0,1,0.0,0,1,0.0,0,0,0.0,2,0,2,1,0,0,0,0,0,1
../kbl_data/2022-2023,S41G01N37,대구 한국가스공사,Away,전현우,0,0,0,0.0,0,0,0.0,0,0,0.0,0,0,0.0,0,0,0,0,0,0,0,0,0,0
../kbl_data/2022-2023,S41G01N37,대구 한국가스공사,Away,신승민,0,0,0,0.0,0,1,0.0,0,1,0.0,0,0,0.0,0,1,1,0,0,0,0,0,0,0
../kbl_data/2022-2023,S41G01N37,대구 한국가스공사,Away,샘조세프 벨란겔,13,2,2,100.0,3,7,42.9,5,9,55.6,0,0,0.0,0,2,2,1,0,0,2,0,2,2
../kbl_data/2022-2023,S41G01N37,대구 한국가스공사,Away,유슈 은도예,0,0,0,0.0,0,0,0.0,0,0,0.0,0,0,0.0,1,0,1,0,0,0,0,0,0,1
../kbl_data/2022-2023,S41G01N38,수원 KT,Home,김동욱,8,1,2,50.0,2,5,40.0,3,7,42.9,0,0,0.0,0,0,0,5,2,0,0,0,0,3
../kbl_data/2022-2023,S41G01N38,수원 KT,Home,김영환,6,0,1,0.0,2,3,66.7,2,4,50.0,0,0,0.0,0,0,0,1,0,0,0,0,0,2
../kbl_data/2022-2023,S41G01N38,수원 KT,Home,김민욱,0,0,0,0.0,0,1,0.0,0,1,0.0,0,0,0.0,0,1,1,0,0,0,0,0,0,1
../kbl_data/2022-2023,S41G01N38,수원 KT,Home,한희원,8,2,4,50.0,1,3,33.3,3,7,42.9,1,1,100.0,2,2,4,1,0,0,0,0,0,2
../kbl_data/2022-2023,S41G01N38,수원 KT,Home,최창진,5,1,1,100.0,1,1,100.0,2,2,100.0,0,0,0.0,1,0,1,2,1,0,0,0,1,2
../kbl_data/2022-2023,S41G01N38,수원 KT,Home,이현석,3,0,0,0.0,1,2,50.0,1,2,50.0,0,0,0.0,1,2,3,0,0,0,0,0,0,1
../kbl_data/2022-2023,S41G01N38,수원 KT,Home,정성우,17,4,10,40.0,2,6,33.3,6,16,37.5,3,3,100.0,2,2,4,6,0,0,0,0,5,3
../kbl_data/2022-2023,S41G01N38,수원 KT,Home,최성모,0,0,0,0.0,0,1,0.0,0,1,0.0,0,0,0.0,0,1,1,2,0,0,0,0,0,1
../kbl_data/2022-2023,S41G01N38,수원 KT,Home,박지원,0,0,2,0.0,0,1,0.0,0,3,0.0,0,0,0.0,0,0,0,0,0,0,0,0,0,1
../kbl_data/2022-2023,S41G01N38,수원 KT,Home,하윤기,17,8,10,80.0,0,0,0.0,8,10,80.0,1,2,50.0,1,6,7,1,3,2,0,1,0,1
../kbl_data/2022-2023,S41G01N38,수원 KT,Home,이제이 아노시케,4,2,5,40.0,0,4,0.0,2,9,22.2,0,0,0.0,1,2,3,3,0,0,0,0,1,3
../kbl_data/2022-2023,S41G01N38,수원 KT,Home,랜드리 은노코,5,2,5,40.0,0,0,0.0,2,5,40.0,1,2,50.0,1,4,5,0,1,1,1,0,1,1
../kbl_data/2022-2023,S41G01N38,전주 KCC,Away,정창영,14,5,10,50.0,1,3,33.3,6,13,46.2,1,2,50.0,2,2,4,1,0,0,0,0,1,2
../kbl_data/2022-2023,S41G01N38,전주 KCC,Away,라건아,21,6,13,46.2,1,3,33.3,7,16,43.8,6,6,100.0,2,15,17,1,0,1,0,0,0,1
../kbl_data/2022-2023,S41G01N38,전주 KCC,Away,김지완,13,2,2,100.0,3,4,75.0,5,6,83.3,0,0,0.0,0,1,1,3,1,0,0,0,3,4
../kbl_data/2022-2023,S41G01N38,전주 KCC,Away,김상규,0,0,1,0.0,0,0,0.0,0,1,0.0,0,0,0.0,2,0,2,0,0,0,0,0,1,0
../kbl_data/2022-2023,S41G01N38,전주 KCC,Away,유병훈,0,0,0,0.0,0,0,0.0,0,0,0.0,0,0,0.0,0,0,0,0,0,0,0,0,0,0
../kbl_data/2022-2023,S41G01N38,전주 KCC,Away,전준범,3,0,0,0.0,1,2,50.0,1,2,50.0,0,0,0.0,0,1,1,1,0,0,0,0,0,3
../kbl_data/2022-2023,S41G01N38,전주 KCC,Away,허웅,12,2,4,50.0,2,2,100.0,4,6,66.7,2,2,100.0,0,2,2,9,0,0,0,0,3,1
../kbl_data/2022-2023,S41G01N38,전주 KCC,Away,이승현,9,3,8,37.5,1,2,50.0,4,10,40.0,0,0,0.0,3,5,8,2,3,0,0,0,0,2
../kbl_data/2022-2023,S41G01N38,전주 KCC,Away,이진욱,0,0,0,0.0,0,0,0.0,0,0,0.0,0,0,0.0,0,0,0,0,0,0,0,0,0,0
../kbl_data/2022-2023,S41G01N38,전주 KCC,Away,이근휘,5,1,1,100.0,1,2,50.0,2,3,66.7,0,1,0.0,2,1,3,1,0,0,1,0,0,1
../kbl_data/2022-2023,S41G01N38,전주 KCC,Away,론데 홀리스 제퍼슨,11,5,10,50.0,0,1,0.0,5,11,45.5,1,2,50.0,1,0,1,0,0,0,1,0,1,0
../kbl_data/2022-2023,S41G01N38,전주 KCC,Away,송동훈,0,0,0,0.0,0,0,0.0,0,0,0.0,0,0,0.0,0,1,1,2,0,0,0,0,1,1
../kbl_data/2022-2023,S41G01N39,원주 DB,Home,박찬희,5,1,2,50.0,1,4,25.0,2,6,33.3,0,2,0.0,0,1,1,2,1,0,0,0,0,2
../kbl_data/2022-2023,S41G01N39,원주 DB,Home,김현호,2,1,2,50.0,0,1,0.0,1,3,33.3,0,0,0.0,0,0,0,0,0,0,1,0,0,0
../kbl_data/2022-2023,S41G01N39,원주 DB,Home,두경민,18,2,5,40.0,4,8,50.0,6,13,46.2,2,2,100.0,0,2,2,6,1,0,0,0,1,2
../kbl_data/2022-2023,S41G01N39,원주 DB,Home,김종규,3,1,6,16.7,0,0,0.0,1,6,16.7,1,2,50.0,3,1,4,0,0,0,0,0,1,2
../kbl_data/2022-2023,S41G01N39,원주 DB,Home,최승욱,6,3,5,60.0,0,0,0.0,3,5,60.0,0,0,0.0,3,1,4,3,2,0,0,0,0,2
../kbl_data/2022-2023,S41G01N39,원주 DB,Home,강상재,12,6,8,75.0,0,0,0.0,6,8,75.0,0,0,0.0,4,7,11,3,0,0,0,0,2,3
../kbl_data/2022-2023,S41G01N39,원주 DB,Home,윤성원,0,0,0,0.0,0,0,0.0,0,0,0.0,0,0,0.0,0,0,0,0,0,0,0,0,0,0
../kbl_data/2022-2023,S41G01N39,원주 DB,Home,레나드 프리먼,10,5,7,71.4,0,0,0.0,5,7,71.4,0,1,0.0,1,4,5,0,3,2,0,0,1,3
../kbl_data/2022-2023,S41G01N39,원주 DB,Home,정호영,0,0,0,0.0,0,0,0.0,0,0,0.0,0,0,0.0,0,0,0,0,0,0,0,0,0,0
../kbl_data/2022-2023,S41G01N39,원주 DB,Home,이선 알바노,10,4,11,36.4,0,2,0.0,4,13,30.8,2,3,66.7,2,2,4,5,0,0,0,0,0,2
../kbl_data/2022-2023,S41G01N39,원주 DB,Home,드완 에르난데스,20,7,11,63.6,0,0,0.0,7,11,63.6,6,9,66.7,1,7,8,1,0,2,0,4,3,3
../kbl_data/2022-2023,S41G01N39,원주 DB,Home,박인웅,0,0,1,0.0,0,0,0.0,0,1,0.0,0,0,0.0,1,1,2,1,0,0,0,0,1,1
../kbl_data/2022-2023,S41G01N39,울산 현대모비스,Away,함지훈,10,4,5,80.0,0,1,0.0,4,6,66.7,2,3,66.7,1,1,2,2,0,0,0,0,1,2
../kbl_data/2022-2023,S41G01N39,울산 현대모비스,Away,김현민,0,0,0,0.0,0,0,0.0,0,0,0.0,0,0,0.0,0,0,0,0,0,0,0,0,0,0
../kbl_data/2022-2023,S41G01N39,울산 현대모비스,Away,장재석,4,2,5,40.0,0,0,0.0,2,5,40.0,0,2,0.0,3,3,6,0,0,2,0,0,1,3
../kbl_data/2022-2023,S41G01N39,울산 현대모비스,Away,김영현,2,1,3,33.3,0,4,0.0,1,7,14.3,0,0,0.0,1,1,2,0,0,0,0,0,1,1
../kbl_data/2022-2023,S41G01N39,울산 현대모비스,Away,김국찬,4,0,0,0.0,1,4,25.0,1,4,25.0,1,2,50.0,0,1,1,0,0,0,0,0,0,0
../kbl_data/2022-2023,S41G01N39,울산 현대모비스,Away,서명진,9,2,5,40.0,1,6,16.7,3,11,27.3,2,2,100.0,1,4,5,8,0,0,0,0,1,0
../kbl_data/2022-2023,S41G01N39,울산 현대모비스,Away,저스틴 녹스,14,3,6,50.0,1,1,100.0,4,7,57.1,5,5,100.0,2,4,6,1,1,1,0,0,3,4
../kbl_data/2022-2023,S41G01N39,울산 현대모비스,Away,이우석,19,6,9,66.7,1,3,33.3,7,12,58.3,4,6,66.7,1,5,6,1,2,0,0,0,0,2
../kbl_data/2022-2023,S41G01N39,울산 현대모비스,Away,신민석,0,0,0,0.0,0,0,0.0,0,0,0.0,0,0,0.0,0,0,0,0,0,0,0,0,0,0
../kbl_data/2022-2023,S41G01N39,울산 현대모비스,Away,김동준,2,0,4,0.0,0,1,0.0,0,5,0.0,2,2,100.0,0,0,0,0,1,0,0,0,1,0
../kbl_data/2022-2023,S41G01N39,울산 현대모비스,Away,게이지 프림,14,7,12,58.3,0,0,0.0,7,12,58.3,0,1,0.0,7,6,13,6,3,1,0,0,1,5
../kbl_data/2022-2023,S41G01N39,울산 현대모비스,Away,김태완,3,0,2,0.0,1,1,100.0,1,3,33.3,0,0,0.0,0,0,0,3,1,0,0,0,0,4
../kbl_data/2022-2023,S41G01N40,서울 삼성,Home,이정현,10,2,4,50.0,1,5,20.0,3,9,33.3,3,4,75.0,0,2,2,5,1,0,0,0,0,3
../kbl_data/2022-2023,S41G01N40,서울 삼성,Home,장민국,2,1,1,100.0,0,2,0.0,1,3,33.3,0,0,0.0,0,1,1,1,0,0,0,0,0,2
../kbl_data/2022-2023,S41G01N40,서울 삼성,Home,김현수,0,0,0,0.0,0,0,0.0,0,0,0.0,0,0,0.0,0,0,0,0,0,0,0,0,0,0
../kbl_data/2022-2023,S41G01N40,서울 삼성,Home,임동섭,7,2,2,100.0,1,4,25.0,3,6,50.0,0,0,0.0,1,5,6,0,0,0,0,0,2,1
../kbl_data/2022-2023,S41G01N40,서울 삼성,Home,이동엽,2,1,5,20.0,0,1,0.0,1,6,16.7,0,0,0.0,2,3,5,3,0,0,0,0,1,1
../kbl_data/2022-2023,S41G01N40,서울 삼성,Home,이호현,10,1,2,50.0,2,7,28.6,3,9,33.3,2,2,100.0,0,1,1,1,1,0,0,0,1,3
../kbl_data/2022-2023,S41G01N40,서울 삼성,Home,마커스 데릭슨,14,2,5,40.0,2,3,66.7,4,8,50.0,4,4,100.0,2,7,9,3,2,0,0,0,3,2
../kbl_data/2022-2023,S41G01N40,서울 삼성,Home,전형준,0,0,0,0.0,0,0,0.0,0,0,0.0,0,0,0.0,0,0,0,0,0,0,0,0,0,0
../kbl_data/2022-2023,S41G01N40,서울 삼성,Home,조우성,2,1,2,50.0,0,0,0.0,1,2,50.0,0,0,0.0,1,2,3,1,0,0,0,0,0,5
../kbl_data/2022-2023,S41G01N40,서울 삼성,Home,이원석,10,5,5,100.0,0,1,0.0,5,6,83.3,0,0,0.0,0,3,3,0,0,0,0,0,1,4
../kbl_data/2022-2023,S41G01N40,서울 삼성,Home,이매뉴얼 테리,2,1,10,10.0,0,0,0.0,1,10,10.0,0,0,0.0,4,5,9,2,0,0,0,0,1,0
../kbl_data/2022-2023,S41G01N40,서울 삼성,Home,신동혁,12,3,4,75.0,2,2,100.0,5,6,83.3,0,0,0.0,0,1,1,1,0,0,0,0,0,1
../kbl_data/2022-2023,S41G01N40,전주 KCC,Away,정창영,11,1,1,100.0,3,6,50.0,4,7,57.1,0,0,0.0,0,3,3,1,0,0,0,0,0,3
../kbl_data/2022-2023,S41G01N40,전주 KCC,Away,라건아,12,4,9,44.4,0,2,0.0,4,11,36.4,4,7,57.1,10,9,19,0,1,0,0,0,1,0
../kbl_data/2022-2023,S41G01N40,전주 KCC,Away,김지완,2,0,1,0.0,0,4,0.0,0,5,0.0,2,2,100.0,0,1,1,2,1,0,1,0,0,2
../kbl_data/2022-2023,S41G01N40,전주 KCC,Away,김상규,0,0,0,0.0,0,2,0.0,0,2,0.0,0,0,0.0,1,0,1,0,0,0,0,0,0,0
../kbl_data/2022-2023,S41G01N40,전주 KCC,Away,유병훈,3,0,1,0.0,1,1,100.0,1,2,50.0,0,0,0.0,0,0,0,1,0,0,0,0,0,2
../kbl_data/2022-2023,S41G01N40,전주 KCC,Away,허웅,8,1,6,16.7,1,5,20.0,2,11,18.2,3,3,100.0,0,0,0,4,0,0,0,0,2,1
../kbl_data/2022-2023,S41G01N40,전주 KCC,Away,이승현,4,1,9,11.1,0,0,0.0,1,9,11.1,2,2,100.0,4,7,11,3,0,0,0,0,2,1
../kbl_data/2022-2023,S41G01N40,전주 KCC,Away,이진욱,0,0,0,0.0,0,0,0.0,0,0,0.0,0,0,0.0,0,0,0,0,0,0,0,0,0,0
../kbl_data/2022-2023,S41G01N40,전주 KCC,Away,곽정훈,0,0,0,0.0,0,0,0.0,0,0,0.0,0,0,0.0,0,0,0,0,0,0,0,0,0,0
../kbl_data/2022-2023,S41G01N40,전주 KCC,Away,이근휘,3,0,1,0.0,1,4,25.0,1,5,20.0,0,0,0.0,1,2,3,1,1,0,0,0,0,1
../kbl_data/2022-2023,S41G01N40,전주 KCC,Away,론데 홀리스 제퍼슨,15,4,9,44.4,1,2,50.0,5,11,45.5,4,6,66.7,2,4,6,2,1,0,1,0,3,4
../kbl_data/2022-2023,S41G01N40,전주 KCC,Away,송동훈,4,2,3,66.7,0,2,0.0,2,5,40.0,0,0,0.0,0,0,0,0,0,0,1,0,0,3
../kbl_data/2022-2023,S41G01N41,대구 한국가스공사,Home,차바위,2,1,1,100.0,0,1,0.0,1,2,50.0,0,0,0.0,0,2,2,0,0,0,0,0,0,2
../kbl_data/2022-2023,S41G01N41,대구 한국가스공사,Home,박지훈,0,0,0,0.0,0,0,0.0,0,0,0.0,0,0,0.0,0,1,1,0,0,0,0,0,1,2
../kbl_data/2022-2023,S41G01N41,대구 한국가스공사,Home,이원대,4,2,4,50.0,0,1,0.0,2,5,40.0,0,0,0.0,0,1,1,7,1,0,0,0,0,1
../kbl_data/2022-2023,S41G01N41,대구 한국가스공사,Home,이대헌,9,4,6,66.7,0,1,0.0,4,7,57.1,1,2,50.0,2,1,3,2,1,0,0,0,1,1
../kbl_data/2022-2023,S41G01N41,대구 한국가스공사,Home,이대성,20,4,8,50.0,3,4,75.0,7,12,58.3,3,4,75.0,0,4,4,3,3,0,0,0,1,3
../kbl_data/2022-2023,S41G01N41,대구 한국가스공사,Home,정효근,0,0,1,0.0,0,2,0.0,0,3,0.0,0,0,0.0,0,1,1,0,0,1,0,0,4,2
../kbl_data/2022-2023,S41G01N41,대구 한국가스공사,Home,박봉진,0,0,0,0.0,0,0,0.0,0,0,0.0,0,0,0.0,0,0,0,0,0,0,0,0,0,0
../kbl_data/2022-2023,S41G01N41,대구 한국가스공사,Home,머피 할로웨이,15,6,19,31.6,0,0,0.0,6,19,31.6,3,5,60.0,4,6,10,0,2,2,0,0,1,3
../kbl_data/2022-2023,S41G01N41,대구 한국가스공사,Home,우동현,2,1,1,100.0,0,0,0.0,1,1,100.0,0,0,0.0,0,1,1,0,0,0,0,0,1,0
../kbl_data/2022-2023,S41G01N41,대구 한국가스공사,Home,전현우,2,1,1,100.0,0,0,0.0,1,1,100.0,0,0,0.0,0,0,0,0,1,1,0,0,1,2
../kbl_data/2022-2023,S41G01N41,대구 한국가스공사,Home,샘조세프 벨란겔,2,1,2,50.0,0,2,0.0,1,4,25.0,0,0,0.0,1,1,2,0,0,0,0,0,1,2
../kbl_data/2022-2023,S41G01N41,대구 한국가스공사,Home,유슈 은도예,6,3,6,50.0,0,0,0.0,3,6,50.0,0,0,0.0,1,0,1,0,2,0,0,0,1,1
../kbl_data/2022-2023,S41G01N41,창원 LG,Away,이관희,19,4,6,66.7,3,8,37.5,7,14,50.0,2,2,100.0,0,3,3,1,2,2,1,0,3,1
../kbl_data/2022-2023,S41G01N41,창원 LG,Away,정희재,3,0,2,0.0,1,2,50.0,1,4,25.0,0,0,0.0,2,0,2,1,1,0,0,0,2,3
../kbl_data/2022-2023,S41G01N41,창원 LG,Away,서민수,2,1,2,50.0,0,3,0.0,1,5,20.0,0,0,0.0,0,2,2,2,1,0,1,0,0,2
../kbl_data/2022-2023,S41G01N41,창원 LG,Away,한상혁,0,0,0,0.0,0,0,0.0,0,0,0.0,0,0,0.0,0,0,0,0,0,0,0,0,2,0
../kbl_data/2022-2023,S41G01N41,창원 LG,Away,이재도,12,4,6,66.7,1,5,20.0,5,11,45.5,1,1,100.0,0,0,0,2,0,0,0,0,2,1
../kbl_data/2022-2023,S41G01N41,창원 LG,Away,김준일,2,1,2,50.0,0,0,0.0,1,2,50.0,0,0,0.0,0,1,1,2,0,0,0,0,3,1
../kbl_data/2022-2023,S41G01N41,창원 LG,Away,박인태,0,0,0,0.0,0,0,0.0,0,0,0.0,0,0,0.0,0,0,0,0,0,0,0,0,0,0
../kbl_data/2022-2023,S41G01N41,창원 LG,Away,윤원상,8,0,0,0.0,2,3,66.7,2,3,66.7,2,2,100.0,0,0,0,1,0,0,0,0,0,3
../kbl_data/2022-2023,S41G01N41,창원 LG,Away,아셈 마레이,20,9,13,69.2,0,0,0.0,9,13,69.2,2,2,100.0,6,15,21,2,3,1,1,0,4,1
../kbl_data/2022-2023,S41G01N41,창원 LG,Away,이승우,10,3,3,100.0,1,4,25.0,4,7,57.1,1,4,25.0,3,5,8,2,1,0,0,0,0,2
../kbl_data/2022-2023,S41G01N41,창원 LG,Away,저스틴 구탕,0,0,1,0.0,0,0,0.0,0,1,0.0,0,0,0.0,0,0,0,1,0,0,0,0,0,0
../kbl_data/2022-2023,S41G01N41,창원 LG,Away,단테 커닝햄,0,0,1,0.0,0,0,0.0,0,1,0.0,0,0,0.0,0,1,1,0,0,1,0,0,0,0
../kbl_data/2022-2023,S41G01N42,고양 캐롯,Home,김강선,0,0,0,0.0,0,0,0.0,0,0,0.0,0,0,0.0,0,0,0,0,0,0,0,0,0,0
../kbl_data/2022-2023,S41G01N42,고양 캐롯,Home,데이비드 사이먼,21,9,14,64.3,0,2,0.0,9,16,56.2,3,5,60.0,0,8,8,2,1,2,0,0,2,2
../kbl_data/2022-2023,S41G01N42,고양 캐롯,Home,최현민,19,0,1,0.0,6,7,85.7,6,8,75.0,1,3,33.3,1,1,2,1,0,0,0,0,1,3
../kbl_data/2022-2023,S41G01N42,고양 캐롯,Home,한호빈,5,1,1,100.0,1,2,50.0,2,3,66.7,0,0,0.0,1,1,2,5,0,0,0,0,1,1
../kbl_data/2022-2023,S41G01N42,고양 캐롯,Home,전성현,22,2,5,40.0,4,6,66.7,6,11,54.5,6,6,100.0,0,4,4,6,2,0,0,0,1,3
../kbl_data/2022-2023,S41G01N42,고양 캐롯,Home,이종현,0,0,1,0.0,0,0,0.0,0,1,0.0,0,0,0.0,0,2,2,0,1,0,0,0,1,0
../kbl_data/2022-2023,S41G01N42,고양 캐롯,Home,김진유,0,0,0,0.0,0,1,0.0,0,1,0.0,0,0,0.0,2,0,2,1,0,0,0,0,0,2
../kbl_data/2022-2023,S41G01N42,고양 캐롯,Home,조한진,12,0,0,0.0,4,5,80.0,4,5,80.0,0,2,0.0,2,0,2,1,0,0,0,0,1,1
../kbl_data/2022-2023,S41G01N42,고양 캐롯,Home,김세창,2,1,1,100.0,0,0,0.0,1,1,100.0,0,0,0.0,0,0,0,1,0,0,0,0,0,0
../kbl_data/2022-2023,S41G01N42,고양 캐롯,Home,디드릭 로슨,19,8,12,66.7,1,3,33.3,9,15,60.0,0,0,0.0,2,6,8,1,2,1,0,0,0,4
../kbl_data/2022-2023,S41G01N42,고양 캐롯,Home,박진철,1,0,0,0.0,0,0,0.0,0,0,0.0,1,2,50.0,1,1,2,0,0,0,0,0,0,5
../kbl_data/2022-2023,S41G01N42,고양 캐롯,Home,이정현,11,3,4,75.0,1,4,25.0,4,8,50.0,2,2,100.0,0,2,2,5,0,0,0,0,0,1
../kbl_data/2022-2023,S41G01N42,울산 현대모비스,Away,함지훈,11,3,4,75.0,1,1,100.0,4,5,80.0,2,4,50.0,3,1,4,5,0,0,0,0,0,0
../kbl_data/2022-2023,S41G01N42,울산 현대모비스,Away,김현민,4,2,2,100.0,0,1,0.0,2,3,66.7,0,0,0.0,1,0,1,0,0,0,0,0,0,0
../kbl_data/2022-2023,S41G01N42,울산 현대모비스,Away,장재석,8,3,7,42.9,0,0,0.0,3,7,42.9,2,4,50.0,2,2,4,2,0,0,0,0,0,2
../kbl_data/2022-2023,S41G01N42,울산 현대모비스,Away,김영현,9,0,0,0.0,3,4,75.0,3,4,75.0,0,0,0.0,0,0,0,0,0,0,0,0,0,2
../kbl_data/2022-2023,S41G01N42,울산 현대모비스,Away,김국찬,0,0,0,0.0,0,0,0.0,0,0,0.0,0,0,0.0,0,0,0,0,0,0,0,0,0,0
../kbl_data/2022-2023,S41G01N42,울산 현대모비스,Away,서명진,4,2,4,50.0,0,8,0.0,2,12,16.7,0,0,0.0,0,2,2,5,0,0,1,0,3,1
../kbl_data/2022-2023,S41G01N42,울산 현대모비스,Away,저스틴 녹스,6,3,6,50.0,0,0,0.0,3,6,50.0,0,0,0.0,2,4,6,2,0,0,0,0,0,2
../kbl_data/2022-2023,S41G01N42,울산 현대모비스,Away,이우석,7,2,5,40.0,1,2,50.0,3,7,42.9,0,0,0.0,0,3,3,4,2,0,0,0,0,2
../kbl_data/2022-2023,S41G01N42,울산 현대모비스,Away,신민석,7,0,1,0.0,2,5,40.0,2,6,33.3,1,2,50.0,0,0,0,0,0,0,0,0,1,4
../kbl_data/2022-2023,S41G01N42,울산 현대모비스,Away,김동준,5,1,2,50.0,1,2,50.0,2,4,50.0,0,0,0.0,0,2,2,3,1,0,0,0,0,1
../kbl_data/2022-2023,S41G01N42,울산 현대모비스,Away,게이지 프림,24,7,13,53.8,0,0,0.0,7,13,53.8,10,13,76.9,3,6,9,0,0,0,0,0,2,4
../kbl_data/2022-2023,S41G01N42,울산 현대모비스,Away,김태완,3,0,1,0.0,1,2,50.0,1,3,33.3,0,0,0.0,0,1,1,6,2,0,0,0,0,4
../kbl_data/2022-2023,S41G01N43,수원 KT,Home,김동욱,15,4,6,66.7,2,6,33.3,6,12,50.0,1,2,50.0,1,4,5,4,0,0,0,0,1,2
../kbl_data/2022-2023,S41G01N43,수원 KT,Home,김민욱,0,0,0,0.0,0,0,0.0,0,0,0.0,0,0,0.0,0,0,0,0,0,0,0,0,0,0
../kbl_data/2022-2023,S41G01N43,수원 KT,Home,한희원,9,3,3,100.0,1,2,50.0,4,5,80.0,0,0,0.0,1,4,5,1,0,1,0,0,0,3
../kbl_data/2022-2023,S41G01N43,수원 KT,Home,최창진,8,1,2,50.0,2,2,100.0,3,4,75.0,0,0,0.0,1,4,5,0,0,0,1,0,1,4
../kbl_data/2022-2023,S41G01N43,수원 KT,Home,이현석,0,0,0,0.0,0,1,0.0,0,1,0.0,0,0,0.0,0,0,0,2,1,0,0,0,2,1
../kbl_data/2022-2023,S41G01N43,수원 KT,Home,정성우,17,3,9,33.3,3,6,50.0,6,15,40.0,2,3,66.7,0,1,1,5,0,0,0,0,0,1
../kbl_data/2022-2023,S41G01N43,수원 KT,Home,최성모,0,0,0,0.0,0,0,0.0,0,0,0.0,0,0,0.0,0,0,0,0,0,0,0,0,0,0
../kbl_data/2022-2023,S41G01N43,수원 KT,Home,양홍석,10,2,3,66.7,2,4,50.0,4,7,57.1,0,0,0.0,0,2,2,1,0,0,0,0,1,1
../kbl_data/2022-2023,S41G01N43,수원 KT,Home,박지원,0,0,0,0.0,0,0,0.0,0,0,0.0,0,0,0.0,0,0,0,0,0,0,0,0,0,0
../kbl_data/2022-2023,S41G01N43,수원 KT,Home,하윤기,12,6,11,54.5,0,0,0.0,6,11,54.5,0,0,0.0,2,5,7,2,0,0,0,0,2,0
../kbl_data/2022-2023,S41G01N43,수원 KT,Home,이제이 아노시케,0,0,3,0.0,0,1,0.0,0,4,0.0,0,0,0.0,0,3,3,0,0,0,0,0,2,3
../kbl_data/2022-2023,S41G01N43,수원 KT,Home,랜드리 은노코,5,2,3,66.7,0,0,0.0,2,3,66.7,1,2,50.0,3,5,8,2,1,2,0,1,1,1
../kbl_data/2022-2023,S41G01N43,서울 SK,Away,양우섭,5,1,1,100.0,1,2,50.0,2,3,66.7,0,0,0.0,0,1,1,1,0,0,0,0,0,2
../kbl_data/2022-2023,S41G01N43,서울 SK,Away,허일영,2,1,3,33.3,0,2,0.0,1,5,20.0,0,0,0.0,4,6,10,0,1,0,0,0,0,2
../kbl_data/2022-2023,S41G01N43,서울 SK,Away,송창용,3,1,1,100.0,0,1,0.0,1,2,50.0,1,2,50.0,0,1,1,2,0,0,0,0,0,1
../kbl_data/2022-2023,S41G01N43,서울 SK,Away,김선형,12,1,5,20.0,2,4,50.0,3,9,33.3,4,6,66.7,0,1,1,7,0,0,0,0,2,1
../kbl_data/2022-2023,S41G01N43,서울 SK,Away,홍경기,11,0,1,0.0,3,5,60.0,3,6,50.0,2,2,100.0,2,1,3,0,1,0,0,0,1,1
../kbl_data/2022-2023,S41G01N43,서울 SK,Away,김승원,0,0,0,0.0,0,0,0.0,0,0,0.0,0,0,0.0,0,0,0,0,0,0,0,0,0,0
../kbl_data/2022-2023,S41G01N43,서울 SK,Away,리온 윌리엄스,3,1,1,100.0,0,1,0.0,1,2,50.0,1,2,50.0,0,2,2,0,1,0,0,0,0,1
../kbl_data/2022-2023,S41G01N43,서울 SK,Away,최원혁,2,1,2,50.0,0,1,0.0,1,3,33.3,0,0,0.0,2,0,2,1,0,0,0,0,0,3
../kbl_data/2022-2023,S41G01N43,서울 SK,Away,장문호,0,0,0,0.0,0,0,0.0,0,0,0.0,0,0,0.0,0,0,0,0,0,0,0,0,0,0
../kbl_data/2022-2023,S41G01N43,서울 SK,Away,자밀 워니,20,8,16,50.0,0,4,0.0,8,20,40.0,4,4,100.0,1,10,11,2,2,1,0,1,0,1
../kbl_data/2022-2023,S41G01N43,서울 SK,Away,김형빈,8,4,7,57.1,0,0,0.0,4,7,57.1,0,0,0.0,2,1,3,1,1,0,0,0,1,2
../kbl_data/2022-2023,S41G01N43,서울 SK,Away,오재현,8,1,4,25.0,2,6,33.3,3,10,30.0,0,0,0.0,1,0,1,3,0,1,1,0,0,3
../kbl_data/2022-2023,S41G01N44,고양 캐롯,Home,김강선,6,0,0,0.0,2,2,100.0,2,2,100.0,0,0,0.0,0,0,0,0,0,0,0,0,0,1
../kbl_data/2022-2023,S41G01N44,고양 캐롯,Home,데이비드 사이먼,16,8,14,57.1,0,1,0.0,8,15,53.3,0,1,0.0,1,4,5,1,1,0,0,0,0,2
../kbl_data/2022-2023,S41G01N44,고양 캐롯,Home,최현민,0,0,0,0.0,0,0,0.0,0,0,0.0,0,0,0.0,2,1,3,1,0,0,0,0,0,2
../kbl_data/2022-2023,S41G01N44,고양 캐롯,Home,한호빈,6,1,3,33.3,1,6,16.7,2,9,22.2,1,1,100.0,0,1,1,2,1,0,0,0,1,3
../kbl_data/2022-2023,S41G01N44,고양 캐롯,Home,전성현,20,1,2,50.0,5,7,71.4,6,9,66.7,3,3,100.0,0,0,0,3,2,0,0,0,3,2
../kbl_data/2022-2023,S41G01N44,고양 캐롯,Home,이종현,0,0,0,0.0,0,0,0.0,0,0,0.0,0,0,0.0,0,0,0,0,0,0,0,0,0,0
../kbl_data/2022-2023,S41G01N44,고양 캐롯,Home,김진유,0,0,0,0.0,0,0,0.0,0,0,0.0,0,0,0.0,1,1,2,2,1,0,1,0,0,0
../kbl_data/2022-2023,S41G01N44,고양 캐롯,Home,정해원,0,0,0,0.0,0,0,0.0,0,0,0.0,0,0,0.0,0,0,0,0,0,0,0,0,0,0
../kbl_data/2022-2023,S41G01N44,고양 캐롯,Home,조한진,8,4,4,100.0,0,4,0.0,4,8,50.0,0,0,0.0,2,4,6,0,0,1,0,0,0,1
../kbl_data/2022-2023,S41G01N44,고양 캐롯,Home,디드릭 로슨,28,9,14,64.3,3,4,75.0,12,18,66.7,1,2,50.0,3,9,12,2,2,1,0,2,3,2
../kbl_data/2022-2023,S41G01N44,고양 캐롯,Home,박진철,0,0,0,0.0,0,0,0.0,0,0,0.0,0,0,0.0,0,0,0,0,0,0,0,0,0,0
../kbl_data/2022-2023,S41G01N44,고양 캐롯,Home,이정현,18,6,11,54.5,2,4,50.0,8,15,53.3,0,0,0.0,2,0,2,6,1,0,0,0,1,4
../kbl_data/2022-2023,S41G01N44,서울 SK,Away,양우섭,2,1,2,50.0,0,0,0.0,1,2,50.0,0,0,0.0,0,0,0,2,2,0,0,0,3,4
../kbl_data/2022-2023,S41G01N44,서울 SK,Away,허일영,17,3,4,75.0,2,3,66.7,5,7,71.4,5,6,83.3,0,1,1,0,1,0,0,0,0,1
../kbl_data/2022-2023,S41G01N44,서울 SK,Away,송창용,5,2,2,100.0,0,0,0.0,2,2,100.0,1,1,100.0,1,0,1,0,0,0,0,0,0,1
../kbl_data/2022-2023,S41G01N44,서울 SK,Away,김선형,23,6,14,42.9,2,4,50.0,8,18,44.4,5,7,71.4,1,5,6,5,1,1,0,0,2,1
../kbl_data/2022-2023,S41G01N44,서울 SK,Away,홍경기,9,1,2,50.0,2,4,50.0,3,6,50.0,1,1,100.0,1,1,2,1,0,0,0,0,2,2
../kbl_data/2022-2023,S41G01N44,서울 SK,Away,김승원,0,0,0,0.0,0,0,0.0,0,0,0.0,0,0,0.0,0,0,0,0,0,0,0,0,0,0
../kbl_data/2022-2023,S41G01N44,서울 SK,Away,리온 윌리엄스,2,1,1,100.0,0,2,0.0,1,3,33.3,0,0,0.0,1,2,3,0,1,0,0,0,1,2
../kbl_data/2022-2023,S41G01N44,서울 SK,Away,최원혁,2,1,3,33.3,0,4,0.0,1,7,14.3,0,0,0.0,2,2,4,3,0,0,0,0,0,3
../kbl_data/2022-2023,S41G01N44,서울 SK,Away,장문호,4,1,2,50.0,0,0,0.0,1,2,50.0,2,2,100.0,2,1,3,1,0,0,0,0,0,0
../kbl_data/2022-2023,S41G01N44,서울 SK,Away,자밀 워니,28,14,20,70.0,0,1,0.0,14,21,66.7,0,2,0.0,2,8,10,3,1,0,0,2,3,1
../kbl_data/2022-2023,S41G01N44,서울 SK,Away,김형빈,0,0,0,0.0,0,0,0.0,0,0,0.0,0,0,0.0,0,0,0,0,0,0,0,0,0,2
../kbl_data/2022-2023,S41G01N44,서울 SK,Away,오재현,0,0,0,0.0,0,1,0.0,0,1,0.0,0,0,0.0,0,0,0,1,0,0,0,0,0,0
../kbl_data/2022-2023,S41G01N45,안양 KGC,Home,양희종,2,1,1,100.0,0,2,0.0,1,3,33.3,0,0,0.0,1,4,5,0,1,0,0,0,0,3
../kbl_data/2022-2023,S41G01N45,안양 KGC,Home,오세근,6,0,2,0.0,2,3,66.7,2,5,40.0,0,0,0.0,1,3,4,0,0,1,0,0,4,0
../kbl_data/2022-2023,S41G01N45,안양 KGC,Home,정준원,11,3,4,75.0,1,1,100.0,4,5,80.0,2,2,100.0,0,2,2,0,1,0,0,0,0,2
../kbl_data/2022-2023,S41G01N45,안양 KGC,Home,배병준,4,1,3,33.3,0,3,0.0,1,6,16.7,2,2,100.0,1,2,3,1,1,0,0,0,1,1
../kbl_data/2022-2023,S41G01N45,안양 KGC,Home,문성곤,4,2,2,100.0,0,3,0.0,2,5,40.0,0,0,0.0,1,2,3,3,1,2,1,0,0,4
../kbl_data/2022-2023,S41G01N45,안양 KGC,Home,박지훈,4,1,4,25.0,0,1,0.0,1,5,20.0,2,2,100.0,1,2,3,2,0,0,0,0,3,2
../kbl_data/2022-2023,S41G01N45,안양 KGC,Home,대릴 먼로,8,3,4,75.0,0,0,0.0,3,4,75.0,2,4,50.0,2,2,4,0,0,0,0,0,1,1
../kbl_data/2022-2023,S41G01N45,안양 KGC,Home,변준형,13,4,8,50.0,1,4,25.0,5,12,41.7,2,2,100.0,1,1,2,3,2,1,1,0,2,1
../kbl_data/2022-2023,S41G01N45,안양 KGC,Home,한승희,0,0,0,0.0,0,0,0.0,0,0,0.0,0,0,0.0,0,0,0,0,0,0,0,0,0,0
../kbl_data/2022-2023,S41G01N45,안양 KGC,Home,오마리 스펠맨,8,3,7,42.9,0,7,0.0,3,14,21.4,2,2,100.0,3,7,10,0,1,0,0,1,3,2
../kbl_data/2022-2023,S41G01N45,안양 KGC,Home,조은후,0,0,0,0.0,0,0,0.0,0,0,0.0,0,0,0.0,0,0,0,0,0,0,0,0,0,0
../kbl_data/2022-2023,S41G01N45,안양 KGC,Home,렌즈 아반도,0,0,1,0.0,0,0,0.0,0,1,0.0,0,0,0.0,0,0,0,0,1,1,0,0,2,0
../kbl_data/2022-2023,S41G01N45,서울 삼성,Away,이정현,17,3,8,37.5,2,5,40.0,5,13,38.5,5,6,83.3,0,2,2,1,0,0,0,0,3,4
../kbl_data/2022-2023,S41G01N45,서울 삼성,Away,장민국,2,1,1,100.0,0,1,0.0,1,2,50.0,0,0,0.0,0,2,2,0,0,0,0,0,1,0
../kbl_data/2022-2023,S41G01N45,서울 삼성,Away,김현수,0,0,0,0.0,0,0,0.0,0,0,0.0,0,0,0.0,0,0,0,0,0,0,0,0,0,0
../kbl_data/2022-2023,S41G01N45,서울 삼성,Away,임동섭,2,1,2,50.0,0,2,0.0,1,4,25.0,0,0,0.0,2,4,6,0,0,0,0,0,2,1
../kbl_data/2022-2023,S41G01N45,서울 삼성,Away,이동엽,8,4,6,66.7,0,1,0.0,4,7,57.1,0,0,0.0,2,1,3,5,3,0,1,0,3,2
../kbl_data/2022-2023,S41G01N45,서울 삼성,Away,이호현,9,3,7,42.9,1,5,20.0,4,12,33.3,0,0,0.0,1,1,2,1,3,0,0,0,0,3
../kbl_data/2022-2023,S41G01N45,서울 삼성,Away,마커스 데릭슨,15,2,5,40.0,3,7,42.9,5,12,41.7,2,2,100.0,1,5,6,1,2,1,0,0,2,2
../kbl_data/2022-2023,S41G01N45,서울 삼성,Away,전형준,0,0,0,0.0,0,0,0.0,0,0,0.0,0,0,0.0,0,0,0,0,0,0,0,0,0,1
../kbl_data/2022-2023,S41G01N45,서울 삼성,Away,조우성,0,0,0,0.0,0,0,0.0,0,0,0.0,0,0,0.0,0,0,0,0,0,0,0,0,0,0
../kbl_data/2022-2023,S41G01N45,서울 삼성,Away,이원석,4,2,5,40.0,0,0,0.0,2,5,40.0,0,4,0.0,4,4,8,1,3,1,0,1,0,4
../kbl_data/2022-2023,S41G01N45,서울 삼성,Away,이매뉴얼 테리,10,5,10,50.0,0,0,0.0,5,10,50.0,0,0,0.0,6,4,10,2,2,0,0,1,2,1
../kbl_data/2022-2023,S41G01N45,서울 삼성,Away,신동혁,0,0,3,0.0,0,2,0.0,0,5,0.0,0,0,0.0,0,1,1,0,0,0,0,0,0,2
../kbl_data/2022-2023,S41G01N46,전주 KCC,Home,정창영,10,3,4,75.0,1,3,33.3,4,7,57.1,1,1,100.0,1,1,2,1,0,0,0,0,2,2
../kbl_data/2022-2023,S41G01N46,전주 KCC,Home,라건아,21,7,17,41.2,0,1,0.0,7,18,38.9,7,7,100.0,6,15,21,4,1,1,0,0,1,1
../kbl_data/2022-2023,S41G01N46,전주 KCC,Home,김지완,7,3,5,60.0,0,1,0.0,3,6,50.0,1,1,100.0,0,0,0,2,1,0,0,0,2,3
../kbl_data/2022-2023,S41G01N46,전주 KCC,Home,유병훈,0,0,0,0.0,0,0,0.0,0,0,0.0,0,0,0.0,0,0,0,0,0,0,0,0,0,0
../kbl_data/2022-2023,S41G01N46,전주 KCC,Home,허웅,14,4,8,50.0,1,5,20.0,5,13,38.5,3,3,100.0,0,1,1,5,3,0,0,0,0,2
../kbl_data/2022-2023,S41G01N46,전주 KCC,Home,이승현,10,3,8,37.5,0,0,0.0,3,8,37.5,4,4,100.0,3,4,7,1,0,0,0,0,1,1
../kbl_data/2022-2023,S41G01N46,전주 KCC,Home,이진욱,0,0,0,0.0,0,0,0.0,0,0,0.0,0,0,0.0,0,0,0,0,0,0,0,0,0,0
../kbl_data/2022-2023,S41G01N46,전주 KCC,Home,곽정훈,0,0,0,0.0,0,0,0.0,0,0,0.0,0,0,0.0,0,0,0,0,0,0,0,0,0,0
../kbl_data/2022-2023,S41G01N46,전주 KCC,Home,이근휘,17,1,3,33.3,5,7,71.4,6,10,60.0,0,0,0.0,1,3,4,1,0,0,0,0,1,3
../kbl_data/2022-2023,S41G01N46,전주 KCC,Home,서정현,0,0,0,0.0,0,0,0.0,0,0,0.0,0,0,0.0,1,0,1,0,0,0,0,0,0,1
../kbl_data/2022-2023,S41G01N46,전주 KCC,Home,론데 홀리스 제퍼슨,6,1,3,33.3,0,0,0.0,1,3,33.3,4,4,100.0,0,1,1,0,0,0,0,0,1,1
../kbl_data/2022-2023,S41G01N46,전주 KCC,Home,송동훈,3,0,0,0.0,1,1,100.0,1,1,100.0,0,0,0.0,0,0,0,3,0,0,0,0,2,3
../kbl_data/2022-2023,S41G01N46,원주 DB,Away,박찬희,0,0,2,0.0,0,0,0.0,0,2,0.0,0,0,0.0,0,1,1,0,0,0,0,0,0,0
../kbl_data/2022-2023,S41G01N46,원주 DB,Away,김현호,4,2,2,100.0,0,3,0.0,2,5,40.0,0,0,0.0,1,2,3,0,0,0,1,0,2,1
../kbl_data/2022-2023,S41G01N46,원주 DB,Away,두경민,3,0,1,0.0,1,7,14.3,1,8,12.5,0,0,0.0,0,0,0,4,1,0,0,0,1,1
../kbl_data/2022-2023,S41G01N46,원주 DB,Away,김종규,4,2,3,66.7,0,0,0.0,2,3,66.7,0,0,0.0,1,0,1,0,0,0,0,0,0,4
../kbl_data/2022-2023,S41G01N46,원주 DB,Away,최승욱,2,1,1,100.0,0,2,0.0,1,3,33.3,0,0,0.0,2,2,4,0,0,0,0,0,1,4
../kbl_data/2022-2023,S41G01N46,원주 DB,Away,강상재,10,5,9,55.6,0,1,0.0,5,10,50.0,0,0,0.0,2,3,5,3,1,2,0,0,1,0
../kbl_data/2022-2023,S41G01N46,원주 DB,Away,윤성원,0,0,0,0.0,0,0,0.0,0,0,0.0,0,0,0.0,0,0,0,0,0,0,0,0,0,0
../kbl_data/2022-2023,S41G01N46,원주 DB,Away,이준희,9,2,3,66.7,1,7,14.3,3,10,30.0,2,3,66.7,1,3,4,1,1,0,0,0,1,3
../kbl_data/2022-2023,S41G01N46,원주 DB,Away,레나드 프리먼,15,7,8,87.5,0,0,0.0,7,8,87.5,1,2,50.0,4,3,7,0,0,0,0,0,1,0
../kbl_data/2022-2023,S41G01N46,원주 DB,Away,이선 알바노,14,5,7,71.4,1,6,16.7,6,13,46.2,1,2,50.0,1,3,4,4,4,0,0,0,0,3
../kbl_data/2022-2023,S41G01N46,원주 DB,Away,드완 에르난데스,11,4,10,40.0,0,1,0.0,4,11,36.4,3,3,100.0,5,3,8,0,0,0,0,1,1,2
../kbl_data/2022-2023,S41G01N46,원주 DB,Away,박인웅,1,0,0,0.0,0,1,0.0,0,1,0.0,1,2,50.0,0,0,0,0,0,0,0,0,0,1
../kbl_data/2022-2023,S41G01N47,서울 삼성,Home,이정현,62,12,26,46.2,10,22,45.5,22,48,45.8,8,16,50.0,2,8,10,24,2,0,0,0,6,10
../kbl_data/2022-2023,S41G01N47,서울 삼성,Home,장민국,2,1,2,50.0,0,0,0.0,1,2,50.0,0,0,0.0,0,1,1,1,1,0,1,0,0,5
../kbl_data/2022-2023,S41G01N47,서울 삼성,Home,김현수,0,0,0,0.0,0,0,0.0,0,0,0.0,0,0,0.0,0,0,0,0,0,0,0,0,0,0
../kbl_data/2022-2023,S41G01N47,서울 삼성,Home,임동섭,3,0,1,0.0,1,2,50.0,1,3,33.3,0,0,0.0,0,0,0,0,0,0,0,0,0,2
../kbl_data/2022-2023,S41G01N47,서울 삼성,Home,이동엽,9,1,6,16.7,2,3,66.7,3,9,33.3,1,2,50.0,1,3,4,1,2,0,0,0,1,1
../kbl_data/2022-2023,S41G01N47,서울 삼성,Home,이호현,14,5,7,71.4,1,1,100.0,6,8,75.0,1,1,100.0,0,1,1,3,1,0,0,0,3,2
../kbl_data/2022-2023,S41G01N47,서울 삼성,Home,마커스 데릭슨,7,1,2,50.0,0,3,0.0,1,5,20.0,5,5,100.0,0,4,4,0,0,0,0,0,2,3
../kbl_data/2022-2023,S41G01N47,서울 삼성,Home,전형준,0,0,0,0.0,0,0,0.0,0,0,0.0,0,0,0.0,0,0,0,0,0,0,0,0,0,1
../kbl_data/2022-2023,S41G01N47,서울 삼성,Home,이원석,8,3,7,42.9,0,0,0.0,3,7,42.9,2,3,66.7,2,2,4,0,0,1,0,1,0,2
../kbl_data/2022-2023,S41G01N47,서울 삼성,Home,이매뉴얼 테리,10,4,9,44.4,0,0,0.0,4,9,44.4,2,4,50.0,2,12,14,2,0,0,0,2,2,2
../kbl_data/2022-2023,S41G01N47,서울 삼성,Home,신동혁,2,1,2,50.0,0,0,0.0,1,2,50.0,0,0,0.0,0,0,0,0,0,0,0,0,0,2
../kbl_data/2022-2023,S41G01N47,서울 삼성,Home,박민채,0,0,0,0.0,0,0,0.0,0,0,0.0,0,0,0.0,0,0,0,0,0,0,0,0,0,0
../kbl_data/2022-2023,S41G01N47,고양 캐롯,Away,김강선,0,0,0,0.0,0,0,0.0,0,0,0.0,0,0,0.0,0,0,0,0,0,0,0,0,0,0
../kbl_data/2022-2023,S41G01N47,고양 캐롯,Away,데이비드 사이먼,12,4,9,44.4,0,1,0.0,4,10,40.0,4,5,80.0,1,7,8,1,0,0,0,0,3,4
../kbl_data/2022-2023,S41G01N47,고양 캐롯,Away,최현민,0,0,0,0.0,0,1,0.0,0,1,0.0,0,0,0.0,0,1,1,0,0,0,0,0,0,1
../kbl_data/2022-2023,S41G01N47,고양 캐롯,Away,한호빈,8,1,1,100.0,2,7,28.6,3,8,37.5,0,0,0.0,0,3,3,3,1,0,0,0,3,1
../kbl_data/2022-2023,S41G01N47,고양 캐롯,Away,전성현,26,2,8,25.0,5,9,55.6,7,17,41.2,7,7,100.0,2,2,4,2,1,0,0,0,2,2
../kbl_data/2022-2023,S41G01N47,고양 캐롯,Away,이종현,0,0,0,0.0,0,0,0.0,0,0,0.0,0,0,0.0,0,0,0,0,0,0,0,0,1,0
../kbl_data/2022-2023,S41G01N47,고양 캐롯,Away,김진유,3,0,0,0.0,1,2,50.0,1,2,50.0,0,0,0.0,3,5,8,2,0,0,1,0,0,4
../kbl_data/2022-2023,S41G01N47,고양 캐롯,Away,조한진,4,0,1,0.0,1,2,50.0,1,3,33.3,1,2,50.0,1,2,3,1,1,0,0,0,0,0
../kbl_data/2022-2023,S41G01N47,고양 캐롯,Away,김세창,0,0,0,0.0,0,0,0.0,0,0,0.0,0,0,0.0,0,0,0,0,0,0,0,0,0,0
../kbl_data/2022-2023,S41G01N47,고양 캐롯,Away,디드릭 로슨,11,4,8,50.0,0,1,0.0,4,9,44.4,3,6,50.0,2,4,6,5,1,1,0,0,0,2
../kbl_data/2022-2023,S41G01N47,고양 캐롯,Away,이정현,62,12,26,46.2,10,22,45.5,22,48,45.8,8,16,50.0,2,8,10,24,2,0,0,0,6,10
../kbl_data/2022-2023,S41G01N47,고양 캐롯,Away,조재우,3,1,2,50.0,0,0,0.0,1,2,50.0,1,2,50.0,0,1,1,0,0,1,0,0,0,2
../kbl_data/2022-2023,S41G01N48,창원 LG,Home,이관희,14,4,5,80.0,2,7,28.6,6,12,50.0,0,0,0.0,0,1,1,1,1,0,0,0,0,1
../kbl_data/2022-2023,S41G01N48,창원 LG,Home,정희재,13,2,3,66.7,3,4,75.0,5,7,71.4,0,0,0.0,2,1,3,0,0,0,0,0,2,2
../kbl_data/2022-2023,S41G01N48,창원 LG,Home,서민수,3,0,0,0.0,1,1,100.0,1,1,100.0,0,0,0.0,1,0,1,0,0,0,0,0,0,1
../kbl_data/2022-2023,S41G01N48,창원 LG,Home,한상혁,4,2,3,66.7,0,1,0.0,2,4,50.0,0,0,0.0,0,0,0,2,1,0,0,0,1,5
../kbl_data/2022-2023,S41G01N48,창원 LG,Home,이재도,2,1,4,25.0,0,4,0.0,1,8,12.5,0,0,0.0,0,2,2,4,0,0,0,0,1,2
../kbl_data/2022-2023,S41G01N48,창원 LG,Home,김준일,0,0,2,0.0,0,0,0.0,0,2,0.0,0,0,0.0,1,0,1,0,1,0,0,0,2,2
../kbl_data/2022-2023,S41G01N48,창원 LG,Home,박인태,0,0,1,0.0,0,0,0.0,0,1,0.0,0,0,0.0,0,0,0,0,0,0,0,0,0,0
../kbl_data/2022-2023,S41G01N48,창원 LG,Home,윤원상,11,4,6,66.7,1,3,33.3,5,9,55.6,0,0,0.0,0,2,2,2,2,0,1,0,0,1
../kbl_data/2022-2023,S41G01N48,창원 LG,Home,아셈 마레이,5,2,5,40.0,0,0,0.0,2,5,40.0,1,2,50.0,1,5,6,3,0,2,0,0,2,2
../kbl_data/2022-2023,S41G01N48,창원 LG,Home,이승우,4,2,5,40.0,0,1,0.0,2,6,33.3,0,0,0.0,0,1,1,1,1,0,0,0,0,2
../kbl_data/2022-2023,S41G01N48,창원 LG,Home,저스틴 구탕,2,0,0,0.0,0,0,0.0,0,0,0.0,2,2,100.0,0,1,1,1,0,0,0,0,2,1
../kbl_data/2022-2023,S41G01N48,창원 LG,Home,단테 커닝햄,7,3,9,33.3,0,2,0.0,3,11,27.3,1,2,50.0,3,4,7,0,1,1,0,0,2,2
../kbl_data/2022-2023,S41G01N48,서울 SK,Away,양우섭,5,1,3,33.3,1,3,33.3,2,6,33.3,0,0,0.0,0,1,1,3,0,0,0,0,1,0
../kbl_data/2022-2023,S41G01N48,서울 SK,Away,허일영,9,3,8,37.5,1,2,50.0,4,10,40.0,0,0,0.0,3,3,6,1,1,0,0,0,1,0
../kbl_data/2022-2023,S41G01N48,서울 SK,Away,송창용,4,1,1,100.0,0,0,0.0,1,1,100.0,2,4,50.0,1,1,2,4,2,0,1,0,1,0
../kbl_data/2022-2023,S41G01N48,서울 SK,Away,김선형,10,2,4,50.0,2,3,66.7,4,7,57.1,0,0,0.0,0,5,5,3,0,1,1,0,2,1
../kbl_data/2022-2023,S41G01N48,서울 SK,Away,홍경기,0,0,1,0.0,0,2,0.0,0,3,0.0,0,0,0.0,0,0,0,2,1,0,0,0,0,1
../kbl_data/2022-2023,S41G01N48,서울 SK,Away,최부경,8,4,5,80.0,0,0,0.0,4,5,80.0,0,0,0.0,1,3,4,0,0,0,0,0,1,1
../kbl_data/2022-2023,S41G01N48,서울 SK,Away,리온 윌리엄스,12,0,2,0.0,1,2,50.0,1,4,25.0,9,11,81.8,2,3,5,2,0,1,0,0,0,2
../kbl_data/2022-2023,S41G01N48,서울 SK,Away,최원혁,0,0,0,0.0,0,0,0.0,0,0,0.0,0,0,0.0,0,0,0,0,0,0,0,0,0,0
../kbl_data/2022-2023,S41G01N48,서울 SK,Away,장문호,8,2,2,100.0,1,1,100.0,3,3,100.0,1,2,50.0,1,2,3,1,1,0,0,0,1,3
../kbl_data/2022-2023,S41G01N48,서울 SK,Away,자밀 워니,19,8,15,53.3,0,1,0.0,8,16,50.0,3,4,75.0,1,6,7,2,1,4,0,2,2,1
../kbl_data/2022-2023,S41G01N48,서울 SK,Away,김형빈,5,1,1,100.0,0,0,0.0,1,1,100.0,3,3,100.0,1,1,2,0,0,0,0,0,0,5
../kbl_data/2022-2023,S41G01N48,서울 SK,Away,오재현,10,4,5,80.0,0,0,0.0,4,5,80.0,2,2,100.0,0,3,3,2,1,0,0,0,1,3
../kbl_data/2022-2023,S41G01N49,안양 KGC,Home,양희종,0,0,1,0.0,0,1,0.0,0,2,0.0,0,0,0.0,0,1,1,0,0,0,0,0,0,1
../kbl_data/2022-2023,S41G01N49,안양 KGC,Home,함준후,0,0,0,0.0,0,2,0.0,0,2,0.0,0,0,0.0,0,0,0,0,0,0,0,0,0,3
../kbl_data/2022-2023,S41G01N49,안양 KGC,Home,오세근,13,4,10,40.0,0,2,0.0,4,12,33.3,5,8,62.5,3,5,8,0,0,0,0,0,1,5
../kbl_data/2022-2023,S41G01N49,안양 KGC,Home,정준원,0,0,0,0.0,0,0,0.0,0,0,0.0,0,0,0.0,0,0,0,0,0,0,0,0,0,0
../kbl_data/2022-2023,S41G01N49,안양 KGC,Home,배병준,9,3,5,60.0,1,4,25.0,4,9,44.4,0,0,0.0,0,0,0,2,0,0,0,0,1,2
../kbl_data/2022-2023,S41G01N49,안양 KGC,Home,문성곤,4,1,3,33.3,0,4,0.0,1,7,14.3,2,2,100.0,1,2,3,1,3,0,0,0,3,2
../kbl_data/2022-2023,S41G01N49,안양 KGC,Home,박지훈,14,5,7,71.4,1,2,50.0,6,9,66.7,1,2,50.0,1,1,2,4,0,1,0,0,1,4
../kbl_data/2022-2023,S41G01N49,안양 KGC,Home,대릴 먼로,0,0,1,0.0,0,0,0.0,0,1,0.0,0,0,0.0,0,2,2,2,0,0,0,0,0,1
../kbl_data/2022-2023,S41G01N49,안양 KGC,Home,변준형,19,5,7,71.4,3,6,50.0,8,13,61.5,0,2,0.0,1,1,2,6,1,1,1,0,1,1
../kbl_data/2022-2023,S41G01N49,안양 KGC,Home,한승희,5,0,1,0.0,1,2,50.0,1,3,33.3,2,2,100.0,3,2,5,2,0,0,0,0,0,3
../kbl_data/2022-2023,S41G01N49,안양 KGC,Home,오마리 스펠맨,21,7,10,70.0,2,8,25.0,9,18,50.0,1,2,50.0,2,7,9,1,1,1,0,2,2,1
../kbl_data/2022-2023,S41G01N49,안양 KGC,Home,렌즈 아반도,0,0,0,0.0,0,0,0.0,0,0,0.0,0,0,0.0,0,0,0,0,0,0,0,0,0,0
../kbl_data/2022-2023,S41G01N49,울산 현대모비스,Away,함지훈,17,6,10,60.0,0,2,0.0,6,12,50.0,5,6,83.3,2,4,6,4,0,0,0,0,2,1
../kbl_data/2022-2023,S41G01N49,울산 현대모비스,Away,김현민,0,0,0,0.0,0,0,0.0,0,0,0.0,0,0,0.0,0,0,0,0,0,0,0,0,0,0
../kbl_data/2022-2023,S41G01N49,울산 현대모비스,Away,최진수,0,0,1,0.0,0,0,0.0,0,1,0.0,0,0,0.0,0,1,1,0,0,0,0,0,0,0
../kbl_data/2022-2023,S41G01N49,울산 현대모비스,Away,장재석,4,2,2,100.0,0,1,0.0,2,3,66.7,0,0,0.0,0,1,1,0,0,0,0,0,0,3
../kbl_data/2022-2023,S41G01N49,울산 현대모비스,Away,김영현,0,0,0,0.0,0,0,0.0,0,0,0.0,0,0,0.0,0,2,2,2,0,0,0,0,0,1
../kbl_data/2022-2023,S41G01N49,울산 현대모비스,Away,김국찬,0,0,0,0.0,0,2,0.0,0,2,0.0,0,0,0.0,0,0,0,3,0,0,0,0,0,1
../kbl_data/2022-2023,S41G01N49,울산 현대모비스,Away,서명진,4,1,2,50.0,0,2,0.0,1,4,25.0,2,2,100.0,2,0,2,2,0,0,0,0,2,3
../kbl_data/2022-2023,S41G01N49,울산 현대모비스,Away,이우석,16,2,6,33.3,4,4,100.0,6,10,60.0,0,0,0.0,1,5,6,2,1,1,0,0,1,2
../kbl_data/2022-2023,S41G01N49,울산 현대모비스,Away,신민석,13,2,3,66.7,2,6,33.3,4,9,44.4,3,4,75.0,1,4,5,1,1,0,0,0,1,4
../kbl_data/2022-2023,S41G01N49,울산 현대모비스,Away,김동준,10,2,4,50.0,1,2,50.0,3,6,50.0,3,4,75.0,0,3,3,2,2,0,0,0,1,4
../kbl_data/2022-2023,S41G01N49,울산 현대모비스,Away,론제이 아바리엔토스,3,0,2,0.0,1,4,25.0,1,6,16.7,0,0,0.0,0,1,1,2,0,0,0,0,1,0
../kbl_data/2022-2023,S41G01N49,울산 현대모비스,Away,게이지 프림,25,10,19,52.6,0,0,0.0,10,19,52.6,5,6,83.3,6,9,15,2,3,1,0,0,2,2
../kbl_data/2022-2023,S41G01N50,서울 SK,Home,양우섭,4,2,2,100.0,0,2,0.0,2,4,50.0,0,0,0.0,1,2,3,1,0,0,0,0,1,2
../kbl_data/2022-2023,S41G01N50,서울 SK,Home,허일영,9,2,4,50.0,1,3,33.3,3,7,42.9,2,2,100.0,2,2,4,1,0,0,0,0,1,4
../kbl_data/2022-2023,S41G01N50,서울 SK,Home,송창용,3,1,1,100.0,0,2,0.0,1,3,33.3,1,2,50.0,1,2,3,1,1,0,0,0,2,1
../kbl_data/2022-2023,S41G01N50,서울 SK,Home,김선형,17,5,6,83.3,2,6,33.3,7,12,58.3,1,2,50.0,1,4,5,4,3,0,0,0,2,1
../kbl_data/2022-2023,S41G01N50,서울 SK,Home,최부경,2,1,7,14.3,0,0,0.0,1,7,14.3,0,0,0.0,1,1,2,2,2,3,0,0,0,3
../kbl_data/2022-2023,S41G01N50,서울 SK,Home,리온 윌리엄스,4,2,4,50.0,0,1,0.0,2,5,40.0,0,0,0.0,1,2,3,0,1,0,0,0,0,3
../kbl_data/2022-2023,S41G01N50,서울 SK,Home,최원혁,0,0,0,0.0,0,2,0.0,0,2,0.0,0,0,0.0,2,0,2,3,0,0,0,0,0,1
../kbl_data/2022-2023,S41G01N50,서울 SK,Home,장문호,0,0,0,0.0,0,0,0.0,0,0,0.0,0,0,0.0,0,0,0,0,0,0,0,0,0,0
../kbl_data/2022-2023,S41G01N50,서울 SK,Home,자밀 워니,17,7,16,43.8,0,0,0.0,7,16,43.8,3,5,60.0,4,3,7,2,1,2,0,0,2,2
../kbl_data/2022-2023,S41G01N50,서울 SK,Home,김형빈,2,1,4,25.0,0,0,0.0,1,4,25.0,0,0,0.0,3,0,3,0,0,0,0,0,0,2
../kbl_data/2022-2023,S41G01N50,서울 SK,Home,오재현,20,2,5,40.0,5,10,50.0,7,15,46.7,1,2,50.0,2,0,2,3,1,0,0,0,0,2
../kbl_data/2022-2023,S41G01N50,서울 SK,Home,임현택,0,0,0,0.0,0,1,0.0,0,1,0.0,0,0,0.0,0,1,1,0,0,0,0,0,0,0
../kbl_data/2022-2023,S41G01N50,전주 KCC,Away,정창영,3,0,1,0.0,1,3,33.3,1,4,25.0,0,0,0.0,0,3,3,1,0,0,0,0,0,0
../kbl_data/2022-2023,S41G01N50,전주 KCC,Away,라건아,7,2,4,50.0,0,0,0.0,2,4,50.0,3,3,100.0,3,4,7,0,0,0,0,0,3,1
../kbl_data/2022-2023,S41G01N50,전주 KCC,Away,김지완,5,1,2,50.0,1,4,25.0,2,6,33.3,0,0,0.0,3,1,4,1,0,0,1,0,0,4
../kbl_data/2022-2023,S41G01N50,전주 KCC,Away,유병훈,0,0,0,0.0,0,1,0.0,0,1,0.0,0,0,0.0,0,0,0,1,1,0,0,0,0,0
../kbl_data/2022-2023,S41G01N50,전주 KCC,Away,허웅,18,6,9,66.7,2,5,40.0,8,14,57.1,0,0,0.0,0,1,1,6,1,0,0,0,2,0
../kbl_data/2022-2023,S41G01N50,전주 KCC,Away,이승현,8,3,10,30.0,0,2,0.0,3,12,25.0,2,2,100.0,7,7,14,0,0,1,0,0,2,3
../kbl_data/2022-2023,S41G01N50,전주 KCC,Away,이진욱,2,1,2,50.0,0,0,0.0,1,2,50.0,0,0,0.0,0,0,0,0,0,0,0,0,1,0
../kbl_data/2022-2023,S41G01N50,전주 KCC,Away,곽정훈,0,0,0,0.0,0,0,0.0,0,0,0.0,0,0,0.0,0,0,0,0,0,0,0,0,0,0
../kbl_data/2022-2023,S41G01N50,전주 KCC,Away,이근휘,6,0,0,0.0,2,6,33.3,2,6,33.3,0,0,0.0,0,1,1,1,0,0,1,0,1,3
../kbl_data/2022-2023,S41G01N50,전주 KCC,Away,서정현,0,0,0,0.0,0,0,0.0,0,0,0.0,0,0,0.0,1,0,1,0,0,0,0,0,0,0
../kbl_data/2022-2023,S41G01N50,전주 KCC,Away,론데 홀리스 제퍼슨,19,6,14,42.9,0,2,0.0,6,16,37.5,7,8,87.5,3,8,11,2,1,0,0,0,4,3
../kbl_data/2022-2023,S41G01N50,전주 KCC,Away,송동훈,0,0,0,0.0,0,1,0.0,0,1,0.0,0,0,0.0,0,0,0,0,0,0,0,0,0,1
../kbl_data/2022-2023,S41G01N51,대구 한국가스공사,Home,차바위,4,2,2,100.0,0,2,0.0,2,4,50.0,0,0,0.0,0,2,2,3,2,0,1,0,0,1
../kbl_data/2022-2023,S41G01N51,대구 한국가스공사,Home,박지훈,3,0,0,0.0,0,0,0.0,0,0,0.0,3,3,100.0,0,0,0,0,0,0,0,0,0,0
../kbl_data/2022-2023,S41G01N51,대구 한국가스공사,Home,이원대,0,0,1,0.0,0,1,0.0,0,2,0.0,0,0,0.0,0,0,0,0,1,0,0,0,0,0
../kbl_data/2022-2023,S41G01N51,대구 한국가스공사,Home,이대성,14,4,7,57.1,2,8,25.0,6,15,40.0,0,0,0.0,0,1,1,2,1,1,0,0,1,3
../kbl_data/2022-2023,S41G01N51,대구 한국가스공사,Home,정효근,7,2,6,33.3,0,1,0.0,2,7,28.6,3,4,75.0,3,4,7,1,0,0,0,0,3,2
../kbl_data/2022-2023,S41G01N51,대구 한국가스공사,Home,박봉진,0,0,0,0.0,0,0,0.0,0,0,0.0,0,0,0.0,0,0,0,0,0,0,0,0,0,0
../kbl_data/2022-2023,S41G01N51,대구 한국가스공사,Home,머피 할로웨이,16,8,14,57.1,0,0,0.0,8,14,57.1,0,2,0.0,4,8,12,0,1,0,0,4,1,1
../kbl_data/2022-2023,S41G01N51,대구 한국가스공사,Home,우동현,0,0,0,0.0,0,0,0.0,0,0,0.0,0,0,0.0,0,0,0,0,0,0,0,0,0,0
../kbl_data/2022-2023,S41G01N51,대구 한국가스공사,Home,전현우,2,1,2,50.0,0,3,0.0,1,5,20.0,0,0,0.0,0,2,2,0,0,0,0,0,0,1
../kbl_data/2022-2023,S41G01N51,대구 한국가스공사,Home,신승민,2,1,2,50.0,0,2,0.0,1,4,25.0,0,0,0.0,0,1,1,1,0,0,0,0,2,3
../kbl_data/2022-2023,S41G01N51,대구 한국가스공사,Home,샘조세프 벨란겔,10,4,8,50.0,0,3,0.0,4,11,36.4,2,2,100.0,2,3,5,3,0,0,0,0,0,3
../kbl_data/2022-2023,S41G01N51,대구 한국가스공사,Home,유슈 은도예,8,2,4,50.0,0,0,0.0,2,4,50.0,4,4,100.0,1,3,4,1,0,0,0,0,2,2
../kbl_data/2022-2023,S41G01N51,고양 캐롯,Away,김강선,2,1,1,100.0,0,1,0.0,1,2,50.0,0,0,0.0,0,1,1,0,1,0,0,0,0,1
../kbl_data/2022-2023,S41G01N51,고양 캐롯,Away,데이비드 사이먼,0,0,0,0.0,0,0,0.0,0,0,0.0,0,2,0.0,0,0,0,0,0,0,0,0,0,0
../kbl_data/2022-2023,S41G01N51,고양 캐롯,Away,최현민,14,1,2,50.0,4,6,66.7,5,8,62.5,0,0,0.0,1,3,4,1,0,1,0,0,0,1
../kbl_data/2022-2023,S41G01N51,고양 캐롯,Away,한호빈,11,2,3,66.7,2,7,28.6,4,10,40.0,1,1,100.0,0,4,4,2,0,0,0,0,1,2
../kbl_data/2022-2023,S41G01N51,고양 캐롯,Away,전성현,16,4,4,100.0,2,4,50.0,6,8,75.0,2,2,100.0,0,1,1,6,1,0,0,0,1,4
../kbl_data/2022-2023,S41G01N51,고양 캐롯,Away,김진유,2,1,1,100.0,0,0,0.0,1,1,100.0,0,0,0.0,2,3,5,1,3,1,0,0,0,5
../kbl_data/2022-2023,S41G01N51,고양 캐롯,Away,정해원,0,0,0,0.0,0,3,0.0,0,3,0.0,0,0,0.0,0,0,0,0,0,0,0,0,0,1
../kbl_data/2022-2023,S41G01N51,고양 캐롯,Away,조한진,3,0,0,0.0,1,2,50.0,1,2,50.0,0,0,0.0,0,2,2,1,0,0,0,0,0,1
../kbl_data/2022-2023,S41G01N51,고양 캐롯,Away,디드릭 로슨,20,6,8,75.0,2,6,33.3,8,14,57.1,2,2,100.0,2,8,10,6,2,5,0,1,2,2
../kbl_data/2022-2023,S41G01N51,고양 캐롯,Away,박진철,0,0,0,0.0,0,0,0.0,0,0,0.0,0,0,0.0,0,0,0,0,0,0,0,0,0,0
../kbl_data/2022-2023,S41G01N51,고양 캐롯,Away,이정현,22,6,9,66.7,2,8,25.0,8,17,47.1,4,5,80.0,0,4,4,4,0,0,2,0,3,2
../kbl_data/2022-2023,S41G01N51,고양 캐롯,Away,조재우,0,0,0,0.0,0,0,0.0,0,0,0.0,0,0,0.0,0,0,0,0,0,0,0,0,0,0
../kbl_data/2022-2023,S41G01N52,서울 삼성,Home,이정현,14,2,9,22.2,2,5,40.0,4,14,28.6,4,6,66.7,1,6,7,3,0,0,0,0,1,3
../kbl_data/2022-2023,S41G01N52,서울 삼성,Home,장민국,0,0,1,0.0,0,1,0.0,0,2,0.0,0,0,0.0,0,0,0,0,0,0,0,0,0,2
../kbl_data/2022-2023,S41G01N52,서울 삼성,Home,김현수,0,0,0,0.0,0,0,0.0,0,0,0.0,0,0,0.0,0,0,0,0,0,0,0,0,0,2
../kbl_data/2022-2023,S41G01N52,서울 삼성,Home,임동섭,0,0,0,0.0,0,2,0.0,0,2,0.0,0,0,0.0,0,2,2,0,0,0,0,0,0,0
../kbl_data/2022-2023,S41G01N52,서울 삼성,Home,이동엽,4,1,4,25.0,0,0,0.0,1,4,25.0,2,2,100.0,1,2,3,1,0,0,0,0,3,3
../kbl_data/2022-2023,S41G01N52,서울 삼성,Home,이호현,4,2,4,50.0,0,1,0.0,2,5,40.0,0,0,0.0,0,2,2,1,0,0,0,0,2,0
../kbl_data/2022-2023,S41G01N52,서울 삼성,Home,마커스 데릭슨,27,8,13,61.5,2,6,33.3,10,19,52.6,5,6,83.3,1,10,11,1,1,2,1,2,0,2
../kbl_data/2022-2023,S41G01N52,서울 삼성,Home,전형준,0,0,0,0.0,0,0,0.0,0,0,0.0,0,0,0.0,0,0,0,0,0,0,0,0,0,0
../kbl_data/2022-2023,S41G01N52,서울 삼성,Home,조우성,0,0,0,0.0,0,0,0.0,0,0,0.0,0,0,0.0,0,1,1,0,0,0,0,0,0,1
../kbl_data/2022-2023,S41G01N52,서울 삼성,Home,이원석,13,5,7,71.4,0,0,0.0,5,7,71.4,3,4,75.0,3,0,3,0,2,0,0,0,0,3
../kbl_data/2022-2023,S41G01N52,서울 삼성,Home,이매뉴얼 테리,2,1,2,50.0,0,0,0.0,1,2,50.0,0,0,0.0,1,2,3,0,0,2,0,1,0,0
../kbl_data/2022-2023,S41G01N52,서울 삼성,Home,신동혁,2,1,2,50.0,0,0,0.0,1,2,50.0,0,0,0.0,1,1,2,1,1,0,0,0,2,2
../kbl_data/2022-2023,S41G01N52,수원 KT,Away,김동량,5,2,3,66.7,0,1,0.0,2,4,50.0,1,2,50.0,1,1,2,1,0,0,0,0,0,0
../kbl_data/2022-2023,S41G01N52,수원 KT,Away,김종범,0,0,0,0.0,0,0,0.0,0,0,0.0,0,0,0.0,0,0,0,0,0,0,0,0,0,0
../kbl_data/2022-2023,S41G01N52,수원 KT,Away,한희원,12,2,3,66.7,2,5,40.0,4,8,50.0,2,2,100.0,1,5,6,2,0,0,1,0,1,3
../kbl_data/2022-2023,S41G01N52,수원 KT,Away,이현석,0,0,1,0.0,0,1,0.0,0,2,0.0,0,0,0.0,2,3,5,0,1,0,0,0,0,4
../kbl_data/2022-2023,S41G01N52,수원 KT,Away,정성우,5,2,9,22.2,0,4,0.0,2,13,15.4,1,1,100.0,0,0,0,4,1,0,1,0,2,3
../kbl_data/2022-2023,S41G01N52,수원 KT,Away,최성모,0,0,1,0.0,0,1,0.0,0,2,0.0,0,0,0.0,0,0,0,0,0,0,0,0,0,1
../kbl_data/2022-2023,S41G01N52,수원 KT,Away,양홍석,16,2,8,25.0,3,9,33.3,5,17,29.4,3,4,75.0,4,9,13,5,2,0,0,0,3,4
../kbl_data/2022-2023,S41G01N52,수원 KT,Away,박지원,0,0,1,0.0,0,0,0.0,0,1,0.0,0,0,0.0,1,0,1,1,0,0,0,0,0,1
../kbl_data/2022-2023,S41G01N52,수원 KT,Away,김준환,0,0,0,0.0,0,0,0.0,0,0,0.0,0,0,0.0,0,0,0,0,0,0,0,0,0,0
../kbl_data/2022-2023,S41G01N52,수원 KT,Away,하윤기,7,3,8,37.5,0,0,0.0,3,8,37.5,1,2,50.0,2,1,3,0,0,0,0,1,0,2
../kbl_data/2022-2023,S41G01N52,수원 KT,Away,이제이 아노시케,4,2,3,66.7,0,1,0.0,2,4,50.0,0,0,0.0,0,0,0,0,0,1,0,0,0,0
../kbl_data/2022-2023,S41G01N52,수원 KT,Away,랜드리 은노코,13,4,8,50.0,0,1,0.0,4,9,44.4,5,8,62.5,6,4,10,2,1,0,0,1,2,1
../kbl_data/2022-2023,S41G01N53,전주 KCC,Home,정창영,7,1,4,25.0,1,3,33.3,2,7,28.6,2,2,100.0,0,3,3,2,2,0,1,0,1,2
../kbl_data/2022-2023,S41G01N53,전주 KCC,Home,라건아,13,3,7,42.9,2,2,100.0,5,9,55.6,1,1,100.0,4,11,15,2,0,0,0,0,0,2
../kbl_data/2022-2023,S41G01N53,전주 KCC,Home,박경상,0,0,0,0.0,0,0,0.0,0,0,0.0,0,0,0.0,0,0,0,0,0,0,0,0,0,0
../kbl_data/2022-2023,S41G01N53,전주 KCC,Home,김지완,2,1,5,20.0,0,5,0.0,1,10,10.0,0,0,0.0,0,1,1,4,1,0,0,0,1,4
../kbl_data/2022-2023,S41G01N53,전주 KCC,Home,허웅,14,6,10,60.0,0,1,0.0,6,11,54.5,2,4,50.0,0,6,6,7,3,0,1,0,1,1
../kbl_data/2022-2023,S41G01N53,전주 KCC,Home,이승현,15,7,15,46.7,0,0,0.0,7,15,46.7,1,2,50.0,1,5,6,0,2,0,0,0,2,4
../kbl_data/2022-2023,S41G01N53,전주 KCC,Home,곽정훈,0,0,0,0.0,0,0,0.0,0,0,0.0,0,0,0.0,0,0,0,0,0,0,0,0,0,0
../kbl_data/2022-2023,S41G01N53,전주 KCC,Home,이근휘,6,0,2,0.0,2,3,66.7,2,5,40.0,0,0,0.0,0,0,0,0,0,0,0,0,0,0
../kbl_data/2022-2023,S41G01N53,전주 KCC,Home,김동현,0,0,0,0.0,0,0,0.0,0,0,0.0,0,0,0.0,0,0,0,0,0,0,0,0,0,0
../kbl_data/2022-2023,S41G01N53,전주 KCC,Home,서정현,0,0,5,0.0,0,0,0.0,0,5,0.0,0,0,0.0,1,2,3,0,0,0,0,0,1,0
../kbl_data/2022-2023,S41G01N53,전주 KCC,Home,론데 홀리스 제퍼슨,5,2,4,50.0,0,0,0.0,2,4,50.0,1,3,33.3,0,2,2,1,0,0,0,0,1,4
../kbl_data/2022-2023,S41G01N53,전주 KCC,Home,송동훈,0,0,3,0.0,0,0,0.0,0,3,0.0,0,0,0.0,2,1,3,0,0,0,1,0,2,2
../kbl_data/2022-2023,S41G01N53,창원 LG,Away,이관희,9,3,9,33.3,1,4,25.0,4,13,30.8,0,0,0.0,1,7,8,2,0,0,0,0,0,2
../kbl_data/2022-2023,S41G01N53,창원 LG,Away,정희재,2,1,1,100.0,0,2,0.0,1,3,33.3,0,0,0.0,1,2,3,0,0,0,1,0,1,1
../kbl_data/2022-2023,S41G01N53,창원 LG,Away,서민수,0,0,3,0.0,0,2,0.0,0,5,0.0,0,0,0.0,1,2,3,1,0,0,1,0,0,2
../kbl_data/2022-2023,S41G01N53,창원 LG,Away,한상혁,4,1,1,100.0,0,0,0.0,1,1,100.0,2,2,100.0,0,0,0,1,0,0,0,0,0,0
../kbl_data/2022-2023,S41G01N53,창원 LG,Away,이재도,8,0,4,0.0,2,7,28.6,2,11,18.2,2,2,100.0,1,5,6,3,0,0,0,0,3,1
../kbl_data/2022-2023,S41G01N53,창원 LG,Away,김준일,2,1,3,33.3,0,0,0.0,1,3,33.3,0,0,0.0,1,2,3,0,0,1,0,0,1,0
../kbl_data/2022-2023,S41G01N53,창원 LG,Away,윤원상,21,3,4,75.0,5,10,50.0,8,14,57.1,0,0,0.0,0,1,1,0,0,0,0,0,1,4
../kbl_data/2022-2023,S41G01N53,창원 LG,Away,아셈 마레이,12,3,8,37.5,0,0,0.0,3,8,37.5,6,10,60.0,6,13,19,3,4,0,0,0,5,2
../kbl_data/2022-2023,S41G01N53,창원 LG,Away,이승우,0,0,1,0.0,0,1,0.0,0,2,0.0,0,0,0.0,2,1,3,0,0,0,0,0,2,2
../kbl_data/2022-2023,S41G01N53,창원 LG,Away,저스틴 구탕,3,0,0,0.0,1,1,100.0,1,1,100.0,0,0,0.0,0,0,0,0,0,0,0,0,0,0
../kbl_data/2022-2023,S41G01N53,창원 LG,Away,이승훈,0,0,0,0.0,0,0,0.0,0,0,0.0,0,0,0.0,0,0,0,0,0,0,0,0,0,0
../kbl_data/2022-2023,S41G01N53,창원 LG,Away,단테 커닝햄,2,0,2,0.0,0,0,0.0,0,2,0.0,2,2,100.0,0,1,1,1,0,1,0,0,1,3
../kbl_data/2022-2023,S41G01N54,원주 DB,Home,박찬희,0,0,0,0.0,0,0,0.0,0,0,0.0,0,0,0.0,0,0,0,0,0,0,0,0,0,0
../kbl_data/2022-2023,S41G01N54,원주 DB,Home,김현호,0,0,0,0.0,0,0,0.0,0,0,0.0,0,0,0.0,0,0,0,0,0,0,0,0,0,2
../kbl_data/2022-2023,S41G01N54,원주 DB,Home,두경민,18,7,10,70.0,1,9,11.1,8,19,42.1,1,1,100.0,0,2,2,0,3,0,0,0,5,2
../kbl_data/2022-2023,S41G01N54,원주 DB,Home,김종규,6,3,3,100.0,0,1,0.0,3,4,75.0,0,0,0.0,5,2,7,1,0,2,0,0,0,1
../kbl_data/2022-2023,S41G01N54,원주 DB,Home,최승욱,5,1,5,20.0,1,1,100.0,2,6,33.3,0,0,0.0,1,1,2,0,0,0,0,0,2,4
../kbl_data/2022-2023,S41G01N54,원주 DB,Home,강상재,10,2,7,28.6,2,3,66.7,4,10,40.0,0,0,0.0,2,6,8,1,1,0,0,0,1,4
../kbl_data/2022-2023,S41G01N54,원주 DB,Home,윤성원,0,0,0,0.0,0,0,0.0,0,0,0.0,0,0,0.0,0,0,0,0,0,0,0,0,0,0
../kbl_data/2022-2023,S41G01N54,원주 DB,Home,이준희,3,0,3,0.0,1,4,25.0,1,7,14.3,0,0,0.0,0,2,2,1,1,0,0,0,0,3
../kbl_data/2022-2023,S41G01N54,원주 DB,Home,레나드 프리먼,6,3,3,100.0,0,0,0.0,3,3,100.0,0,0,0.0,0,7,7,0,0,0,0,0,0,0
../kbl_data/2022-2023,S41G01N54,원주 DB,Home,이선 알바노,12,3,6,50.0,2,11,18.2,5,17,29.4,0,0,0.0,4,3,7,5,1,1,0,0,1,1
../kbl_data/2022-2023,S41G01N54,원주 DB,Home,드완 에르난데스,14,7,15,46.7,0,0,0.0,7,15,46.7,0,0,0.0,5,9,14,1,0,0,0,1,4,1
../kbl_data/2022-2023,S41G01N54,원주 DB,Home,박인웅,4,1,1,100.0,0,1,0.0,1,2,50.0,2,2,100.0,4,1,5,0,0,0,0,0,0,1
../kbl_data/2022-2023,S41G01N54,안양 KGC,Away,양희종,1,0,0,0.0,0,2,0.0,0,2,0.0,1,2,50.0,0,2,2,0,1,0,0,0,0,0
../kbl_data/2022-2023,S41G01N54,안양 KGC,Away,함준후,0,0,0,0.0,0,0,0.0,0,0,0.0,0,0,0.0,0,0,0,0,0,0,0,0,0,0
../kbl_data/2022-2023,S41G01N54,안양 KGC,Away,오세근,20,6,11,54.5,0,0,0.0,6,11,54.5,8,9,88.9,3,3,6,3,1,0,0,0,0,3
../kbl_data/2022-2023,S41G01N54,안양 KGC,Away,정준원,2,1,2,50.0,0,0,0.0,1,2,50.0,0,0,0.0,0,1,1,2,0,0,0,0,0,0
../kbl_data/2022-2023,S41G01N54,안양 KGC,Away,문성곤,8,1,1,100.0,2,3,66.7,3,4,75.0,0,0,0.0,0,3,3,4,0,0,0,0,1,3
../kbl_data/2022-2023,S41G01N54,안양 KGC,Away,박지훈,0,0,1,0.0,0,4,0.0,0,5,0.0,0,0,0.0,0,3,3,1,1,0,0,0,0,3
../kbl_data/2022-2023,S41G01N54,안양 KGC,Away,대릴 먼로,3,1,2,50.0,0,0,0.0,1,2,50.0,1,1,100.0,0,3,3,0,0,0,0,0,2,1
../kbl_data/2022-2023,S41G01N54,안양 KGC,Away,변준형,13,3,7,42.9,2,4,50.0,5,11,45.5,1,3,33.3,0,2,2,7,2,0,0,0,2,3
../kbl_data/2022-2023,S41G01N54,안양 KGC,Away,한승희,0,0,1,0.0,0,1,0.0,0,2,0.0,0,0,0.0,0,0,0,0,0,0,0,0,0,1
../kbl_data/2022-2023,S41G01N54,안양 KGC,Away,오마리 스펠맨,13,2,4,50.0,3,6,50.0,5,10,50.0,0,2,0.0,1,6,7,2,1,3,0,1,1,1
../kbl_data/2022-2023,S41G01N54,안양 KGC,Away,조은후,0,0,0,0.0,0,0,0.0,0,0,0.0,0,0,0.0,0,0,0,0,0,0,0,0,0,0
../kbl_data/2022-2023,S41G01N54,안양 KGC,Away,렌즈 아반도,20,4,10,40.0,2,4,50.0,6,14,42.9,6,7,85.7,1,2,3,0,1,6,0,0,1,1
../kbl_data/2022-2023,S41G01N55,울산 현대모비스,Home,함지훈,9,4,4,100.0,0,0,0.0,4,4,100.0,1,2,50.0,0,1,1,4,0,0,0,0,3,2
../kbl_data/2022-2023,S41G01N55,울산 현대모비스,Home,김현민,0,0,0,0.0,0,0,0.0,0,0,0.0,0,0,0.0,0,0,0,0,0,0,0,0,0,0
../kbl_data/2022-2023,S41G01N55,울산 현대모비스,Home,최진수,0,0,0,0.0,0,0,0.0,0,0,0.0,0,0,0.0,0,0,0,0,0,0,0,0,0,0
../kbl_data/2022-2023,S41G01N55,울산 현대모비스,Home,장재석,7,3,4,75.0,0,0,0.0,3,4,75.0,1,2,50.0,1,0,1,1,0,0,0,0,1,3
../kbl_data/2022-2023,S41G01N55,울산 현대모비스,Home,김영현,0,0,0,0.0,0,2,0.0,0,2,0.0,0,0,0.0,0,1,1,1,1,1,0,0,0,5
../kbl_data/2022-2023,S41G01N55,울산 현대모비스,Home,김국찬,0,0,0,0.0,0,0,0.0,0,0,0.0,0,0,0.0,0,0,0,0,0,0,0,0,0,0
../kbl_data/2022-2023,S41G01N55,울산 현대모비스,Home,서명진,9,2,3,66.7,1,5,20.0,3,8,37.5,2,4,50.0,3,1,4,2,1,0,0,0,1,2
../kbl_data/2022-2023,S41G01N55,울산 현대모비스,Home,이우석,15,6,7,85.7,1,4,25.0,7,11,63.6,0,0,0.0,0,0,0,1,0,0,0,0,0,3
../kbl_data/2022-2023,S41G01N55,울산 현대모비스,Home,신민석,12,0,1,0.0,3,5,60.0,3,6,50.0,3,5,60.0,0,2,2,0,0,0,0,0,0,2
../kbl_data/2022-2023,S41G01N55,울산 현대모비스,Home,김동준,2,0,1,0.0,0,2,0.0,0,3,0.0,2,2,100.0,0,2,2,1,0,0,0,0,0,1
../kbl_data/2022-2023,S41G01N55,울산 현대모비스,Home,론제이 아바리엔토스,7,2,4,50.0,1,8,12.5,3,12,25.0,0,0,0.0,1,0,1,7,2,0,1,0,3,1
../kbl_data/2022-2023,S41G01N55,울산 현대모비스,Home,게이지 프림,25,10,13,76.9,0,0,0.0,10,13,76.9,5,7,71.4,5,15,20,6,2,1,0,0,2,1
../kbl_data/2022-2023,S41G01N55,서울 삼성,Away,이정현,5,1,3,33.3,0,4,0.0,1,7,14.3,3,3,100.0,0,3,3,7,0,0,1,0,4,3
../kbl_data/2022-2023,S41G01N55,서울 삼성,Away,장민국,0,0,2,0.0,0,0,0.0,0,2,0.0,0,0,0.0,1,0,1,0,0,0,0,0,0,2
../kbl_data/2022-2023,S41G01N55,서울 삼성,Away,김현수,2,1,2,50.0,0,1,0.0,1,3,33.3,0,0,0.0,1,0,1,0,0,0,0,0,0,2
../kbl_data/2022-2023,S41G01N55,서울 삼성,Away,임동섭,7,3,3,100.0,0,4,0.0,3,7,42.9,1,2,50.0,0,4,4,0,1,0,0,0,0,5
../kbl_data/2022-2023,S41G01N55,서울 삼성,Away,이동엽,11,3,5,60.0,1,1,100.0,4,6,66.7,2,2,100.0,1,0,1,4,2,0,0,0,1,0
../kbl_data/2022-2023,S41G01N55,서울 삼성,Away,이호현,0,0,0,0.0,0,0,0.0,0,0,0.0,0,0,0.0,0,0,0,0,0,0,0,0,0,0
../kbl_data/2022-2023,S41G01N55,서울 삼성,Away,마커스 데릭슨,24,9,11,81.8,1,3,33.3,10,14,71.4,3,5,60.0,0,6,6,2,0,0,0,0,3,2
../kbl_data/2022-2023,S41G01N55,서울 삼성,Away,전형준,0,0,0,0.0,0,0,0.0,0,0,0.0,0,0,0.0,0,0,0,0,0,0,0,0,0,0
../kbl_data/2022-2023,S41G01N55,서울 삼성,Away,조우성,0,0,0,0.0,0,0,0.0,0,0,0.0,0,0,0.0,0,0,0,0,0,0,0,0,1,2
../kbl_data/2022-2023,S41G01N55,서울 삼성,Away,이원석,12,3,8,37.5,0,0,0.0,3,8,37.5,6,8,75.0,0,4,4,1,1,0,0,0,1,3
../kbl_data/2022-2023,S41G01N55,서울 삼성,Away,이매뉴얼 테리,10,4,7,57.1,0,0,0.0,4,7,57.1,2,2,100.0,1,4,5,0,1,0,0,0,0,1
../kbl_data/2022-2023,S41G01N55,서울 삼성,Away,신동혁,6,2,3,66.7,0,0,0.0,2,3,66.7,2,3,66.7,0,2,2,0,1,0,0,0,0,0
../kbl_data/2022-2023,S41G01N56,서울 SK,Home,양우섭,5,2,2,100.0,0,1,0.0,2,3,66.7,1,2,50.0,0,1,1,1,1,0,0,0,0,0
../kbl_data/2022-2023,S41G01N56,서울 SK,Home,허일영,7,2,4,50.0,1,4,25.0,3,8,37.5,0,0,0.0,1,2,3,0,0,0,0,0,0,1
../kbl_data/2022-2023,S41G01N56,서울 SK,Home,송창용,5,1,1,100.0,1,4,25.0,2,5,40.0,0,0,0.0,1,4,5,1,0,0,1,0,0,1
../kbl_data/2022-2023,S41G01N56,서울 SK,Home,김선형,19,3,10,30.0,2,5,40.0,5,15,33.3,7,11,63.6,0,0,0,5,3,0,0,0,3,2
../kbl_data/2022-2023,S41G01N56,서울 SK,Home,최부경,3,1,5,20.0,0,1,0.0,1,6,16.7,1,2,50.0,5,4,9,1,2,0,0,0,1,4
../kbl_data/2022-2023,S41G01N56,서울 SK,Home,리온 윌리엄스,3,1,2,50.0,0,0,0.0,1,2,50.0,1,1,100.0,0,0,0,1,0,0,0,0,1,0
../kbl_data/2022-2023,S41G01N56,서울 SK,Home,최원혁,3,0,0,0.0,1,1,100.0,1,1,100.0,0,0,0.0,2,0,2,0,0,0,0,0,0,0
../kbl_data/2022-2023,S41G01N56,서울 SK,Home,장문호,0,0,0,0.0,0,0,0.0,0,0,0.0,0,0,0.0,0,0,0,0,0,0,0,0,0,0
../kbl_data/2022-2023,S41G01N56,서울 SK,Home,자밀 워니,21,8,19,42.1,0,0,0.0,8,19,42.1,5,7,71.4,4,6,10,2,1,1,0,4,2,1
../kbl_data/2022-2023,S41G01N56,서울 SK,Home,김형빈,4,2,4,50.0,0,0,0.0,2,4,50.0,0,0,0.0,0,1,1,1,0,0,0,0,0,3
../kbl_data/2022-2023,S41G01N56,서울 SK,Home,오재현,6,0,1,0.0,1,3,33.3,1,4,25.0,3,5,60.0,0,4,4,1,2,0,0,0,2,4
../kbl_data/2022-2023,S41G01N56,서울 SK,Home,임현택,0,0,0,0.0,0,0,0.0,0,0,0.0,0,0,0.0,0,0,0,0,0,0,0,0,0,0
../kbl_data/2022-2023,S41G01N56,대구 한국가스공사,Away,차바위,3,0,0,0.0,1,2,50.0,1,2,50.0,0,0,0.0,0,4,4,4,0,0,0,0,0,5
../kbl_data/2022-2023,S41G01N56,대구 한국가스공사,Away,박지훈,0,0,0,0.0,0,0,0.0,0,0,0.0,0,0,0.0,0,0,0,0,0,0,0,0,0,1
../kbl_data/2022-2023,S41G01N56,대구 한국가스공사,Away,이원대,4,2,3,66.7,0,1,0.0,2,4,50.0,0,0,0.0,0,2,2,1,0,0,1,0,3,3
../kbl_data/2022-2023,S41G01N56,대구 한국가스공사,Away,이대성,22,6,9,66.7,2,7,28.6,8,16,50.0,4,5,80.0,2,1,3,4,0,0,0,0,3,2
../kbl_data/2022-2023,S41G01N56,대구 한국가스공사,Away,정효근,10,1,4,25.0,2,7,28.6,3,11,27.3,2,2,100.0,1,4,5,1,0,2,0,0,3,0
../kbl_data/2022-2023,S41G01N56,대구 한국가스공사,Away,박봉진,0,0,0,0.0,0,0,0.0,0,0,0.0,0,0,0.0,0,0,0,0,0,0,0,0,0,0
../kbl_data/2022-2023,S41G01N56,대구 한국가스공사,Away,머피 할로웨이,11,5,9,55.6,0,0,0.0,5,9,55.6,1,3,33.3,2,9,11,2,1,1,0,2,2,4
../kbl_data/2022-2023,S41G01N56,대구 한국가스공사,Away,우동현,0,0,0,0.0,0,0,0.0,0,0,0.0,0,0,0.0,0,0,0,0,0,0,0,0,0,0
../kbl_data/2022-2023,S41G01N56,대구 한국가스공사,Away,전현우,0,0,1,0.0,0,2,0.0,0,3,0.0,0,0,0.0,0,2,2,2,0,0,0,0,0,1
../kbl_data/2022-2023,S41G01N56,대구 한국가스공사,Away,신승민,4,2,2,100.0,0,1,0.0,2,3,66.7,0,0,0.0,3,1,4,1,1,0,0,0,1,0
../kbl_data/2022-2023,S41G01N56,대구 한국가스공사,Away,샘조세프 벨란겔,10,1,3,33.3,2,6,33.3,3,9,33.3,2,2,100.0,0,3,3,2,3,0,0,0,1,3
../kbl_data/2022-2023,S41G01N56,대구 한국가스공사,Away,유슈 은도예,17,8,9,88.9,0,0,0.0,8,9,88.9,1,1,100.0,1,2,3,0,1,0,0,1,1,2
../kbl_data/2022-2023,S41G01N57,고양 캐롯,Home,김강선,3,0,0,0.0,1,3,33.3,1,3,33.3,0,0,0.0,0,0,0,0,0,0,1,0,0,0
../kbl_data/2022-2023,S41G01N57,고양 캐롯,Home,데이비드 사이먼,8,4,6,66.7,0,1,0.0,4,7,57.1,0,0,0.0,0,2,2,0,0,2,0,0,0,3
../kbl_data/2022-2023,S41G01N57,고양 캐롯,Home,최현민,6,0,0,0.0,2,7,28.6,2,7,28.6,0,2,0.0,4,6,10,1,0,0,1,0,1,5
../kbl_data/2022-2023,S41G01N57,고양 캐롯,Home,한호빈,0,0,0,0.0,0,3,0.0,0,3,0.0,0,0,0.0,0,0,0,0,0,0,0,0,0,0
../kbl_data/2022-2023,S41G01N57,고양 캐롯,Home,전성현,10,2,8,25.0,2,8,25.0,4,16,25.0,0,0,0.0,0,1,1,1,1,0,0,0,2,0
../kbl_data/2022-2023,S41G01N57,고양 캐롯,Home,이종현,0,0,0,0.0,0,0,0.0,0,0,0.0,0,0,0.0,0,0,0,0,0,0,0,0,0,0
../kbl_data/2022-2023,S41G01N57,고양 캐롯,Home,김진유,0,0,0,0.0,0,2,0.0,0,2,0.0,0,0,0.0,3,2,5,1,3,0,0,0,1,4
../kbl_data/2022-2023,S41G01N57,고양 캐롯,Home,조한진,0,0,0,0.0,0,0,0.0,0,0,0.0,0,0,0.0,0,0,0,0,0,0,0,0,0,1
../kbl_data/2022-2023,S41G01N57,고양 캐롯,Home,김세창,0,0,0,0.0,0,0,0.0,0,0,0.0,0,0,0.0,0,0,0,0,0,0,0,0,0,0
../kbl_data/2022-2023,S41G01N57,고양 캐롯,Home,디드릭 로슨,18,3,4,75.0,3,6,50.0,6,10,60.0,3,4,75.0,0,6,6,5,2,0,0,1,2,0
../kbl_data/2022-2023,S41G01N57,고양 캐롯,Home,박진철,0,0,0,0.0,0,0,0.0,0,0,0.0,0,0,0.0,0,0,0,0,0,0,0,0,0,0
../kbl_data/2022-2023,S41G01N57,고양 캐롯,Home,이정현,25,4,5,80.0,4,10,40.0,8,15,53.3,5,5,100.0,0,0,0,1,3,0,0,0,1,3
../kbl_data/2022-2023,S41G01N57,수원 KT,Away,김동량,2,1,1,100.0,0,0,0.0,1,1,100.0,0,0,0.0,0,0,0,0,0,0,0,0,0,2
../kbl_data/2022-2023,S41G01N57,수원 KT,Away,김종범,0,0,0,0.0,0,0,0.0,0,0,0.0,0,0,0.0,0,0,0,0,0,0,0,0,0,0
../kbl_data/2022-2023,S41G01N57,수원 KT,Away,한희원,5,2,4,50.0,0,3,0.0,2,7,28.6,1,1,100.0,2,3,5,1,0,0,0,0,0,3
../kbl_data/2022-2023,S41G01N57,수원 KT,Away,이현석,0,0,0,0.0,0,2,0.0,0,2,0.0,0,0,0.0,2,2,4,1,3,0,0,0,1,1
../kbl_data/2022-2023,S41G01N57,수원 KT,Away,정성우,9,2,4,50.0,1,7,14.3,3,11,27.3,2,2,100.0,1,4,5,4,0,0,0,0,2,4
../kbl_data/2022-2023,S41G01N57,수원 KT,Away,최성모,8,2,2,100.0,1,4,25.0,3,6,50.0,1,1,100.0,0,3,3,1,0,0,0,0,0,2
../kbl_data/2022-2023,S41G01N57,수원 KT,Away,양홍석,10,3,6,50.0,1,7,14.3,4,13,30.8,1,1,100.0,1,9,10,4,1,0,0,0,3,1
../kbl_data/2022-2023,S41G01N57,수원 KT,Away,박지원,0,0,0,0.0,0,0,0.0,0,0,0.0,0,0,0.0,0,0,0,0,0,0,0,0,0,0
../kbl_data/2022-2023,S41G01N57,수원 KT,Away,김준환,0,0,0,0.0,0,0,0.0,0,0,0.0,0,0,0.0,0,0,0,0,0,0,0,0,0,0
../kbl_data/2022-2023,S41G01N57,수원 KT,Away,하윤기,14,6,10,60.0,0,0,0.0,6,10,60.0,2,6,33.3,6,4,10,3,0,1,0,1,3,1
../kbl_data/2022-2023,S41G01N57,수원 KT,Away,이제이 아노시케,22,7,11,63.6,2,9,22.2,9,20,45.0,2,2,100.0,5,1,6,1,1,1,0,3,5,5
../kbl_data/2022-2023,S41G01N57,수원 KT,Away,랜드리 은노코,2,1,1,100.0,0,0,0.0,1,1,100.0,0,0,0.0,3,1,4,0,0,0,0,0,0,1
../kbl_data/2022-2023,S41G01N58,울산 현대모비스,Home,함지훈,4,2,3,66.7,0,0,0.0,2,3,66.7,0,0,0.0,0,5,5,6,0,0,0,0,0,1
../kbl_data/2022-2023,S41G01N58,울산 현대모비스,Home,김현민,0,0,0,0.0,0,0,0.0,0,0,0.0,0,0,0.0,0,0,0,0,0,0,0,0,0,0
../kbl_data/2022-2023,S41G01N58,울산 현대모비스,Home,최진수,0,0,0,0.0,0,0,0.0,0,0,0.0,0,0,0.0,0,0,0,0,0,0,0,0,0,0
../kbl_data/2022-2023,S41G01N58,울산 현대모비스,Home,장재석,12,6,11,54.5,0,0,0.0,6,11,54.5,0,0,0.0,3,3,6,3,0,1,0,1,1,1
../kbl_data/2022-2023,S41G01N58,울산 현대모비스,Home,김영현,9,0,1,0.0,3,5,60.0,3,6,50.0,0,2,0.0,1,1,2,1,0,0,0,0,1,3
../kbl_data/2022-2023,S41G01N58,울산 현대모비스,Home,김국찬,0,0,0,0.0,0,0,0.0,0,0,0.0,0,0,0.0,0,2,2,0,0,0,0,0,0,1
../kbl_data/2022-2023,S41G01N58,울산 현대모비스,Home,서명진,5,0,2,0.0,1,2,50.0,1,4,25.0,2,4,50.0,1,1,2,4,0,0,0,0,1,2
../kbl_data/2022-2023,S41G01N58,울산 현대모비스,Home,이우석,24,7,9,77.8,3,6,50.0,10,15,66.7,1,2,50.0,2,6,8,3,1,0,0,0,0,1
../kbl_data/2022-2023,S41G01N58,울산 현대모비스,Home,신민석,0,0,2,0.0,0,1,0.0,0,3,0.0,0,0,0.0,0,0,0,1,0,0,0,0,0,2
../kbl_data/2022-2023,S41G01N58,울산 현대모비스,Home,김동준,0,0,2,0.0,0,0,0.0,0,2,0.0,0,0,0.0,0,2,2,0,0,0,0,0,0,0
../kbl_data/2022-2023,S41G01N58,울산 현대모비스,Home,론제이 아바리엔토스,8,1,3,33.3,2,3,66.7,3,6,50.0,0,0,0.0,0,1,1,1,1,0,1,0,5,3
../kbl_data/2022-2023,S41G01N58,울산 현대모비스,Home,게이지 프림,23,9,13,69.2,0,0,0.0,9,13,69.2,5,7,71.4,4,11,15,4,2,0,0,0,4,4
../kbl_data/2022-2023,S41G01N58,대구 한국가스공사,Away,차바위,0,0,0,0.0,0,2,0.0,0,2,0.0,0,0,0.0,1,2,3,0,1,0,1,0,0,0
../kbl_data/2022-2023,S41G01N58,대구 한국가스공사,Away,조상열,1,0,0,0.0,0,1,0.0,0,1,0.0,1,2,50.0,0,1,1,0,0,0,0,0,0,1
../kbl_data/2022-2023,S41G01N58,대구 한국가스공사,Away,이원대,2,1,1,100.0,0,1,0.0,1,2,50.0,0,0,0.0,0,0,0,3,1,0,0,0,0,0
../kbl_data/2022-2023,S41G01N58,대구 한국가스공사,Away,이대성,15,7,13,53.8,0,3,0.0,7,16,43.8,1,3,33.3,2,3,5,4,1,0,0,0,2,1
../kbl_data/2022-2023,S41G01N58,대구 한국가스공사,Away,정효근,6,2,5,40.0,0,3,0.0,2,8,25.0,2,2,100.0,0,2,2,0,0,0,0,0,2,1
../kbl_data/2022-2023,S41G01N58,대구 한국가스공사,Away,박봉진,0,0,0,0.0,0,0,0.0,0,0,0.0,0,0,0.0,0,0,0,0,0,0,0,0,0,0
../kbl_data/2022-2023,S41G01N58,대구 한국가스공사,Away,머피 할로웨이,12,6,8,75.0,0,0,0.0,6,8,75.0,0,1,0.0,0,6,6,4,2,0,0,1,1,2
../kbl_data/2022-2023,S41G01N58,대구 한국가스공사,Away,우동현,0,0,0,0.0,0,0,0.0,0,0,0.0,0,0,0.0,0,0,0,0,0,0,0,0,0,0
../kbl_data/2022-2023,S41G01N58,대구 한국가스공사,Away,전현우,11,1,1,100.0,3,6,50.0,4,7,57.1,0,0,0.0,1,1,2,1,1,0,0,0,0,3
../kbl_data/2022-2023,S41G01N58,대구 한국가스공사,Away,신승민,13,4,6,66.7,1,3,33.3,5,9,55.6,2,2,100.0,1,1,2,2,0,0,2,0,2,4
../kbl_data/2022-2023,S41G01N58,대구 한국가스공사,Away,샘조세프 벨란겔,2,1,2,50.0,0,2,0.0,1,4,25.0,0,0,0.0,0,0,0,0,0,0,0,0,0,1
../kbl_data/2022-2023,S41G01N58,대구 한국가스공사,Away,유슈 은도예,10,4,11,36.4,0,0,0.0,4,11,36.4,2,5,40.0,3,4,7,2,0,1,0,1,0,2
../kbl_data/2022-2023,S41G01N59,창원 LG,Home,이관희,8,0,0,0.0,2,5,40.0,2,5,40.0,2,2,100.0,0,1,1,1,0,1,0,0,2,1
../kbl_data/2022-2023,S41G01N59,창원 LG,Home,정희재,8,1,1,100.0,2,3,66.7,3,4,75.0,0,0,0.0,0,2,2,1,0,0,0,0,1,3
../kbl_data/2022-2023,S41G01N59,창원 LG,Home,서민수,3,0,1,0.0,1,1,100.0,1,2,50.0,0,0,0.0,0,1,1,1,1,0,0,0,0,2
../kbl_data/2022-2023,S41G01N59,창원 LG,Home,한상혁,10,0,4,0.0,2,4,50.0,2,8,25.0,4,4,100.0,0,1,1,2,0,0,0,0,1,1
../kbl_data/2022-2023,S41G01N59,창원 LG,Home,이재도,0,0,0,0.0,0,1,0.0,0,1,0.0,0,0,0.0,0,0,0,3,2,0,0,0,1,1
../kbl_data/2022-2023,S41G01N59,창원 LG,Home,김준일,0,0,0,0.0,0,0,0.0,0,0,0.0,0,0,0.0,0,0,0,0,0,0,0,0,0,0
../kbl_data/2022-2023,S41G01N59,창원 LG,Home,윤원상,2,1,4,25.0,0,3,0.0,1,7,14.3,0,0,0.0,2,1,3,0,0,0,0,0,0,1
../kbl_data/2022-2023,S41G01N59,창원 LG,Home,아셈 마레이,15,6,12,50.0,0,0,0.0,6,12,50.0,3,3,100.0,3,8,11,0,2,0,0,0,1,1
../kbl_data/2022-2023,S41G01N59,창원 LG,Home,이승우,4,1,2,50.0,0,0,0.0,1,2,50.0,2,2,100.0,0,0,0,1,0,0,0,0,2,2
../kbl_data/2022-2023,S41G01N59,창원 LG,Home,저스틴 구탕,0,0,5,0.0,0,2,0.0,0,7,0.0,0,0,0.0,1,2,3,4,2,0,0,0,4,2
../kbl_data/2022-2023,S41G01N59,창원 LG,Home,이승훈,0,0,1,0.0,0,3,0.0,0,4,0.0,0,0,0.0,0,2,2,1,1,0,0,0,2,2
../kbl_data/2022-2023,S41G01N59,창원 LG,Home,단테 커닝햄,17,7,9,77.8,0,0,0.0,7,9,77.8,3,3,100.0,1,5,6,0,1,0,0,1,2,3
../kbl_data/2022-2023,S41G01N59,안양 KGC,Away,양희종,2,1,1,100.0,0,0,0.0,1,1,100.0,0,0,0.0,0,0,0,0,0,0,0,0,0,0
../kbl_data/2022-2023,S41G01N59,안양 KGC,Away,함준후,0,0,0,0.0,0,1,0.0,0,1,0.0,0,0,0.0,0,1,1,0,0,0,0,0,0,0
../kbl_data/2022-2023,S41G01N59,안양 KGC,Away,오세근,0,0,0,0.0,0,0,0.0,0,0,0.0,0,0,0.0,0,3,3,0,1,0,0,0,0,1
../kbl_data/2022-2023,S41G01N59,안양 KGC,Away,정준원,6,3,4,75.0,0,0,0.0,3,4,75.0,0,0,0.0,1,0,1,0,0,0,0,0,0,0
../kbl_data/2022-2023,S41G01N59,안양 KGC,Away,문성곤,13,3,5,60.0,2,5,40.0,5,10,50.0,1,1,100.0,3,6,9,0,1,0,0,0,1,1
../kbl_data/2022-2023,S41G01N59,안양 KGC,Away,박지훈,8,3,3,100.0,0,0,0.0,3,3,100.0,2,3,66.7,1,3,4,2,2,1,0,0,2,1
../kbl_data/2022-2023,S41G01N59,안양 KGC,Away,대릴 먼로,0,0,1,0.0,0,3,0.0,0,4,0.0,0,0,0.0,1,0,1,2,0,1,0,0,1,2
../kbl_data/2022-2023,S41G01N59,안양 KGC,Away,변준형,11,4,8,50.0,1,5,20.0,5,13,38.5,0,0,0.0,2,2,4,10,2,0,0,0,2,4
../kbl_data/2022-2023,S41G01N59,안양 KGC,Away,한승희,10,2,4,50.0,2,4,50.0,4,8,50.0,0,0,0.0,0,1,1,1,2,0,1,0,0,3
../kbl_data/2022-2023,S41G01N59,안양 KGC,Away,오마리 스펠맨,15,5,12,41.7,1,4,25.0,6,16,37.5,2,2,100.0,0,6,6,2,1,2,0,2,3,5
../kbl_data/2022-2023,S41G01N59,안양 KGC,Away,렌즈 아반도,17,6,10,60.0,1,2,50.0,7,12,58.3,2,5,40.0,3,4,7,1,1,2,0,1,2,2
../kbl_data/2022-2023,S41G01N59,안양 KGC,Away,고찬혁,2,0,0,0.0,0,0,0.0,0,0,0.0,2,3,66.7,0,0,0,0,0,0,0,0,0,0
../kbl_data/2022-2023,S41G01N60,고양 캐롯,Home,김강선,0,0,0,0.0,0,0,0.0,0,0,0.0,0,0,0.0,0,0,0,0,0,0,0,0,0,0
../kbl_data/2022-2023,S41G01N60,고양 캐롯,Home,데이비드 사이먼,12,6,9,66.7,0,1,0.0,6,10,60.0,0,0,0.0,2,4,6,2,0,1,0,0,1,1
../kbl_data/2022-2023,S41G01N60,고양 캐롯,Home,최현민,6,0,0,0.0,1,8,12.5,1,8,12.5,3,3,100.0,2,6,8,0,1,0,0,0,0,1
../kbl_data/2022-2023,S41G01N60,고양 캐롯,Home,한호빈,6,0,0,0.0,2,4,50.0,2,4,50.0,0,0,0.0,1,1,2,3,2,0,0,0,2,1
../kbl_data/2022-2023,S41G01N60,고양 캐롯,Home,전성현,10,2,4,50.0,2,8,25.0,4,12,33.3,0,0,0.0,1,0,1,4,1,0,0,0,2,3
../kbl_data/2022-2023,S41G01N60,고양 캐롯,Home,김진유,6,0,0,0.0,2,5,40.0,2,5,40.0,0,0,0.0,2,5,7,0,1,1,0,0,0,2
../kbl_data/2022-2023,S41G01N60,고양 캐롯,Home,정해원,0,0,0,0.0,0,0,0.0,0,0,0.0,0,0,0.0,0,0,0,0,0,0,0,0,0,0
../kbl_data/2022-2023,S41G01N60,고양 캐롯,Home,조한진,0,0,0,0.0,0,1,0.0,0,1,0.0,0,0,0.0,1,0,1,0,0,0,0,0,0,1
../kbl_data/2022-2023,S41G01N60,고양 캐롯,Home,디드릭 로슨,21,7,10,70.0,2,6,33.3,9,16,56.2,1,3,33.3,2,3,5,2,1,0,0,1,0,0
../kbl_data/2022-2023,S41G01N60,고양 캐롯,Home,박진철,0,0,0,0.0,0,0,0.0,0,0,0.0,0,0,0.0,0,0,0,0,0,0,0,0,1,0
../kbl_data/2022-2023,S41G01N60,고양 캐롯,Home,이정현,19,0,4,0.0,6,8,75.0,6,12,50.0,1,2,50.0,0,2,2,4,4,0,0,0,5,2
../kbl_data/2022-2023,S41G01N60,고양 캐롯,Home,조재우,2,1,2,50.0,0,0,0.0,1,2,50.0,0,0,0.0,1,1,2,0,0,0,0,0,0,1
../kbl_data/2022-2023,S41G01N60,원주 DB,Away,박찬희,8,1,2,50.0,2,3,66.7,3,5,60.0,0,0,0.0,0,2,2,5,0,0,0,0,0,2
../kbl_data/2022-2023,S41G01N60,원주 DB,Away,두경민,19,4,5,80.0,2,11,18.2,6,16,37.5,5,6,83.3,1,3,4,3,2,0,0,0,5,2
../kbl_data/2022-2023,S41G01N60,원주 DB,Away,김종규,10,5,5,100.0,0,0,0.0,5,5,100.0,0,1,0.0,2,2,4,2,1,1,0,0,0,1
../kbl_data/2022-2023,S41G01N60,원주 DB,Away,최승욱,10,2,2,100.0,2,2,100.0,4,4,100.0,0,0,0.0,3,2,5,1,1,1,0,0,2,1
../kbl_data/2022-2023,S41G01N60,원주 DB,Away,강상재,7,3,6,50.0,0,0,0.0,3,6,50.0,1,1,100.0,1,3,4,0,1,0,0,0,2,2
../kbl_data/2022-2023,S41G01N60,원주 DB,Away,윤성원,0,0,0,0.0,0,0,0.0,0,0,0.0,0,0,0.0,0,0,0,0,0,0,0,0,0,0
../kbl_data/2022-2023,S41G01N60,원주 DB,Away,이준희,0,0,0,0.0,0,0,0.0,0,0,0.0,0,0,0.0,0,1,1,0,1,0,0,0,1,1
../kbl_data/2022-2023,S41G01N60,원주 DB,Away,레나드 프리먼,6,3,8,37.5,0,0,0.0,3,8,37.5,0,0,0.0,0,5,5,1,1,0,0,0,2,1
../kbl_data/2022-2023,S41G01N60,원주 DB,Away,정호영,0,0,0,0.0,0,0,0.0,0,0,0.0,0,0,0.0,0,0,0,0,0,0,0,0,0,0
../kbl_data/2022-2023,S41G01N60,원주 DB,Away,이선 알바노,7,3,6,50.0,0,2,0.0,3,8,37.5,1,2,50.0,0,2,2,2,1,0,0,0,2,3
../kbl_data/2022-2023,S41G01N60,원주 DB,Away,드완 에르난데스,6,3,7,42.9,0,0,0.0,3,7,42.9,0,0,0.0,0,6,6,2,0,0,0,2,0,0
../kbl_data/2022-2023,S41G01N60,원주 DB,Away,박인웅,4,1,2,50.0,0,1,0.0,1,3,33.3,2,4,50.0,0,1,1,0,1,0,0,0,0,2
../kbl_data/2022-2023,S41G01N61,서울 SK,Home,양우섭,9,3,5,60.0,1,2,50.0,4,7,57.1,0,0,0.0,1,4,5,4,1,0,1,0,1,0
../kbl_data/2022-2023,S41G01N61,서울 SK,Home,허일영,16,5,7,71.4,0,3,0.0,5,10,50.0,6,7,85.7,1,2,3,1,0,0,0,0,0,0
../kbl_data/2022-2023,S41G01N61,서울 SK,Home,송창용,0,0,4,0.0,0,0,0.0,0,4,0.0,0,0,0.0,0,0,0,3,0,0,0,0,0,1
../kbl_data/2022-2023,S41G01N61,서울 SK,Home,김선형,3,0,4,0.0,1,3,33.3,1,7,14.3,0,0,0.0,0,0,0,3,0,1,0,0,1,0
../kbl_data/2022-2023,S41G01N61,서울 SK,Home,최부경,2,1,3,33.3,0,0,0.0,1,3,33.3,0,0,0.0,0,1,1,3,1,1,0,0,0,2
../kbl_data/2022-2023,S41G01N61,서울 SK,Home,리온 윌리엄스,4,1,1,100.0,0,0,0.0,1,1,100.0,2,2,100.0,1,2,3,0,0,0,0,0,0,2
../kbl_data/2022-2023,S41G01N61,서울 SK,Home,최원혁,0,0,1,0.0,0,0,0.0,0,1,0.0,0,0,0.0,3,3,6,2,1,0,0,0,0,3
../kbl_data/2022-2023,S41G01N61,서울 SK,Home,장문호,4,2,2,100.0,0,0,0.0,2,2,100.0,0,0,0.0,0,1,1,0,0,0,0,0,0,0
../kbl_data/2022-2023,S41G01N61,서울 SK,Home,자밀 워니,15,7,18,38.9,0,0,0.0,7,18,38.9,1,2,50.0,2,8,10,0,0,2,0,3,2,1
../kbl_data/2022-2023,S41G01N61,서울 SK,Home,김형빈,12,5,9,55.6,0,1,0.0,5,10,50.0,2,2,100.0,1,2,3,0,1,0,0,0,0,2
../kbl_data/2022-2023,S41G01N61,서울 SK,Home,오재현,4,2,3,66.7,0,4,0.0,2,7,28.6,0,0,0.0,1,1,2,2,1,0,0,0,2,4
../kbl_data/2022-2023,S41G01N61,서울 SK,Home,임현택,0,0,0,0.0,0,0,0.0,0,0,0.0,0,0,0.0,0,0,0,0,0,0,0,0,0,0
../kbl_data/2022-2023,S41G01N61,수원 KT,Away,김동량,0,0,1,0.0,0,0,0.0,0,1,0.0,0,0,0.0,1,0,1,0,0,0,0,0,0,2
../kbl_data/2022-2023,S41G01N61,수원 KT,Away,김종범,3,0,0,0.0,1,4,25.0,1,4,25.0,0,0,0.0,0,1,1,0,0,0,0,0,0,1
../kbl_data/2022-2023,S41G01N61,수원 KT,Away,한희원,7,2,2,100.0,1,4,25.0,3,6,50.0,0,0,0.0,2,1,3,1,0,0,0,0,0,4
../kbl_data/2022-2023,S41G01N61,수원 KT,Away,이현석,2,1,1,100.0,0,2,0.0,1,3,33.3,0,0,0.0,0,2,2,0,3,0,0,0,0,3
../kbl_data/2022-2023,S41G01N61,수원 KT,Away,정성우,15,3,7,42.9,3,6,50.0,6,13,46.2,0,0,0.0,0,1,1,8,2,0,0,0,3,0
../kbl_data/2022-2023,S41G01N61,수원 KT,Away,최성모,13,2,3,66.7,3,5,60.0,5,8,62.5,0,0,0.0,3,4,7,3,0,0,0,0,0,2
../kbl_data/2022-2023,S41G01N61,수원 KT,Away,양홍석,17,4,8,50.0,2,7,28.6,6,15,40.0,3,4,75.0,4,7,11,4,0,1,0,0,3,3
../kbl_data/2022-2023,S41G01N61,수원 KT,Away,박지원,2,1,1,100.0,0,1,0.0,1,2,50.0,0,0,0.0,2,1,3,0,0,0,0,0,1,1
../kbl_data/2022-2023,S41G01N61,수원 KT,Away,김준환,0,0,0,0.0,0,0,0.0,0,0,0.0,0,0,0.0,0,0,0,0,0,0,0,0,0,0
../kbl_data/2022-2023,S41G01N61,수원 KT,Away,하윤기,11,4,7,57.1,0,0,0.0,4,7,57.1,3,5,60.0,3,6,9,0,0,2,0,1,0,2
../kbl_data/2022-2023,S41G01N61,수원 KT,Away,이제이 아노시케,11,2,6,33.3,2,6,33.3,4,12,33.3,1,2,50.0,2,6,8,3,1,1,0,0,3,1
../kbl_data/2022-2023,S41G01N61,수원 KT,Away,랜드리 은노코,0,0,3,0.0,0,0,0.0,0,3,0.0,0,0,0.0,2,2,4,1,0,0,0,0,1,0
../kbl_data/2022-2023,S41G01N62,서울 삼성,Home,이정현,7,1,3,33.3,0,3,0.0,1,6,16.7,5,6,83.3,1,1,2,5,0,0,0,0,3,1
../kbl_data/2022-2023,S41G01N62,서울 삼성,Home,장민국,4,2,4,50.0,0,0,0.0,2,4,50.0,0,0,0.0,1,0,1,1,0,0,0,0,0,2
../kbl_data/2022-2023,S41G01N62,서울 삼성,Home,김현수,6,0,0,0.0,2,6,33.3,2,6,33.3,0,0,0.0,1,0,1,3,2,0,0,0,0,3
../kbl_data/2022-2023,S41G01N62,서울 삼성,Home,임동섭,6,2,4,50.0,0,2,0.0,2,6,33.3,2,2,100.0,3,2,5,2,3,0,0,0,1,3
../kbl_data/2022-2023,S41G01N62,서울 삼성,Home,이동엽,2,1,5,20.0,0,1,0.0,1,6,16.7,0,0,0.0,1,3,4,2,1,0,0,0,3,2
../kbl_data/2022-2023,S41G01N62,서울 삼성,Home,정희원,0,0,0,0.0,0,0,0.0,0,0,0.0,0,0,0.0,0,0,0,0,0,0,0,0,0,0
../kbl_data/2022-2023,S41G01N62,서울 삼성,Home,마커스 데릭슨,18,7,10,70.0,1,5,20.0,8,15,53.3,1,2,50.0,1,3,4,3,0,1,0,2,2,0
../kbl_data/2022-2023,S41G01N62,서울 삼성,Home,전형준,1,0,0,0.0,0,2,0.0,0,2,0.0,1,2,50.0,1,0,1,0,0,0,0,0,1,1
../kbl_data/2022-2023,S41G01N62,서울 삼성,Home,조우성,0,0,0,0.0,0,0,0.0,0,0,0.0,0,0,0.0,0,0,0,0,0,0,0,0,0,0
../kbl_data/2022-2023,S41G01N62,서울 삼성,Home,이원석,10,5,9,55.6,0,0,0.0,5,9,55.6,0,0,0.0,3,9,12,0,1,2,0,0,2,4
../kbl_data/2022-2023,S41G01N62,서울 삼성,Home,이매뉴얼 테리,8,4,6,66.7,0,0,0.0,4,6,66.7,0,0,0.0,1,0,1,0,0,0,0,1,0,3
../kbl_data/2022-2023,S41G01N62,서울 삼성,Home,신동혁,10,2,3,66.7,2,3,66.7,4,6,66.7,0,1,0.0,1,1,2,1,0,0,0,0,0,5
../kbl_data/2022-2023,S41G01N62,전주 KCC,Away,정창영,11,2,5,40.0,1,2,50.0,3,7,42.9,4,4,100.0,1,6,7,5,0,0,0,0,2,3
../kbl_data/2022-2023,S41G01N62,전주 KCC,Away,라건아,18,6,14,42.9,0,0,0.0,6,14,42.9,6,8,75.0,7,11,18,3,0,1,0,0,3,3
../kbl_data/2022-2023,S41G01N62,전주 KCC,Away,박경상,0,0,0,0.0,0,0,0.0,0,0,0.0,0,0,0.0,0,0,0,0,0,0,0,0,0,0
../kbl_data/2022-2023,S41G01N62,전주 KCC,Away,김지완,0,0,0,0.0,0,0,0.0,0,0,0.0,0,0,0.0,0,2,2,4,1,0,0,0,2,3
../kbl_data/2022-2023,S41G01N62,전주 KCC,Away,허웅,18,3,8,37.5,3,5,60.0,6,13,46.2,3,4,75.0,1,1,2,5,2,0,0,0,2,4
../kbl_data/2022-2023,S41G01N62,전주 KCC,Away,이승현,18,8,17,47.1,0,1,0.0,8,18,44.4,2,2,100.0,2,3,5,0,1,0,1,0,0,3
../kbl_data/2022-2023,S41G01N62,전주 KCC,Away,곽정훈,2,1,1,100.0,0,1,0.0,1,2,50.0,0,0,0.0,0,1,1,0,1,0,0,0,0,0
../kbl_data/2022-2023,S41G01N62,전주 KCC,Away,이근휘,0,0,0,0.0,0,1,0.0,0,1,0.0,0,0,0.0,0,0,0,0,0,0,0,0,0,0
../kbl_data/2022-2023,S41G01N62,전주 KCC,Away,김동현,0,0,0,0.0,0,0,0.0,0,0,0.0,0,0,0.0,0,0,0,0,0,0,0,0,0,0
../kbl_data/2022-2023,S41G01N62,전주 KCC,Away,서정현,0,0,0,0.0,0,0,0.0,0,0,0.0,0,0,0.0,0,0,0,0,0,0,0,0,0,0
../kbl_data/2022-2023,S41G01N62,전주 KCC,Away,론데 홀리스 제퍼슨,3,1,2,50.0,0,0,0.0,1,2,50.0,1,1,100.0,0,0,0,0,1,0,0,0,0,0
../kbl_data/2022-2023,S41G01N62,전주 KCC,Away,송동훈,8,2,3,66.7,1,1,100.0,3,4,75.0,1,2,50.0,1,1,2,1,0,0,0,0,0,2
../kbl_data/2022-2023,S41G01N63,원주 DB,Home,박찬희,5,0,2,0.0,1,1,100.0,1,3,33.3,2,3,66.7,1,2,3,3,0,0,0,0,0,1
../kbl_data/2022-2023,S41G01N63,원주 DB,Home,김현호,0,0,2,0.0,0,0,0.0,0,2,0.0,0,0,0.0,1,0,1,0,0,0,0,0,0,0
../kbl_data/2022-2023,S41G01N63,원주 DB,Home,두경민,8,0,3,0.0,2,3,66.7,2,6,33.3,2,2,100.0,0,4,4,3,0,0,0,0,1,4
../kbl_data/2022-2023,S41G01N63,원주 DB,Home,김종규,0,0,4,0.0,0,1,0.0,0,5,0.0,0,0,0.0,0,0,0,0,1,1,0,0,1,0
../kbl_data/2022-2023,S41G01N63,원주 DB,Home,최승욱,5,2,5,40.0,0,2,0.0,2,7,28.6,1,2,50.0,1,3,4,0,2,0,0,0,0,1
../kbl_data/2022-2023,S41G01N63,원주 DB,Home,강상재,0,0,4,0.0,0,0,0.0,0,4,0.0,0,0,0.0,0,0,0,0,0,0,0,0,0,0
../kbl_data/2022-2023,S41G01N63,원주 DB,Home,윤성원,0,0,0,0.0,0,0,0.0,0,0,0.0,0,0,0.0,0,0,0,0,0,0,0,0,0,0
../kbl_data/2022-2023,S41G01N63,원주 DB,Home,원종훈,0,0,0,0.0,0,0,0.0,0,0,0.0,0,0,0.0,0,2,2,1,0,0,0,0,0,3
../kbl_data/2022-2023,S41G01N63,원주 DB,Home,레나드 프리먼,6,3,7,42.9,0,0,0.0,3,7,42.9,0,0,0.0,5,0,5,0,1,0,0,0,1,0
../kbl_data/2022-2023,S41G01N63,원주 DB,Home,이선 알바노,15,3,8,37.5,3,5,60.0,6,13,46.2,0,0,0.0,1,6,7,5,2,0,0,0,2,3
../kbl_data/2022-2023,S41G01N63,원주 DB,Home,드완 에르난데스,36,13,20,65.0,1,2,50.0,14,22,63.6,7,9,77.8,5,6,11,1,0,2,0,5,5,4
../kbl_data/2022-2023,S41G01N63,원주 DB,Home,박인웅,2,0,0,0.0,0,2,0.0,0,2,0.0,2,2,100.0,3,1,4,1,1,0,0,0,1,2
../kbl_data/2022-2023,S41G01N63,창원 LG,Away,이관희,16,4,8,50.0,2,9,22.2,6,17,35.3,2,2,100.0,0,1,1,0,0,0,0,0,3,1
../kbl_data/2022-2023,S41G01N63,창원 LG,Away,정희재,2,1,3,33.3,0,1,0.0,1,4,25.0,0,0,0.0,0,0,0,1,1,0,0,0,0,3
../kbl_data/2022-2023,S41G01N63,창원 LG,Away,서민수,11,2,2,100.0,2,4,50.0,4,6,66.7,1,2,50.0,3,2,5,2,0,0,0,0,2,3
../kbl_data/2022-2023,S41G01N63,창원 LG,Away,한상혁,0,0,0,0.0,0,0,0.0,0,0,0.0,0,0,0.0,0,0,0,0,0,0,0,0,0,1
../kbl_data/2022-2023,S41G01N63,창원 LG,Away,이재도,28,6,10,60.0,4,10,40.0,10,20,50.0,4,5,80.0,3,2,5,5,1,0,1,0,2,2
../kbl_data/2022-2023,S41G01N63,창원 LG,Away,김준일,0,0,1,0.0,0,0,0.0,0,1,0.0,0,0,0.0,0,1,1,0,0,1,0,0,1,0
../kbl_data/2022-2023,S41G01N63,창원 LG,Away,윤원상,14,1,5,20.0,3,4,75.0,4,9,44.4,3,4,75.0,1,2,3,1,1,0,0,0,1,0
../kbl_data/2022-2023,S41G01N63,창원 LG,Away,아셈 마레이,10,4,7,57.1,0,0,0.0,4,7,57.1,2,4,50.0,6,13,19,3,2,1,0,0,2,4
../kbl_data/2022-2023,S41G01N63,창원 LG,Away,이승우,0,0,2,0.0,0,0,0.0,0,2,0.0,0,0,0.0,2,2,4,1,0,1,0,0,0,2
../kbl_data/2022-2023,S41G01N63,창원 LG,Away,저스틴 구탕,0,0,0,0.0,0,0,0.0,0,0,0.0,0,0,0.0,0,0,0,1,1,0,0,0,0,0
../kbl_data/2022-2023,S41G01N63,창원 LG,Away,이승훈,0,0,0,0.0,0,0,0.0,0,0,0.0,0,0,0.0,0,0,0,0,0,0,0,0,0,0
../kbl_data/2022-2023,S41G01N63,창원 LG,Away,단테 커닝햄,0,0,2,0.0,0,0,0.0,0,2,0.0,0,0,0.0,0,4,4,0,1,3,0,0,0,0
../kbl_data/2022-2023,S41G01N64,전주 KCC,Home,정창영,12,2,5,40.0,2,3,66.7,4,8,50.0,2,2,100.0,2,1,3,2,0,0,0,0,0,2
../kbl_data/2022-2023,S41G01N64,전주 KCC,Home,라건아,8,4,7,57.1,0,0,0.0,4,7,57.1,0,0,0.0,2,2,4,0,1,0,0,0,1,0
../kbl_data/2022-2023,S41G01N64,전주 KCC,Home,박경상,0,0,0,0.0,0,0,0.0,0,0,0.0,0,0,0.0,0,0,0,1,0,0,0,0,0,0
../kbl_data/2022-2023,S41G01N64,전주 KCC,Home,김지완,4,1,2,50.0,0,0,0.0,1,2,50.0,2,2,100.0,0,5,5,3,0,0,1,0,0,3
../kbl_data/2022-2023,S41G01N64,전주 KCC,Home,허웅,11,2,3,66.7,1,7,14.3,3,10,30.0,4,4,100.0,1,1,2,7,3,0,1,0,0,2
../kbl_data/2022-2023,S41G01N64,전주 KCC,Home,이승현,8,4,8,50.0,0,2,0.0,4,10,40.0,0,0,0.0,1,0,1,0,0,1,0,0,0,3
../kbl_data/2022-2023,S41G01N64,전주 KCC,Home,곽정훈,2,1,1,100.0,0,1,0.0,1,2,50.0,0,0,0.0,0,3,3,0,0,0,0,0,0,0
../kbl_data/2022-2023,S41G01N64,전주 KCC,Home,이근휘,6,0,1,0.0,2,6,33.3,2,7,28.6,0,0,0.0,0,0,0,0,0,0,0,0,0,3
../kbl_data/2022-2023,S41G01N64,전주 KCC,Home,김동현,0,0,0,0.0,0,0,0.0,0,0,0.0,0,0,0.0,0,0,0,0,0,0,0,0,0,0
../kbl_data/2022-2023,S41G01N64,전주 KCC,Home,서정현,2,1,1,100.0,0,0,0.0,1,1,100.0,0,0,0.0,1,0,1,0,0,0,0,0,0,0
../kbl_data/2022-2023,S41G01N64,전주 KCC,Home,론데 홀리스 제퍼슨,29,12,19,63.2,0,0,0.0,12,19,63.2,5,11,45.5,2,8,10,2,1,3,0,3,2,3
../kbl_data/2022-2023,S41G01N64,전주 KCC,Home,송동훈,0,0,0,0.0,0,0,0.0,0,0,0.0,0,0,0.0,0,0,0,1,1,0,0,0,0,2
../kbl_data/2022-2023,S41G01N64,안양 KGC,Away,양희종,0,0,0,0.0,0,0,0.0,0,0,0.0,0,0,0.0,0,0,0,0,0,0,0,0,0,0
../kbl_data/2022-2023,S41G01N64,안양 KGC,Away,함준후,0,0,0,0.0,0,0,0.0,0,0,0.0,0,0,0.0,0,0,0,0,0,0,0,0,0,0
../kbl_data/2022-2023,S41G01N64,안양 KGC,Away,오세근,9,4,8,50.0,0,0,0.0,4,8,50.0,1,3,33.3,1,5,6,3,0,0,0,0,1,0
../kbl_data/2022-2023,S41G01N64,안양 KGC,Away,정준원,0,0,1,0.0,0,0,0.0,0,1,0.0,0,0,0.0,1,1,2,0,0,0,0,0,0,0
../kbl_data/2022-2023,S41G01N64,안양 KGC,Away,문성곤,8,1,2,50.0,2,3,66.7,3,5,60.0,0,0,0.0,1,2,3,3,0,0,1,0,1,3
../kbl_data/2022-2023,S41G01N64,안양 KGC,Away,박지훈,6,0,1,0.0,2,3,66.7,2,4,50.0,0,0,0.0,1,3,4,1,0,0,0,0,3,4
../kbl_data/2022-2023,S41G01N64,안양 KGC,Away,대릴 먼로,12,6,11,54.5,0,1,0.0,6,12,50.0,0,2,0.0,5,7,12,1,1,0,0,0,1,1
../kbl_data/2022-2023,S41G01N64,안양 KGC,Away,변준형,22,5,10,50.0,2,4,50.0,7,14,50.0,6,7,85.7,3,1,4,6,0,0,0,0,2,2
../kbl_data/2022-2023,S41G01N64,안양 KGC,Away,한승희,0,0,1,0.0,0,3,0.0,0,4,0.0,0,0,0.0,3,1,4,0,0,0,0,0,0,5
../kbl_data/2022-2023,S41G01N64,안양 KGC,Away,오마리 스펠맨,12,3,4,75.0,2,9,22.2,5,13,38.5,0,0,0.0,1,6,7,3,1,2,0,0,0,4
../kbl_data/2022-2023,S41G01N64,안양 KGC,Away,렌즈 아반도,15,2,3,66.7,2,3,66.7,4,6,66.7,5,5,100.0,0,1,1,0,0,1,0,1,1,3
../kbl_data/2022-2023,S41G01N64,안양 KGC,Away,고찬혁,0,0,0,0.0,0,0,0.0,0,0,0.0,0,0,0.0,0,0,0,0,0,0,0,0,0,0
../kbl_data/2022-2023,S41G01N65,서울 SK,Home,양우섭,7,2,3,66.7,1,2,50.0,3,5,60.0,0,0,0.0,0,2,2,2,0,0,0,0,0,4
../kbl_data/2022-2023,S41G01N65,서울 SK,Home,허일영,14,5,6,83.3,0,1,0.0,5,7,71.4,4,7,57.1,2,5,7,1,0,1,0,0,1,1
../kbl_data/2022-2023,S41G01N65,서울 SK,Home,김선형,10,4,8,50.0,0,1,0.0,4,9,44.4,2,2,100.0,0,2,2,6,0,0,0,0,1,1
../kbl_data/2022-2023,S41G01N65,서울 SK,Home,최부경,0,0,1,0.0,0,0,0.0,0,1,0.0,0,0,0.0,1,0,1,0,0,0,0,0,0,0
../kbl_data/2022-2023,S41G01N65,서울 SK,Home,리온 윌리엄스,9,2,6,33.3,1,1,100.0,3,7,42.9,2,2,100.0,2,2,4,0,0,1,0,0,2,2
../kbl_data/2022-2023,S41G01N65,서울 SK,Home,최원혁,0,0,0,0.0,0,0,0.0,0,0,0.0,0,0,0.0,0,0,0,0,0,0,0,0,0,0
../kbl_data/2022-2023,S41G01N65,서울 SK,Home,최준용,19,6,8,75.0,1,4,25.0,7,12,58.3,4,6,66.7,2,4,6,4,1,0,0,0,1,3
../kbl_data/2022-2023,S41G01N65,서울 SK,Home,장문호,0,0,0,0.0,0,0,0.0,0,0,0.0,0,0,0.0,0,0,0,0,0,0,0,0,0,1
../kbl_data/2022-2023,S41G01N65,서울 SK,Home,최성원,4,2,2,100.0,0,3,0.0,2,5,40.0,0,0,0.0,0,1,1,1,1,0,0,0,0,2
../kbl_data/2022-2023,S41G01N65,서울 SK,Home,자밀 워니,18,8,21,38.1,0,0,0.0,8,21,38.1,2,3,66.7,2,9,11,3,0,3,0,3,0,1
../kbl_data/2022-2023,S41G01N65,서울 SK,Home,김형빈,2,1,3,33.3,0,0,0.0,1,3,33.3,0,0,0.0,0,1,1,0,2,0,0,0,0,1
../kbl_data/2022-2023,S41G01N65,서울 SK,Home,오재현,9,3,4,75.0,0,2,0.0,3,6,50.0,3,4,75.0,1,4,5,5,1,0,0,0,1,4
../kbl_data/2022-2023,S41G01N65,울산 현대모비스,Away,함지훈,9,2,5,40.0,1,2,50.0,3,7,42.9,2,2,100.0,1,2,3,4,0,0,0,0,0,3
../kbl_data/2022-2023,S41G01N65,울산 현대모비스,Away,최진수,0,0,0,0.0,0,0,0.0,0,0,0.0,0,0,0.0,0,0,0,0,0,0,0,0,0,0
../kbl_data/2022-2023,S41G01N65,울산 현대모비스,Away,장재석,2,1,7,14.3,0,0,0.0,1,7,14.3,0,2,0.0,1,3,4,0,0,0,0,0,0,1
../kbl_data/2022-2023,S41G01N65,울산 현대모비스,Away,김영현,3,0,1,0.0,1,1,100.0,1,2,50.0,0,0,0.0,1,1,2,0,1,0,0,0,1,3
../kbl_data/2022-2023,S41G01N65,울산 현대모비스,Away,김국찬,0,0,0,0.0,0,0,0.0,0,0,0.0,0,0,0.0,0,0,0,0,0,0,0,0,0,0
../kbl_data/2022-2023,S41G01N65,울산 현대모비스,Away,서명진,8,3,5,60.0,0,2,0.0,3,7,42.9,2,3,66.7,1,1,2,4,2,0,0,0,2,2
../kbl_data/2022-2023,S41G01N65,울산 현대모비스,Away,헨리 심스,0,0,2,0.0,0,0,0.0,0,2,0.0,0,0,0.0,1,1,2,0,0,0,0,0,0,0
../kbl_data/2022-2023,S41G01N65,울산 현대모비스,Away,이우석,24,7,12,58.3,3,5,60.0,10,17,58.8,1,4,25.0,0,6,6,5,0,0,0,0,2,3
../kbl_data/2022-2023,S41G01N65,울산 현대모비스,Away,신민석,5,1,2,50.0,1,4,25.0,2,6,33.3,0,0,0.0,1,1,2,1,0,0,0,0,0,3
../kbl_data/2022-2023,S41G01N65,울산 현대모비스,Away,김동준,2,1,3,33.3,0,1,0.0,1,4,25.0,0,1,0.0,0,0,0,1,1,0,0,0,0,1
../kbl_data/2022-2023,S41G01N65,울산 현대모비스,Away,론제이 아바리엔토스,13,5,8,62.5,1,5,20.0,6,13,46.2,0,0,0.0,1,2,3,6,0,0,0,0,1,4
../kbl_data/2022-2023,S41G01N65,울산 현대모비스,Away,게이지 프림,24,9,17,52.9,0,0,0.0,9,17,52.9,6,8,75.0,7,9,16,4,1,2,0,0,1,2
../kbl_data/2022-2023,S41G01N66,수원 KT,Home,김동욱,0,0,0,0.0,0,0,0.0,0,0,0.0,0,0,0.0,0,0,0,1,0,0,0,0,0,1
../kbl_data/2022-2023,S41G01N66,수원 KT,Home,김동량,0,0,1,0.0,0,0,0.0,0,1,0.0,0,0,0.0,0,1,1,0,0,0,0,0,0,0
../kbl_data/2022-2023,S41G01N66,수원 KT,Home,김종범,0,0,0,0.0,0,0,0.0,0,0,0.0,0,0,0.0,0,0,0,0,0,0,0,0,0,0
../kbl_data/2022-2023,S41G01N66,수원 KT,Home,한희원,6,0,2,0.0,1,2,50.0,1,4,25.0,3,3,100.0,3,1,4,2,2,0,0,0,1,3
../kbl_data/2022-2023,S41G01N66,수원 KT,Home,이현석,0,0,0,0.0,0,1,0.0,0,1,0.0,0,0,0.0,0,2,2,0,2,0,0,0,0,2
../kbl_data/2022-2023,S41G01N66,수원 KT,Home,정성우,6,1,5,20.0,1,3,33.3,2,8,25.0,1,2,50.0,0,0,0,2,1,0,0,0,0,5
../kbl_data/2022-2023,S41G01N66,수원 KT,Home,최성모,13,0,3,0.0,2,4,50.0,2,7,28.6,7,7,100.0,0,6,6,2,1,0,0,0,0,0
../kbl_data/2022-2023,S41G01N66,수원 KT,Home,양홍석,22,7,12,58.3,2,3,66.7,9,15,60.0,2,2,100.0,2,5,7,1,3,0,0,0,2,1
../kbl_data/2022-2023,S41G01N66,수원 KT,Home,박지원,0,0,0,0.0,0,0,0.0,0,0,0.0,0,0,0.0,0,0,0,0,0,0,0,0,0,0
../kbl_data/2022-2023,S41G01N66,수원 KT,Home,하윤기,9,3,6,50.0,0,0,0.0,3,6,50.0,3,5,60.0,0,4,4,3,2,0,0,0,2,4
../kbl_data/2022-2023,S41G01N66,수원 KT,Home,이제이 아노시케,32,4,6,66.7,6,12,50.0,10,18,55.6,6,9,66.7,2,4,6,2,4,0,0,0,3,3
../kbl_data/2022-2023,S41G01N66,수원 KT,Home,랜드리 은노코,0,0,0,0.0,0,0,0.0,0,0,0.0,0,0,0.0,0,0,0,0,0,0,0,0,0,0
../kbl_data/2022-2023,S41G01N66,원주 DB,Away,박찬희,3,0,0,0.0,1,2,50.0,1,2,50.0,0,0,0.0,0,1,1,7,0,0,0,0,1,1
../kbl_data/2022-2023,S41G01N66,원주 DB,Away,김현호,0,0,0,0.0,0,2,0.0,0,2,0.0,0,0,0.0,1,0,1,0,1,0,0,0,1,2
../kbl_data/2022-2023,S41G01N66,원주 DB,Away,두경민,28,5,7,71.4,5,11,45.5,10,18,55.6,3,3,100.0,1,4,5,1,0,1,0,0,3,3
../kbl_data/2022-2023,S41G01N66,원주 DB,Away,김종규,4,2,2,100.0,0,0,0.0,2,2,100.0,0,0,0.0,2,3,5,0,0,0,0,0,2,2
../kbl_data/2022-2023,S41G01N66,원주 DB,Away,최승욱,2,1,4,25.0,0,1,0.0,1,5,20.0,0,0,0.0,1,3,4,2,2,1,0,0,0,2
../kbl_data/2022-2023,S41G01N66,원주 DB,Away,윤성원,2,1,1,100.0,0,1,0.0,1,2,50.0,0,0,0.0,0,0,0,0,0,0,0,0,1,1
../kbl_data/2022-2023,S41G01N66,원주 DB,Away,레나드 프리먼,11,5,7,71.4,0,0,0.0,5,7,71.4,1,4,25.0,0,5,5,2,0,1,0,0,3,2
../kbl_data/2022-2023,S41G01N66,원주 DB,Away,정호영,0,0,2,0.0,0,0,0.0,0,2,0.0,0,0,0.0,0,0,0,0,1,0,0,0,0,0
../kbl_data/2022-2023,S41G01N66,원주 DB,Away,이선 알바노,3,0,3,0.0,1,2,50.0,1,5,20.0,0,0,0.0,0,2,2,1,0,0,0,0,4,3
../kbl_data/2022-2023,S41G01N66,원주 DB,Away,드완 에르난데스,14,6,10,60.0,0,1,0.0,6,11,54.5,2,2,100.0,0,4,4,2,0,0,0,0,0,2
../kbl_data/2022-2023,S41G01N66,원주 DB,Away,박인웅,3,0,0,0.0,1,1,100.0,1,1,100.0,0,0,0.0,1,0,1,2,0,0,0,0,0,0
../kbl_data/2022-2023,S41G01N66,원주 DB,Away,인승찬,8,2,3,66.7,1,1,100.0,3,4,75.0,1,3,33.3,1,2,3,0,0,0,1,0,1,5
../kbl_data/2022-2023,S41G01N67,대구 한국가스공사,Home,차바위,8,1,2,50.0,2,3,66.7,3,5,60.0,0,0,0.0,0,4,4,2,0,0,1,0,1,4
../kbl_data/2022-2023,S41G01N67,대구 한국가스공사,Home,조상열,3,0,0,0.0,1,1,100.0,1,1,100.0,0,0,0.0,0,0,0,0,1,0,0,0,0,1
../kbl_data/2022-2023,S41G01N67,대구 한국가스공사,Home,이원대,0,0,0,0.0,0,0,0.0,0,0,0.0,0,0,0.0,0,0,0,0,0,0,0,0,1,0
../kbl_data/2022-2023,S41G01N67,대구 한국가스공사,Home,이대성,25,6,8,75.0,1,1,100.0,7,9,77.8,10,10,100.0,0,6,6,7,0,0,0,0,2,2
../kbl_data/2022-2023,S41G01N67,대구 한국가스공사,Home,정효근,5,2,2,100.0,0,1,0.0,2,3,66.7,1,2,50.0,0,1,1,1,0,0,0,0,1,1
../kbl_data/2022-2023,S41G01N67,대구 한국가스공사,Home,박봉진,0,0,0,0.0,0,0,0.0,0,0,0.0,0,0,0.0,0,0,0,0,0,0,0,0,0,0
../kbl_data/2022-2023,S41G01N67,대구 한국가스공사,Home,머피 할로웨이,14,6,12,50.0,0,0,0.0,6,12,50.0,2,2,100.0,2,9,11,4,1,1,0,0,2,2
../kbl_data/2022-2023,S41G01N67,대구 한국가스공사,Home,우동현,0,0,0,0.0,0,0,0.0,0,0,0.0,0,0,0.0,0,0,0,0,0,0,0,0,0,0
../kbl_data/2022-2023,S41G01N67,대구 한국가스공사,Home,전현우,17,0,2,0.0,5,7,71.4,5,9,55.6,2,2,100.0,0,0,0,0,0,0,0,0,1,4
../kbl_data/2022-2023,S41G01N67,대구 한국가스공사,Home,신승민,17,4,4,100.0,2,3,66.7,6,7,85.7,3,5,60.0,1,2,3,3,0,2,0,0,0,4
../kbl_data/2022-2023,S41G01N67,대구 한국가스공사,Home,샘조세프 벨란겔,13,3,4,75.0,2,3,66.7,5,7,71.4,1,1,100.0,2,4,6,4,1,0,0,0,0,3
../kbl_data/2022-2023,S41G01N67,대구 한국가스공사,Home,유슈 은도예,4,2,4,50.0,0,0,0.0,2,4,50.0,0,0,0.0,1,4,5,2,0,1,0,1,0,1
../kbl_data/2022-2023,S41G01N67,서울 삼성,Away,이정현,11,0,4,0.0,3,8,37.5,3,12,25.0,2,2,100.0,0,3,3,2,0,0,0,0,2,2
../kbl_data/2022-2023,S41G01N67,서울 삼성,Away,장민국,15,4,6,66.7,1,6,16.7,5,12,41.7,4,4,100.0,1,1,2,1,1,0,0,0,1,3
../kbl_data/2022-2023,S41G01N67,서울 삼성,Away,김현수,0,0,0,0.0,0,1,0.0,0,1,0.0,0,0,0.0,0,0,0,0,0,0,1,0,0,1
../kbl_data/2022-2023,S41G01N67,서울 삼성,Away,임동섭,4,2,3,66.7,0,3,0.0,2,6,33.3,0,0,0.0,1,0,1,0,0,0,0,0,1,1
../kbl_data/2022-2023,S41G01N67,서울 삼성,Away,김광철,2,1,2,50.0,0,0,0.0,1,2,50.0,0,2,0.0,0,0,0,2,0,0,0,0,0,1
../kbl_data/2022-2023,S41G01N67,서울 삼성,Away,마커스 데릭슨,9,4,6,66.7,0,2,0.0,4,8,50.0,1,2,50.0,1,1,2,1,1,1,0,0,2,2
../kbl_data/2022-2023,S41G01N67,서울 삼성,Away,전형준,9,0,0,0.0,3,4,75.0,3,4,75.0,0,0,0.0,0,0,0,1,0,0,0,0,1,0
../kbl_data/2022-2023,S41G01N67,서울 삼성,Away,조우성,0,0,0,0.0,0,0,0.0,0,0,0.0,0,0,0.0,0,0,0,0,0,0,0,0,0,0
../kbl_data/2022-2023,S41G01N67,서울 삼성,Away,이원석,5,2,3,66.7,0,0,0.0,2,3,66.7,1,2,50.0,0,0,0,0,2,0,0,0,0,2
../kbl_data/2022-2023,S41G01N67,서울 삼성,Away,이매뉴얼 테리,8,4,6,66.7,0,0,0.0,4,6,66.7,0,4,0.0,1,6,7,3,0,1,0,0,0,2
../kbl_data/2022-2023,S41G01N67,서울 삼성,Away,신동혁,10,1,4,25.0,2,2,100.0,3,6,50.0,2,2,100.0,1,2,3,2,0,0,0,0,0,3
../kbl_data/2022-2023,S41G01N67,서울 삼성,Away,박민채,2,1,1,100.0,0,2,0.0,1,3,33.3,0,0,0.0,0,1,1,1,1,0,0,0,0,3
../kbl_data/2022-2023,S41G01N68,안양 KGC,Home,양희종,0,0,0,0.0,0,3,0.0,0,3,0.0,0,0,0.0,0,1,1,0,1,0,0,0,1,2
../kbl_data/2022-2023,S41G01N68,안양 KGC,Home,함준후,0,0,0,0.0,0,0,0.0,0,0,0.0,0,0,0.0,0,0,0,0,0,0,0,0,0,0
../kbl_data/2022-2023,S41G01N68,안양 KGC,Home,오세근,2,1,5,20.0,0,0,0.0,1,5,20.0,0,0,0.0,0,2,2,2,0,0,0,0,0,1
../kbl_data/2022-2023,S41G01N68,안양 KGC,Home,정준원,3,1,2,50.0,0,0,0.0,1,2,50.0,1,2,50.0,0,0,0,0,0,0,0,0,1,1
../kbl_data/2022-2023,S41G01N68,안양 KGC,Home,배병준,8,1,1,100.0,2,6,33.3,3,7,42.9,0,0,0.0,2,3,5,1,0,0,0,0,1,1
../kbl_data/2022-2023,S41G01N68,안양 KGC,Home,문성곤,12,0,0,0.0,4,6,66.7,4,6,66.7,0,0,0.0,3,4,7,0,3,0,0,0,1,4
../kbl_data/2022-2023,S41G01N68,안양 KGC,Home,박지훈,4,2,3,66.7,0,1,0.0,2,4,50.0,0,0,0.0,1,2,3,5,0,0,0,0,1,1
../kbl_data/2022-2023,S41G01N68,안양 KGC,Home,대릴 먼로,8,4,4,100.0,0,1,0.0,4,5,80.0,0,0,0.0,0,4,4,0,0,0,0,0,1,2
../kbl_data/2022-2023,S41G01N68,안양 KGC,Home,변준형,20,6,8,75.0,2,5,40.0,8,13,61.5,2,3,66.7,3,1,4,5,1,0,1,0,4,2
../kbl_data/2022-2023,S41G01N68,안양 KGC,Home,한승희,3,0,0,0.0,1,3,33.3,1,3,33.3,0,0,0.0,0,0,0,2,0,0,0,0,0,2
../kbl_data/2022-2023,S41G01N68,안양 KGC,Home,오마리 스펠맨,21,8,14,57.1,1,5,20.0,9,19,47.4,2,5,40.0,7,8,15,3,2,0,0,2,3,0
../kbl_data/2022-2023,S41G01N68,안양 KGC,Home,렌즈 아반도,5,1,4,25.0,0,2,0.0,1,6,16.7,3,4,75.0,0,3,3,0,0,0,0,0,1,1
../kbl_data/2022-2023,S41G01N68,고양 캐롯,Away,김강선,3,0,0,0.0,1,3,33.3,1,3,33.3,0,0,0.0,0,2,2,0,1,0,0,0,0,3
../kbl_data/2022-2023,S41G01N68,고양 캐롯,Away,데이비드 사이먼,6,3,5,60.0,0,1,0.0,3,6,50.0,0,0,0.0,0,4,4,0,0,0,0,0,1,0
../kbl_data/2022-2023,S41G01N68,고양 캐롯,Away,최현민,0,0,0,0.0,0,0,0.0,0,0,0.0,0,0,0.0,0,0,0,1,0,0,0,0,0,1
../kbl_data/2022-2023,S41G01N68,고양 캐롯,Away,한호빈,3,0,0,0.0,1,3,33.3,1,3,33.3,0,0,0.0,1,1,2,0,2,0,0,0,1,0
../kbl_data/2022-2023,S41G01N68,고양 캐롯,Away,이정제,0,0,0,0.0,0,0,0.0,0,0,0.0,0,0,0.0,0,0,0,0,0,0,0,0,0,0
../kbl_data/2022-2023,S41G01N68,고양 캐롯,Away,전성현,23,5,5,100.0,3,9,33.3,8,14,57.1,4,6,66.7,0,2,2,4,1,1,0,0,4,1
../kbl_data/2022-2023,S41G01N68,고양 캐롯,Away,김진유,2,1,1,100.0,0,3,0.0,1,4,25.0,0,0,0.0,1,4,5,1,0,0,2,0,0,3
../kbl_data/2022-2023,S41G01N68,고양 캐롯,Away,정해원,0,0,0,0.0,0,0,0.0,0,0,0.0,0,0,0.0,0,0,0,0,0,0,0,0,0,0
../kbl_data/2022-2023,S41G01N68,고양 캐롯,Away,조한진,1,0,0,0.0,0,0,0.0,0,0,0.0,1,3,33.3,1,1,2,1,0,0,0,0,0,0
../kbl_data/2022-2023,S41G01N68,고양 캐롯,Away,김세창,0,0,0,0.0,0,0,0.0,0,0,0.0,0,0,0.0,0,0,0,0,0,0,0,0,0,0
../kbl_data/2022-2023,S41G01N68,고양 캐롯,Away,디드릭 로슨,30,8,16,50.0,4,8,50.0,12,24,50.0,2,2,100.0,2,4,6,2,1,0,0,1,5,4
../kbl_data/2022-2023,S41G01N68,고양 캐롯,Away,이정현,11,1,3,33.3,3,4,75.0,4,7,57.1,0,0,0.0,0,3,3,3,3,0,0,0,4,4
../kbl_data/2022-2023,S41G01N69,서울 SK,Home,양우섭,0,0,1,0.0,0,1,0.0,0,2,0.0,0,0,0.0,1,0,1,1,0,0,0,0,0,2
../kbl_data/2022-2023,S41G01N69,서울 SK,Home,허일영,8,1,4,25.0,2,4,50.0,3,8,37.5,0,0,0.0,1,1,2,0,0,0,0,0,1,0
../kbl_data/2022-2023,S41G01N69,서울 SK,Home,김선형,15,4,11,36.4,2,2,100.0,6,13,46.2,1,2,50.0,0,3,3,5,4,1,0,0,3,1
../kbl_data/2022-2023,S41G01N69,서울 SK,Home,최부경,0,0,0,0.0,0,0,0.0,0,0,0.0,0,0,0.0,0,0,0,0,0,0,0,0,0,1
../kbl_data/2022-2023,S41G01N69,서울 SK,Home,리온 윌리엄스,4,2,3,66.7,0,1,0.0,2,4,50.0,0,0,0.0,2,0,2,1,0,1,0,0,0,1
../kbl_data/2022-2023,S41G01N69,서울 SK,Home,최원혁,0,0,0,0.0,0,0,0.0,0,0,0.0,0,0,0.0,0,0,0,0,0,0,0,0,0,0
../kbl_data/2022-2023,S41G01N69,서울 SK,Home,최준용,23,1,5,20.0,5,7,71.4,6,12,50.0,6,8,75.0,0,8,8,4,0,1,0,0,2,4
../kbl_data/2022-2023,S41G01N69,서울 SK,Home,장문호,0,0,0,0.0,0,0,0.0,0,0,0.0,0,0,0.0,0,0,0,0,1,0,1,0,1,0
../kbl_data/2022-2023,S41G01N69,서울 SK,Home,최성원,9,0,1,0.0,3,5,60.0,3,6,50.0,0,0,0.0,1,1,2,1,0,0,1,0,0,3
../kbl_data/2022-2023,S41G01N69,서울 SK,Home,자밀 워니,24,11,22,50.0,0,1,0.0,11,23,47.8,2,5,40.0,5,5,10,3,0,1,2,1,1,3
../kbl_data/2022-2023,S41G01N69,서울 SK,Home,김형빈,0,0,1,0.0,0,0,0.0,0,1,0.0,0,0,0.0,1,2,3,0,0,0,0,0,0,0
../kbl_data/2022-2023,S41G01N69,서울 SK,Home,오재현,2,1,2,50.0,0,3,0.0,1,5,20.0,0,0,0.0,2,2,4,2,2,0,1,0,0,2
../kbl_data/2022-2023,S41G01N69,원주 DB,Away,박찬희,2,1,1,100.0,0,1,0.0,1,2,50.0,0,0,0.0,0,1,1,2,0,0,0,0,1,0
../kbl_data/2022-2023,S41G01N69,원주 DB,Away,김현호,0,0,1,0.0,0,0,0.0,0,1,0.0,0,0,0.0,0,0,0,0,1,0,0,0,1,0
../kbl_data/2022-2023,S41G01N69,원주 DB,Away,두경민,25,4,7,57.1,4,6,66.7,8,13,61.5,5,5,100.0,2,2,4,2,0,0,0,0,3,3
../kbl_data/2022-2023,S41G01N69,원주 DB,Away,김종규,2,1,2,50.0,0,0,0.0,1,2,50.0,0,0,0.0,1,4,5,2,0,0,0,0,1,1
../kbl_data/2022-2023,S41G01N69,원주 DB,Away,최승욱,10,3,3,100.0,1,5,20.0,4,8,50.0,1,2,50.0,2,1,3,0,0,0,0,0,1,1
../kbl_data/2022-2023,S41G01N69,원주 DB,Away,윤성원,0,0,0,0.0,0,0,0.0,0,0,0.0,0,0,0.0,0,2,2,0,0,0,0,0,0,3
../kbl_data/2022-2023,S41G01N69,원주 DB,Away,레나드 프리먼,2,1,3,33.3,0,0,0.0,1,3,33.3,0,0,0.0,0,4,4,0,0,0,0,0,0,0
../kbl_data/2022-2023,S41G01N69,원주 DB,Away,정호영,0,0,0,0.0,0,0,0.0,0,0,0.0,0,0,0.0,0,0,0,0,0,0,0,0,0,0
../kbl_data/2022-2023,S41G01N69,원주 DB,Away,이선 알바노,20,4,7,57.1,4,6,66.7,8,13,61.5,0,0,0.0,0,5,5,7,3,0,1,0,1,3
../kbl_data/2022-2023,S41G01N69,원주 DB,Away,드완 에르난데스,18,7,13,53.8,0,0,0.0,7,13,53.8,4,9,44.4,3,10,13,3,0,0,0,3,6,5
../kbl_data/2022-2023,S41G01N69,원주 DB,Away,박인웅,2,1,3,33.3,0,2,0.0,1,5,20.0,0,0,0.0,1,1,2,0,0,0,0,0,0,3
../kbl_data/2022-2023,S41G01N69,원주 DB,Away,인승찬,0,0,1,0.0,0,0,0.0,0,1,0.0,0,0,0.0,0,0,0,0,0,0,0,0,0,3
../kbl_data/2022-2023,S41G01N70,울산 현대모비스,Home,함지훈,4,2,2,100.0,0,0,0.0,2,2,100.0,0,0,0.0,0,1,1,3,0,0,0,0,0,2
../kbl_data/2022-2023,S41G01N70,울산 현대모비스,Home,최진수,2,1,1,100.0,0,1,0.0,1,2,50.0,0,0,0.0,0,0,0,0,0,0,0,0,0,0
../kbl_data/2022-2023,S41G01N70,울산 현대모비스,Home,장재석,11,5,10,50.0,0,0,0.0,5,10,50.0,1,3,33.3,3,3,6,0,0,2,0,0,1,2
../kbl_data/2022-2023,S41G01N70,울산 현대모비스,Home,김영현,0,0,2,0.0,0,2,0.0,0,4,0.0,0,0,0.0,0,0,0,1,0,0,0,0,0,2
../kbl_data/2022-2023,S41G01N70,울산 현대모비스,Home,김국찬,0,0,0,0.0,0,0,0.0,0,0,0.0,0,0,0.0,0,1,1,0,0,0,0,0,0,0
../kbl_data/2022-2023,S41G01N70,울산 현대모비스,Home,서명진,9,2,7,28.6,1,3,33.3,3,10,30.0,2,2,100.0,0,5,5,3,1,0,0,0,1,3
../kbl_data/2022-2023,S41G01N70,울산 현대모비스,Home,헨리 심스,5,2,3,66.7,0,0,0.0,2,3,66.7,1,2,50.0,1,4,5,0,0,0,0,0,0,1
../kbl_data/2022-2023,S41G01N70,울산 현대모비스,Home,이우석,20,8,10,80.0,1,4,25.0,9,14,64.3,1,2,50.0,1,3,4,1,1,0,0,0,1,2
../kbl_data/2022-2023,S41G01N70,울산 현대모비스,Home,신민석,0,0,0,0.0,0,0,0.0,0,0,0.0,0,0,0.0,0,0,0,0,0,0,0,0,0,0
../kbl_data/2022-2023,S41G01N70,울산 현대모비스,Home,김동준,2,1,1,100.0,0,0,0.0,1,1,100.0,0,0,0.0,0,0,0,0,0,0,0,0,1,1
../kbl_data/2022-2023,S41G01N70,울산 현대모비스,Home,론제이 아바리엔토스,22,3,6,50.0,5,9,55.6,8,15,53.3,1,3,33.3,2,5,7,5,1,1,0,0,2,3
../kbl_data/2022-2023,S41G01N70,울산 현대모비스,Home,게이지 프림,10,5,14,35.7,0,0,0.0,5,14,35.7,0,0,0.0,3,9,12,1,1,0,0,0,1,3
../kbl_data/2022-2023,S41G01N70,전주 KCC,Away,정창영,16,3,6,50.0,1,2,50.0,4,8,50.0,7,7,100.0,0,2,2,2,0,0,0,0,2,2
../kbl_data/2022-2023,S41G01N70,전주 KCC,Away,라건아,20,10,14,71.4,0,2,0.0,10,16,62.5,0,0,0.0,2,11,13,1,0,1,0,1,1,2
../kbl_data/2022-2023,S41G01N70,전주 KCC,Away,박경상,3,1,1,100.0,0,0,0.0,1,1,100.0,1,2,50.0,0,1,1,0,0,0,0,0,0,0
../kbl_data/2022-2023,S41G01N70,전주 KCC,Away,김지완,0,0,1,0.0,0,1,0.0,0,2,0.0,0,0,0.0,0,3,3,1,0,0,0,0,1,2
../kbl_data/2022-2023,S41G01N70,전주 KCC,Away,허웅,10,2,6,33.3,2,7,28.6,4,13,30.8,0,0,0.0,0,1,1,2,1,0,0,0,2,0
../kbl_data/2022-2023,S41G01N70,전주 KCC,Away,이승현,6,3,8,37.5,0,0,0.0,3,8,37.5,0,0,0.0,1,7,8,1,0,1,0,0,1,1
../kbl_data/2022-2023,S41G01N70,전주 KCC,Away,곽정훈,0,0,0,0.0,0,1,0.0,0,1,0.0,0,0,0.0,1,0,1,0,1,0,0,0,0,3
../kbl_data/2022-2023,S41G01N70,전주 KCC,Away,이근휘,5,0,0,0.0,1,4,25.0,1,4,25.0,2,3,66.7,0,1,1,0,0,0,0,0,0,0
../kbl_data/2022-2023,S41G01N70,전주 KCC,Away,김동현,0,0,0,0.0,0,0,0.0,0,0,0.0,0,0,0.0,0,0,0,0,0,0,0,0,0,0
../kbl_data/2022-2023,S41G01N70,전주 KCC,Away,서정현,0,0,1,0.0,0,0,0.0,0,1,0.0,0,0,0.0,0,0,0,2,1,0,0,0,0,1
../kbl_data/2022-2023,S41G01N70,전주 KCC,Away,론데 홀리스 제퍼슨,4,1,6,16.7,0,3,0.0,1,9,11.1,2,4,50.0,0,3,3,1,1,0,0,0,0,3
../kbl_data/2022-2023,S41G01N70,전주 KCC,Away,송동훈,4,1,2,50.0,0,0,0.0,1,2,50.0,2,2,100.0,0,1,1,2,1,0,1,0,0,3
../kbl_data/2022-2023,S41G01N71,수원 KT,Home,김동욱,0,0,1,0.0,0,1,0.0,0,2,0.0,0,0,0.0,0,0,0,0,0,0,0,0,0,1
../kbl_data/2022-2023,S41G01N71,수원 KT,Home,김동량,0,0,0,0.0,0,0,0.0,0,0,0.0,0,0,0.0,0,0,0,0,0,0,0,0,0,0
../kbl_data/2022-2023,S41G01N71,수원 KT,Home,김종범,0,0,0,0.0,0,0,0.0,0,0,0.0,0,0,0.0,0,0,0,0,0,0,0,0,0,1
../kbl_data/2022-2023,S41G01N71,수원 KT,Home,한희원,12,3,5,60.0,2,6,33.3,5,11,45.5,0,0,0.0,0,0,0,1,2,1,1,0,2,3
../kbl_data/2022-2023,S41G01N71,수원 KT,Home,이현석,0,0,0,0.0,0,2,0.0,0,2,0.0,0,0,0.0,0,0,0,0,0,0,0,0,0,0
../kbl_data/2022-2023,S41G01N71,수원 KT,Home,정성우,11,1,5,20.0,2,5,40.0,3,10,30.0,3,4,75.0,0,1,1,5,1,0,0,0,2,1
../kbl_data/2022-2023,S41G01N71,수원 KT,Home,최성모,0,0,0,0.0,0,1,0.0,0,1,0.0,0,0,0.0,0,0,0,1,0,0,0,0,0,0
../kbl_data/2022-2023,S41G01N71,수원 KT,Home,양홍석,14,2,6,33.3,3,8,37.5,5,14,35.7,1,3,33.3,3,8,11,3,1,0,0,0,2,3
../kbl_data/2022-2023,S41G01N71,수원 KT,Home,박지원,0,0,0,0.0,0,0,0.0,0,0,0.0,0,0,0.0,0,0,0,0,0,0,0,0,0,0
../kbl_data/2022-2023,S41G01N71,수원 KT,Home,하윤기,12,4,10,40.0,0,0,0.0,4,10,40.0,4,4,100.0,0,3,3,0,0,0,0,0,2,2
../kbl_data/2022-2023,S41G01N71,수원 KT,Home,이제이 아노시케,18,0,3,0.0,3,7,42.9,3,10,30.0,9,11,81.8,4,5,9,0,0,0,0,0,0,3
../kbl_data/2022-2023,S41G01N71,수원 KT,Home,랜드리 은노코,4,2,2,100.0,0,0,0.0,2,2,100.0,0,0,0.0,1,3,4,0,0,0,0,1,2,1
../kbl_data/2022-2023,S41G01N71,창원 LG,Away,이관희,5,1,3,33.3,1,3,33.3,2,6,33.3,0,0,0.0,0,0,0,0,0,0,0,0,0,1
../kbl_data/2022-2023,S41G01N71,창원 LG,Away,정희재,2,0,0,0.0,0,0,0.0,0,0,0.0,2,2,100.0,1,0,1,1,0,0,0,0,1,3
../kbl_data/2022-2023,S41G01N71,창원 LG,Away,서민수,6,3,4,75.0,0,2,0.0,3,6,50.0,0,0,0.0,0,1,1,4,0,0,0,0,0,3
../kbl_data/2022-2023,S41G01N71,창원 LG,Away,한상혁,0,0,0,0.0,0,0,0.0,0,0,0.0,0,0,0.0,0,0,0,0,0,0,0,0,0,0
../kbl_data/2022-2023,S41G01N71,창원 LG,Away,이재도,8,4,9,44.4,0,3,0.0,4,12,33.3,0,0,0.0,0,7,7,9,2,0,0,0,1,1
../kbl_data/2022-2023,S41G01N71,창원 LG,Away,김준일,18,9,11,81.8,0,0,0.0,9,11,81.8,0,0,0.0,2,3,5,0,0,1,0,1,1,1
../kbl_data/2022-2023,S41G01N71,창원 LG,Away,정인덕,0,0,0,0.0,0,1,0.0,0,1,0.0,0,0,0.0,0,0,0,0,0,0,0,0,0,0
../kbl_data/2022-2023,S41G01N71,창원 LG,Away,윤원상,14,1,5,20.0,4,6,66.7,5,11,45.5,0,0,0.0,1,2,3,1,0,0,2,0,0,3
../kbl_data/2022-2023,S41G01N71,창원 LG,Away,아셈 마레이,21,10,14,71.4,0,0,0.0,10,14,71.4,1,5,20.0,7,3,10,0,2,2,0,1,2,2
../kbl_data/2022-2023,S41G01N71,창원 LG,Away,이승우,0,0,2,0.0,0,1,0.0,0,3,0.0,0,0,0.0,0,4,4,0,0,0,0,0,2,3
../kbl_data/2022-2023,S41G01N71,창원 LG,Away,저스틴 구탕,2,1,1,100.0,0,0,0.0,1,1,100.0,0,0,0.0,3,2,5,4,0,0,0,0,2,2
../kbl_data/2022-2023,S41G01N71,창원 LG,Away,단테 커닝햄,7,3,7,42.9,0,0,0.0,3,7,42.9,1,2,50.0,2,6,8,1,1,0,0,0,0,2
../kbl_data/2022-2023,S41G01N72,안양 KGC,Home,양희종,2,1,1,100.0,0,1,0.0,1,2,50.0,0,0,0.0,0,1,1,0,0,0,0,0,0,0
../kbl_data/2022-2023,S41G01N72,안양 KGC,Home,함준후,0,0,0,0.0,0,0,0.0,0,0,0.0,0,0,0.0,0,0,0,0,0,0,0,0,0,0
../kbl_data/2022-2023,S41G01N72,안양 KGC,Home,오세근,17,6,8,75.0,0,0,0.0,6,8,75.0,5,6,83.3,2,1,3,3,3,0,0,0,3,0
../kbl_data/2022-2023,S41G01N72,안양 KGC,Home,정준원,0,0,0,0.0,0,0,0.0,0,0,0.0,0,0,0.0,0,0,0,0,0,0,0,0,0,0
../kbl_data/2022-2023,S41G01N72,안양 KGC,Home,배병준,5,1,2,50.0,1,1,100.0,2,3,66.7,0,0,0.0,0,1,1,1,1,0,0,0,1,0
../kbl_data/2022-2023,S41G01N72,안양 KGC,Home,문성곤,2,1,1,100.0,0,1,0.0,1,2,50.0,0,0,0.0,2,2,4,4,1,0,0,0,2,3
../kbl_data/2022-2023,S41G01N72,안양 KGC,Home,박지훈,3,0,2,0.0,1,3,33.3,1,5,20.0,0,0,0.0,0,0,0,1,0,0,0,0,1,1
../kbl_data/2022-2023,S41G01N72,안양 KGC,Home,대릴 먼로,0,0,0,0.0,0,0,0.0,0,0,0.0,0,0,0.0,0,3,3,0,0,0,0,0,1,0
../kbl_data/2022-2023,S41G01N72,안양 KGC,Home,변준형,19,3,5,60.0,2,4,50.0,5,9,55.6,7,9,77.8,1,3,4,3,0,0,0,0,4,4
../kbl_data/2022-2023,S41G01N72,안양 KGC,Home,한승희,0,0,0,0.0,0,0,0.0,0,0,0.0,0,0,0.0,0,1,1,0,0,0,0,0,0,2
../kbl_data/2022-2023,S41G01N72,안양 KGC,Home,오마리 스펠맨,21,3,6,50.0,5,14,35.7,8,20,40.0,0,0,0.0,0,12,12,5,2,1,0,1,2,3
../kbl_data/2022-2023,S41G01N72,안양 KGC,Home,렌즈 아반도,21,6,8,75.0,3,4,75.0,9,12,75.0,0,1,0.0,2,3,5,5,0,0,0,1,1,3
../kbl_data/2022-2023,S41G01N72,서울 SK,Away,양우섭,0,0,0,0.0,0,1,0.0,0,1,0.0,0,0,0.0,0,0,0,0,0,0,0,0,0,2
../kbl_data/2022-2023,S41G01N72,서울 SK,Away,허일영,4,2,4,50.0,0,2,0.0,2,6,33.3,0,0,0.0,0,3,3,1,1,0,0,0,0,3
../kbl_data/2022-2023,S41G01N72,서울 SK,Away,김선형,22,7,12,58.3,1,5,20.0,8,17,47.1,5,5,100.0,3,1,4,10,2,0,0,0,3,3
../kbl_data/2022-2023,S41G01N72,서울 SK,Away,최부경,0,0,0,0.0,0,0,0.0,0,0,0.0,0,0,0.0,0,0,0,0,0,0,0,0,0,0
../kbl_data/2022-2023,S41G01N72,서울 SK,Away,리온 윌리엄스,3,0,0,0.0,0,0,0.0,0,0,0.0,3,4,75.0,0,2,2,0,0,0,0,0,0,2
../kbl_data/2022-2023,S41G01N72,서울 SK,Away,최원혁,0,0,0,0.0,0,0,0.0,0,0,0.0,0,0,0.0,0,0,0,0,0,0,0,0,0,0
../kbl_data/2022-2023,S41G01N72,서울 SK,Away,최준용,14,4,6,66.7,2,8,25.0,6,14,42.9,0,0,0.0,2,6,8,1,2,2,0,0,2,2
../kbl_data/2022-2023,S41G01N72,서울 SK,Away,장문호,0,0,0,0.0,0,0,0.0,0,0,0.0,0,0,0.0,0,0,0,0,0,0,0,0,0,0
../kbl_data/2022-2023,S41G01N72,서울 SK,Away,최성원,15,3,3,100.0,3,8,37.5,6,11,54.5,0,0,0.0,0,1,1,1,1,0,0,0,1,4
../kbl_data/2022-2023,S41G01N72,서울 SK,Away,자밀 워니,22,11,19,57.9,0,0,0.0,11,19,57.9,0,2,0.0,4,3,7,3,3,0,0,2,1,0
../kbl_data/2022-2023,S41G01N72,서울 SK,Away,김형빈,1,0,1,0.0,0,1,0.0,0,2,0.0,1,2,50.0,0,1,1,0,0,1,0,0,0,0
../kbl_data/2022-2023,S41G01N72,서울 SK,Away,오재현,3,0,1,0.0,1,3,33.3,1,4,25.0,0,0,0.0,2,0,2,1,2,0,0,0,1,5
../kbl_data/2022-2023,S41G01N73,울산 현대모비스,Home,함지훈,7,2,5,40.0,0,0,0.0,2,5,40.0,3,6,50.0,1,3,4,4,0,0,0,0,2,1
../kbl_data/2022-2023,S41G01N73,울산 현대모비스,Home,최진수,0,0,0,0.0,0,0,0.0,0,0,0.0,0,0,0.0,0,0,0,0,0,0,0,0,0,0
../kbl_data/2022-2023,S41G01N73,울산 현대모비스,Home,장재석,2,1,2,50.0,0,0,0.0,1,2,50.0,0,0,0.0,0,1,1,1,0,0,0,0,0,1
../kbl_data/2022-2023,S41G01N73,울산 현대모비스,Home,김영현,2,1,1,100.0,0,0,0.0,1,1,100.0,0,0,0.0,0,1,1,0,0,0,0,0,0,1
../kbl_data/2022-2023,S41G01N73,울산 현대모비스,Home,김국찬,0,0,0,0.0,0,0,0.0,0,0,0.0,0,0,0.0,0,0,0,0,0,0,0,0,0,0
../kbl_data/2022-2023,S41G01N73,울산 현대모비스,Home,서명진,10,5,5,100.0,0,5,0.0,5,10,50.0,0,0,0.0,0,1,1,9,0,0,0,0,2,2
../kbl_data/2022-2023,S41G01N73,울산 현대모비스,Home,헨리 심스,6,3,5,60.0,0,0,0.0,3,5,60.0,0,0,0.0,2,3,5,1,0,0,0,0,1,4
../kbl_data/2022-2023,S41G01N73,울산 현대모비스,Home,이우석,12,4,7,57.1,1,3,33.3,5,10,50.0,1,2,50.0,2,7,9,3,1,0,0,0,2,4
../kbl_data/2022-2023,S41G01N73,울산 현대모비스,Home,신민석,6,0,1,0.0,2,5,40.0,2,6,33.3,0,2,0.0,1,5,6,0,0,0,0,0,0,2
../kbl_data/2022-2023,S41G01N73,울산 현대모비스,Home,김동준,0,0,0,0.0,0,0,0.0,0,0,0.0,0,0,0.0,0,0,0,0,0,0,0,0,0,0
../kbl_data/2022-2023,S41G01N73,울산 현대모비스,Home,론제이 아바리엔토스,16,0,1,0.0,4,8,50.0,4,9,44.4,4,5,80.0,0,5,5,2,2,0,0,0,3,2
../kbl_data/2022-2023,S41G01N73,울산 현대모비스,Home,게이지 프림,17,5,12,41.7,0,0,0.0,5,12,41.7,7,12,58.3,3,2,5,4,0,1,0,0,3,5
../kbl_data/2022-2023,S41G01N73,창원 LG,Away,이관희,8,1,3,33.3,2,4,50.0,3,7,42.9,0,0,0.0,0,1,1,3,1,0,0,0,0,0
../kbl_data/2022-2023,S41G01N73,창원 LG,Away,정희재,0,0,1,0.0,0,0,0.0,0,1,0.0,0,0,0.0,0,0,0,0,0,0,0,0,0,1
../kbl_data/2022-2023,S41G01N73,창원 LG,Away,서민수,3,1,2,50.0,0,1,0.0,1,3,33.3,1,2,50.0,0,0,0,4,0,0,0,0,1,5
../kbl_data/2022-2023,S41G01N73,창원 LG,Away,한상혁,0,0,0,0.0,0,0,0.0,0,0,0.0,0,0,0.0,0,0,0,0,0,0,0,0,0,0
../kbl_data/2022-2023,S41G01N73,창원 LG,Away,이재도,22,5,7,71.4,3,7,42.9,8,14,57.1,3,4,75.0,0,1,1,2,0,0,0,0,2,1
../kbl_data/2022-2023,S41G01N73,창원 LG,Away,김준일,6,1,3,33.3,0,0,0.0,1,3,33.3,4,6,66.7,0,2,2,1,0,0,1,0,0,5
../kbl_data/2022-2023,S41G01N73,창원 LG,Away,정인덕,0,0,0,0.0,0,0,0.0,0,0,0.0,0,0,0.0,0,0,0,0,0,0,0,0,0,0
../kbl_data/2022-2023,S41G01N73,창원 LG,Away,윤원상,5,1,3,33.3,1,4,25.0,2,7,28.6,0,0,0.0,0,0,0,1,1,0,0,0,1,4
../kbl_data/2022-2023,S41G01N73,창원 LG,Away,아셈 마레이,8,3,8,37.5,0,0,0.0,3,8,37.5,2,3,66.7,1,12,13,1,2,0,0,1,0,4
../kbl_data/2022-2023,S41G01N73,창원 LG,Away,이승우,3,1,4,25.0,0,0,0.0,1,4,25.0,1,2,50.0,0,1,1,0,0,0,0,0,0,0
../kbl_data/2022-2023,S41G01N73,창원 LG,Away,저스틴 구탕,10,5,6,83.3,0,0,0.0,5,6,83.3,0,0,0.0,0,3,3,6,1,2,0,0,0,3
../kbl_data/2022-2023,S41G01N73,창원 LG,Away,단테 커닝햄,21,8,10,80.0,0,0,0.0,8,10,80.0,5,6,83.3,1,10,11,2,2,2,0,0,2,3
../kbl_data/2022-2023,S41G01N74,고양 캐롯,Home,김강선,0,0,0,0.0,0,3,0.0,0,3,0.0,0,0,0.0,0,1,1,0,1,0,0,0,2,0
../kbl_data/2022-2023,S41G01N74,고양 캐롯,Home,데이비드 사이먼,10,5,8,62.5,0,1,0.0,5,9,55.6,0,0,0.0,0,2,2,0,0,0,0,1,1,2
../kbl_data/2022-2023,S41G01N74,고양 캐롯,Home,최현민,3,1,4,25.0,0,6,0.0,1,10,10.0,1,2,50.0,3,1,4,2,1,0,0,0,1,3
../kbl_data/2022-2023,S41G01N74,고양 캐롯,Home,한호빈,0,0,0,0.0,0,3,0.0,0,3,0.0,0,0,0.0,0,1,1,3,0,0,0,0,0,0
../kbl_data/2022-2023,S41G01N74,고양 캐롯,Home,전성현,14,2,3,66.7,2,9,22.2,4,12,33.3,4,6,66.7,0,2,2,1,0,0,0,0,2,0
../kbl_data/2022-2023,S41G01N74,고양 캐롯,Home,김진유,3,0,0,0.0,1,5,20.0,1,5,20.0,0,0,0.0,1,2,3,2,1,0,0,0,0,3
../kbl_data/2022-2023,S41G01N74,고양 캐롯,Home,정해원,0,0,0,0.0,0,0,0.0,0,0,0.0,0,0,0.0,1,0,1,0,0,0,0,0,1,0
../kbl_data/2022-2023,S41G01N74,고양 캐롯,Home,조한진,5,1,2,50.0,1,7,14.3,2,9,22.2,0,0,0.0,2,5,7,1,1,1,0,0,1,3
../kbl_data/2022-2023,S41G01N74,고양 캐롯,Home,김세창,0,0,0,0.0,0,0,0.0,0,0,0.0,0,0,0.0,0,0,0,0,0,0,0,0,0,0
../kbl_data/2022-2023,S41G01N74,고양 캐롯,Home,디드릭 로슨,20,7,11,63.6,2,3,66.7,9,14,64.3,0,0,0.0,6,8,14,0,2,2,0,0,4,2
../kbl_data/2022-2023,S41G01N74,고양 캐롯,Home,이정현,13,1,2,50.0,3,4,75.0,4,6,66.7,2,2,100.0,1,1,2,3,1,0,0,0,1,3
../kbl_data/2022-2023,S41G01N74,고양 캐롯,Home,조재우,0,0,0,0.0,0,0,0.0,0,0,0.0,0,0,0.0,0,0,0,0,0,0,0,0,1,0
../kbl_data/2022-2023,S41G01N74,서울 SK,Away,양우섭,0,0,1,0.0,0,3,0.0,0,4,0.0,0,0,0.0,1,2,3,1,0,0,0,0,1,1
../kbl_data/2022-2023,S41G01N74,서울 SK,Away,허일영,15,3,3,100.0,2,5,40.0,5,8,62.5,3,5,60.0,2,2,4,0,0,0,0,0,0,4
../kbl_data/2022-2023,S41G01N74,서울 SK,Away,김선형,11,3,5,60.0,1,3,33.3,4,8,50.0,2,4,50.0,1,1,2,7,0,0,0,0,2,1
../kbl_data/2022-2023,S41G01N74,서울 SK,Away,최부경,2,1,1,100.0,0,0,0.0,1,1,100.0,0,0,0.0,0,0,0,1,0,0,0,0,0,1
../kbl_data/2022-2023,S41G01N74,서울 SK,Away,리온 윌리엄스,12,3,6,50.0,1,2,50.0,4,8,50.0,3,4,75.0,3,4,7,2,0,0,0,1,0,0
../kbl_data/2022-2023,S41G01N74,서울 SK,Away,최원혁,2,1,1,100.0,0,1,0.0,1,2,50.0,0,0,0.0,0,0,0,0,0,0,0,0,0,1
../kbl_data/2022-2023,S41G01N74,서울 SK,Away,최준용,8,3,7,42.9,0,1,0.0,3,8,37.5,2,4,50.0,2,5,7,3,2,1,0,0,0,1
../kbl_data/2022-2023,S41G01N74,서울 SK,Away,장문호,0,0,0,0.0,0,0,0.0,0,0,0.0,0,0,0.0,0,0,0,0,1,0,0,0,2,0
../kbl_data/2022-2023,S41G01N74,서울 SK,Away,최성원,14,3,5,60.0,2,4,50.0,5,9,55.6,2,2,100.0,1,6,7,8,3,0,0,0,1,3
../kbl_data/2022-2023,S41G01N74,서울 SK,Away,자밀 워니,19,8,10,80.0,1,1,100.0,9,11,81.8,0,0,0.0,1,3,4,1,2,2,0,1,1,1
../kbl_data/2022-2023,S41G01N74,서울 SK,Away,김형빈,2,1,3,33.3,0,0,0.0,1,3,33.3,0,0,0.0,0,2,2,0,0,1,0,0,0,1
../kbl_data/2022-2023,S41G01N74,서울 SK,Away,오재현,8,4,8,50.0,0,3,0.0,4,11,36.4,0,0,0.0,2,2,4,2,3,0,0,0,2,3
../kbl_data/2022-2023,S41G01N75,서울 삼성,Home,이정현,26,3,3,100.0,5,6,83.3,8,9,88.9,5,5,100.0,0,2,2,5,1,1,0,0,4,3
../kbl_data/2022-2023,S41G01N75,서울 삼성,Home,장민국,6,3,4,75.0,0,2,0.0,3,6,50.0,0,0,0.0,3,2,5,0,1,0,0,0,2,4
../kbl_data/2022-2023,S41G01N75,서울 삼성,Home,김시래,10,3,5,60.0,1,1,100.0,4,6,66.7,1,1,100.0,0,1,1,3,2,1,1,0,2,2
../kbl_data/2022-2023,S41G01N75,서울 삼성,Home,김현수,2,1,2,50.0,0,0,0.0,1,2,50.0,0,0,0.0,0,1,1,0,0,0,0,0,0,1
../kbl_data/2022-2023,S41G01N75,서울 삼성,Home,임동섭,0,0,0,0.0,0,0,0.0,0,0,0.0,0,0,0.0,0,0,0,0,0,0,0,0,0,0
../kbl_data/2022-2023,S41G01N75,서울 삼성,Home,김광철,2,1,4,25.0,0,2,0.0,1,6,16.7,0,0,0.0,0,2,2,0,1,0,0,0,3,4
../kbl_data/2022-2023,S41G01N75,서울 삼성,Home,마커스 데릭슨,16,5,13,38.5,0,4,0.0,5,17,29.4,6,9,66.7,3,8,11,0,2,0,0,0,3,1
../kbl_data/2022-2023,S41G01N75,서울 삼성,Home,전형준,0,0,0,0.0,0,0,0.0,0,0,0.0,0,0,0.0,0,0,0,0,0,0,0,0,0,0
../kbl_data/2022-2023,S41G01N75,서울 삼성,Home,조우성,0,0,0,0.0,0,0,0.0,0,0,0.0,0,0,0.0,1,0,1,1,0,0,0,0,0,3
../kbl_data/2022-2023,S41G01N75,서울 삼성,Home,이원석,7,3,8,37.5,0,0,0.0,3,8,37.5,1,5,20.0,2,8,10,3,1,0,0,0,2,4
../kbl_data/2022-2023,S41G01N75,서울 삼성,Home,이매뉴얼 테리,6,3,5,60.0,0,0,0.0,3,5,60.0,0,0,0.0,0,1,1,0,1,0,0,2,0,2
../kbl_data/2022-2023,S41G01N75,서울 삼성,Home,신동혁,0,0,1,0.0,0,1,0.0,0,2,0.0,0,0,0.0,2,1,3,2,0,1,1,0,0,1
../kbl_data/2022-2023,S41G01N75,창원 LG,Away,이관희,2,0,3,0.0,0,1,0.0,0,4,0.0,2,3,66.7,0,0,0,0,0,0,0,0,0,0
../kbl_data/2022-2023,S41G01N75,창원 LG,Away,정희재,0,0,1,0.0,0,0,0.0,0,1,0.0,0,0,0.0,0,0,0,0,0,1,0,0,0,2
../kbl_data/2022-2023,S41G01N75,창원 LG,Away,서민수,8,2,3,66.7,1,6,16.7,3,9,33.3,1,1,100.0,0,0,0,3,0,0,1,0,1,4
../kbl_data/2022-2023,S41G01N75,창원 LG,Away,한상혁,0,0,0,0.0,0,0,0.0,0,0,0.0,0,0,0.0,0,0,0,0,0,0,0,0,0,0
../kbl_data/2022-2023,S41G01N75,창원 LG,Away,이재도,16,4,6,66.7,2,6,33.3,6,12,50.0,2,2,100.0,0,3,3,4,3,0,0,0,4,3
../kbl_data/2022-2023,S41G01N75,창원 LG,Away,김준일,10,3,5,60.0,0,0,0.0,3,5,60.0,4,4,100.0,1,0,1,0,1,0,0,0,3,2
../kbl_data/2022-2023,S41G01N75,창원 LG,Away,정인덕,0,0,0,0.0,0,0,0.0,0,0,0.0,0,0,0.0,0,0,0,0,0,0,0,0,0,0
../kbl_data/2022-2023,S41G01N75,창원 LG,Away,윤원상,7,1,4,25.0,1,2,50.0,2,6,33.3,2,3,66.7,1,2,3,0,1,0,0,0,0,4
../kbl_data/2022-2023,S41G01N75,창원 LG,Away,아셈 마레이,15,5,7,71.4,0,0,0.0,5,7,71.4,5,6,83.3,2,12,14,1,4,0,0,0,3,2
../kbl_data/2022-2023,S41G01N75,창원 LG,Away,이승우,0,0,3,0.0,0,1,0.0,0,4,0.0,0,0,0.0,3,2,5,1,1,0,0,0,1,4
../kbl_data/2022-2023,S41G01N75,창원 LG,Away,저스틴 구탕,6,3,4,75.0,0,1,0.0,3,5,60.0,0,0,0.0,0,1,1,2,0,0,0,0,1,1
../kbl_data/2022-2023,S41G01N75,창원 LG,Away,단테 커닝햄,6,1,4,25.0,0,0,0.0,1,4,25.0,4,4,100.0,0,2,2,0,1,0,0,0,0,2
../kbl_data/2022-2023,S41G01N76,대구 한국가스공사,Home,차바위,3,0,0,0.0,1,2,50.0,1,2,50.0,0,0,0.0,0,1,1,1,1,0,0,0,1,3
../kbl_data/2022-2023,S41G01N76,대구 한국가스공사,Home,박지훈,0,0,0,0.0,0,0,0.0,0,0,0.0,0,0,0.0,0,0,0,2,0,0,0,0,0,1
../kbl_data/2022-2023,S41G01N76,대구 한국가스공사,Home,조상열,6,0,0,0.0,2,5,40.0,2,5,40.0,0,0,0.0,1,0,1,3,0,0,0,0,0,5
../kbl_data/2022-2023,S41G01N76,대구 한국가스공사,Home,이원대,0,0,0,0.0,0,0,0.0,0,0,0.0,0,0,0.0,0,0,0,0,0,0,0,0,0,0
../kbl_data/2022-2023,S41G01N76,대구 한국가스공사,Home,이대헌,6,2,2,100.0,0,0,0.0,2,2,100.0,2,2,100.0,0,0,0,2,1,0,0,0,0,0
../kbl_data/2022-2023,S41G01N76,대구 한국가스공사,Home,이대성,10,4,7,57.1,0,1,0.0,4,8,50.0,2,2,100.0,0,2,2,5,1,1,0,0,3,1
../kbl_data/2022-2023,S41G01N76,대구 한국가스공사,Home,정효근,0,0,0,0.0,0,0,0.0,0,0,0.0,0,0,0.0,0,0,0,0,0,0,0,0,0,0
../kbl_data/2022-2023,S41G01N76,대구 한국가스공사,Home,머피 할로웨이,8,4,11,36.4,0,0,0.0,4,11,36.4,0,0,0.0,9,12,21,9,3,6,0,0,8,1
../kbl_data/2022-2023,S41G01N76,대구 한국가스공사,Home,전현우,24,3,3,100.0,6,9,66.7,9,12,75.0,0,0,0.0,0,3,3,1,0,0,0,0,2,4
../kbl_data/2022-2023,S41G01N76,대구 한국가스공사,Home,신승민,21,3,8,37.5,5,7,71.4,8,15,53.3,0,0,0.0,0,6,6,4,0,0,0,0,1,3
../kbl_data/2022-2023,S41G01N76,대구 한국가스공사,Home,샘조세프 벨란겔,9,3,4,75.0,1,5,20.0,4,9,44.4,0,0,0.0,0,0,0,2,3,0,0,0,0,4
../kbl_data/2022-2023,S41G01N76,대구 한국가스공사,Home,유슈 은도예,5,1,1,100.0,0,0,0.0,1,1,100.0,3,4,75.0,0,4,4,0,0,0,0,0,0,0
../kbl_data/2022-2023,S41G01N76,전주 KCC,Away,정창영,6,2,4,50.0,0,2,0.0,2,6,33.3,2,2,100.0,1,1,2,1,1,0,1,0,0,3
../kbl_data/2022-2023,S41G01N76,전주 KCC,Away,라건아,7,3,5,60.0,0,0,0.0,3,5,60.0,1,2,50.0,2,5,7,0,0,2,0,0,2,1
../kbl_data/2022-2023,S41G01N76,전주 KCC,Away,박경상,4,1,1,100.0,0,0,0.0,1,1,100.0,2,2,100.0,0,1,1,1,0,0,0,0,2,1
../kbl_data/2022-2023,S41G01N76,전주 KCC,Away,김지완,13,2,6,33.3,3,7,42.9,5,13,38.5,0,0,0.0,0,1,1,5,1,0,0,0,3,2
../kbl_data/2022-2023,S41G01N76,전주 KCC,Away,허웅,4,0,3,0.0,0,3,0.0,0,6,0.0,4,4,100.0,1,1,2,4,1,0,0,0,3,1
../kbl_data/2022-2023,S41G01N76,전주 KCC,Away,이승현,12,5,9,55.6,0,2,0.0,5,11,45.5,2,2,100.0,2,4,6,6,1,0,0,0,0,0
../kbl_data/2022-2023,S41G01N76,전주 KCC,Away,곽정훈,0,0,0,0.0,0,0,0.0,0,0,0.0,0,0,0.0,0,0,0,0,0,0,0,0,0,0
../kbl_data/2022-2023,S41G01N76,전주 KCC,Away,이근휘,4,0,1,0.0,1,4,25.0,1,5,20.0,1,2,50.0,1,0,1,1,2,0,0,0,0,0
../kbl_data/2022-2023,S41G01N76,전주 KCC,Away,김동현,0,0,0,0.0,0,0,0.0,0,0,0.0,0,0,0.0,0,0,0,0,0,0,0,0,0,1
../kbl_data/2022-2023,S41G01N76,전주 KCC,Away,서정현,1,0,0,0.0,0,0,0.0,0,0,0.0,1,2,50.0,0,1,1,0,0,0,0,0,1,0
../kbl_data/2022-2023,S41G01N76,전주 KCC,Away,론데 홀리스 제퍼슨,20,8,16,50.0,0,1,0.0,8,17,47.1,4,5,80.0,1,6,7,1,0,0,0,2,0,4
../kbl_data/2022-2023,S41G01N76,전주 KCC,Away,송동훈,0,0,0,0.0,0,0,0.0,0,0,0.0,0,0,0.0,0,0,0,0,0,0,0,0,0,1
../kbl_data/2022-2023,S41G01N77,수원 KT,Home,김동욱,0,0,0,0.0,0,0,0.0,0,0,0.0,0,0,0.0,0,0,0,0,0,0,0,0,0,0
../kbl_data/2022-2023,S41G01N77,수원 KT,Home,김영환,7,0,1,0.0,1,1,100.0,1,2,50.0,4,4,100.0,1,1,2,0,1,0,0,0,0,0
../kbl_data/2022-2023,S41G01N77,수원 KT,Home,김민욱,0,0,0,0.0,0,1,0.0,0,1,0.0,0,0,0.0,0,2,2,0,0,0,0,0,0,0
../kbl_data/2022-2023,S41G01N77,수원 KT,Home,한희원,3,0,2,0.0,1,3,33.3,1,5,20.0,0,0,0.0,1,0,1,1,0,0,1,0,0,0
../kbl_data/2022-2023,S41G01N77,수원 KT,Home,이현석,0,0,0,0.0,0,1,0.0,0,1,0.0,0,0,0.0,1,4,5,0,1,0,0,0,0,3
../kbl_data/2022-2023,S41G01N77,수원 KT,Home,정성우,15,1,3,33.3,4,7,57.1,5,10,50.0,1,1,100.0,0,1,1,4,0,0,0,0,2,3
../kbl_data/2022-2023,S41G01N77,수원 KT,Home,최성모,9,1,1,100.0,1,4,25.0,2,5,40.0,4,5,80.0,1,2,3,1,0,0,0,0,0,4
../kbl_data/2022-2023,S41G01N77,수원 KT,Home,양홍석,15,3,5,60.0,3,10,30.0,6,15,40.0,0,0,0.0,1,3,4,3,0,0,0,0,1,2
../kbl_data/2022-2023,S41G01N77,수원 KT,Home,박지원,0,0,0,0.0,0,0,0.0,0,0,0.0,0,0,0.0,0,1,1,1,0,0,0,0,0,0
../kbl_data/2022-2023,S41G01N77,수원 KT,Home,하윤기,12,5,11,45.5,0,0,0.0,5,11,45.5,2,4,50.0,4,4,8,1,0,3,0,0,2,2
../kbl_data/2022-2023,S41G01N77,수원 KT,Home,이제이 아노시케,21,6,9,66.7,2,11,18.2,8,20,40.0,3,6,50.0,4,6,10,2,0,1,0,0,2,4
../kbl_data/2022-2023,S41G01N77,수원 KT,Home,랜드리 은노코,0,0,0,0.0,0,0,0.0,0,0,0.0,0,0,0.0,0,1,1,0,0,0,0,0,1,1
../kbl_data/2022-2023,S41G01N77,안양 KGC,Away,양희종,12,2,2,100.0,2,3,66.7,4,5,80.0,2,2,100.0,0,4,4,2,2,0,0,0,0,1
../kbl_data/2022-2023,S41G01N77,안양 KGC,Away,함준후,0,0,0,0.0,0,0,0.0,0,0,0.0,0,0,0.0,0,0,0,0,0,0,0,0,0,0
../kbl_data/2022-2023,S41G01N77,안양 KGC,Away,오세근,10,1,4,25.0,2,2,100.0,3,6,50.0,2,2,100.0,0,2,2,1,0,0,0,0,0,4
../kbl_data/2022-2023,S41G01N77,안양 KGC,Away,정준원,0,0,0,0.0,0,1,0.0,0,1,0.0,0,0,0.0,0,1,1,0,0,0,0,0,0,0
../kbl_data/2022-2023,S41G01N77,안양 KGC,Away,배병준,2,1,2,50.0,0,0,0.0,1,2,50.0,0,0,0.0,0,0,0,1,0,0,0,0,0,1
../kbl_data/2022-2023,S41G01N77,안양 KGC,Away,문성곤,9,1,4,25.0,2,2,100.0,3,6,50.0,1,1,100.0,3,3,6,1,1,0,0,0,1,5
../kbl_data/2022-2023,S41G01N77,안양 KGC,Away,박지훈,4,2,6,33.3,0,0,0.0,2,6,33.3,0,0,0.0,0,1,1,3,1,0,0,0,0,1
../kbl_data/2022-2023,S41G01N77,안양 KGC,Away,대릴 먼로,7,3,4,75.0,0,0,0.0,3,4,75.0,1,1,100.0,2,2,4,0,0,0,0,0,1,1
../kbl_data/2022-2023,S41G01N77,안양 KGC,Away,변준형,16,4,6,66.7,1,3,33.3,5,9,55.6,5,7,71.4,0,2,2,6,0,0,0,0,0,2
../kbl_data/2022-2023,S41G01N77,안양 KGC,Away,한승희,0,0,2,0.0,0,1,0.0,0,3,0.0,0,0,0.0,1,2,3,0,0,0,0,0,0,1
../kbl_data/2022-2023,S41G01N77,안양 KGC,Away,오마리 스펠맨,23,9,15,60.0,1,8,12.5,10,23,43.5,2,5,40.0,2,8,10,2,0,0,0,2,1,1
../kbl_data/2022-2023,S41G01N77,안양 KGC,Away,렌즈 아반도,9,3,4,75.0,1,3,33.3,4,7,57.1,0,1,0.0,1,1,2,2,1,1,0,0,0,3
../kbl_data/2022-2023,S41G01N78,원주 DB,Home,박찬희,0,0,3,0.0,0,2,0.0,0,5,0.0,0,0,0.0,0,1,1,1,0,0,0,0,0,0
../kbl_data/2022-2023,S41G01N78,원주 DB,Home,김현호,3,0,2,0.0,1,1,100.0,1,3,33.3,0,0,0.0,1,0,1,1,0,0,0,0,1,3
../kbl_data/2022-2023,S41G01N78,원주 DB,Home,김종규,6,3,5,60.0,0,0,0.0,3,5,60.0,0,0,0.0,0,5,5,0,0,0,0,1,0,1
../kbl_data/2022-2023,S41G01N78,원주 DB,Home,최승욱,5,1,1,100.0,1,1,100.0,2,2,100.0,0,0,0.0,1,3,4,0,1,1,0,0,1,3
../kbl_data/2022-2023,S41G01N78,원주 DB,Home,강상재,7,2,5,40.0,1,5,20.0,3,10,30.0,0,0,0.0,0,3,3,0,0,0,0,0,0,0
../kbl_data/2022-2023,S41G01N78,원주 DB,Home,윤성원,0,0,0,0.0,0,0,0.0,0,0,0.0,0,0,0.0,0,0,0,0,0,0,0,0,0,0
../kbl_data/2022-2023,S41G01N78,원주 DB,Home,이준희,0,0,0,0.0,0,0,0.0,0,0,0.0,0,0,0.0,0,0,0,0,0,0,0,0,0,0
../kbl_data/2022-2023,S41G01N78,원주 DB,Home,레나드 프리먼,9,3,6,50.0,0,0,0.0,3,6,50.0,3,4,75.0,2,4,6,0,0,0,0,0,0,1
../kbl_data/2022-2023,S41G01N78,원주 DB,Home,정호영,2,1,2,50.0,0,1,0.0,1,3,33.3,0,0,0.0,0,0,0,0,0,0,0,0,2,1
../kbl_data/2022-2023,S41G01N78,원주 DB,Home,이선 알바노,14,7,12,58.3,0,3,0.0,7,15,46.7,0,0,0.0,1,7,8,8,2,1,0,0,3,4
../kbl_data/2022-2023,S41G01N78,원주 DB,Home,드완 에르난데스,19,7,12,58.3,1,3,33.3,8,15,53.3,2,4,50.0,2,3,5,1,0,0,0,1,4,2
../kbl_data/2022-2023,S41G01N78,원주 DB,Home,박인웅,0,0,1,0.0,0,0,0.0,0,1,0.0,0,0,0.0,1,0,1,0,0,0,1,0,0,0
../kbl_data/2022-2023,S41G01N78,서울 삼성,Away,이정현,4,1,4,25.0,0,7,0.0,1,11,9.1,2,2,100.0,0,2,2,10,2,0,0,0,4,2
../kbl_data/2022-2023,S41G01N78,서울 삼성,Away,장민국,0,0,0,0.0,0,1,0.0,0,1,0.0,0,0,0.0,0,0,0,1,0,0,0,0,0,1
../kbl_data/2022-2023,S41G01N78,서울 삼성,Away,김시래,8,1,2,50.0,2,6,33.3,3,8,37.5,0,0,0.0,2,1,3,1,0,0,0,0,0,1
../kbl_data/2022-2023,S41G01N78,서울 삼성,Away,김현수,0,0,0,0.0,0,1,0.0,0,1,0.0,0,0,0.0,0,0,0,0,0,0,0,0,0,0
../kbl_data/2022-2023,S41G01N78,서울 삼성,Away,임동섭,0,0,2,0.0,0,1,0.0,0,3,0.0,0,0,0.0,0,1,1,0,0,0,0,0,2,2
../kbl_data/2022-2023,S41G01N78,서울 삼성,Away,김광철,0,0,2,0.0,0,0,0.0,0,2,0.0,0,0,0.0,0,0,0,3,2,0,0,0,0,2
../kbl_data/2022-2023,S41G01N78,서울 삼성,Away,마커스 데릭슨,9,3,5,60.0,1,3,33.3,4,8,50.0,0,0,0.0,1,4,5,0,0,0,0,0,0,0
../kbl_data/2022-2023,S41G01N78,서울 삼성,Away,전형준,0,0,0,0.0,0,0,0.0,0,0,0.0,0,0,0.0,0,0,0,0,0,0,0,0,0,0
../kbl_data/2022-2023,S41G01N78,서울 삼성,Away,조우성,0,0,1,0.0,0,0,0.0,0,1,0.0,0,0,0.0,1,0,1,0,0,0,0,0,0,3
../kbl_data/2022-2023,S41G01N78,서울 삼성,Away,이원석,18,8,15,53.3,0,2,0.0,8,17,47.1,2,2,100.0,1,4,5,1,2,3,2,0,1,2
../kbl_data/2022-2023,S41G01N78,서울 삼성,Away,이매뉴얼 테리,16,7,10,70.0,0,0,0.0,7,10,70.0,2,3,66.7,1,15,16,1,0,2,0,2,1,4
../kbl_data/2022-2023,S41G01N78,서울 삼성,Away,신동혁,7,2,3,66.7,1,1,100.0,3,4,75.0,0,0,0.0,0,1,1,1,0,0,0,0,1,2
../kbl_data/2022-2023,S41G01N79,울산 현대모비스,Home,함지훈,10,5,6,83.3,0,0,0.0,5,6,83.3,0,0,0.0,1,4,5,2,0,0,0,0,3,0
../kbl_data/2022-2023,S41G01N79,울산 현대모비스,Home,최진수,0,0,0,0.0,0,0,0.0,0,0,0.0,0,0,0.0,0,0,0,0,0,0,0,0,0,0
../kbl_data/2022-2023,S41G01N79,울산 현대모비스,Home,장재석,3,1,4,25.0,0,0,0.0,1,4,25.0,1,2,50.0,1,0,1,0,1,0,0,0,0,1
../kbl_data/2022-2023,S41G01N79,울산 현대모비스,Home,김영현,2,1,4,25.0,0,3,0.0,1,7,14.3,0,0,0.0,2,1,3,1,1,0,0,0,0,3
../kbl_data/2022-2023,S41G01N79,울산 현대모비스,Home,김국찬,4,2,2,100.0,0,1,0.0,2,3,66.7,0,0,0.0,0,1,1,0,0,0,0,0,0,2
../kbl_data/2022-2023,S41G01N79,울산 현대모비스,Home,서명진,3,0,3,0.0,1,1,100.0,1,4,25.0,0,0,0.0,0,1,1,2,0,1,0,0,3,1
../kbl_data/2022-2023,S41G01N79,울산 현대모비스,Home,헨리 심스,4,1,3,33.3,0,0,0.0,1,3,33.3,2,2,100.0,0,3,3,1,0,0,0,0,0,2
../kbl_data/2022-2023,S41G01N79,울산 현대모비스,Home,이우석,11,4,8,50.0,1,2,50.0,5,10,50.0,0,0,0.0,0,0,0,1,1,0,0,0,2,1
../kbl_data/2022-2023,S41G01N79,울산 현대모비스,Home,신민석,2,1,3,33.3,0,1,0.0,1,4,25.0,0,0,0.0,3,2,5,1,0,0,0,0,0,2
../kbl_data/2022-2023,S41G01N79,울산 현대모비스,Home,김동준,2,1,2,50.0,0,0,0.0,1,2,50.0,0,0,0.0,0,1,1,1,0,0,0,0,0,1
../kbl_data/2022-2023,S41G01N79,울산 현대모비스,Home,론제이 아바리엔토스,14,4,7,57.1,1,3,33.3,5,10,50.0,3,3,100.0,0,5,5,1,0,0,0,0,5,1
../kbl_data/2022-2023,S41G01N79,울산 현대모비스,Home,게이지 프림,19,9,16,56.2,0,0,0.0,9,16,56.2,1,2,50.0,6,10,16,4,0,1,0,0,1,2
../kbl_data/2022-2023,S41G01N79,고양 캐롯,Away,김강선,0,0,0,0.0,0,0,0.0,0,0,0.0,0,0,0.0,0,0,0,0,0,0,0,0,0,0
../kbl_data/2022-2023,S41G01N79,고양 캐롯,Away,데이비드 사이먼,15,6,10,60.0,1,1,100.0,7,11,63.6,0,0,0.0,1,8,9,0,1,2,0,2,0,1
../kbl_data/2022-2023,S41G01N79,고양 캐롯,Away,최현민,5,0,0,0.0,1,6,16.7,1,6,16.7,2,4,50.0,2,0,2,0,1,0,0,0,1,4
../kbl_data/2022-2023,S41G01N79,고양 캐롯,Away,한호빈,2,1,1,100.0,0,3,0.0,1,4,25.0,0,0,0.0,0,0,0,6,0,0,0,0,0,4
../kbl_data/2022-2023,S41G01N79,고양 캐롯,Away,전성현,12,1,8,12.5,3,8,37.5,4,16,25.0,1,1,100.0,0,1,1,2,0,0,0,0,2,1
../kbl_data/2022-2023,S41G01N79,고양 캐롯,Away,이종현,2,1,1,100.0,0,0,0.0,1,1,100.0,0,0,0.0,0,2,2,0,0,1,0,0,1,0
../kbl_data/2022-2023,S41G01N79,고양 캐롯,Away,김진유,2,1,1,100.0,0,0,0.0,1,1,100.0,0,0,0.0,2,1,3,1,0,0,0,0,0,0
../kbl_data/2022-2023,S41G01N79,고양 캐롯,Away,조한진,7,1,1,100.0,1,2,50.0,2,3,66.7,2,3,66.7,2,2,4,1,2,1,0,0,1,2
../kbl_data/2022-2023,S41G01N79,고양 캐롯,Away,디드릭 로슨,11,5,7,71.4,0,2,0.0,5,9,55.6,1,1,100.0,0,4,4,1,2,2,0,0,0,2
../kbl_data/2022-2023,S41G01N79,고양 캐롯,Away,박진철,0,0,0,0.0,0,0,0.0,0,0,0.0,0,0,0.0,0,0,0,0,0,0,0,0,0,0
../kbl_data/2022-2023,S41G01N79,고양 캐롯,Away,이정현,19,5,8,62.5,1,6,16.7,6,14,42.9,6,9,66.7,0,2,2,7,3,0,0,0,1,0
../kbl_data/2022-2023,S41G01N79,고양 캐롯,Away,모리구치 히사시,0,0,0,0.0,0,0,0.0,0,0,0.0,0,0,0.0,0,0,0,0,0,0,0,0,0,0
../kbl_data/2022-2023,S41G01N80,창원 LG,Home,이관희,17,1,4,25.0,5,11,45.5,6,15,40.0,0,0,0.0,0,3,3,5,1,0,0,0,1,4
../kbl_data/2022-2023,S41G01N80,창원 LG,Home,정희재,0,0,3,0.0,0,1,0.0,0,4,0.0,0,0,0.0,0,0,0,0,0,0,0,0,0,1
../kbl_data/2022-2023,S41G01N80,창원 LG,Home,서민수,5,1,1,100.0,1,1,100.0,2,2,100.0,0,0,0.0,0,1,1,0,0,0,0,0,0,0
../kbl_data/2022-2023,S41G01N80,창원 LG,Home,한상혁,0,0,0,0.0,0,0,0.0,0,0,0.0,0,0,0.0,0,0,0,0,0,0,0,0,0,0
../kbl_data/2022-2023,S41G01N80,창원 LG,Home,이재도,13,4,8,50.0,0,3,0.0,4,11,36.4,5,6,83.3,2,2,4,4,1,0,0,0,3,1
../kbl_data/2022-2023,S41G01N80,창원 LG,Home,김준일,14,6,8,75.0,0,0,0.0,6,8,75.0,2,4,50.0,2,5,7,3,0,0,0,0,0,3
../kbl_data/2022-2023,S41G01N80,창원 LG,Home,정인덕,0,0,0,0.0,0,0,0.0,0,0,0.0,0,0,0.0,0,0,0,0,0,0,0,0,0,0
../kbl_data/2022-2023,S41G01N80,창원 LG,Home,윤원상,0,0,1,0.0,0,2,0.0,0,3,0.0,0,0,0.0,0,0,0,1,0,0,0,0,1,1
../kbl_data/2022-2023,S41G01N80,창원 LG,Home,아셈 마레이,21,9,15,60.0,0,0,0.0,9,15,60.0,3,4,75.0,9,6,15,3,0,0,0,3,1,2
../kbl_data/2022-2023,S41G01N80,창원 LG,Home,이승우,2,1,3,33.3,0,1,0.0,1,4,25.0,0,0,0.0,1,0,1,0,0,0,0,0,0,3
../kbl_data/2022-2023,S41G01N80,창원 LG,Home,저스틴 구탕,9,3,3,100.0,1,2,50.0,4,5,80.0,0,0,0.0,0,1,1,7,1,0,0,0,0,1
../kbl_data/2022-2023,S41G01N80,창원 LG,Home,단테 커닝햄,17,6,7,85.7,1,2,50.0,7,9,77.8,2,2,100.0,2,6,8,0,0,1,0,2,1,3
../kbl_data/2022-2023,S41G01N80,서울 SK,Away,양우섭,0,0,0,0.0,0,0,0.0,0,0,0.0,0,0,0.0,0,1,1,0,0,0,0,0,1,0
../kbl_data/2022-2023,S41G01N80,서울 SK,Away,허일영,16,0,3,0.0,5,5,100.0,5,8,62.5,1,1,100.0,1,1,2,1,0,0,0,0,0,2
../kbl_data/2022-2023,S41G01N80,서울 SK,Away,김선형,23,9,12,75.0,0,1,0.0,9,13,69.2,5,8,62.5,0,2,2,12,2,0,0,0,2,1
../kbl_data/2022-2023,S41G01N80,서울 SK,Away,홍경기,0,0,0,0.0,0,0,0.0,0,0,0.0,0,0,0.0,0,0,0,0,0,0,1,0,0,1
../kbl_data/2022-2023,S41G01N80,서울 SK,Away,최부경,0,0,0,0.0,0,0,0.0,0,0,0.0,0,0,0.0,0,0,0,0,0,0,0,0,0,1
../kbl_data/2022-2023,S41G01N80,서울 SK,Away,리온 윌리엄스,5,2,4,50.0,0,1,0.0,2,5,40.0,1,2,50.0,2,0,2,0,0,0,0,0,0,0
../kbl_data/2022-2023,S41G01N80,서울 SK,Away,최원혁,0,0,0,0.0,0,0,0.0,0,0,0.0,0,0,0.0,0,0,0,0,0,0,0,0,0,0
../kbl_data/2022-2023,S41G01N80,서울 SK,Away,최준용,19,5,9,55.6,2,5,40.0,7,14,50.0,3,4,75.0,0,4,4,5,0,0,0,0,1,4
../kbl_data/2022-2023,S41G01N80,서울 SK,Away,최성원,14,1,1,100.0,4,5,80.0,5,6,83.3,0,0,0.0,0,1,1,1,0,0,0,0,0,4
../kbl_data/2022-2023,S41G01N80,서울 SK,Away,자밀 워니,23,10,13,76.9,0,2,0.0,10,15,66.7,3,4,75.0,1,10,11,3,1,0,0,0,2,2
../kbl_data/2022-2023,S41G01N80,서울 SK,Away,김형빈,0,0,0,0.0,0,0,0.0,0,0,0.0,0,0,0.0,0,0,0,0,0,0,0,0,0,0
../kbl_data/2022-2023,S41G01N80,서울 SK,Away,오재현,0,0,2,0.0,0,1,0.0,0,3,0.0,0,0,0.0,0,1,1,0,0,0,0,0,0,4
../kbl_data/2022-2023,S41G01N81,대구 한국가스공사,Home,박지훈,24,0,6,0.0,8,18,44.4,8,24,33.3,0,0,0.0,2,6,8,4,0,4,0,0,6,14
../kbl_data/2022-2023,S41G01N81,대구 한국가스공사,Home,조상열,6,0,1,0.0,2,3,66.7,2,4,50.0,0,0,0.0,0,0,0,1,2,0,1,0,1,5
../kbl_data/2022-2023,S41G01N81,대구 한국가스공사,Home,이원대,0,0,0,0.0,0,0,0.0,0,0,0.0,0,0,0.0,0,0,0,0,0,0,0,0,0,0
../kbl_data/2022-2023,S41G01N81,대구 한국가스공사,Home,이대헌,0,0,0,0.0,0,0,0.0,0,0,0.0,0,0,0.0,0,0,0,0,0,0,0,0,0,0
../kbl_data/2022-2023,S41G01N81,대구 한국가스공사,Home,이대성,25,4,15,26.7,2,7,28.6,6,22,27.3,11,13,84.6,0,4,4,7,3,0,0,0,1,1
../kbl_data/2022-2023,S41G01N81,대구 한국가스공사,Home,정효근,19,4,6,66.7,3,5,60.0,7,11,63.6,2,3,66.7,4,4,8,3,1,0,0,0,1,2
../kbl_data/2022-2023,S41G01N81,대구 한국가스공사,Home,머피 할로웨이,17,6,6,100.0,1,1,100.0,7,7,100.0,2,2,100.0,2,8,10,4,0,1,0,1,1,4
../kbl_data/2022-2023,S41G01N81,대구 한국가스공사,Home,전현우,3,1,1,100.0,0,2,0.0,1,3,33.3,1,2,50.0,0,1,1,0,0,0,0,0,0,1
../kbl_data/2022-2023,S41G01N81,대구 한국가스공사,Home,신승민,0,0,0,0.0,0,0,0.0,0,0,0.0,0,0,0.0,0,0,0,0,0,0,0,0,1,0
../kbl_data/2022-2023,S41G01N81,대구 한국가스공사,Home,샘조세프 벨란겔,0,0,2,0.0,0,0,0.0,0,2,0.0,0,0,0.0,0,0,0,0,0,0,0,0,1,2
../kbl_data/2022-2023,S41G01N81,대구 한국가스공사,Home,유슈 은도예,4,2,5,40.0,0,0,0.0,2,5,40.0,0,0,0.0,1,3,4,1,0,0,0,0,1,3
../kbl_data/2022-2023,S41G01N81,대구 한국가스공사,Home,염유성,0,0,0,0.0,0,0,0.0,0,0,0.0,0,0,0.0,0,0,0,0,0,0,0,0,0,0
../kbl_data/2022-2023,S41G01N81,안양 KGC,Away,양희종,3,0,1,0.0,1,4,25.0,1,5,20.0,0,0,0.0,1,1,2,0,0,0,0,0,1,0
../kbl_data/2022-2023,S41G01N81,안양 KGC,Away,함준후,0,0,0,0.0,0,0,0.0,0,0,0.0,0,0,0.0,0,0,0,0,0,0,0,0,0,0
../kbl_data/2022-2023,S41G01N81,안양 KGC,Away,오세근,19,5,8,62.5,1,2,50.0,6,10,60.0,6,6,100.0,2,5,7,3,0,0,0,0,1,1
../kbl_data/2022-2023,S41G01N81,안양 KGC,Away,정준원,0,0,0,0.0,0,0,0.0,0,0,0.0,0,0,0.0,0,0,0,0,0,0,0,0,0,0
../kbl_data/2022-2023,S41G01N81,안양 KGC,Away,배병준,3,0,2,0.0,1,4,25.0,1,6,16.7,0,0,0.0,3,4,7,2,0,0,2,0,3,2
../kbl_data/2022-2023,S41G01N81,안양 KGC,Away,문성곤,4,0,2,0.0,1,2,50.0,1,4,25.0,1,2,50.0,1,1,2,1,0,1,0,0,0,2
../kbl_data/2022-2023,S41G01N81,안양 KGC,Away,박지훈,24,0,6,0.0,8,18,44.4,8,24,33.3,0,0,0.0,2,6,8,4,0,4,0,0,6,14
../kbl_data/2022-2023,S41G01N81,안양 KGC,Away,대릴 먼로,9,3,6,50.0,1,1,100.0,4,7,57.1,0,0,0.0,0,6,6,3,0,0,1,0,0,2
../kbl_data/2022-2023,S41G01N81,안양 KGC,Away,변준형,25,7,10,70.0,3,8,37.5,10,18,55.6,2,2,100.0,2,1,3,3,2,0,1,0,1,3
../kbl_data/2022-2023,S41G01N81,안양 KGC,Away,한승희,0,0,0,0.0,0,0,0.0,0,0,0.0,0,0,0.0,0,0,0,0,0,0,0,0,0,2
../kbl_data/2022-2023,S41G01N81,안양 KGC,Away,오마리 스펠맨,12,4,8,50.0,1,5,20.0,5,13,38.5,1,2,50.0,3,6,9,1,2,0,0,1,1,4
../kbl_data/2022-2023,S41G01N81,안양 KGC,Away,렌즈 아반도,0,0,0,0.0,0,3,0.0,0,3,0.0,0,0,0.0,0,0,0,1,0,0,0,0,2,3
../kbl_data/2022-2023,S41G01N82,전주 KCC,Home,정창영,12,3,3,100.0,1,3,33.3,4,6,66.7,3,6,50.0,0,1,1,4,0,0,1,0,0,2
../kbl_data/2022-2023,S41G01N82,전주 KCC,Home,라건아,20,10,14,71.4,0,0,0.0,10,14,71.4,0,0,0.0,5,5,10,3,0,0,0,0,1,2
../kbl_data/2022-2023,S41G01N82,전주 KCC,Home,박경상,0,0,1,0.0,0,0,0.0,0,1,0.0,0,0,0.0,0,1,1,0,0,0,0,0,0,0
../kbl_data/2022-2023,S41G01N82,전주 KCC,Home,김지완,13,3,3,100.0,2,2,100.0,5,5,100.0,1,1,100.0,0,1,1,4,0,0,0,0,2,3
../kbl_data/2022-2023,S41G01N82,전주 KCC,Home,전준범,2,1,1,100.0,0,0,0.0,1,1,100.0,0,0,0.0,0,0,0,1,0,0,0,0,0,1
../kbl_data/2022-2023,S41G01N82,전주 KCC,Home,허웅,26,3,4,75.0,4,6,66.7,7,10,70.0,8,9,88.9,0,2,2,5,1,0,0,0,3,3
../kbl_data/2022-2023,S41G01N82,전주 KCC,Home,이승현,14,7,10,70.0,0,0,0.0,7,10,70.0,0,0,0.0,2,3,5,1,2,0,0,0,2,4
../kbl_data/2022-2023,S41G01N82,전주 KCC,Home,곽정훈,0,0,0,0.0,0,0,0.0,0,0,0.0,0,0,0.0,0,0,0,0,0,0,0,0,0,0
../kbl_data/2022-2023,S41G01N82,전주 KCC,Home,이근휘,6,0,1,0.0,2,2,100.0,2,3,66.7,0,0,0.0,0,3,3,1,0,0,0,0,0,0
../kbl_data/2022-2023,S41G01N82,전주 KCC,Home,서정현,4,2,2,100.0,0,0,0.0,2,2,100.0,0,0,0.0,2,1,3,1,0,0,0,0,0,1
../kbl_data/2022-2023,S41G01N82,전주 KCC,Home,론데 홀리스 제퍼슨,12,5,7,71.4,0,0,0.0,5,7,71.4,2,3,66.7,1,2,3,2,1,0,0,0,0,1
../kbl_data/2022-2023,S41G01N82,전주 KCC,Home,송동훈,0,0,0,0.0,0,0,0.0,0,0,0.0,0,0,0.0,0,0,0,0,0,0,0,0,1,1
../kbl_data/2022-2023,S41G01N82,수원 KT,Away,김동욱,0,0,0,0.0,0,0,0.0,0,0,0.0,0,0,0.0,0,0,0,0,0,0,0,0,0,0
../kbl_data/2022-2023,S41G01N82,수원 KT,Away,김영환,2,1,2,50.0,0,1,0.0,1,3,33.3,0,0,0.0,2,0,2,0,0,0,0,0,0,1
../kbl_data/2022-2023,S41G01N82,수원 KT,Away,김민욱,2,1,3,33.3,0,1,0.0,1,4,25.0,0,0,0.0,2,1,3,1,1,0,0,0,0,1
../kbl_data/2022-2023,S41G01N82,수원 KT,Away,한희원,9,3,5,60.0,1,3,33.3,4,8,50.0,0,0,0.0,2,0,2,1,1,0,0,0,0,3
../kbl_data/2022-2023,S41G01N82,수원 KT,Away,이현석,0,0,0,0.0,0,2,0.0,0,2,0.0,0,0,0.0,0,0,0,0,0,0,0,0,1,1
../kbl_data/2022-2023,S41G01N82,수원 KT,Away,정성우,17,1,3,33.3,4,5,80.0,5,8,62.5,3,5,60.0,1,1,2,4,1,0,0,0,2,1
../kbl_data/2022-2023,S41G01N82,수원 KT,Away,최성모,5,0,2,0.0,1,2,50.0,1,4,25.0,2,4,50.0,0,0,0,1,1,0,1,0,0,2
../kbl_data/2022-2023,S41G01N82,수원 KT,Away,양홍석,17,6,7,85.7,1,3,33.3,7,10,70.0,2,2,100.0,2,0,2,3,0,0,0,0,3,3
../kbl_data/2022-2023,S41G01N82,수원 KT,Away,박지원,0,0,1,0.0,0,0,0.0,0,1,0.0,0,0,0.0,0,0,0,0,0,0,0,0,1,1
../kbl_data/2022-2023,S41G01N82,수원 KT,Away,하윤기,13,5,11,45.5,0,0,0.0,5,11,45.5,3,4,75.0,3,2,5,1,0,0,0,1,0,3
../kbl_data/2022-2023,S41G01N82,수원 KT,Away,이제이 아노시케,21,4,7,57.1,3,9,33.3,7,16,43.8,4,5,80.0,3,3,6,6,1,0,0,0,1,0
../kbl_data/2022-2023,S41G01N82,수원 KT,Away,랜드리 은노코,2,0,0,0.0,0,0,0.0,0,0,0.0,2,2,100.0,0,1,1,0,0,0,0,0,0,1
../kbl_data/2022-2023,S41G01N83,서울 삼성,Home,이정현,8,1,6,16.7,2,6,33.3,3,12,25.0,0,0,0.0,0,0,0,3,0,0,0,0,0,4
../kbl_data/2022-2023,S41G01N83,서울 삼성,Home,장민국,16,1,3,33.3,4,8,50.0,5,11,45.5,2,4,50.0,1,1,2,1,1,0,0,0,2,4
../kbl_data/2022-2023,S41G01N83,서울 삼성,Home,김시래,9,3,7,42.9,1,4,25.0,4,11,36.4,0,0,0.0,0,3,3,3,0,0,1,0,2,4
../kbl_data/2022-2023,S41G01N83,서울 삼성,Home,김현수,0,0,0,0.0,0,0,0.0,0,0,0.0,0,0,0.0,0,0,0,0,0,0,0,0,0,0
../kbl_data/2022-2023,S41G01N83,서울 삼성,Home,임동섭,0,0,0,0.0,0,0,0.0,0,0,0.0,0,0,0.0,0,0,0,0,0,0,0,0,0,0
../kbl_data/2022-2023,S41G01N83,서울 삼성,Home,김광철,7,1,3,33.3,1,2,50.0,2,5,40.0,2,2,100.0,0,0,0,3,1,0,0,0,1,1
../kbl_data/2022-2023,S41G01N83,서울 삼성,Home,김한솔,0,0,0,0.0,0,0,0.0,0,0,0.0,0,0,0.0,0,0,0,0,0,0,0,0,0,0
../kbl_data/2022-2023,S41G01N83,서울 삼성,Home,조우성,0,0,1,0.0,0,0,0.0,0,1,0.0,0,0,0.0,1,2,3,0,0,1,0,0,0,4
../kbl_data/2022-2023,S41G01N83,서울 삼성,Home,이원석,11,4,4,100.0,1,2,50.0,5,6,83.3,0,2,0.0,2,2,4,2,0,0,0,1,2,2
../kbl_data/2022-2023,S41G01N83,서울 삼성,Home,이매뉴얼 테리,18,8,12,66.7,0,0,0.0,8,12,66.7,2,3,66.7,2,16,18,2,1,1,0,1,1,1
../kbl_data/2022-2023,S41G01N83,서울 삼성,Home,신동혁,4,1,2,50.0,0,1,0.0,1,3,33.3,2,2,100.0,0,3,3,0,0,0,0,0,1,2
../kbl_data/2022-2023,S41G01N83,서울 삼성,Home,박민채,0,0,0,0.0,0,0,0.0,0,0,0.0,0,0,0.0,0,0,0,0,0,0,0,0,0,0
../kbl_data/2022-2023,S41G01N83,안양 KGC,Away,양희종,5,1,1,100.0,1,3,33.3,2,4,50.0,0,0,0.0,0,2,2,1,0,0,0,0,1,1
../kbl_data/2022-2023,S41G01N83,안양 KGC,Away,함준후,0,0,0,0.0,0,0,0.0,0,0,0.0,0,0,0.0,0,0,0,0,0,0,0,0,0,0
../kbl_data/2022-2023,S41G01N83,안양 KGC,Away,오세근,19,4,9,44.4,1,2,50.0,5,11,45.5,8,10,80.0,4,5,9,1,0,1,0,0,0,1
../kbl_data/2022-2023,S41G01N83,안양 KGC,Away,정준원,0,0,1,0.0,0,0,0.0,0,1,0.0,0,0,0.0,0,0,0,0,0,0,0,0,0,1
../kbl_data/2022-2023,S41G01N83,안양 KGC,Away,배병준,15,3,4,75.0,2,3,66.7,5,7,71.4,3,3,100.0,0,2,2,2,0,0,1,0,1,3
../kbl_data/2022-2023,S41G01N83,안양 KGC,Away,문성곤,2,1,2,50.0,0,3,0.0,1,5,20.0,0,0,0.0,1,1,2,0,2,0,1,0,0,2
../kbl_data/2022-2023,S41G01N83,안양 KGC,Away,김철욱,0,0,0,0.0,0,0,0.0,0,0,0.0,0,0,0.0,0,0,0,0,0,0,0,0,0,1
../kbl_data/2022-2023,S41G01N83,안양 KGC,Away,박지훈,0,0,2,0.0,0,1,0.0,0,3,0.0,0,0,0.0,0,1,1,2,0,0,0,0,0,3
../kbl_data/2022-2023,S41G01N83,안양 KGC,Away,대릴 먼로,2,0,3,0.0,0,0,0.0,0,3,0.0,2,2,100.0,1,0,1,0,1,0,0,0,0,0
../kbl_data/2022-2023,S41G01N83,안양 KGC,Away,변준형,7,2,5,40.0,1,3,33.3,3,8,37.5,0,1,0.0,0,2,2,3,0,0,0,0,2,2
../kbl_data/2022-2023,S41G01N83,안양 KGC,Away,오마리 스펠맨,22,5,10,50.0,3,10,30.0,8,20,40.0,3,4,75.0,6,9,15,2,0,1,0,1,4,2
../kbl_data/2022-2023,S41G01N83,안양 KGC,Away,렌즈 아반도,5,1,2,50.0,0,2,0.0,1,4,25.0,3,3,100.0,0,2,2,0,0,2,0,0,0,3
../kbl_data/2022-2023,S41G01N84,고양 캐롯,Home,김강선,0,0,0,0.0,0,0,0.0,0,0,0.0,0,0,0.0,0,0,0,0,0,0,0,0,0,0
../kbl_data/2022-2023,S41G01N84,고양 캐롯,Home,데이비드 사이먼,2,1,2,50.0,0,0,0.0,1,2,50.0,0,0,0.0,0,0,0,0,0,0,0,0,1,0
../kbl_data/2022-2023,S41G01N84,고양 캐롯,Home,최현민,11,1,3,33.3,2,4,50.0,3,7,42.9,3,3,100.0,1,2,3,2,0,0,1,0,0,4
../kbl_data/2022-2023,S41G01N84,고양 캐롯,Home,한호빈,11,1,4,25.0,3,6,50.0,4,10,40.0,0,1,0.0,4,1,5,1,0,0,0,0,1,4
../kbl_data/2022-2023,S41G01N84,고양 캐롯,Home,전성현,27,2,4,50.0,6,13,46.2,8,17,47.1,5,5,100.0,0,1,1,3,1,0,0,0,2,0
../kbl_data/2022-2023,S41G01N84,고양 캐롯,Home,이종현,2,0,3,0.0,0,0,0.0,0,3,0.0,2,2,100.0,1,1,2,2,0,0,0,0,0,1
../kbl_data/2022-2023,S41G01N84,고양 캐롯,Home,김진유,2,0,0,0.0,0,1,0.0,0,1,0.0,2,2,100.0,2,1,3,2,0,0,0,0,0,4
../kbl_data/2022-2023,S41G01N84,고양 캐롯,Home,조한진,0,0,0,0.0,0,2,0.0,0,2,0.0,0,0,0.0,0,1,1,0,0,0,0,0,0,1
../kbl_data/2022-2023,S41G01N84,고양 캐롯,Home,김세창,0,0,0,0.0,0,0,0.0,0,0,0.0,0,0,0.0,0,0,0,0,0,0,0,0,0,0
../kbl_data/2022-2023,S41G01N84,고양 캐롯,Home,디드릭 로슨,17,6,10,60.0,0,3,0.0,6,13,46.2,5,7,71.4,5,14,19,5,2,0,0,0,2,3
../kbl_data/2022-2023,S41G01N84,고양 캐롯,Home,박진철,0,0,0,0.0,0,0,0.0,0,0,0.0,0,0,0.0,0,0,0,0,0,0,0,0,0,0
../kbl_data/2022-2023,S41G01N84,고양 캐롯,Home,이정현,12,3,8,37.5,1,5,20.0,4,13,30.8,3,5,60.0,0,1,1,2,3,0,1,0,2,4
../kbl_data/2022-2023,S41G01N84,창원 LG,Away,이관희,20,3,5,60.0,3,6,50.0,6,11,54.5,5,6,83.3,0,0,0,3,0,0,0,0,0,1
../kbl_data/2022-2023,S41G01N84,창원 LG,Away,정희재,3,0,1,0.0,1,1,100.0,1,2,50.0,0,0,0.0,0,0,0,2,0,0,0,0,0,1
../kbl_data/2022-2023,S41G01N84,창원 LG,Away,서민수,2,1,1,100.0,0,2,0.0,1,3,33.3,0,0,0.0,2,2,4,2,0,1,0,0,2,2
../kbl_data/2022-2023,S41G01N84,창원 LG,Away,한상혁,0,0,0,0.0,0,0,0.0,0,0,0.0,0,0,0.0,0,0,0,0,0,0,0,0,0,0
../kbl_data/2022-2023,S41G01N84,창원 LG,Away,이재도,13,3,5,60.0,1,3,33.3,4,8,50.0,4,6,66.7,2,6,8,2,4,1,0,0,1,0
../kbl_data/2022-2023,S41G01N84,창원 LG,Away,김준일,12,5,8,62.5,0,0,0.0,5,8,62.5,2,4,50.0,1,3,4,2,0,0,0,0,1,5
../kbl_data/2022-2023,S41G01N84,창원 LG,Away,윤원상,3,0,1,0.0,1,1,100.0,1,2,50.0,0,0,0.0,0,3,3,1,0,0,0,0,1,3
../kbl_data/2022-2023,S41G01N84,창원 LG,Away,아셈 마레이,4,1,1,100.0,0,0,0.0,1,1,100.0,2,4,50.0,0,2,2,1,0,0,0,0,1,1
../kbl_data/2022-2023,S41G01N84,창원 LG,Away,이승우,6,3,4,75.0,0,0,0.0,3,4,75.0,0,0,0.0,0,0,0,0,0,0,0,0,0,3
../kbl_data/2022-2023,S41G01N84,창원 LG,Away,저스틴 구탕,8,3,5,60.0,0,0,0.0,3,5,60.0,2,2,100.0,0,1,1,3,0,0,0,0,1,3
../kbl_data/2022-2023,S41G01N84,창원 LG,Away,이승훈,0,0,0,0.0,0,0,0.0,0,0,0.0,0,0,0.0,0,0,0,0,0,0,0,0,0,0
../kbl_data/2022-2023,S41G01N84,창원 LG,Away,단테 커닝햄,14,6,11,54.5,0,1,0.0,6,12,50.0,2,2,100.0,2,12,14,4,2,2,0,1,2,2
../kbl_data/2022-2023,S41G01N85,수원 KT,Home,김동욱,12,0,1,0.0,4,7,57.1,4,8,50.0,0,0,0.0,0,1,1,3,0,0,1,0,6,1
../kbl_data/2022-2023,S41G01N85,수원 KT,Home,김영환,0,0,0,0.0,0,0,0.0,0,0,0.0,0,0,0.0,0,0,0,0,0,0,0,0,0,0
../kbl_data/2022-2023,S41G01N85,수원 KT,Home,한희원,3,0,2,0.0,1,6,16.7,1,8,12.5,0,0,0.0,3,3,6,2,2,0,0,0,1,2
../kbl_data/2022-2023,S41G01N85,수원 KT,Home,이현석,0,0,0,0.0,0,0,0.0,0,0,0.0,0,0,0.0,0,0,0,0,0,0,0,0,0,1
../kbl_data/2022-2023,S41G01N85,수원 KT,Home,정성우,8,0,4,0.0,2,4,50.0,2,8,25.0,2,2,100.0,2,1,3,4,0,0,1,0,0,3
../kbl_data/2022-2023,S41G01N85,수원 KT,Home,최성모,2,0,0,0.0,0,3,0.0,0,3,0.0,2,2,100.0,1,0,1,0,0,0,0,0,0,1
../kbl_data/2022-2023,S41G01N85,수원 KT,Home,양홍석,14,4,8,50.0,2,5,40.0,6,13,46.2,0,0,0.0,1,6,7,2,0,0,0,0,2,2
../kbl_data/2022-2023,S41G01N85,수원 KT,Home,박지원,0,0,0,0.0,0,0,0.0,0,0,0.0,0,0,0.0,0,0,0,0,0,0,0,0,0,0
../kbl_data/2022-2023,S41G01N85,수원 KT,Home,김준환,0,0,0,0.0,0,0,0.0,0,0,0.0,0,0,0.0,0,0,0,0,0,0,0,0,0,0
../kbl_data/2022-2023,S41G01N85,수원 KT,Home,하윤기,14,4,8,50.0,0,0,0.0,4,8,50.0,6,8,75.0,2,3,5,1,0,1,0,0,0,3
../kbl_data/2022-2023,S41G01N85,수원 KT,Home,이제이 아노시케,2,1,2,50.0,0,1,0.0,1,3,33.3,0,0,0.0,0,1,1,0,0,0,0,0,2,2
../kbl_data/2022-2023,S41G01N85,수원 KT,Home,랜드리 은노코,8,2,9,22.2,0,0,0.0,2,9,22.2,4,4,100.0,1,7,8,4,1,0,0,1,0,1
../kbl_data/2022-2023,S41G01N85,대구 한국가스공사,Away,박지훈,0,0,1,0.0,0,2,0.0,0,3,0.0,0,0,0.0,1,1,2,0,1,1,0,0,1,1
../kbl_data/2022-2023,S41G01N85,대구 한국가스공사,Away,조상열,0,0,1,0.0,0,0,0.0,0,1,0.0,0,0,0.0,1,1,2,0,0,0,0,0,0,1
../kbl_data/2022-2023,S41G01N85,대구 한국가스공사,Away,이원대,0,0,0,0.0,0,0,0.0,0,0,0.0,0,0,0.0,0,0,0,0,1,0,0,0,0,1
../kbl_data/2022-2023,S41G01N85,대구 한국가스공사,Away,이대헌,15,6,8,75.0,1,3,33.3,7,11,63.6,0,0,0.0,1,4,5,4,1,0,0,0,2,5
../kbl_data/2022-2023,S41G01N85,대구 한국가스공사,Away,이대성,11,4,10,40.0,1,3,33.3,5,13,38.5,0,0,0.0,0,1,1,6,2,0,0,0,1,1
../kbl_data/2022-2023,S41G01N85,대구 한국가스공사,Away,정효근,12,4,4,100.0,1,1,100.0,5,5,100.0,1,2,50.0,1,3,4,1,1,0,0,0,3,2
../kbl_data/2022-2023,S41G01N85,대구 한국가스공사,Away,머피 할로웨이,26,11,15,73.3,0,0,0.0,11,15,73.3,4,5,80.0,1,14,15,1,2,2,0,1,1,3
../kbl_data/2022-2023,S41G01N85,대구 한국가스공사,Away,전현우,3,0,0,0.0,1,4,25.0,1,4,25.0,0,0,0.0,0,1,1,0,0,0,0,0,1,1
../kbl_data/2022-2023,S41G01N85,대구 한국가스공사,Away,신승민,0,0,1,0.0,0,1,0.0,0,2,0.0,0,0,0.0,0,0,0,0,0,1,0,0,0,2
../kbl_data/2022-2023,S41G01N85,대구 한국가스공사,Away,샘조세프 벨란겔,2,1,3,33.3,0,1,0.0,1,4,25.0,0,0,0.0,0,2,2,0,1,0,0,0,0,2
../kbl_data/2022-2023,S41G01N85,대구 한국가스공사,Away,유슈 은도예,2,1,3,33.3,0,0,0.0,1,3,33.3,0,0,0.0,1,1,2,0,0,1,0,0,1,0
../kbl_data/2022-2023,S41G01N85,대구 한국가스공사,Away,염유성,0,0,0,0.0,0,0,0.0,0,0,0.0,0,0,0.0,0,0,0,0,0,0,0,0,0,0
../kbl_data/2022-2023,S41G01N86,원주 DB,Home,박찬희,0,0,0,0.0,0,0,0.0,0,0,0.0,0,0,0.0,0,0,0,1,1,0,0,0,2,2
../kbl_data/2022-2023,S41G01N86,원주 DB,Home,김현호,5,2,3,66.7,0,2,0.0,2,5,40.0,1,1,100.0,0,1,1,2,1,0,0,0,1,1
../kbl_data/2022-2023,S41G01N86,원주 DB,Home,김종규,7,3,7,42.9,0,0,0.0,3,7,42.9,1,1,100.0,2,1,3,0,2,0,0,0,2,4
../kbl_data/2022-2023,S41G01N86,원주 DB,Home,최승욱,2,1,2,50.0,0,1,0.0,1,3,33.3,0,0,0.0,5,2,7,1,0,0,0,0,3,1
../kbl_data/2022-2023,S41G01N86,원주 DB,Home,강상재,4,2,6,33.3,0,3,0.0,2,9,22.2,0,0,0.0,1,4,5,1,1,1,0,0,3,1
../kbl_data/2022-2023,S41G01N86,원주 DB,Home,이윤수,0,0,0,0.0,0,0,0.0,0,0,0.0,0,0,0.0,0,0,0,0,0,0,0,0,0,1
../kbl_data/2022-2023,S41G01N86,원주 DB,Home,레나드 프리먼,21,9,15,60.0,0,0,0.0,9,15,60.0,3,4,75.0,6,5,11,2,1,0,0,0,3,1
../kbl_data/2022-2023,S41G01N86,원주 DB,Home,정호영,8,4,9,44.4,0,2,0.0,4,11,36.4,0,0,0.0,0,0,0,3,0,1,1,0,1,5
../kbl_data/2022-2023,S41G01N86,원주 DB,Home,이민석,3,0,2,0.0,1,1,100.0,1,3,33.3,0,0,0.0,0,0,0,0,0,0,1,0,0,2
../kbl_data/2022-2023,S41G01N86,원주 DB,Home,이선 알바노,14,6,14,42.9,0,5,0.0,6,19,31.6,2,2,100.0,0,4,4,4,0,0,0,0,2,1
../kbl_data/2022-2023,S41G01N86,원주 DB,Home,박인웅,6,3,6,50.0,0,0,0.0,3,6,50.0,0,0,0.0,1,3,4,0,1,0,0,0,1,2
../kbl_data/2022-2023,S41G01N86,원주 DB,Home,인승찬,0,0,0,0.0,0,0,0.0,0,0,0.0,0,0,0.0,0,0,0,0,0,0,0,0,0,0
../kbl_data/2022-2023,S41G01N86,울산 현대모비스,Away,함지훈,2,1,4,25.0,0,1,0.0,1,5,20.0,0,0,0.0,2,3,5,2,2,0,0,0,0,4
../kbl_data/2022-2023,S41G01N86,울산 현대모비스,Away,김현민,0,0,0,0.0,0,0,0.0,0,0,0.0,0,0,0.0,0,0,0,0,0,0,0,0,1,3
../kbl_data/2022-2023,S41G01N86,울산 현대모비스,Away,장재석,8,3,8,37.5,0,0,0.0,3,8,37.5,2,3,66.7,3,2,5,0,0,0,0,0,0,2
../kbl_data/2022-2023,S41G01N86,울산 현대모비스,Away,김영현,3,0,2,0.0,1,2,50.0,1,4,25.0,0,0,0.0,0,0,0,0,0,0,1,0,1,2
../kbl_data/2022-2023,S41G01N86,울산 현대모비스,Away,김국찬,0,0,0,0.0,0,0,0.0,0,0,0.0,0,0,0.0,0,1,1,0,0,0,0,0,0,0
../kbl_data/2022-2023,S41G01N86,울산 현대모비스,Away,서명진,14,4,6,66.7,1,2,50.0,5,8,62.5,3,4,75.0,0,6,6,3,1,0,0,0,1,1
../kbl_data/2022-2023,S41G01N86,울산 현대모비스,Away,헨리 심스,2,1,3,33.3,0,0,0.0,1,3,33.3,0,0,0.0,1,2,3,0,0,0,0,0,2,1
../kbl_data/2022-2023,S41G01N86,울산 현대모비스,Away,이우석,9,3,6,50.0,1,2,50.0,4,8,50.0,0,0,0.0,0,6,6,1,0,0,0,0,2,2
../kbl_data/2022-2023,S41G01N86,울산 현대모비스,Away,신민석,2,1,2,50.0,0,1,0.0,1,3,33.3,0,0,0.0,0,1,1,1,1,0,0,0,0,1
../kbl_data/2022-2023,S41G01N86,울산 현대모비스,Away,론제이 아바리엔토스,15,4,4,100.0,1,10,10.0,5,14,35.7,4,4,100.0,0,1,1,6,4,0,0,0,3,2
../kbl_data/2022-2023,S41G01N86,울산 현대모비스,Away,게이지 프림,24,11,14,78.6,0,0,0.0,11,14,78.6,2,5,40.0,6,6,12,3,2,1,0,0,3,2
../kbl_data/2022-2023,S41G01N86,울산 현대모비스,Away,김태완,4,0,0,0.0,0,0,0.0,0,0,0.0,4,4,100.0,0,0,0,0,0,0,0,0,1,0
../kbl_data/2022-2023,S41G01N87,서울 SK,Home,양우섭,2,1,3,33.3,0,0,0.0,1,3,33.3,0,0,0.0,0,1,1,1,2,0,0,0,1,3
../kbl_data/2022-2023,S41G01N87,서울 SK,Home,허일영,8,0,2,0.0,1,2,50.0,1,4,25.0,5,6,83.3,1,2,3,0,0,0,1,0,0,4
../kbl_data/2022-2023,S41G01N87,서울 SK,Home,김선형,10,4,9,44.4,0,3,0.0,4,12,33.3,2,6,33.3,0,1,1,4,0,0,0,0,1,3
../kbl_data/2022-2023,S41G01N87,서울 SK,Home,홍경기,0,0,0,0.0,0,1,0.0,0,1,0.0,0,0,0.0,0,0,0,0,0,0,0,0,0,1
../kbl_data/2022-2023,S41G01N87,서울 SK,Home,최부경,0,0,1,0.0,0,0,0.0,0,1,0.0,0,0,0.0,0,3,3,1,0,1,0,0,0,1
../kbl_data/2022-2023,S41G01N87,서울 SK,Home,리온 윌리엄스,3,0,0,0.0,1,1,100.0,1,1,100.0,0,0,0.0,1,0,1,0,0,0,0,0,1,1
../kbl_data/2022-2023,S41G01N87,서울 SK,Home,최원혁,0,0,0,0.0,0,0,0.0,0,0,0.0,0,0,0.0,0,0,0,0,0,0,0,0,0,0
../kbl_data/2022-2023,S41G01N87,서울 SK,Home,최준용,15,2,5,40.0,1,4,25.0,3,9,33.3,8,10,80.0,0,6,6,10,3,0,0,0,2,3
../kbl_data/2022-2023,S41G01N87,서울 SK,Home,최성원,6,0,1,0.0,2,5,40.0,2,6,33.3,0,0,0.0,0,3,3,2,1,0,0,0,1,3
../kbl_data/2022-2023,S41G01N87,서울 SK,Home,자밀 워니,37,14,18,77.8,1,2,50.0,15,20,75.0,6,9,66.7,5,10,15,2,1,2,1,5,3,0
../kbl_data/2022-2023,S41G01N87,서울 SK,Home,김형빈,0,0,0,0.0,0,0,0.0,0,0,0.0,0,0,0.0,0,0,0,0,0,0,0,0,0,0
../kbl_data/2022-2023,S41G01N87,서울 SK,Home,오재현,2,0,0,0.0,0,0,0.0,0,0,0.0,2,2,100.0,0,0,0,1,1,0,0,0,0,3
../kbl_data/2022-2023,S41G01N87,서울 삼성,Away,이정현,12,2,4,50.0,2,9,22.2,4,13,30.8,2,2,100.0,0,5,5,3,0,0,0,0,1,3
../kbl_data/2022-2023,S41G01N87,서울 삼성,Away,장민국,3,0,1,0.0,1,1,100.0,1,2,50.0,0,0,0.0,1,0,1,1,0,0,0,0,0,4
../kbl_data/2022-2023,S41G01N87,서울 삼성,Away,김시래,4,1,3,33.3,0,2,0.0,1,5,20.0,2,4,50.0,0,1,1,7,1,0,0,0,2,1
../kbl_data/2022-2023,S41G01N87,서울 삼성,Away,김현수,0,0,0,0.0,0,0,0.0,0,0,0.0,0,0,0.0,0,0,0,0,2,0,0,0,0,0
../kbl_data/2022-2023,S41G01N87,서울 삼성,Away,임동섭,6,1,1,100.0,1,4,25.0,2,5,40.0,1,2,50.0,2,2,4,2,0,0,0,0,0,2
../kbl_data/2022-2023,S41G01N87,서울 삼성,Away,김광철,0,0,2,0.0,0,1,0.0,0,3,0.0,0,0,0.0,0,1,1,2,1,0,1,0,1,4
../kbl_data/2022-2023,S41G01N87,서울 삼성,Away,김한솔,0,0,0,0.0,0,0,0.0,0,0,0.0,0,0,0.0,0,0,0,0,0,0,0,0,0,0
../kbl_data/2022-2023,S41G01N87,서울 삼성,Away,조우성,2,1,2,50.0,0,0,0.0,1,2,50.0,0,0,0.0,1,0,1,0,0,0,0,0,1,2
../kbl_data/2022-2023,S41G01N87,서울 삼성,Away,이원석,6,2,5,40.0,0,0,0.0,2,5,40.0,2,2,100.0,2,3,5,0,1,0,0,0,3,4
../kbl_data/2022-2023,S41G01N87,서울 삼성,Away,이매뉴얼 테리,32,13,22,59.1,1,1,100.0,14,23,60.9,3,4,75.0,2,10,12,1,1,0,0,4,1,3
../kbl_data/2022-2023,S41G01N87,서울 삼성,Away,신동혁,13,2,6,33.3,3,4,75.0,5,10,50.0,0,0,0.0,2,1,3,1,0,0,0,0,2,1
../kbl_data/2022-2023,S41G01N87,서울 삼성,Away,박민채,0,0,0,0.0,0,0,0.0,0,0,0.0,0,0,0.0,0,0,0,0,0,0,0,0,0,0
../kbl_data/2022-2023,S41G01N88,창원 LG,Home,이관희,12,2,4,50.0,2,6,33.3,4,10,40.0,2,2,100.0,0,1,1,1,1,1,0,0,1,2
../kbl_data/2022-2023,S41G01N88,창원 LG,Home,정희재,0,0,2,0.0,0,0,0.0,0,2,0.0,0,0,0.0,1,1,2,0,0,0,0,0,0,0
../kbl_data/2022-2023,S41G01N88,창원 LG,Home,서민수,9,3,4,75.0,1,3,33.3,4,7,57.1,0,1,0.0,0,2,2,3,1,1,0,1,1,3
../kbl_data/2022-2023,S41G01N88,창원 LG,Home,한상혁,0,0,0,0.0,0,0,0.0,0,0,0.0,0,0,0.0,0,0,0,0,0,0,0,0,0,0
../kbl_data/2022-2023,S41G01N88,창원 LG,Home,이재도,7,2,4,50.0,0,2,0.0,2,6,33.3,3,4,75.0,1,4,5,1,0,0,0,0,1,4
../kbl_data/2022-2023,S41G01N88,창원 LG,Home,김준일,4,1,5,20.0,0,0,0.0,1,5,20.0,2,2,100.0,2,2,4,2,0,0,0,0,0,2
../kbl_data/2022-2023,S41G01N88,창원 LG,Home,최승욱,2,1,1,100.0,0,0,0.0,1,1,100.0,0,0,0.0,0,0,0,0,0,0,0,0,0,0
../kbl_data/2022-2023,S41G01N88,창원 LG,Home,윤원상,2,1,1,100.0,0,4,0.0,1,5,20.0,0,0,0.0,0,1,1,2,2,0,0,0,0,3
../kbl_data/2022-2023,S41G01N88,창원 LG,Home,아셈 마레이,26,11,14,78.6,0,0,0.0,11,14,78.6,4,9,44.4,7,6,13,1,3,0,0,1,2,3
../kbl_data/2022-2023,S41G01N88,창원 LG,Home,이승우,4,2,4,50.0,0,2,0.0,2,6,33.3,0,0,0.0,1,0,1,5,0,0,0,0,1,1
../kbl_data/2022-2023,S41G01N88,창원 LG,Home,저스틴 구탕,13,5,5,100.0,0,0,0.0,5,5,100.0,3,3,100.0,0,1,1,4,0,0,1,0,2,2
../kbl_data/2022-2023,S41G01N88,창원 LG,Home,단테 커닝햄,7,3,5,60.0,0,0,0.0,3,5,60.0,1,1,100.0,1,1,2,0,3,1,0,0,2,1
../kbl_data/2022-2023,S41G01N88,대구 한국가스공사,Away,박지훈,0,0,0,0.0,0,1,0.0,0,1,0.0,0,0,0.0,2,1,3,1,0,0,0,0,0,5
../kbl_data/2022-2023,S41G01N88,대구 한국가스공사,Away,조상열,4,2,2,100.0,0,1,0.0,2,3,66.7,0,0,0.0,1,0,1,1,0,0,0,0,1,0
../kbl_data/2022-2023,S41G01N88,대구 한국가스공사,Away,이원대,0,0,0,0.0,0,0,0.0,0,0,0.0,0,0,0.0,0,0,0,0,0,0,0,0,1,0
../kbl_data/2022-2023,S41G01N88,대구 한국가스공사,Away,이대헌,14,4,8,50.0,2,5,40.0,6,13,46.2,0,0,0.0,3,2,5,1,0,0,0,0,2,2
../kbl_data/2022-2023,S41G01N88,대구 한국가스공사,Away,이대성,8,3,7,42.9,0,1,0.0,3,8,37.5,2,2,100.0,0,3,3,3,0,0,0,0,5,3
../kbl_data/2022-2023,S41G01N88,대구 한국가스공사,Away,정효근,9,2,2,100.0,1,2,50.0,3,4,75.0,2,2,100.0,0,0,0,0,0,0,0,0,1,2
../kbl_data/2022-2023,S41G01N88,대구 한국가스공사,Away,머피 할로웨이,12,6,7,85.7,0,0,0.0,6,7,85.7,0,0,0.0,0,6,6,4,0,0,0,0,2,5
../kbl_data/2022-2023,S41G01N88,대구 한국가스공사,Away,우동현,0,0,0,0.0,0,1,0.0,0,1,0.0,0,0,0.0,0,0,0,0,0,0,0,0,0,0
../kbl_data/2022-2023,S41G01N88,대구 한국가스공사,Away,전현우,10,0,1,0.0,3,6,50.0,3,7,42.9,1,1,100.0,1,2,3,1,1,0,0,0,1,5
../kbl_data/2022-2023,S41G01N88,대구 한국가스공사,Away,신승민,0,0,0,0.0,0,1,0.0,0,1,0.0,0,0,0.0,0,0,0,0,0,0,0,0,0,0
../kbl_data/2022-2023,S41G01N88,대구 한국가스공사,Away,샘조세프 벨란겔,7,3,6,50.0,0,3,0.0,3,9,33.3,1,3,33.3,0,0,0,2,3,0,2,0,0,3
../kbl_data/2022-2023,S41G01N88,대구 한국가스공사,Away,유슈 은도예,12,5,8,62.5,0,0,0.0,5,8,62.5,2,6,33.3,2,5,7,2,3,2,0,3,1,0
../kbl_data/2022-2023,S41G01N89,고양 캐롯,Home,김강선,0,0,0,0.0,0,1,0.0,0,1,0.0,0,0,0.0,0,0,0,0,0,0,0,0,1,0
../kbl_data/2022-2023,S41G01N89,고양 캐롯,Home,데이비드 사이먼,5,1,8,12.5,0,1,0.0,1,9,11.1,3,4,75.0,0,5,5,1,0,0,0,0,0,2
../kbl_data/2022-2023,S41G01N89,고양 캐롯,Home,최현민,5,1,4,25.0,1,7,14.3,2,11,18.2,0,0,0.0,4,4,8,4,1,0,0,0,1,3
../kbl_data/2022-2023,S41G01N89,고양 캐롯,Home,한호빈,0,0,0,0.0,0,1,0.0,0,1,0.0,0,0,0.0,1,0,1,0,0,0,0,0,2,2
../kbl_data/2022-2023,S41G01N89,고양 캐롯,Home,전성현,22,1,7,14.3,6,13,46.2,7,20,35.0,2,2,100.0,1,4,5,2,2,0,0,0,3,1
../kbl_data/2022-2023,S41G01N89,고양 캐롯,Home,이종현,0,0,0,0.0,0,0,0.0,0,0,0.0,0,0,0.0,0,2,2,0,0,0,0,0,0,1
../kbl_data/2022-2023,S41G01N89,고양 캐롯,Home,정해원,0,0,0,0.0,0,0,0.0,0,0,0.0,0,0,0.0,0,0,0,0,0,0,0,0,0,0
../kbl_data/2022-2023,S41G01N89,고양 캐롯,Home,조한진,9,0,0,0.0,3,4,75.0,3,4,75.0,0,0,0.0,2,2,4,0,0,0,0,0,1,0
../kbl_data/2022-2023,S41G01N89,고양 캐롯,Home,김세창,6,1,3,33.3,1,3,33.3,2,6,33.3,1,1,100.0,1,0,1,2,0,0,0,0,0,0
../kbl_data/2022-2023,S41G01N89,고양 캐롯,Home,디드릭 로슨,7,2,6,33.3,1,1,100.0,3,7,42.9,0,0,0.0,3,7,10,5,0,1,0,0,2,3
../kbl_data/2022-2023,S41G01N89,고양 캐롯,Home,박진철,0,0,0,0.0,0,0,0.0,0,0,0.0,0,0,0.0,0,0,0,0,0,0,0,0,0,0
../kbl_data/2022-2023,S41G01N89,고양 캐롯,Home,이정현,22,5,6,83.3,4,10,40.0,9,16,56.2,0,0,0.0,1,1,2,2,1,0,0,0,0,3
../kbl_data/2022-2023,S41G01N89,전주 KCC,Away,정창영,13,5,7,71.4,1,2,50.0,6,9,66.7,0,0,0.0,1,5,6,6,2,0,0,0,0,1
../kbl_data/2022-2023,S41G01N89,전주 KCC,Away,라건아,9,2,6,33.3,1,1,100.0,3,7,42.9,2,2,100.0,0,9,9,1,0,0,0,0,0,1
../kbl_data/2022-2023,S41G01N89,전주 KCC,Away,박경상,2,1,1,100.0,0,1,0.0,1,2,50.0,0,0,0.0,0,2,2,0,1,0,0,0,0,1
../kbl_data/2022-2023,S41G01N89,전주 KCC,Away,김지완,4,1,3,33.3,0,3,0.0,1,6,16.7,2,2,100.0,0,1,1,4,1,0,0,0,3,3
../kbl_data/2022-2023,S41G01N89,전주 KCC,Away,전준범,0,0,0,0.0,0,0,0.0,0,0,0.0,0,0,0.0,0,0,0,0,0,0,0,0,0,0
../kbl_data/2022-2023,S41G01N89,전주 KCC,Away,허웅,23,4,7,57.1,4,7,57.1,8,14,57.1,3,4,75.0,0,2,2,8,2,0,0,0,3,2
../kbl_data/2022-2023,S41G01N89,전주 KCC,Away,이승현,8,4,10,40.0,0,0,0.0,4,10,40.0,0,0,0.0,3,9,12,0,0,0,0,0,0,1
../kbl_data/2022-2023,S41G01N89,전주 KCC,Away,이진욱,0,0,0,0.0,0,0,0.0,0,0,0.0,0,0,0.0,0,0,0,0,0,0,0,0,0,0
../kbl_data/2022-2023,S41G01N89,전주 KCC,Away,곽정훈,0,0,0,0.0,0,0,0.0,0,0,0.0,0,0,0.0,0,0,0,0,0,0,0,0,0,0
../kbl_data/2022-2023,S41G01N89,전주 KCC,Away,이근휘,8,0,1,0.0,2,3,66.7,2,4,50.0,2,2,100.0,2,1,3,2,1,0,0,0,0,2
../kbl_data/2022-2023,S41G01N89,전주 KCC,Away,서정현,0,0,0,0.0,0,0,0.0,0,0,0.0,0,0,0.0,0,0,0,0,0,0,0,0,0,0
../kbl_data/2022-2023,S41G01N89,전주 KCC,Away,론데 홀리스 제퍼슨,17,7,13,53.8,0,0,0.0,7,13,53.8,3,4,75.0,2,4,6,2,1,1,0,3,2,1
../kbl_data/2022-2023,S41G01N90,울산 현대모비스,Home,함지훈,17,4,6,66.7,2,3,66.7,6,9,66.7,3,3,100.0,2,5,7,7,1,0,0,0,2,0
../kbl_data/2022-2023,S41G01N90,울산 현대모비스,Home,김현민,0,0,0,0.0,0,0,0.0,0,0,0.0,0,0,0.0,0,0,0,0,0,0,0,0,0,0
../kbl_data/2022-2023,S41G01N90,울산 현대모비스,Home,장재석,2,1,3,33.3,0,0,0.0,1,3,33.3,0,0,0.0,2,1,3,2,1,0,0,0,1,1
../kbl_data/2022-2023,S41G01N90,울산 현대모비스,Home,김영현,0,0,0,0.0,0,0,0.0,0,0,0.0,0,0,0.0,0,2,2,1,0,0,0,0,1,3
../kbl_data/2022-2023,S41G01N90,울산 현대모비스,Home,김국찬,0,0,1,0.0,0,0,0.0,0,1,0.0,0,0,0.0,0,0,0,1,1,0,0,0,0,0
../kbl_data/2022-2023,S41G01N90,울산 현대모비스,Home,서명진,12,2,4,50.0,2,5,40.0,4,9,44.4,2,2,100.0,0,0,0,2,1,0,0,0,1,2
../kbl_data/2022-2023,S41G01N90,울산 현대모비스,Home,헨리 심스,4,2,4,50.0,0,0,0.0,2,4,50.0,0,0,0.0,2,1,3,1,1,2,0,0,1,3
../kbl_data/2022-2023,S41G01N90,울산 현대모비스,Home,이우석,12,3,7,42.9,1,4,25.0,4,11,36.4,3,3,100.0,1,2,3,2,0,0,0,0,2,1
../kbl_data/2022-2023,S41G01N90,울산 현대모비스,Home,신민석,2,1,1,100.0,0,1,0.0,1,2,50.0,0,0,0.0,0,0,0,0,0,0,0,0,0,1
../kbl_data/2022-2023,S41G01N90,울산 현대모비스,Home,론제이 아바리엔토스,22,3,7,42.9,4,7,57.1,7,14,50.0,4,5,80.0,0,7,7,7,4,0,0,0,4,1
../kbl_data/2022-2023,S41G01N90,울산 현대모비스,Home,게이지 프림,18,7,9,77.8,0,0,0.0,7,9,77.8,4,5,80.0,1,3,4,0,3,1,0,0,3,4
../kbl_data/2022-2023,S41G01N90,울산 현대모비스,Home,김태완,2,1,1,100.0,0,0,0.0,1,1,100.0,0,0,0.0,0,0,0,0,0,0,0,0,0,1
../kbl_data/2022-2023,S41G01N90,수원 KT,Away,김동욱,0,0,0,0.0,0,0,0.0,0,0,0.0,0,0,0.0,0,0,0,0,0,0,0,0,0,0
../kbl_data/2022-2023,S41G01N90,수원 KT,Away,김영환,9,2,3,66.7,0,3,0.0,2,6,33.3,5,5,100.0,0,0,0,8,1,0,0,0,1,4
../kbl_data/2022-2023,S41G01N90,수원 KT,Away,김민욱,0,0,0,0.0,0,0,0.0,0,0,0.0,0,0,0.0,0,1,1,0,0,0,0,0,1,0
../kbl_data/2022-2023,S41G01N90,수원 KT,Away,한희원,0,0,0,0.0,0,1,0.0,0,1,0.0,0,0,0.0,0,2,2,0,0,0,0,0,1,2
../kbl_data/2022-2023,S41G01N90,수원 KT,Away,최창진,2,1,1,100.0,0,0,0.0,1,1,100.0,0,0,0.0,0,0,0,0,0,0,0,0,0,1
../kbl_data/2022-2023,S41G01N90,수원 KT,Away,정성우,12,3,6,50.0,2,4,50.0,5,10,50.0,0,0,0.0,0,4,4,1,2,0,0,0,4,3
../kbl_data/2022-2023,S41G01N90,수원 KT,Away,최성모,3,0,0,0.0,1,1,100.0,1,1,100.0,0,0,0.0,0,1,1,2,0,0,0,0,0,0
../kbl_data/2022-2023,S41G01N90,수원 KT,Away,양홍석,16,5,6,83.3,2,9,22.2,7,15,46.7,0,0,0.0,1,2,3,4,1,0,0,0,4,4
../kbl_data/2022-2023,S41G01N90,수원 KT,Away,김준환,0,0,0,0.0,0,0,0.0,0,0,0.0,0,0,0.0,0,0,0,0,0,0,0,0,0,0
../kbl_data/2022-2023,S41G01N90,수원 KT,Away,하윤기,27,13,18,72.2,0,0,0.0,13,18,72.2,1,2,50.0,3,3,6,2,0,0,0,1,2,1
../kbl_data/2022-2023,S41G01N90,수원 KT,Away,이제이 아노시케,8,4,8,50.0,0,3,0.0,4,11,36.4,0,0,0.0,0,5,5,1,3,0,0,0,1,4
../kbl_data/2022-2023,S41G01N90,수원 KT,Away,랜드리 은노코,5,2,3,66.7,0,0,0.0,2,3,66.7,1,1,100.0,1,1,2,1,0,1,0,0,1,1
../kbl_data/2022-2023,S41G01N91,대구 한국가스공사,Home,박지훈,2,0,0,0.0,0,1,0.0,0,1,0.0,2,2,100.0,2,0,2,1,0,0,0,0,0,1
../kbl_data/2022-2023,S41G01N91,대구 한국가스공사,Home,조상열,0,0,0,0.0,0,2,0.0,0,2,0.0,0,0,0.0,0,0,0,0,0,0,0,0,3,1
../kbl_data/2022-2023,S41G01N91,대구 한국가스공사,Home,이원대,0,0,0,0.0,0,0,0.0,0,0,0.0,0,0,0.0,0,0,0,0,0,0,0,0,0,0
../kbl_data/2022-2023,S41G01N91,대구 한국가스공사,Home,이대헌,23,6,8,75.0,2,4,50.0,8,12,66.7,5,8,62.5,0,5,5,2,2,0,0,0,2,3
../kbl_data/2022-2023,S41G01N91,대구 한국가스공사,Home,이대성,9,2,7,28.6,1,3,33.3,3,10,30.0,2,4,50.0,0,1,1,3,1,0,0,0,1,3
../kbl_data/2022-2023,S41G01N91,대구 한국가스공사,Home,정효근,12,3,5,60.0,2,5,40.0,5,10,50.0,0,0,0.0,4,2,6,4,0,1,0,0,2,1
../kbl_data/2022-2023,S41G01N91,대구 한국가스공사,Home,머피 할로웨이,10,5,9,55.6,0,0,0.0,5,9,55.6,0,2,0.0,4,7,11,4,0,1,0,0,1,0
../kbl_data/2022-2023,S41G01N91,대구 한국가스공사,Home,우동현,2,0,0,0.0,0,0,0.0,0,0,0.0,2,2,100.0,1,0,1,2,0,0,0,0,2,2
../kbl_data/2022-2023,S41G01N91,대구 한국가스공사,Home,전현우,6,0,0,0.0,2,6,33.3,2,6,33.3,0,0,0.0,0,1,1,2,0,0,0,0,1,1
../kbl_data/2022-2023,S41G01N91,대구 한국가스공사,Home,신승민,0,0,0,0.0,0,1,0.0,0,1,0.0,0,0,0.0,0,2,2,1,0,0,0,0,0,3
../kbl_data/2022-2023,S41G01N91,대구 한국가스공사,Home,샘조세프 벨란겔,2,1,3,33.3,0,1,0.0,1,4,25.0,0,0,0.0,0,1,1,1,0,0,0,0,2,1
../kbl_data/2022-2023,S41G01N91,대구 한국가스공사,Home,유슈 은도예,11,4,5,80.0,0,0,0.0,4,5,80.0,3,5,60.0,2,4,6,1,0,1,0,2,0,1
../kbl_data/2022-2023,S41G01N91,원주 DB,Away,박찬희,0,0,0,0.0,0,0,0.0,0,0,0.0,0,0,0.0,0,0,0,0,0,0,0,0,0,0
../kbl_data/2022-2023,S41G01N91,원주 DB,Away,김현호,5,1,1,100.0,0,1,0.0,1,2,50.0,3,3,100.0,0,0,0,0,1,0,0,0,1,0
../kbl_data/2022-2023,S41G01N91,원주 DB,Away,두경민,10,2,6,33.3,1,6,16.7,3,12,25.0,3,3,100.0,0,1,1,2,1,0,0,0,0,2
../kbl_data/2022-2023,S41G01N91,원주 DB,Away,김종규,10,3,5,60.0,1,2,50.0,4,7,57.1,1,2,50.0,0,4,4,2,1,0,0,0,2,5
../kbl_data/2022-2023,S41G01N91,원주 DB,Away,최승욱,2,1,4,25.0,0,1,0.0,1,5,20.0,0,0,0.0,0,2,2,2,0,0,0,0,0,1
../kbl_data/2022-2023,S41G01N91,원주 DB,Away,윤성원,4,2,2,100.0,0,1,0.0,2,3,66.7,0,0,0.0,2,1,3,0,2,0,0,0,0,2
../kbl_data/2022-2023,S41G01N91,원주 DB,Away,레나드 프리먼,9,2,9,22.2,0,0,0.0,2,9,22.2,5,6,83.3,6,7,13,0,3,0,0,0,1,2
../kbl_data/2022-2023,S41G01N91,원주 DB,Away,정호영,2,1,2,50.0,0,0,0.0,1,2,50.0,0,0,0.0,0,1,1,1,0,0,0,0,0,1
../kbl_data/2022-2023,S41G01N91,원주 DB,Away,이선 알바노,21,9,16,56.2,1,4,25.0,10,20,50.0,0,0,0.0,2,2,4,8,2,0,0,0,1,4
../kbl_data/2022-2023,S41G01N91,원주 DB,Away,박인웅,7,2,3,66.7,1,3,33.3,3,6,50.0,0,0,0.0,1,1,2,0,1,0,0,0,1,1
../kbl_data/2022-2023,S41G01N91,원주 DB,Away,인승찬,0,0,0,0.0,0,0,0.0,0,0,0.0,0,0,0.0,0,0,0,1,0,0,0,0,0,0
../kbl_data/2022-2023,S41G01N91,원주 DB,Away,드미트리우스 트레드웰,2,1,1,100.0,0,0,0.0,1,1,100.0,0,0,0.0,2,1,3,0,0,0,0,0,3,2
../kbl_data/2022-2023,S41G01N92,서울 SK,Home,양우섭,0,0,1,0.0,0,1,0.0,0,2,0.0,0,0,0.0,0,0,0,0,0,0,0,0,0,0
../kbl_data/2022-2023,S41G01N92,서울 SK,Home,허일영,5,2,2,100.0,0,3,0.0,2,5,40.0,1,2,50.0,2,3,5,0,0,0,0,0,2,3
../kbl_data/2022-2023,S41G01N92,서울 SK,Home,김선형,23,9,12,75.0,1,1,100.0,10,13,76.9,2,2,100.0,0,2,2,4,0,0,0,0,4,0
../kbl_data/2022-2023,S41G01N92,서울 SK,Home,홍경기,5,1,2,50.0,1,1,100.0,2,3,66.7,0,0,0.0,1,0,1,0,0,0,0,0,0,1
../kbl_data/2022-2023,S41G01N92,서울 SK,Home,최부경,0,0,4,0.0,0,0,0.0,0,4,0.0,0,2,0.0,2,1,3,0,0,1,0,0,0,0
../kbl_data/2022-2023,S41G01N92,서울 SK,Home,리온 윌리엄스,6,2,4,50.0,0,0,0.0,2,4,50.0,2,2,100.0,1,0,1,0,0,0,0,0,0,2
../kbl_data/2022-2023,S41G01N92,서울 SK,Home,최원혁,0,0,0,0.0,0,0,0.0,0,0,0.0,0,0,0.0,1,0,1,0,0,0,0,0,0,2
../kbl_data/2022-2023,S41G01N92,서울 SK,Home,최준용,18,4,7,57.1,2,6,33.3,6,13,46.2,4,8,50.0,2,5,7,4,0,0,0,0,4,4
../kbl_data/2022-2023,S41G01N92,서울 SK,Home,최성원,6,0,0,0.0,2,4,50.0,2,4,50.0,0,0,0.0,0,4,4,3,1,0,1,0,1,1
../kbl_data/2022-2023,S41G01N92,서울 SK,Home,자밀 워니,20,9,16,56.2,0,1,0.0,9,17,52.9,2,4,50.0,0,5,5,2,4,0,0,0,0,3
../kbl_data/2022-2023,S41G01N92,서울 SK,Home,김형빈,0,0,0,0.0,0,0,0.0,0,0,0.0,0,0,0.0,0,0,0,0,0,0,0,0,0,0
../kbl_data/2022-2023,S41G01N92,서울 SK,Home,오재현,0,0,1,0.0,0,1,0.0,0,2,0.0,0,0,0.0,1,2,3,1,0,0,1,0,1,3
../kbl_data/2022-2023,S41G01N92,전주 KCC,Away,정창영,13,2,5,40.0,3,5,60.0,5,10,50.0,0,0,0.0,0,4,4,0,2,0,0,0,1,3
../kbl_data/2022-2023,S41G01N92,전주 KCC,Away,라건아,25,10,11,90.9,0,0,0.0,10,11,90.9,5,5,100.0,4,8,12,4,1,1,0,0,3,4
../kbl_data/2022-2023,S41G01N92,전주 KCC,Away,박경상,3,0,0,0.0,0,0,0.0,0,0,0.0,3,4,75.0,0,1,1,1,1,0,0,0,0,1
../kbl_data/2022-2023,S41G01N92,전주 KCC,Away,김지완,4,2,6,33.3,0,2,0.0,2,8,25.0,0,0,0.0,0,2,2,7,3,0,0,0,1,2
../kbl_data/2022-2023,S41G01N92,전주 KCC,Away,전준범,0,0,1,0.0,0,2,0.0,0,3,0.0,0,0,0.0,0,0,0,1,0,1,1,0,1,3
../kbl_data/2022-2023,S41G01N92,전주 KCC,Away,허웅,21,2,5,40.0,5,11,45.5,7,16,43.8,2,2,100.0,0,6,6,4,1,0,0,0,1,2
../kbl_data/2022-2023,S41G01N92,전주 KCC,Away,이승현,13,6,11,54.5,0,0,0.0,6,11,54.5,1,2,50.0,5,0,5,1,0,0,0,0,2,5
../kbl_data/2022-2023,S41G01N92,전주 KCC,Away,이진욱,0,0,0,0.0,0,0,0.0,0,0,0.0,0,0,0.0,0,0,0,0,0,0,0,0,0,0
../kbl_data/2022-2023,S41G01N92,전주 KCC,Away,곽정훈,0,0,0,0.0,0,0,0.0,0,0,0.0,0,0,0.0,0,0,0,0,0,0,0,0,0,0
../kbl_data/2022-2023,S41G01N92,전주 KCC,Away,이근휘,5,1,1,100.0,1,3,33.3,2,4,50.0,0,0,0.0,0,3,3,0,0,0,0,0,0,0
../kbl_data/2022-2023,S41G01N92,전주 KCC,Away,서정현,0,0,1,0.0,0,0,0.0,0,1,0.0,0,0,0.0,1,0,1,1,0,0,0,0,0,2
../kbl_data/2022-2023,S41G01N92,전주 KCC,Away,론데 홀리스 제퍼슨,4,2,4,50.0,0,0,0.0,2,4,50.0,0,0,0.0,1,0,1,2,0,0,0,0,0,1
../kbl_data/2022-2023,S41G01N93,창원 LG,Home,이관희,12,3,9,33.3,2,6,33.3,5,15,33.3,0,0,0.0,1,1,2,1,2,0,0,0,1,3
../kbl_data/2022-2023,S41G01N93,창원 LG,Home,정희재,0,0,1,0.0,0,1,0.0,0,2,0.0,0,0,0.0,0,0,0,1,1,0,0,0,1,1
../kbl_data/2022-2023,S41G01N93,창원 LG,Home,서민수,0,0,0,0.0,0,0,0.0,0,0,0.0,0,0,0.0,0,0,0,0,0,0,0,0,0,0
../kbl_data/2022-2023,S41G01N93,창원 LG,Home,한상혁,0,0,1,0.0,0,0,0.0,0,1,0.0,0,2,0.0,0,0,0,3,2,0,1,0,0,2
../kbl_data/2022-2023,S41G01N93,창원 LG,Home,이재도,3,0,4,0.0,1,2,50.0,1,6,16.7,0,0,0.0,1,4,5,3,1,0,0,0,1,0
../kbl_data/2022-2023,S41G01N93,창원 LG,Home,김준일,23,10,14,71.4,0,0,0.0,10,14,71.4,3,5,60.0,1,2,3,0,1,0,0,1,3,4
../kbl_data/2022-2023,S41G01N93,창원 LG,Home,최승욱,0,0,1,0.0,0,1,0.0,0,2,0.0,0,0,0.0,0,0,0,1,0,0,0,0,0,1
../kbl_data/2022-2023,S41G01N93,창원 LG,Home,윤원상,0,0,3,0.0,0,2,0.0,0,5,0.0,0,0,0.0,0,0,0,1,1,0,0,0,0,3
../kbl_data/2022-2023,S41G01N93,창원 LG,Home,아셈 마레이,6,3,6,50.0,0,0,0.0,3,6,50.0,0,0,0.0,4,6,10,0,1,3,0,1,3,1
../kbl_data/2022-2023,S41G01N93,창원 LG,Home,이승우,2,1,3,33.3,0,1,0.0,1,4,25.0,0,2,0.0,3,1,4,0,1,0,0,0,0,1
../kbl_data/2022-2023,S41G01N93,창원 LG,Home,저스틴 구탕,6,2,3,66.7,0,0,0.0,2,3,66.7,2,2,100.0,1,2,3,3,0,1,1,0,1,3
../kbl_data/2022-2023,S41G01N93,창원 LG,Home,단테 커닝햄,17,6,12,50.0,0,0,0.0,6,12,50.0,5,8,62.5,6,2,8,2,2,0,0,1,0,3
../kbl_data/2022-2023,S41G01N93,수원 KT,Away,김동욱,2,1,1,100.0,0,0,0.0,1,1,100.0,0,0,0.0,0,1,1,1,0,0,0,0,1,4
../kbl_data/2022-2023,S41G01N93,수원 KT,Away,김영환,9,0,2,0.0,0,1,0.0,0,3,0.0,9,11,81.8,1,1,2,2,0,0,0,0,1,3
../kbl_data/2022-2023,S41G01N93,수원 KT,Away,김민욱,3,0,0,0.0,1,1,100.0,1,1,100.0,0,0,0.0,0,3,3,0,0,0,0,0,0,1
../kbl_data/2022-2023,S41G01N93,수원 KT,Away,최창진,0,0,0,0.0,0,0,0.0,0,0,0.0,0,0,0.0,0,0,0,1,0,0,1,0,0,0
../kbl_data/2022-2023,S41G01N93,수원 KT,Away,이현석,0,0,0,0.0,0,0,0.0,0,0,0.0,0,0,0.0,0,0,0,0,0,0,0,0,0,0
../kbl_data/2022-2023,S41G01N93,수원 KT,Away,정성우,10,0,2,0.0,2,5,40.0,2,7,28.6,4,4,100.0,0,4,4,5,2,0,0,0,4,2
../kbl_data/2022-2023,S41G01N93,수원 KT,Away,최성모,0,0,1,0.0,0,2,0.0,0,3,0.0,0,0,0.0,1,1,2,3,0,0,0,0,1,0
../kbl_data/2022-2023,S41G01N93,수원 KT,Away,양홍석,14,4,5,80.0,2,7,28.6,6,12,50.0,0,0,0.0,0,8,8,1,1,0,0,0,3,3
../kbl_data/2022-2023,S41G01N93,수원 KT,Away,김준환,0,0,0,0.0,0,0,0.0,0,0,0.0,0,0,0.0,0,0,0,0,0,0,0,0,0,0
../kbl_data/2022-2023,S41G01N93,수원 KT,Away,하윤기,11,5,7,71.4,0,0,0.0,5,7,71.4,1,2,50.0,0,3,3,2,1,2,1,3,0,5
../kbl_data/2022-2023,S41G01N93,수원 KT,Away,이제이 아노시케,28,9,15,60.0,1,2,50.0,10,17,58.8,7,9,77.8,3,6,9,2,0,0,0,2,4,3
../kbl_data/2022-2023,S41G01N93,수원 KT,Away,랜드리 은노코,4,2,3,66.7,0,0,0.0,2,3,66.7,0,0,0.0,0,1,1,0,0,1,0,1,0,1
../kbl_data/2022-2023,S41G01N94,울산 현대모비스,Home,함지훈,2,1,2,50.0,0,1,0.0,1,3,33.3,0,0,0.0,1,5,6,1,0,0,0,0,2,0
../kbl_data/2022-2023,S41G01N94,울산 현대모비스,Home,김현민,0,0,0,0.0,0,0,0.0,0,0,0.0,0,0,0.0,0,0,0,0,0,0,0,0,0,1
../kbl_data/2022-2023,S41G01N94,울산 현대모비스,Home,장재석,10,5,7,71.4,0,0,0.0,5,7,71.4,0,0,0.0,3,2,5,1,0,1,0,0,0,2
../kbl_data/2022-2023,S41G01N94,울산 현대모비스,Home,김영현,16,2,3,66.7,4,6,66.7,6,9,66.7,0,0,0.0,2,3,5,1,0,0,1,0,0,5
../kbl_data/2022-2023,S41G01N94,울산 현대모비스,Home,김국찬,0,0,0,0.0,0,0,0.0,0,0,0.0,0,0,0.0,0,0,0,0,0,0,0,0,0,0
../kbl_data/2022-2023,S41G01N94,울산 현대모비스,Home,서명진,5,2,5,40.0,0,2,0.0,2,7,28.6,1,3,33.3,0,1,1,5,0,0,0,0,3,4
../kbl_data/2022-2023,S41G01N94,울산 현대모비스,Home,헨리 심스,0,0,1,0.0,0,0,0.0,0,1,0.0,0,0,0.0,0,1,1,0,0,0,0,0,1,1
../kbl_data/2022-2023,S41G01N94,울산 현대모비스,Home,이우석,10,2,5,40.0,0,4,0.0,2,9,22.2,6,6,100.0,1,2,3,1,0,0,0,0,1,2
../kbl_data/2022-2023,S41G01N94,울산 현대모비스,Home,신민석,0,0,0,0.0,0,2,0.0,0,2,0.0,0,0,0.0,0,2,2,0,0,0,0,0,0,0
../kbl_data/2022-2023,S41G01N94,울산 현대모비스,Home,론제이 아바리엔토스,8,1,3,33.3,1,10,10.0,2,13,15.4,3,3,100.0,0,2,2,7,4,0,0,0,2,1
../kbl_data/2022-2023,S41G01N94,울산 현대모비스,Home,게이지 프림,18,7,13,53.8,0,1,0.0,7,14,50.0,4,6,66.7,2,12,14,3,3,4,0,2,1,3
../kbl_data/2022-2023,S41G01N94,울산 현대모비스,Home,김태완,2,1,1,100.0,0,1,0.0,1,2,50.0,0,0,0.0,0,0,0,1,0,0,0,0,0,1
../kbl_data/2022-2023,S41G01N94,고양 캐롯,Away,김강선,0,0,0,0.0,0,0,0.0,0,0,0.0,0,0,0.0,0,0,0,0,0,0,0,0,0,0
../kbl_data/2022-2023,S41G01N94,고양 캐롯,Away,데이비드 사이먼,25,11,20,55.0,0,2,0.0,11,22,50.0,3,3,100.0,3,11,14,0,1,1,0,2,1,2
../kbl_data/2022-2023,S41G01N94,고양 캐롯,Away,최현민,5,1,2,50.0,1,5,20.0,2,7,28.6,0,0,0.0,1,1,2,0,0,0,2,0,1,3
../kbl_data/2022-2023,S41G01N94,고양 캐롯,Away,한호빈,6,0,0,0.0,2,2,100.0,2,2,100.0,0,0,0.0,0,0,0,1,1,0,0,0,1,2
../kbl_data/2022-2023,S41G01N94,고양 캐롯,Away,전성현,20,1,2,50.0,5,8,62.5,6,10,60.0,3,3,100.0,0,1,1,1,0,0,0,0,2,0
../kbl_data/2022-2023,S41G01N94,고양 캐롯,Away,정해원,0,0,0,0.0,0,0,0.0,0,0,0.0,0,0,0.0,0,0,0,0,0,0,0,0,0,0
../kbl_data/2022-2023,S41G01N94,고양 캐롯,Away,조한진,0,0,1,0.0,0,2,0.0,0,3,0.0,0,0,0.0,1,2,3,0,0,0,0,0,1,2
../kbl_data/2022-2023,S41G01N94,고양 캐롯,Away,김세창,9,1,5,20.0,2,3,66.7,3,8,37.5,1,2,50.0,0,4,4,2,0,0,0,0,0,3
../kbl_data/2022-2023,S41G01N94,고양 캐롯,Away,디드릭 로슨,0,0,2,0.0,0,0,0.0,0,2,0.0,0,0,0.0,0,2,2,3,1,1,0,0,1,1
../kbl_data/2022-2023,S41G01N94,고양 캐롯,Away,박진철,2,1,1,100.0,0,0,0.0,1,1,100.0,0,0,0.0,1,3,4,0,0,0,0,0,1,4
../kbl_data/2022-2023,S41G01N94,고양 캐롯,Away,이정현,10,1,7,14.3,1,4,25.0,2,11,18.2,5,6,83.3,1,4,5,6,0,0,1,0,2,1
../kbl_data/2022-2023,S41G01N94,고양 캐롯,Away,조재우,0,0,0,0.0,0,0,0.0,0,0,0.0,0,0,0.0,0,0,0,0,0,0,0,0,0,0
../kbl_data/2022-2023,S41G01N95,창원 LG,Home,이관희,8,1,6,16.7,2,6,33.3,3,12,25.0,0,0,0.0,0,3,3,3,2,0,1,0,1,0
../kbl_data/2022-2023,S41G01N95,창원 LG,Home,정희재,2,1,1,100.0,0,2,0.0,1,3,33.3,0,0,0.0,0,4,4,2,3,0,0,0,0,3
../kbl_data/2022-2023,S41G01N95,창원 LG,Home,한상혁,0,0,3,0.0,0,0,0.0,0,3,0.0,0,0,0.0,1,0,1,0,0,0,0,0,0,0
../kbl_data/2022-2023,S41G01N95,창원 LG,Home,이재도,0,0,0,0.0,0,4,0.0,0,4,0.0,0,0,0.0,0,0,0,1,2,0,1,0,0,1
../kbl_data/2022-2023,S41G01N95,창원 LG,Home,김준일,15,5,8,62.5,0,0,0.0,5,8,62.5,5,7,71.4,1,1,2,2,0,0,0,1,0,2
../kbl_data/2022-2023,S41G01N95,창원 LG,Home,정인덕,4,2,4,50.0,0,3,0.0,2,7,28.6,0,0,0.0,1,1,2,0,0,0,0,0,0,0
../kbl_data/2022-2023,S41G01N95,창원 LG,Home,이광진,2,1,1,100.0,0,2,0.0,1,3,33.3,0,0,0.0,1,0,1,0,0,0,0,0,0,1
../kbl_data/2022-2023,S41G01N95,창원 LG,Home,윤원상,0,0,1,0.0,0,1,0.0,0,2,0.0,0,0,0.0,0,1,1,1,1,0,0,0,0,3
../kbl_data/2022-2023,S41G01N95,창원 LG,Home,아셈 마레이,21,9,14,64.3,0,0,0.0,9,14,64.3,3,7,42.9,9,13,22,0,1,0,1,0,4,2
../kbl_data/2022-2023,S41G01N95,창원 LG,Home,이승우,5,2,4,50.0,0,1,0.0,2,5,40.0,1,2,50.0,3,0,3,3,1,0,0,0,0,0
../kbl_data/2022-2023,S41G01N95,창원 LG,Home,저스틴 구탕,9,4,8,50.0,0,0,0.0,4,8,50.0,1,1,100.0,0,3,3,5,1,0,0,1,3,4
../kbl_data/2022-2023,S41G01N95,창원 LG,Home,단테 커닝햄,11,5,6,83.3,0,0,0.0,5,6,83.3,1,1,100.0,3,2,5,0,0,0,0,0,0,2
../kbl_data/2022-2023,S41G01N95,서울 삼성,Away,이정현,6,0,3,0.0,2,5,40.0,2,8,25.0,0,0,0.0,0,4,4,3,1,0,0,0,7,3
../kbl_data/2022-2023,S41G01N95,서울 삼성,Away,장민국,2,1,5,20.0,0,2,0.0,1,7,14.3,0,0,0.0,0,3,3,0,1,0,0,0,0,3
../kbl_data/2022-2023,S41G01N95,서울 삼성,Away,김시래,4,2,6,33.3,0,0,0.0,2,6,33.3,0,0,0.0,0,4,4,3,0,0,0,0,1,1
../kbl_data/2022-2023,S41G01N95,서울 삼성,Away,김현수,4,2,2,100.0,0,1,0.0,2,3,66.7,0,0,0.0,1,0,1,1,0,0,1,0,0,1
../kbl_data/2022-2023,S41G01N95,서울 삼성,Away,임동섭,7,2,3,66.7,0,3,0.0,2,6,33.3,3,4,75.0,0,4,4,1,0,2,0,0,1,2
../kbl_data/2022-2023,S41G01N95,서울 삼성,Away,이호현,11,5,6,83.3,0,0,0.0,5,6,83.3,1,5,20.0,0,2,2,0,1,0,0,0,1,0
../kbl_data/2022-2023,S41G01N95,서울 삼성,Away,김광철,0,0,0,0.0,0,0,0.0,0,0,0.0,0,0,0.0,0,0,0,0,0,0,0,0,0,0
../kbl_data/2022-2023,S41G01N95,서울 삼성,Away,김한솔,2,1,2,50.0,0,2,0.0,1,4,25.0,0,0,0.0,0,1,1,0,0,0,0,0,1,2
../kbl_data/2022-2023,S41G01N95,서울 삼성,Away,전형준,0,0,0,0.0,0,0,0.0,0,0,0.0,0,0,0.0,0,0,0,0,0,0,0,0,0,0
../kbl_data/2022-2023,S41G01N95,서울 삼성,Away,조우성,4,1,4,25.0,0,0,0.0,1,4,25.0,2,2,100.0,2,2,4,1,0,0,0,0,4,4
../kbl_data/2022-2023,S41G01N95,서울 삼성,Away,이매뉴얼 테리,8,4,10,40.0,0,0,0.0,4,10,40.0,0,0,0.0,1,5,6,0,1,0,0,3,1,4
../kbl_data/2022-2023,S41G01N95,서울 삼성,Away,신동혁,7,2,3,66.7,1,2,50.0,3,5,60.0,0,0,0.0,0,2,2,0,0,0,0,0,0,1
../kbl_data/2022-2023,S41G01N96,대구 한국가스공사,Home,박지훈,18,8,16,50.0,0,2,0.0,8,18,44.4,2,2,100.0,4,4,8,4,2,0,0,0,2,8
../kbl_data/2022-2023,S41G01N96,대구 한국가스공사,Home,조상열,14,0,0,0.0,4,5,80.0,4,5,80.0,2,3,66.7,0,0,0,2,1,0,0,0,0,1
../kbl_data/2022-2023,S41G01N96,대구 한국가스공사,Home,이원대,0,0,0,0.0,0,0,0.0,0,0,0.0,0,0,0.0,0,0,0,0,0,0,0,0,0,0
../kbl_data/2022-2023,S41G01N96,대구 한국가스공사,Home,이대헌,7,3,5,60.0,0,2,0.0,3,7,42.9,1,2,50.0,0,5,5,2,0,0,0,0,3,4
../kbl_data/2022-2023,S41G01N96,대구 한국가스공사,Home,이대성,9,3,5,60.0,1,4,25.0,4,9,44.4,0,0,0.0,0,0,0,4,2,0,0,0,1,2
../kbl_data/2022-2023,S41G01N96,대구 한국가스공사,Home,정효근,14,1,2,50.0,3,5,60.0,4,7,57.1,3,4,75.0,1,5,6,4,0,0,0,0,1,3
../kbl_data/2022-2023,S41G01N96,대구 한국가스공사,Home,머피 할로웨이,16,7,11,63.6,0,0,0.0,7,11,63.6,2,2,100.0,2,4,6,3,0,0,0,1,4,2
../kbl_data/2022-2023,S41G01N96,대구 한국가스공사,Home,우동현,12,3,4,75.0,1,2,50.0,4,6,66.7,3,3,100.0,0,0,0,2,1,0,1,0,1,2
../kbl_data/2022-2023,S41G01N96,대구 한국가스공사,Home,전현우,7,2,3,66.7,1,3,33.3,3,6,50.0,0,0,0.0,0,2,2,1,0,0,0,0,1,1
../kbl_data/2022-2023,S41G01N96,대구 한국가스공사,Home,신승민,2,1,1,100.0,0,0,0.0,1,1,100.0,0,0,0.0,1,0,1,0,0,0,1,0,3,2
../kbl_data/2022-2023,S41G01N96,대구 한국가스공사,Home,샘조세프 벨란겔,6,0,0,0.0,2,3,66.7,2,3,66.7,0,0,0.0,0,0,0,1,0,0,0,0,1,1
../kbl_data/2022-2023,S41G01N96,대구 한국가스공사,Home,유슈 은도예,13,5,7,71.4,0,0,0.0,5,7,71.4,3,4,75.0,1,5,6,0,2,1,0,3,0,2
../kbl_data/2022-2023,S41G01N96,안양 KGC,Away,양희종,2,1,1,100.0,0,2,0.0,1,3,33.3,0,0,0.0,1,1,2,2,0,1,0,0,1,0
../kbl_data/2022-2023,S41G01N96,안양 KGC,Away,오세근,10,5,10,50.0,0,0,0.0,5,10,50.0,0,0,0.0,1,3,4,0,3,0,0,0,0,1
../kbl_data/2022-2023,S41G01N96,안양 KGC,Away,정준원,5,1,2,50.0,1,1,100.0,2,3,66.7,0,0,0.0,0,0,0,1,0,0,0,0,0,2
../kbl_data/2022-2023,S41G01N96,안양 KGC,Away,배병준,9,3,4,75.0,1,3,33.3,4,7,57.1,0,0,0.0,1,0,1,1,0,0,0,0,0,3
../kbl_data/2022-2023,S41G01N96,안양 KGC,Away,문성곤,6,0,0,0.0,2,6,33.3,2,6,33.3,0,0,0.0,1,1,2,1,2,0,0,0,1,1
../kbl_data/2022-2023,S41G01N96,안양 KGC,Away,박지훈,18,8,16,50.0,0,2,0.0,8,18,44.4,2,2,100.0,4,4,8,4,2,0,0,0,2,8
../kbl_data/2022-2023,S41G01N96,안양 KGC,Away,대릴 먼로,1,0,2,0.0,0,0,0.0,0,2,0.0,1,2,50.0,1,3,4,1,0,0,0,0,0,3
../kbl_data/2022-2023,S41G01N96,안양 KGC,Away,변준형,21,7,8,87.5,1,5,20.0,8,13,61.5,4,5,80.0,1,2,3,4,1,0,2,0,4,2
../kbl_data/2022-2023,S41G01N96,안양 KGC,Away,한승희,3,0,1,0.0,1,1,100.0,1,2,50.0,0,0,0.0,0,1,1,1,0,0,0,0,0,2
../kbl_data/2022-2023,S41G01N96,안양 KGC,Away,오마리 스펠맨,27,4,4,100.0,4,10,40.0,8,14,57.1,7,8,87.5,0,6,6,2,1,2,0,0,4,3
../kbl_data/2022-2023,S41G01N96,안양 KGC,Away,조은후,0,0,0,0.0,0,0,0.0,0,0,0.0,0,0,0.0,0,0,0,0,0,0,0,0,0,0
../kbl_data/2022-2023,S41G01N96,안양 KGC,Away,렌즈 아반도,2,1,2,50.0,0,0,0.0,1,2,50.0,0,0,0.0,1,0,1,0,0,0,0,0,0,0
../kbl_data/2022-2023,S41G01N97,원주 DB,Home,박찬희,0,0,0,0.0,0,1,0.0,0,1,0.0,0,0,0.0,0,0,0,0,0,0,0,0,0,1
../kbl_data/2022-2023,S41G01N97,원주 DB,Home,김현호,0,0,0,0.0,0,1,0.0,0,1,0.0,0,0,0.0,0,0,0,0,0,0,0,0,1,1
../kbl_data/2022-2023,S41G01N97,원주 DB,Home,두경민,4,1,3,33.3,0,2,0.0,1,5,20.0,2,2,100.0,1,0,1,0,0,0,0,0,1,4
../kbl_data/2022-2023,S41G01N97,원주 DB,Home,김종규,8,4,9,44.4,0,0,0.0,4,9,44.4,0,0,0.0,0,3,3,2,0,0,1,2,1,2
../kbl_data/2022-2023,S41G01N97,원주 DB,Home,최승욱,4,2,3,66.7,0,1,0.0,2,4,50.0,0,0,0.0,1,0,1,0,1,0,0,0,0,2
../kbl_data/2022-2023,S41G01N97,원주 DB,Home,윤성원,3,0,0,0.0,1,1,100.0,1,1,100.0,0,0,0.0,1,1,2,0,0,0,0,0,1,0
../kbl_data/2022-2023,S41G01N97,원주 DB,Home,레나드 프리먼,6,1,4,25.0,0,0,0.0,1,4,25.0,4,6,66.7,5,6,11,3,2,2,0,0,3,2
../kbl_data/2022-2023,S41G01N97,원주 DB,Home,정호영,2,1,5,20.0,0,3,0.0,1,8,12.5,0,0,0.0,1,3,4,1,0,0,0,0,3,1
../kbl_data/2022-2023,S41G01N97,원주 DB,Home,이선 알바노,21,6,13,46.2,2,5,40.0,8,18,44.4,3,3,100.0,3,2,5,2,3,0,0,0,3,2
../kbl_data/2022-2023,S41G01N97,원주 DB,Home,박인웅,7,3,4,75.0,0,3,0.0,3,7,42.9,1,2,50.0,0,1,1,1,1,0,0,0,2,0
../kbl_data/2022-2023,S41G01N97,원주 DB,Home,인승찬,9,3,6,50.0,1,2,50.0,4,8,50.0,0,0,0.0,0,1,1,1,3,0,0,0,1,3
../kbl_data/2022-2023,S41G01N97,원주 DB,Home,드미트리우스 트레드웰,4,2,3,66.7,0,0,0.0,2,3,66.7,0,0,0.0,0,4,4,3,0,0,0,0,2,2
../kbl_data/2022-2023,S41G01N97,서울 SK,Away,양우섭,2,1,1,100.0,0,1,0.0,1,2,50.0,0,0,0.0,0,2,2,2,0,0,0,0,0,0
../kbl_data/2022-2023,S41G01N97,서울 SK,Away,허일영,16,2,5,40.0,3,3,100.0,5,8,62.5,3,3,100.0,2,3,5,0,3,0,0,0,0,2
../kbl_data/2022-2023,S41G01N97,서울 SK,Away,김선형,7,1,2,50.0,1,2,50.0,2,4,50.0,2,2,100.0,0,1,1,7,3,0,0,0,1,3
../kbl_data/2022-2023,S41G01N97,서울 SK,Away,홍경기,4,2,3,66.7,0,2,0.0,2,5,40.0,0,0,0.0,0,1,1,2,1,0,0,0,1,3
../kbl_data/2022-2023,S41G01N97,서울 SK,Away,최부경,2,0,1,0.0,0,0,0.0,0,1,0.0,2,2,100.0,0,0,0,1,1,0,0,0,0,2
../kbl_data/2022-2023,S41G01N97,서울 SK,Away,리온 윌리엄스,15,3,7,42.9,1,2,50.0,4,9,44.4,6,6,100.0,1,11,12,2,2,0,0,0,4,2
../kbl_data/2022-2023,S41G01N97,서울 SK,Away,최원혁,2,1,3,33.3,0,0,0.0,1,3,33.3,0,0,0.0,0,1,1,2,1,0,0,0,2,0
../kbl_data/2022-2023,S41G01N97,서울 SK,Away,최준용,5,1,2,50.0,1,1,100.0,2,3,66.7,0,0,0.0,1,2,3,3,0,1,0,0,1,1
../kbl_data/2022-2023,S41G01N97,서울 SK,Away,최성원,11,0,1,0.0,3,6,50.0,3,7,42.9,2,3,66.7,0,1,1,2,2,0,0,0,1,1
../kbl_data/2022-2023,S41G01N97,서울 SK,Away,자밀 워니,26,10,15,66.7,2,2,100.0,12,17,70.6,0,0,0.0,3,4,7,1,0,0,0,2,1,1
../kbl_data/2022-2023,S41G01N97,서울 SK,Away,김형빈,2,1,2,50.0,0,0,0.0,1,2,50.0,0,0,0.0,0,2,2,0,0,0,0,0,0,1
../kbl_data/2022-2023,S41G01N97,서울 SK,Away,오재현,5,1,2,50.0,1,3,33.3,2,5,40.0,0,2,0.0,1,1,2,2,2,0,0,0,1,1
../kbl_data/2022-2023,S41G01N98,전주 KCC,Home,정창영,5,1,3,33.3,1,2,50.0,2,5,40.0,0,0,0.0,0,3,3,2,1,0,0,0,2,2
../kbl_data/2022-2023,S41G01N98,전주 KCC,Home,라건아,22,6,8,75.0,2,3,66.7,8,11,72.7,4,4,100.0,3,12,15,2,0,1,0,2,1,4
../kbl_data/2022-2023,S41G01N98,전주 KCC,Home,박경상,3,0,0,0.0,1,1,100.0,1,1,100.0,0,0,0.0,0,0,0,0,0,0,0,0,1,1
../kbl_data/2022-2023,S41G01N98,전주 KCC,Home,김지완,0,0,0,0.0,0,3,0.0,0,3,0.0,0,0,0.0,1,0,1,3,1,0,0,0,2,3
../kbl_data/2022-2023,S41G01N98,전주 KCC,Home,전준범,3,0,0,0.0,1,2,50.0,1,2,50.0,0,0,0.0,0,2,2,2,1,0,0,0,1,2
../kbl_data/2022-2023,S41G01N98,전주 KCC,Home,허웅,17,2,5,40.0,2,4,50.0,4,9,44.4,7,8,87.5,0,1,1,7,1,0,0,0,4,2
../kbl_data/2022-2023,S41G01N98,전주 KCC,Home,이승현,20,8,12,66.7,1,1,100.0,9,13,69.2,1,2,50.0,0,3,3,4,2,0,0,0,1,2
../kbl_data/2022-2023,S41G01N98,전주 KCC,Home,이진욱,0,0,0,0.0,0,0,0.0,0,0,0.0,0,0,0.0,0,0,0,1,0,0,0,0,0,0
../kbl_data/2022-2023,S41G01N98,전주 KCC,Home,곽정훈,0,0,0,0.0,0,0,0.0,0,0,0.0,0,0,0.0,0,0,0,0,0,0,0,0,0,0
../kbl_data/2022-2023,S41G01N98,전주 KCC,Home,이근휘,0,0,0,0.0,0,2,0.0,0,2,0.0,0,0,0.0,0,2,2,0,0,0,0,0,0,0
../kbl_data/2022-2023,S41G01N98,전주 KCC,Home,서정현,2,1,2,50.0,0,0,0.0,1,2,50.0,0,0,0.0,1,0,1,0,0,0,0,0,0,2
../kbl_data/2022-2023,S41G01N98,전주 KCC,Home,론데 홀리스 제퍼슨,7,3,6,50.0,0,0,0.0,3,6,50.0,1,1,100.0,0,1,1,0,0,0,0,0,1,0
../kbl_data/2022-2023,S41G01N98,울산 현대모비스,Away,함지훈,12,4,5,80.0,1,1,100.0,5,6,83.3,1,2,50.0,1,2,3,4,0,1,0,0,0,1
../kbl_data/2022-2023,S41G01N98,울산 현대모비스,Away,김현민,0,0,0,0.0,0,0,0.0,0,0,0.0,0,0,0.0,0,0,0,0,0,0,0,0,0,0
../kbl_data/2022-2023,S41G01N98,울산 현대모비스,Away,장재석,8,4,7,57.1,0,0,0.0,4,7,57.1,0,0,0.0,5,1,6,4,2,0,0,1,1,1
../kbl_data/2022-2023,S41G01N98,울산 현대모비스,Away,김영현,6,0,1,0.0,2,3,66.7,2,4,50.0,0,0,0.0,0,0,0,2,1,0,0,0,0,4
../kbl_data/2022-2023,S41G01N98,울산 현대모비스,Away,김국찬,6,0,0,0.0,2,2,100.0,2,2,100.0,0,0,0.0,0,1,1,0,0,0,0,0,0,4
../kbl_data/2022-2023,S41G01N98,울산 현대모비스,Away,서명진,13,2,4,50.0,2,5,40.0,4,9,44.4,3,7,42.9,0,1,1,3,1,0,0,0,0,0
../kbl_data/2022-2023,S41G01N98,울산 현대모비스,Away,헨리 심스,2,1,1,100.0,0,0,0.0,1,1,100.0,0,0,0.0,1,1,2,1,0,0,0,0,0,0
../kbl_data/2022-2023,S41G01N98,울산 현대모비스,Away,이우석,8,4,6,66.7,0,3,0.0,4,9,44.4,0,0,0.0,2,3,5,1,2,0,0,0,0,0
../kbl_data/2022-2023,S41G01N98,울산 현대모비스,Away,신민석,0,0,0,0.0,0,0,0.0,0,0,0.0,0,0,0.0,0,0,0,0,0,0,0,0,0,0
../kbl_data/2022-2023,S41G01N98,울산 현대모비스,Away,론제이 아바리엔토스,8,0,3,0.0,2,6,33.3,2,9,22.2,2,2,100.0,0,1,1,4,2,0,0,0,2,0
../kbl_data/2022-2023,S41G01N98,울산 현대모비스,Away,게이지 프림,20,8,16,50.0,0,0,0.0,8,16,50.0,4,5,80.0,3,6,9,3,2,1,0,1,4,3
../kbl_data/2022-2023,S41G01N98,울산 현대모비스,Away,김태완,0,0,0,0.0,0,2,0.0,0,2,0.0,0,0,0.0,0,1,1,0,0,0,0,0,1,3
../kbl_data/2022-2023,S41G01N99,원주 DB,Home,김현호,2,1,1,100.0,0,1,0.0,1,2,50.0,0,0,0.0,1,1,2,0,2,0,0,0,1,2
../kbl_data/2022-2023,S41G01N99,원주 DB,Home,두경민,23,6,11,54.5,3,4,75.0,9,15,60.0,2,2,100.0,1,2,3,4,0,0,1,0,1,3
../kbl_data/2022-2023,S41G01N99,원주 DB,Home,김종규,16,6,7,85.7,0,1,0.0,6,8,75.0,4,4,100.0,2,2,4,2,0,0,0,1,2,2
../kbl_data/2022-2023,S41G01N99,원주 DB,Home,최승욱,21,7,9,77.8,2,3,66.7,9,12,75.0,1,2,50.0,1,1,2,2,1,1,1,0,0,3
../kbl_data/2022-2023,S41G01N99,원주 DB,Home,윤성원,3,0,3,0.0,1,1,100.0,1,4,25.0,0,0,0.0,1,0,1,0,0,0,0,0,1,1
../kbl_data/2022-2023,S41G01N99,원주 DB,Home,이준희,2,1,1,100.0,0,0,0.0,1,1,100.0,0,0,0.0,0,1,1,0,0,0,0,0,0,1
../kbl_data/2022-2023,S41G01N99,원주 DB,Home,레나드 프리먼,6,2,2,100.0,0,0,0.0,2,2,100.0,2,2,100.0,1,6,7,2,1,0,0,1,0,4
../kbl_data/2022-2023,S41G01N99,원주 DB,Home,정호영,0,0,2,0.0,0,1,0.0,0,3,0.0,0,0,0.0,0,1,1,1,0,0,0,0,0,1
../kbl_data/2022-2023,S41G01N99,원주 DB,Home,이선 알바노,8,3,8,37.5,0,2,0.0,3,10,30.0,2,2,100.0,1,1,2,4,1,0,0,0,1,2
../kbl_data/2022-2023,S41G01N99,원주 DB,Home,박인웅,4,2,3,66.7,0,0,0.0,2,3,66.7,0,0,0.0,2,1,3,0,0,0,0,0,2,0
../kbl_data/2022-2023,S41G01N99,원주 DB,Home,인승찬,0,0,0,0.0,0,0,0.0,0,0,0.0,0,0,0.0,0,0,0,0,0,0,0,0,0,0
../kbl_data/2022-2023,S41G01N99,원주 DB,Home,드미트리우스 트레드웰,6,2,6,33.3,0,0,0.0,2,6,33.3,2,2,100.0,1,7,8,0,0,0,0,0,4,4
../kbl_data/2022-2023,S41G01N99,고양 캐롯,Away,김강선,0,0,0,0.0,0,0,0.0,0,0,0.0,0,0,0.0,0,0,0,0,0,0,0,0,0,0
../kbl_data/2022-2023,S41G01N99,고양 캐롯,Away,데이비드 사이먼,4,2,6,33.3,0,0,0.0,2,6,33.3,0,0,0.0,1,4,5,1,0,0,0,0,0,0
../kbl_data/2022-2023,S41G01N99,고양 캐롯,Away,최현민,5,1,1,100.0,1,6,16.7,2,7,28.6,0,0,0.0,0,3,3,0,0,0,0,0,1,3
../kbl_data/2022-2023,S41G01N99,고양 캐롯,Away,한호빈,0,0,0,0.0,0,1,0.0,0,1,0.0,0,0,0.0,0,0,0,2,1,0,0,0,2,2
../kbl_data/2022-2023,S41G01N99,고양 캐롯,Away,이정제,0,0,0,0.0,0,0,0.0,0,0,0.0,0,0,0.0,0,0,0,0,0,0,0,0,0,0
../kbl_data/2022-2023,S41G01N99,고양 캐롯,Away,전성현,34,3,5,60.0,8,15,53.3,11,20,55.0,4,4,100.0,0,0,0,2,1,0,0,0,4,2
../kbl_data/2022-2023,S41G01N99,고양 캐롯,Away,정해원,0,0,0,0.0,0,0,0.0,0,0,0.0,0,0,0.0,0,0,0,0,0,0,0,0,0,0
../kbl_data/2022-2023,S41G01N99,고양 캐롯,Away,조한진,0,0,0,0.0,0,0,0.0,0,0,0.0,0,0,0.0,0,0,0,0,0,0,0,0,0,0
../kbl_data/2022-2023,S41G01N99,고양 캐롯,Away,김세창,0,0,0,0.0,0,0,0.0,0,0,0.0,0,0,0.0,0,0,0,2,0,0,3,0,0,2
../kbl_data/2022-2023,S41G01N99,고양 캐롯,Away,디드릭 로슨,21,6,12,50.0,1,4,25.0,7,16,43.8,6,7,85.7,5,7,12,3,1,2,0,0,1,3
../kbl_data/2022-2023,S41G01N99,고양 캐롯,Away,박진철,4,2,3,66.7,0,0,0.0,2,3,66.7,0,0,0.0,1,1,2,1,0,0,1,1,1,3
../kbl_data/2022-2023,S41G01N99,고양 캐롯,Away,이정현,14,0,2,0.0,3,9,33.3,3,11,27.3,5,5,100.0,0,2,2,1,2,1,0,0,1,2
../kbl_data/2022-2023,S41G01N100,대구 한국가스공사,Home,박지훈,5,1,2,50.0,1,2,50.0,2,4,50.0,0,0,0.0,0,1,1,1,3,0,0,0,0,5
../kbl_data/2022-2023,S41G01N100,대구 한국가스공사,Home,조상열,6,0,1,0.0,2,3,66.7,2,4,50.0,0,0,0.0,0,0,0,0,0,0,0,0,1,0
../kbl_data/2022-2023,S41G01N100,대구 한국가스공사,Home,이원대,0,0,0,0.0,0,0,0.0,0,0,0.0,0,0,0.0,0,0,0,0,0,0,0,0,0,0
../kbl_data/2022-2023,S41G01N100,대구 한국가스공사,Home,이대헌,11,4,5,80.0,0,0,0.0,4,5,80.0,3,4,75.0,1,1,2,2,0,0,0,0,1,1
../kbl_data/2022-2023,S41G01N100,대구 한국가스공사,Home,이대성,24,4,10,40.0,4,9,44.4,8,19,42.1,4,4,100.0,0,4,4,4,0,0,0,0,0,2
../kbl_data/2022-2023,S41G01N100,대구 한국가스공사,Home,정효근,12,3,4,75.0,1,2,50.0,4,6,66.7,3,4,75.0,0,4,4,1,1,0,0,0,0,2
../kbl_data/2022-2023,S41G01N100,대구 한국가스공사,Home,머피 할로웨이,17,8,11,72.7,0,0,0.0,8,11,72.7,1,1,100.0,4,13,17,6,2,2,0,1,3,3
../kbl_data/2022-2023,S41G01N100,대구 한국가스공사,Home,우동현,5,1,1,100.0,1,3,33.3,2,4,50.0,0,0,0.0,0,1,1,3,0,0,0,0,0,5
../kbl_data/2022-2023,S41G01N100,대구 한국가스공사,Home,전현우,2,0,0,0.0,0,5,0.0,0,5,0.0,2,2,100.0,0,1,1,1,0,0,0,0,0,2
../kbl_data/2022-2023,S41G01N100,대구 한국가스공사,Home,신승민,5,0,1,0.0,1,1,100.0,1,2,50.0,2,2,100.0,2,1,3,0,0,0,0,0,0,3
../kbl_data/2022-2023,S41G01N100,대구 한국가스공사,Home,샘조세프 벨란겔,2,1,1,100.0,0,0,0.0,1,1,100.0,0,0,0.0,0,0,0,2,0,0,0,0,0,1
../kbl_data/2022-2023,S41G01N100,대구 한국가스공사,Home,유슈 은도예,0,0,0,0.0,0,0,0.0,0,0,0.0,0,2,0.0,0,1,1,0,0,0,0,0,0,0
../kbl_data/2022-2023,S41G01N100,서울 삼성,Away,이정현,17,2,5,40.0,3,8,37.5,5,13,38.5,4,5,80.0,0,2,2,5,0,0,0,0,0,4
../kbl_data/2022-2023,S41G01N100,서울 삼성,Away,장민국,8,1,5,20.0,2,5,40.0,3,10,30.0,0,2,0.0,1,1,2,5,0,0,0,0,0,0
../kbl_data/2022-2023,S41G01N100,서울 삼성,Away,김시래,8,1,4,25.0,0,1,0.0,1,5,20.0,6,8,75.0,0,1,1,5,0,0,0,0,2,2
../kbl_data/2022-2023,S41G01N100,서울 삼성,Away,김현수,0,0,0,0.0,0,0,0.0,0,0,0.0,0,0,0.0,0,0,0,0,0,0,0,0,0,0
../kbl_data/2022-2023,S41G01N100,서울 삼성,Away,임동섭,14,2,4,50.0,3,5,60.0,5,9,55.6,1,3,33.3,3,1,4,0,0,0,0,0,0,4
../kbl_data/2022-2023,S41G01N100,서울 삼성,Away,이호현,4,2,3,66.7,0,0,0.0,2,3,66.7,0,0,0.0,0,1,1,3,0,0,0,0,0,0
../kbl_data/2022-2023,S41G01N100,서울 삼성,Away,김광철,0,0,0,0.0,0,0,0.0,0,0,0.0,0,0,0.0,0,0,0,0,0,0,0,0,1,0
../kbl_data/2022-2023,S41G01N100,서울 삼성,Away,김한솔,0,0,0,0.0,0,0,0.0,0,0,0.0,0,0,0.0,0,0,0,0,0,0,0,0,0,0
../kbl_data/2022-2023,S41G01N100,서울 삼성,Away,전형준,0,0,0,0.0,0,0,0.0,0,0,0.0,0,0,0.0,0,0,0,0,0,0,0,0,0,0
../kbl_data/2022-2023,S41G01N100,서울 삼성,Away,조우성,5,2,3,66.7,0,0,0.0,2,3,66.7,1,1,100.0,0,0,0,0,0,0,0,0,0,4
../kbl_data/2022-2023,S41G01N100,서울 삼성,Away,이매뉴얼 테리,11,5,13,38.5,0,1,0.0,5,14,35.7,1,3,33.3,4,14,18,1,3,0,0,1,2,1
../kbl_data/2022-2023,S41G01N100,서울 삼성,Away,신동혁,14,1,2,50.0,4,5,80.0,5,7,71.4,0,0,0.0,0,0,0,2,1,0,0,0,1,3
../kbl_data/2022-2023,S41G01N101,수원 KT,Home,김영환,16,1,5,20.0,4,8,50.0,5,13,38.5,2,4,50.0,2,3,5,1,2,0,0,0,1,2
../kbl_data/2022-2023,S41G01N101,수원 KT,Home,김민욱,0,0,0,0.0,0,2,0.0,0,2,0.0,0,0,0.0,0,1,1,0,0,0,0,0,0,1
../kbl_data/2022-2023,S41G01N101,수원 KT,Home,최창진,0,0,0,0.0,0,0,0.0,0,0,0.0,0,0,0.0,0,2,2,2,0,0,0,0,0,1
../kbl_data/2022-2023,S41G01N101,수원 KT,Home,이현석,6,0,1,0.0,2,2,100.0,2,3,66.7,0,0,0.0,2,3,5,0,1,0,0,0,1,0
../kbl_data/2022-2023,S41G01N101,수원 KT,Home,정성우,7,3,6,50.0,0,4,0.0,3,10,30.0,1,2,50.0,0,1,1,3,0,0,0,0,1,3
../kbl_data/2022-2023,S41G01N101,수원 KT,Home,최성모,0,0,1,0.0,0,0,0.0,0,1,0.0,0,0,0.0,0,0,0,1,0,0,0,0,0,0
../kbl_data/2022-2023,S41G01N101,수원 KT,Home,양홍석,9,3,9,33.3,1,6,16.7,4,15,26.7,0,0,0.0,4,4,8,5,2,0,0,0,3,3
../kbl_data/2022-2023,S41G01N101,수원 KT,Home,박지원,0,0,0,0.0,0,0,0.0,0,0,0.0,0,0,0.0,0,0,0,0,0,0,0,0,0,0
../kbl_data/2022-2023,S41G01N101,수원 KT,Home,김준환,0,0,0,0.0,0,1,0.0,0,1,0.0,0,0,0.0,0,0,0,0,0,0,0,0,0,1
../kbl_data/2022-2023,S41G01N101,수원 KT,Home,하윤기,15,6,10,60.0,0,0,0.0,6,10,60.0,3,4,75.0,0,2,2,1,1,0,0,1,1,0
../kbl_data/2022-2023,S41G01N101,수원 KT,Home,이제이 아노시케,14,4,9,44.4,2,5,40.0,6,14,42.9,0,0,0.0,6,5,11,2,1,0,0,1,2,4
../kbl_data/2022-2023,S41G01N101,수원 KT,Home,랜드리 은노코,4,2,3,66.7,0,0,0.0,2,3,66.7,0,0,0.0,1,1,2,0,0,0,0,0,0,3
../kbl_data/2022-2023,S41G01N101,서울 SK,Away,양우섭,0,0,2,0.0,0,0,0.0,0,2,0.0,0,0,0.0,0,1,1,0,0,0,0,0,0,1
../kbl_data/2022-2023,S41G01N101,서울 SK,Away,허일영,10,2,3,66.7,2,6,33.3,4,9,44.4,0,0,0.0,1,4,5,0,0,0,0,0,0,2
../kbl_data/2022-2023,S41G01N101,서울 SK,Away,김선형,16,4,6,66.7,2,3,66.7,6,9,66.7,2,2,100.0,0,3,3,4,3,1,0,0,2,3
../kbl_data/2022-2023,S41G01N101,서울 SK,Away,홍경기,0,0,0,0.0,0,0,0.0,0,0,0.0,0,0,0.0,0,0,0,0,0,0,0,0,0,0
../kbl_data/2022-2023,S41G01N101,서울 SK,Away,최부경,6,3,6,50.0,0,0,0.0,3,6,50.0,0,0,0.0,3,6,9,0,1,0,0,0,1,1
../kbl_data/2022-2023,S41G01N101,서울 SK,Away,리온 윌리엄스,2,1,2,50.0,0,1,0.0,1,3,33.3,0,0,0.0,0,1,1,0,0,0,0,0,1,1
../kbl_data/2022-2023,S41G01N101,서울 SK,Away,최원혁,0,0,0,0.0,0,0,0.0,0,0,0.0,0,0,0.0,0,0,0,0,0,0,0,0,0,0
../kbl_data/2022-2023,S41G01N101,서울 SK,Away,최준용,12,3,6,50.0,1,1,100.0,4,7,57.1,3,4,75.0,3,4,7,6,1,1,0,0,1,2
../kbl_data/2022-2023,S41G01N101,서울 SK,Away,최성원,0,0,2,0.0,0,1,0.0,0,3,0.0,0,0,0.0,0,0,0,1,0,0,0,0,1,2
../kbl_data/2022-2023,S41G01N101,서울 SK,Away,자밀 워니,31,13,22,59.1,0,3,0.0,13,25,52.0,5,6,83.3,4,9,13,4,1,1,0,1,3,1
../kbl_data/2022-2023,S41G01N101,서울 SK,Away,김형빈,0,0,2,0.0,0,0,0.0,0,2,0.0,0,0,0.0,0,0,0,0,0,0,0,0,0,1
../kbl_data/2022-2023,S41G01N101,서울 SK,Away,오재현,2,1,1,100.0,0,0,0.0,1,1,100.0,0,0,0.0,0,0,0,1,0,0,0,0,0,3
../kbl_data/2022-2023,S41G01N102,안양 KGC,Home,양희종,0,0,0,0.0,0,1,0.0,0,1,0.0,0,0,0.0,0,1,1,2,0,0,0,0,1,2
../kbl_data/2022-2023,S41G01N102,안양 KGC,Home,오세근,22,10,16,62.5,0,0,0.0,10,16,62.5,2,2,100.0,5,5,10,1,0,0,0,0,0,2
../kbl_data/2022-2023,S41G01N102,안양 KGC,Home,정준원,0,0,0,0.0,0,0,0.0,0,0,0.0,0,0,0.0,0,0,0,0,0,0,0,0,0,0
../kbl_data/2022-2023,S41G01N102,안양 KGC,Home,배병준,7,2,3,66.7,1,5,20.0,3,8,37.5,0,0,0.0,0,3,3,1,0,0,0,0,0,2
../kbl_data/2022-2023,S41G01N102,안양 KGC,Home,문성곤,5,0,0,0.0,1,4,25.0,1,4,25.0,2,2,100.0,0,0,0,3,1,0,1,0,0,1
../kbl_data/2022-2023,S41G01N102,안양 KGC,Home,박지훈,5,1,3,33.3,1,2,50.0,2,5,40.0,0,0,0.0,0,1,1,1,0,0,1,0,1,1
../kbl_data/2022-2023,S41G01N102,안양 KGC,Home,이우정,0,0,0,0.0,0,0,0.0,0,0,0.0,0,0,0.0,0,0,0,0,0,0,0,0,0,0
../kbl_data/2022-2023,S41G01N102,안양 KGC,Home,대릴 먼로,6,3,3,100.0,0,0,0.0,3,3,100.0,0,0,0.0,3,5,8,4,0,0,0,0,1,2
../kbl_data/2022-2023,S41G01N102,안양 KGC,Home,변준형,9,3,7,42.9,1,4,25.0,4,11,36.4,0,0,0.0,2,1,3,3,3,0,0,0,1,4
../kbl_data/2022-2023,S41G01N102,안양 KGC,Home,한승희,0,0,0,0.0,0,0,0.0,0,0,0.0,0,0,0.0,0,0,0,0,0,0,1,0,0,2
../kbl_data/2022-2023,S41G01N102,안양 KGC,Home,오마리 스펠맨,16,5,10,50.0,2,6,33.3,7,16,43.8,0,0,0.0,1,4,5,2,1,0,0,3,0,0
../kbl_data/2022-2023,S41G01N102,안양 KGC,Home,렌즈 아반도,10,3,7,42.9,0,1,0.0,3,8,37.5,4,7,57.1,2,1,3,2,0,0,1,0,3,2
../kbl_data/2022-2023,S41G01N102,전주 KCC,Away,정창영,18,7,9,77.8,1,2,50.0,8,11,72.7,1,2,50.0,0,4,4,5,1,0,0,0,2,2
../kbl_data/2022-2023,S41G01N102,전주 KCC,Away,라건아,21,6,10,60.0,2,3,66.7,8,13,61.5,3,3,100.0,1,6,7,1,0,1,0,0,3,1
../kbl_data/2022-2023,S41G01N102,전주 KCC,Away,박경상,5,1,1,100.0,1,1,100.0,2,2,100.0,0,1,0.0,0,1,1,2,1,0,0,0,2,4
../kbl_data/2022-2023,S41G01N102,전주 KCC,Away,김지완,0,0,2,0.0,0,3,0.0,0,5,0.0,0,0,0.0,0,0,0,0,0,0,0,0,1,2
../kbl_data/2022-2023,S41G01N102,전주 KCC,Away,김상규,2,1,1,100.0,0,0,0.0,1,1,100.0,0,0,0.0,1,1,2,1,0,0,0,0,0,0
../kbl_data/2022-2023,S41G01N102,전주 KCC,Away,전준범,0,0,0,0.0,0,1,0.0,0,1,0.0,0,0,0.0,0,1,1,1,0,1,0,0,1,2
../kbl_data/2022-2023,S41G01N102,전주 KCC,Away,허웅,22,2,4,50.0,4,8,50.0,6,12,50.0,6,6,100.0,0,2,2,4,2,0,0,0,1,4
../kbl_data/2022-2023,S41G01N102,전주 KCC,Away,이승현,13,4,5,80.0,1,2,50.0,5,7,71.4,2,2,100.0,0,8,8,8,0,0,0,0,0,0
../kbl_data/2022-2023,S41G01N102,전주 KCC,Away,곽정훈,0,0,0,0.0,0,0,0.0,0,0,0.0,0,0,0.0,0,0,0,0,0,0,0,0,0,0
../kbl_data/2022-2023,S41G01N102,전주 KCC,Away,이근휘,9,0,0,0.0,3,3,100.0,3,3,100.0,0,0,0.0,0,1,1,0,0,0,0,0,1,2
../kbl_data/2022-2023,S41G01N102,전주 KCC,Away,론데 홀리스 제퍼슨,2,1,3,33.3,0,0,0.0,1,3,33.3,0,0,0.0,0,1,1,1,0,0,0,0,0,0
../kbl_data/2022-2023,S41G01N102,전주 KCC,Away,송동훈,0,0,0,0.0,0,1,0.0,0,1,0.0,0,0,0.0,1,0,1,2,0,0,0,0,0,0
../kbl_data/2022-2023,S41G01N103,울산 현대모비스,Home,함지훈,7,3,5,60.0,0,1,0.0,3,6,50.0,1,2,50.0,1,0,1,6,0,0,0,0,0,3
../kbl_data/2022-2023,S41G01N103,울산 현대모비스,Home,김현민,0,0,0,0.0,0,1,0.0,0,1,0.0,0,0,0.0,0,0,0,0,0,0,0,0,0,1
../kbl_data/2022-2023,S41G01N103,울산 현대모비스,Home,장재석,2,1,1,100.0,0,0,0.0,1,1,100.0,0,0,0.0,1,5,6,5,1,1,0,0,4,2
../kbl_data/2022-2023,S41G01N103,울산 현대모비스,Home,김영현,2,1,2,50.0,0,0,0.0,1,2,50.0,0,0,0.0,0,1,1,1,0,0,0,0,1,2
../kbl_data/2022-2023,S41G01N103,울산 현대모비스,Home,김국찬,0,0,0,0.0,0,1,0.0,0,1,0.0,0,0,0.0,0,1,1,0,0,0,0,0,0,1
../kbl_data/2022-2023,S41G01N103,울산 현대모비스,Home,서명진,5,1,4,25.0,1,4,25.0,2,8,25.0,0,0,0.0,0,1,1,3,0,0,0,0,0,3
../kbl_data/2022-2023,S41G01N103,울산 현대모비스,Home,헨리 심스,11,3,4,75.0,1,2,50.0,4,6,66.7,2,2,100.0,2,4,6,0,0,1,0,1,0,1
../kbl_data/2022-2023,S41G01N103,울산 현대모비스,Home,이우석,14,6,11,54.5,0,0,0.0,6,11,54.5,2,2,100.0,0,4,4,2,2,0,0,0,5,1
../kbl_data/2022-2023,S41G01N103,울산 현대모비스,Home,신민석,2,0,0,0.0,0,0,0.0,0,0,0.0,2,2,100.0,0,0,0,0,0,0,0,0,0,0
../kbl_data/2022-2023,S41G01N103,울산 현대모비스,Home,론제이 아바리엔토스,21,6,9,66.7,2,6,33.3,8,15,53.3,3,3,100.0,0,0,0,6,1,0,0,0,1,1
../kbl_data/2022-2023,S41G01N103,울산 현대모비스,Home,게이지 프림,25,9,13,69.2,0,0,0.0,9,13,69.2,7,8,87.5,6,10,16,1,5,0,0,2,2,2
../kbl_data/2022-2023,S41G01N103,울산 현대모비스,Home,김태완,0,0,2,0.0,0,0,0.0,0,2,0.0,0,0,0.0,0,0,0,0,0,0,0,0,0,0
../kbl_data/2022-2023,S41G01N103,원주 DB,Away,김현호,3,0,0,0.0,1,1,100.0,1,1,100.0,0,0,0.0,0,0,0,0,0,0,0,0,1,1
../kbl_data/2022-2023,S41G01N103,원주 DB,Away,두경민,2,1,6,16.7,0,2,0.0,1,8,12.5,0,0,0.0,0,3,3,4,1,0,0,0,3,3
../kbl_data/2022-2023,S41G01N103,원주 DB,Away,김종규,22,11,18,61.1,0,0,0.0,11,18,61.1,0,0,0.0,1,2,3,1,0,0,0,0,1,2
../kbl_data/2022-2023,S41G01N103,원주 DB,Away,최승욱,6,2,5,40.0,0,0,0.0,2,5,40.0,2,2,100.0,1,4,5,1,2,0,0,0,2,0
../kbl_data/2022-2023,S41G01N103,원주 DB,Away,윤성원,6,1,1,100.0,1,1,100.0,2,2,100.0,1,2,50.0,2,1,3,0,0,0,0,0,1,2
../kbl_data/2022-2023,S41G01N103,원주 DB,Away,이윤수,0,0,1,0.0,0,0,0.0,0,1,0.0,0,0,0.0,1,0,1,1,0,0,0,0,1,2
../kbl_data/2022-2023,S41G01N103,원주 DB,Away,이준희,2,1,4,25.0,0,0,0.0,1,4,25.0,0,0,0.0,0,0,0,1,0,0,0,0,0,2
../kbl_data/2022-2023,S41G01N103,원주 DB,Away,레나드 프리먼,10,5,8,62.5,0,0,0.0,5,8,62.5,0,2,0.0,2,3,5,3,4,0,0,0,0,3
../kbl_data/2022-2023,S41G01N103,원주 DB,Away,정호영,0,0,1,0.0,0,0,0.0,0,1,0.0,0,0,0.0,0,1,1,0,0,0,0,0,0,0
../kbl_data/2022-2023,S41G01N103,원주 DB,Away,이선 알바노,18,6,13,46.2,0,2,0.0,6,15,40.0,6,6,100.0,1,1,2,8,2,0,1,0,2,2
../kbl_data/2022-2023,S41G01N103,원주 DB,Away,박인웅,2,0,1,0.0,0,0,0.0,0,1,0.0,2,4,50.0,1,1,2,0,0,0,0,0,0,1
../kbl_data/2022-2023,S41G01N103,원주 DB,Away,드미트리우스 트레드웰,4,2,8,25.0,0,0,0.0,2,8,25.0,0,0,0.0,4,0,4,1,0,0,0,0,1,0
../kbl_data/2022-2023,S41G01N104,대구 한국가스공사,Home,박지훈,3,0,1,0.0,1,2,50.0,1,3,33.3,0,0,0.0,0,1,1,0,1,0,0,0,0,0
../kbl_data/2022-2023,S41G01N104,대구 한국가스공사,Home,이원대,0,0,0,0.0,0,0,0.0,0,0,0.0,0,0,0.0,1,1,2,1,1,0,0,0,1,0
../kbl_data/2022-2023,S41G01N104,대구 한국가스공사,Home,이대헌,6,3,7,42.9,0,1,0.0,3,8,37.5,0,0,0.0,2,1,3,3,1,0,1,0,1,4
../kbl_data/2022-2023,S41G01N104,대구 한국가스공사,Home,이대성,21,6,18,33.3,1,3,33.3,7,21,33.3,6,6,100.0,0,2,2,3,2,1,0,0,1,1
../kbl_data/2022-2023,S41G01N104,대구 한국가스공사,Home,정효근,6,1,6,16.7,1,3,33.3,2,9,22.2,1,4,25.0,2,3,5,0,0,0,1,0,1,3
../kbl_data/2022-2023,S41G01N104,대구 한국가스공사,Home,머피 할로웨이,13,5,12,41.7,0,0,0.0,5,12,41.7,3,4,75.0,2,12,14,2,1,2,0,0,1,0
../kbl_data/2022-2023,S41G01N104,대구 한국가스공사,Home,우동현,4,1,2,50.0,0,2,0.0,1,4,25.0,2,2,100.0,1,1,2,0,0,0,0,0,0,2
../kbl_data/2022-2023,S41G01N104,대구 한국가스공사,Home,전현우,5,1,1,100.0,0,1,0.0,1,2,50.0,3,3,100.0,0,0,0,0,0,0,0,0,1,0
../kbl_data/2022-2023,S41G01N104,대구 한국가스공사,Home,신승민,0,0,0,0.0,0,0,0.0,0,0,0.0,0,0,0.0,0,0,0,0,0,0,0,0,0,1
../kbl_data/2022-2023,S41G01N104,대구 한국가스공사,Home,샘조세프 벨란겔,5,1,2,50.0,1,1,100.0,2,3,66.7,0,0,0.0,2,0,2,2,1,0,0,0,0,1
../kbl_data/2022-2023,S41G01N104,대구 한국가스공사,Home,유슈 은도예,6,3,4,75.0,0,0,0.0,3,4,75.0,0,0,0.0,1,1,2,0,0,0,0,1,0,4
../kbl_data/2022-2023,S41G01N104,대구 한국가스공사,Home,염유성,0,0,0,0.0,0,0,0.0,0,0,0.0,0,0,0.0,0,0,0,0,0,0,0,0,0,0
../kbl_data/2022-2023,S41G01N104,창원 LG,Away,이관희,14,4,4,100.0,2,7,28.6,6,11,54.5,0,0,0.0,0,6,6,1,1,0,0,0,1,1
../kbl_data/2022-2023,S41G01N104,창원 LG,Away,정희재,7,1,2,50.0,1,4,25.0,2,6,33.3,2,2,100.0,0,3,3,4,1,0,0,0,1,3
../kbl_data/2022-2023,S41G01N104,창원 LG,Away,한상혁,0,0,0,0.0,0,0,0.0,0,0,0.0,0,0,0.0,0,0,0,0,0,0,0,0,0,0
../kbl_data/2022-2023,S41G01N104,창원 LG,Away,이재도,6,2,6,33.3,0,0,0.0,2,6,33.3,2,2,100.0,2,3,5,2,1,1,0,0,2,1
../kbl_data/2022-2023,S41G01N104,창원 LG,Away,김준일,4,2,5,40.0,0,0,0.0,2,5,40.0,0,0,0.0,1,1,2,6,1,0,0,0,1,3
../kbl_data/2022-2023,S41G01N104,창원 LG,Away,정인덕,5,1,3,33.3,1,1,100.0,2,4,50.0,0,0,0.0,0,0,0,0,0,0,0,0,0,0
../kbl_data/2022-2023,S41G01N104,창원 LG,Away,김준형,0,0,0,0.0,0,0,0.0,0,0,0.0,0,0,0.0,0,0,0,0,0,0,0,0,0,0
../kbl_data/2022-2023,S41G01N104,창원 LG,Away,윤원상,12,3,4,75.0,2,2,100.0,5,6,83.3,0,0,0.0,1,0,1,0,0,0,0,0,0,2
../kbl_data/2022-2023,S41G01N104,창원 LG,Away,아셈 마레이,17,7,13,53.8,0,0,0.0,7,13,53.8,3,4,75.0,4,7,11,0,0,1,0,0,2,1
../kbl_data/2022-2023,S41G01N104,창원 LG,Away,이승우,0,0,0,0.0,0,0,0.0,0,0,0.0,0,0,0.0,0,1,1,0,0,0,0,0,0,0
../kbl_data/2022-2023,S41G01N104,창원 LG,Away,저스틴 구탕,4,2,6,33.3,0,1,0.0,2,7,28.6,0,0,0.0,1,4,5,6,1,0,1,0,1,4
../kbl_data/2022-2023,S41G01N104,창원 LG,Away,단테 커닝햄,11,5,8,62.5,0,0,0.0,5,8,62.5,1,2,50.0,3,6,9,1,0,3,0,1,2,3
../kbl_data/2022-2023,S41G01N105,고양 캐롯,Home,김강선,6,0,1,0.0,2,4,50.0,2,5,40.0,0,0,0.0,1,1,2,0,1,1,0,0,1,5
../kbl_data/2022-2023,S41G01N105,고양 캐롯,Home,데이비드 사이먼,9,4,7,57.1,0,0,0.0,4,7,57.1,1,1,100.0,1,4,5,2,1,1,0,2,2,1
../kbl_data/2022-2023,S41G01N105,고양 캐롯,Home,이정제,0,0,0,0.0,0,0,0.0,0,0,0.0,0,0,0.0,0,1,1,0,0,0,0,0,0,0
../kbl_data/2022-2023,S41G01N105,고양 캐롯,Home,전성현,26,4,6,66.7,6,10,60.0,10,16,62.5,0,0,0.0,2,0,2,7,1,0,0,0,1,1
../kbl_data/2022-2023,S41G01N105,고양 캐롯,Home,정해원,2,1,1,100.0,0,0,0.0,1,1,100.0,0,0,0.0,0,1,1,0,1,0,0,0,0,0
../kbl_data/2022-2023,S41G01N105,고양 캐롯,Home,조한진,5,1,1,100.0,1,3,33.3,2,4,50.0,0,0,0.0,0,3,3,1,2,0,0,0,0,1
../kbl_data/2022-2023,S41G01N105,고양 캐롯,Home,김세창,1,0,0,0.0,0,0,0.0,0,0,0.0,1,2,50.0,0,0,0,1,0,0,0,0,0,0
../kbl_data/2022-2023,S41G01N105,고양 캐롯,Home,디드릭 로슨,22,6,9,66.7,2,3,66.7,8,12,66.7,4,4,100.0,1,7,8,3,2,0,0,1,1,2
../kbl_data/2022-2023,S41G01N105,고양 캐롯,Home,박진철,0,0,1,0.0,0,0,0.0,0,1,0.0,0,0,0.0,0,0,0,0,0,0,0,0,0,2
../kbl_data/2022-2023,S41G01N105,고양 캐롯,Home,이정현,22,2,6,33.3,6,7,85.7,8,13,61.5,0,0,0.0,1,3,4,7,0,0,0,0,2,2
../kbl_data/2022-2023,S41G01N105,고양 캐롯,Home,모리구치 히사시,0,0,1,0.0,0,0,0.0,0,1,0.0,0,0,0.0,0,0,0,0,0,0,0,0,0,0
../kbl_data/2022-2023,S41G01N105,고양 캐롯,Home,안정욱,13,0,1,0.0,4,8,50.0,4,9,44.4,1,2,50.0,1,2,3,2,1,0,1,0,2,4
../kbl_data/2022-2023,S41G01N105,서울 SK,Away,양우섭,1,0,1,0.0,0,1,0.0,0,2,0.0,1,2,50.0,0,1,1,0,1,0,0,0,0,1
../kbl_data/2022-2023,S41G01N105,서울 SK,Away,허일영,3,0,0,0.0,1,3,33.3,1,3,33.3,0,0,0.0,1,1,2,0,0,0,0,0,0,2
../kbl_data/2022-2023,S41G01N105,서울 SK,Away,김선형,15,6,9,66.7,0,2,0.0,6,11,54.5,3,3,100.0,0,2,2,3,1,0,0,0,4,2
../kbl_data/2022-2023,S41G01N105,서울 SK,Away,홍경기,0,0,1,0.0,0,4,0.0,0,5,0.0,0,0,0.0,0,0,0,0,0,0,1,0,0,1
../kbl_data/2022-2023,S41G01N105,서울 SK,Away,최부경,8,4,5,80.0,0,0,0.0,4,5,80.0,0,0,0.0,3,2,5,1,1,0,0,0,0,1
../kbl_data/2022-2023,S41G01N105,서울 SK,Away,리온 윌리엄스,8,1,1,100.0,2,3,66.7,3,4,75.0,0,0,0.0,0,2,2,1,0,0,0,0,1,0
../kbl_data/2022-2023,S41G01N105,서울 SK,Away,최원혁,0,0,0,0.0,0,0,0.0,0,0,0.0,0,0,0.0,0,0,0,0,0,0,0,0,0,0
../kbl_data/2022-2023,S41G01N105,서울 SK,Away,최준용,13,5,9,55.6,1,3,33.3,6,12,50.0,0,1,0.0,3,2,5,2,1,0,0,0,4,2
../kbl_data/2022-2023,S41G01N105,서울 SK,Away,최성원,8,0,0,0.0,2,4,50.0,2,4,50.0,2,2,100.0,1,1,2,4,1,0,0,0,2,1
../kbl_data/2022-2023,S41G01N105,서울 SK,Away,자밀 워니,20,7,12,58.3,1,1,100.0,8,13,61.5,3,6,50.0,3,7,10,2,0,1,0,0,1,2
../kbl_data/2022-2023,S41G01N105,서울 SK,Away,김형빈,4,2,2,100.0,0,0,0.0,2,2,100.0,0,0,0.0,1,2,3,0,0,0,0,0,0,1
../kbl_data/2022-2023,S41G01N105,서울 SK,Away,오재현,4,2,4,50.0,0,3,0.0,2,7,28.6,0,0,0.0,1,0,1,2,2,0,0,0,0,4
../kbl_data/2022-2023,S41G01N106,수원 KT,Home,김동욱,0,0,0,0.0,0,2,0.0,0,2,0.0,0,0,0.0,0,1,1,0,0,0,0,0,0,0
../kbl_data/2022-2023,S41G01N106,수원 KT,Home,김영환,6,0,4,0.0,2,5,40.0,2,9,22.2,0,0,0.0,3,1,4,3,0,0,0,0,0,2
../kbl_data/2022-2023,S41G01N106,수원 KT,Home,김민욱,0,0,0,0.0,0,0,0.0,0,0,0.0,0,0,0.0,0,0,0,0,0,0,0,0,0,0
../kbl_data/2022-2023,S41G01N106,수원 KT,Home,최창진,0,0,2,0.0,0,1,0.0,0,3,0.0,0,0,0.0,0,0,0,0,0,0,0,0,0,2
../kbl_data/2022-2023,S41G01N106,수원 KT,Home,이현석,3,0,1,0.0,1,3,33.3,1,4,25.0,0,0,0.0,2,5,7,2,1,0,0,0,0,2
../kbl_data/2022-2023,S41G01N106,수원 KT,Home,정성우,23,5,9,55.6,4,7,57.1,9,16,56.2,1,1,100.0,1,3,4,3,1,0,0,0,1,1
../kbl_data/2022-2023,S41G01N106,수원 KT,Home,최성모,0,0,1,0.0,0,1,0.0,0,2,0.0,0,0,0.0,1,0,1,0,0,0,0,0,0,1
../kbl_data/2022-2023,S41G01N106,수원 KT,Home,양홍석,4,1,3,33.3,0,1,0.0,1,4,25.0,2,2,100.0,0,1,1,1,0,0,0,0,0,1
../kbl_data/2022-2023,S41G01N106,수원 KT,Home,박지원,1,0,2,0.0,0,0,0.0,0,2,0.0,1,2,50.0,1,0,1,3,2,0,0,0,2,4
../kbl_data/2022-2023,S41G01N106,수원 KT,Home,하윤기,19,7,8,87.5,0,0,0.0,7,8,87.5,5,6,83.3,3,6,9,3,0,0,0,1,0,1
../kbl_data/2022-2023,S41G01N106,수원 KT,Home,이제이 아노시케,21,3,7,42.9,5,16,31.2,8,23,34.8,0,0,0.0,0,8,8,2,1,2,0,0,1,2
../kbl_data/2022-2023,S41G01N106,수원 KT,Home,랜드리 은노코,0,0,0,0.0,0,1,0.0,0,1,0.0,0,0,0.0,0,0,0,0,0,0,0,0,0,0
../kbl_data/2022-2023,S41G01N106,안양 KGC,Away,양희종,7,3,3,100.0,0,1,0.0,3,4,75.0,1,1,100.0,0,3,3,1,1,0,0,0,0,4
../kbl_data/2022-2023,S41G01N106,안양 KGC,Away,오세근,9,4,8,50.0,0,1,0.0,4,9,44.4,1,2,50.0,0,6,6,1,0,0,0,0,0,3
../kbl_data/2022-2023,S41G01N106,안양 KGC,Away,정준원,0,0,0,0.0,0,1,0.0,0,1,0.0,0,0,0.0,0,0,0,1,0,0,0,0,0,0
../kbl_data/2022-2023,S41G01N106,안양 KGC,Away,배병준,0,0,0,0.0,0,1,0.0,0,1,0.0,0,0,0.0,0,1,1,0,0,0,0,0,1,0
../kbl_data/2022-2023,S41G01N106,안양 KGC,Away,문성곤,9,2,2,100.0,1,3,33.3,3,5,60.0,2,2,100.0,1,5,6,3,2,0,0,0,1,3
../kbl_data/2022-2023,S41G01N106,안양 KGC,Away,박지훈,2,1,2,50.0,0,0,0.0,1,2,50.0,0,0,0.0,0,1,1,3,0,0,0,0,1,0
../kbl_data/2022-2023,S41G01N106,안양 KGC,Away,대릴 먼로,2,1,1,100.0,0,1,0.0,1,2,50.0,0,0,0.0,0,3,3,1,0,0,0,0,0,1
../kbl_data/2022-2023,S41G01N106,안양 KGC,Away,변준형,21,5,8,62.5,3,3,100.0,8,11,72.7,2,2,100.0,1,2,3,7,0,2,0,0,1,3
../kbl_data/2022-2023,S41G01N106,안양 KGC,Away,한승희,0,0,1,0.0,0,0,0.0,0,1,0.0,0,0,0.0,0,1,1,1,0,0,0,0,1,1
../kbl_data/2022-2023,S41G01N106,안양 KGC,Away,오마리 스펠맨,22,5,9,55.6,4,10,40.0,9,19,47.4,0,0,0.0,2,6,8,4,0,0,0,1,0,3
../kbl_data/2022-2023,S41G01N106,안양 KGC,Away,렌즈 아반도,15,3,8,37.5,3,5,60.0,6,13,46.2,0,0,0.0,1,2,3,1,0,4,0,0,0,1
../kbl_data/2022-2023,S41G01N106,안양 KGC,Away,고찬혁,2,0,0,0.0,0,0,0.0,0,0,0.0,2,3,66.7,0,0,0,0,0,0,0,0,0,0
../kbl_data/2022-2023,S41G01N107,전주 KCC,Home,정창영,0,0,2,0.0,0,1,0.0,0,3,0.0,0,0,0.0,1,0,1,2,0,0,1,0,1,4
../kbl_data/2022-2023,S41G01N107,전주 KCC,Home,라건아,5,2,5,40.0,0,1,0.0,2,6,33.3,1,2,50.0,1,4,5,0,0,1,0,0,0,0
../kbl_data/2022-2023,S41G01N107,전주 KCC,Home,박경상,3,1,1,100.0,0,2,0.0,1,3,33.3,1,1,100.0,0,1,1,1,0,0,0,0,0,1
../kbl_data/2022-2023,S41G01N107,전주 KCC,Home,김지완,0,0,1,0.0,0,1,0.0,0,2,0.0,0,0,0.0,0,1,1,0,1,0,0,0,0,2
../kbl_data/2022-2023,S41G01N107,전주 KCC,Home,김상규,0,0,0,0.0,0,0,0.0,0,0,0.0,0,0,0.0,0,0,0,0,0,0,0,0,0,0
../kbl_data/2022-2023,S41G01N107,전주 KCC,Home,전준범,4,1,1,100.0,0,1,0.0,1,2,50.0,2,2,100.0,0,0,0,0,1,0,0,0,0,2
../kbl_data/2022-2023,S41G01N107,전주 KCC,Home,허웅,27,6,10,60.0,4,8,50.0,10,18,55.6,3,5,60.0,0,3,3,4,1,0,0,0,2,2
../kbl_data/2022-2023,S41G01N107,전주 KCC,Home,이승현,8,2,7,28.6,0,0,0.0,2,7,28.6,4,4,100.0,5,5,10,4,1,0,0,0,2,1
../kbl_data/2022-2023,S41G01N107,전주 KCC,Home,곽정훈,0,0,0,0.0,0,0,0.0,0,0,0.0,0,0,0.0,0,0,0,0,0,0,0,0,0,0
../kbl_data/2022-2023,S41G01N107,전주 KCC,Home,이근휘,7,2,2,100.0,1,4,25.0,3,6,50.0,0,0,0.0,0,1,1,0,0,0,0,0,0,4
../kbl_data/2022-2023,S41G01N107,전주 KCC,Home,론데 홀리스 제퍼슨,15,5,9,55.6,0,2,0.0,5,11,45.5,5,6,83.3,0,0,0,0,1,0,1,1,1,0
../kbl_data/2022-2023,S41G01N107,전주 KCC,Home,송동훈,3,0,1,0.0,1,2,50.0,1,3,33.3,0,0,0.0,0,1,1,1,2,0,0,0,0,2
../kbl_data/2022-2023,S41G01N107,서울 삼성,Away,이정현,30,6,9,66.7,5,8,62.5,11,17,64.7,3,5,60.0,0,4,4,3,1,0,0,0,1,3
../kbl_data/2022-2023,S41G01N107,서울 삼성,Away,장민국,5,1,1,100.0,1,4,25.0,2,5,40.0,0,0,0.0,1,1,2,0,0,0,0,0,0,4
../kbl_data/2022-2023,S41G01N107,서울 삼성,Away,김시래,10,3,3,100.0,0,1,0.0,3,4,75.0,4,5,80.0,0,1,1,4,0,0,0,0,3,1
../kbl_data/2022-2023,S41G01N107,서울 삼성,Away,김현수,0,0,0,0.0,0,0,0.0,0,0,0.0,0,0,0.0,0,0,0,1,0,0,0,0,0,1
../kbl_data/2022-2023,S41G01N107,서울 삼성,Away,임동섭,0,0,0,0.0,0,1,0.0,0,1,0.0,0,0,0.0,0,1,1,1,0,0,0,0,0,0
../kbl_data/2022-2023,S41G01N107,서울 삼성,Away,이호현,14,3,7,42.9,2,2,100.0,5,9,55.6,2,2,100.0,0,5,5,6,1,0,0,0,1,1
../kbl_data/2022-2023,S41G01N107,서울 삼성,Away,김광철,0,0,0,0.0,0,1,0.0,0,1,0.0,0,0,0.0,0,0,0,0,0,0,0,0,0,0
../kbl_data/2022-2023,S41G01N107,서울 삼성,Away,김한솔,0,0,0,0.0,0,0,0.0,0,0,0.0,0,0,0.0,0,0,0,0,0,0,0,0,0,0
../kbl_data/2022-2023,S41G01N107,서울 삼성,Away,조우성,10,5,7,71.4,0,0,0.0,5,7,71.4,0,0,0.0,4,6,10,1,1,1,0,0,0,4
../kbl_data/2022-2023,S41G01N107,서울 삼성,Away,이매뉴얼 테리,16,8,13,61.5,0,0,0.0,8,13,61.5,0,0,0.0,1,10,11,2,0,3,0,4,2,1
../kbl_data/2022-2023,S41G01N107,서울 삼성,Away,신동혁,2,1,1,100.0,0,1,0.0,1,2,50.0,0,0,0.0,1,1,2,0,0,0,0,0,1,3
../kbl_data/2022-2023,S41G01N107,서울 삼성,Away,조나단 알렛지,0,0,0,0.0,0,0,0.0,0,0,0.0,0,0,0.0,0,0,0,0,0,0,0,0,2,4
../kbl_data/2022-2023,S41G01N108,대구 한국가스공사,Home,박지훈,2,1,1,100.0,0,1,0.0,1,2,50.0,0,0,0.0,1,0,1,0,0,0,0,0,1,3
../kbl_data/2022-2023,S41G01N108,대구 한국가스공사,Home,이원대,0,0,1,0.0,0,2,0.0,0,3,0.0,0,0,0.0,0,0,0,3,0,1,0,0,0,1
../kbl_data/2022-2023,S41G01N108,대구 한국가스공사,Home,이대헌,23,7,9,77.8,2,3,66.7,9,12,75.0,3,5,60.0,0,0,0,0,2,0,0,0,1,3
../kbl_data/2022-2023,S41G01N108,대구 한국가스공사,Home,이대성,10,4,6,66.7,0,2,0.0,4,8,50.0,2,2,100.0,0,2,2,0,1,0,0,0,1,0
../kbl_data/2022-2023,S41G01N108,대구 한국가스공사,Home,정효근,12,2,3,66.7,1,3,33.3,3,6,50.0,5,6,83.3,1,3,4,2,0,0,0,0,2,2
../kbl_data/2022-2023,S41G01N108,대구 한국가스공사,Home,머피 할로웨이,8,3,5,60.0,0,0,0.0,3,5,60.0,2,2,100.0,1,5,6,5,1,0,0,0,0,1
../kbl_data/2022-2023,S41G01N108,대구 한국가스공사,Home,우동현,7,2,2,100.0,0,2,0.0,2,4,50.0,3,5,60.0,0,0,0,2,0,0,2,0,0,4
../kbl_data/2022-2023,S41G01N108,대구 한국가스공사,Home,전현우,14,2,3,66.7,3,7,42.9,5,10,50.0,1,2,50.0,0,0,0,0,0,0,0,0,1,3
../kbl_data/2022-2023,S41G01N108,대구 한국가스공사,Home,신승민,2,1,2,50.0,0,1,0.0,1,3,33.3,0,0,0.0,0,1,1,0,0,0,1,0,1,1
../kbl_data/2022-2023,S41G01N108,대구 한국가스공사,Home,샘조세프 벨란겔,0,0,1,0.0,0,1,0.0,0,2,0.0,0,0,0.0,1,0,1,1,1,0,0,0,1,0
../kbl_data/2022-2023,S41G01N108,대구 한국가스공사,Home,유슈 은도예,0,0,1,0.0,0,0,0.0,0,1,0.0,0,0,0.0,1,2,3,0,1,0,0,0,1,0
../kbl_data/2022-2023,S41G01N108,대구 한국가스공사,Home,염유성,2,1,2,50.0,0,1,0.0,1,3,33.3,0,0,0.0,0,0,0,0,0,0,0,0,0,0
../kbl_data/2022-2023,S41G01N108,원주 DB,Away,김현호,5,1,1,100.0,1,1,100.0,2,2,100.0,0,0,0.0,0,1,1,0,0,0,0,0,0,5
../kbl_data/2022-2023,S41G01N108,원주 DB,Away,두경민,43,3,4,75.0,9,13,69.2,12,17,70.6,10,10,100.0,0,2,2,8,1,0,0,0,2,1
../kbl_data/2022-2023,S41G01N108,원주 DB,Away,김종규,15,6,7,85.7,1,2,50.0,7,9,77.8,0,0,0.0,2,2,4,7,0,1,0,2,1,3
../kbl_data/2022-2023,S41G01N108,원주 DB,Away,최승욱,6,3,3,100.0,0,2,0.0,3,5,60.0,0,0,0.0,2,2,4,5,1,0,0,0,0,1
../kbl_data/2022-2023,S41G01N108,원주 DB,Away,윤성원,5,0,1,0.0,1,3,33.3,1,4,25.0,2,2,100.0,1,2,3,1,0,0,0,0,0,1
../kbl_data/2022-2023,S41G01N108,원주 DB,Away,이준희,0,0,1,0.0,0,1,0.0,0,2,0.0,0,0,0.0,0,0,0,0,0,0,0,0,0,0
../kbl_data/2022-2023,S41G01N108,원주 DB,Away,레나드 프리먼,14,5,7,71.4,0,0,0.0,5,7,71.4,4,6,66.7,1,7,8,2,0,0,0,0,1,0
../kbl_data/2022-2023,S41G01N108,원주 DB,Away,정호영,4,1,1,100.0,0,1,0.0,1,2,50.0,2,2,100.0,0,0,0,0,1,1,0,0,0,0
../kbl_data/2022-2023,S41G01N108,원주 DB,Away,이선 알바노,5,1,3,33.3,1,2,50.0,2,5,40.0,0,0,0.0,0,0,0,3,0,0,0,0,1,2
../kbl_data/2022-2023,S41G01N108,원주 DB,Away,박인웅,10,2,3,66.7,2,2,100.0,4,5,80.0,0,0,0.0,1,1,2,1,2,0,0,0,2,5
../kbl_data/2022-2023,S41G01N108,원주 DB,Away,인승찬,0,0,0,0.0,0,0,0.0,0,0,0.0,0,0,0.0,1,1,2,0,0,0,0,0,0,0
../kbl_data/2022-2023,S41G01N108,원주 DB,Away,드미트리우스 트레드웰,4,2,3,66.7,0,0,0.0,2,3,66.7,0,0,0.0,0,4,4,1,1,0,0,1,3,1
../kbl_data/2022-2023,S41G01N109,안양 KGC,Home,양희종,0,0,0,0.0,0,1,0.0,0,1,0.0,0,0,0.0,0,0,0,0,0,0,0,0,0,2
../kbl_data/2022-2023,S41G01N109,안양 KGC,Home,오세근,14,6,10,60.0,0,0,0.0,6,10,60.0,2,3,66.7,4,5,9,4,0,0,0,0,2,1
../kbl_data/2022-2023,S41G01N109,안양 KGC,Home,정준원,2,1,2,50.0,0,0,0.0,1,2,50.0,0,0,0.0,0,1,1,0,0,0,0,0,0,0
../kbl_data/2022-2023,S41G01N109,안양 KGC,Home,배병준,0,0,1,0.0,0,0,0.0,0,1,0.0,0,0,0.0,0,0,0,1,0,0,0,0,1,0
../kbl_data/2022-2023,S41G01N109,안양 KGC,Home,문성곤,6,0,1,0.0,2,4,50.0,2,5,40.0,0,0,0.0,6,5,11,2,0,1,0,0,0,2
../kbl_data/2022-2023,S41G01N109,안양 KGC,Home,박지훈,3,0,0,0.0,1,1,100.0,1,1,100.0,0,0,0.0,0,1,1,1,0,0,0,0,0,0
../kbl_data/2022-2023,S41G01N109,안양 KGC,Home,대릴 먼로,0,0,0,0.0,0,0,0.0,0,0,0.0,0,0,0.0,0,1,1,0,0,0,0,0,0,1
../kbl_data/2022-2023,S41G01N109,안양 KGC,Home,변준형,12,3,10,30.0,2,6,33.3,5,16,31.2,0,0,0.0,1,1,2,5,1,1,0,0,4,2
../kbl_data/2022-2023,S41G01N109,안양 KGC,Home,김경원,0,0,0,0.0,0,0,0.0,0,0,0.0,0,0,0.0,0,0,0,0,0,0,0,0,0,0
../kbl_data/2022-2023,S41G01N109,안양 KGC,Home,오마리 스펠맨,14,0,8,0.0,4,15,26.7,4,23,17.4,2,2,100.0,5,7,12,2,2,0,0,0,2,4
../kbl_data/2022-2023,S41G01N109,안양 KGC,Home,조은후,0,0,0,0.0,0,0,0.0,0,0,0.0,0,0,0.0,0,0,0,0,0,0,0,0,0,0
../kbl_data/2022-2023,S41G01N109,안양 KGC,Home,렌즈 아반도,30,5,9,55.6,5,7,71.4,10,16,62.5,5,7,71.4,1,5,6,2,0,2,1,1,2,1
../kbl_data/2022-2023,S41G01N109,서울 SK,Away,양우섭,2,1,1,100.0,0,2,0.0,1,3,33.3,0,0,0.0,0,3,3,1,0,0,0,0,0,1
../kbl_data/2022-2023,S41G01N109,서울 SK,Away,허일영,15,3,5,60.0,3,6,50.0,6,11,54.5,0,0,0.0,2,1,3,0,1,0,0,0,0,3
../kbl_data/2022-2023,S41G01N109,서울 SK,Away,김선형,6,3,6,50.0,0,2,0.0,3,8,37.5,0,0,0.0,0,1,1,7,4,1,0,0,2,4
../kbl_data/2022-2023,S41G01N109,서울 SK,Away,홍경기,0,0,0,0.0,0,0,0.0,0,0,0.0,0,0,0.0,0,0,0,0,0,0,0,0,0,0
../kbl_data/2022-2023,S41G01N109,서울 SK,Away,최부경,0,0,0,0.0,0,0,0.0,0,0,0.0,0,0,0.0,1,2,3,1,0,0,0,0,0,0
../kbl_data/2022-2023,S41G01N109,서울 SK,Away,리온 윌리엄스,0,0,0,0.0,0,0,0.0,0,0,0.0,0,0,0.0,0,0,0,0,0,0,0,0,0,0
../kbl_data/2022-2023,S41G01N109,서울 SK,Away,최원혁,0,0,0,0.0,0,0,0.0,0,0,0.0,0,0,0.0,0,0,0,0,0,0,0,0,0,0
../kbl_data/2022-2023,S41G01N109,서울 SK,Away,최준용,16,4,6,66.7,2,7,28.6,6,13,46.2,2,2,100.0,0,7,7,4,1,0,0,0,0,3
../kbl_data/2022-2023,S41G01N109,서울 SK,Away,최성원,8,0,2,0.0,2,4,50.0,2,6,33.3,2,2,100.0,0,2,2,0,2,0,0,0,0,3
../kbl_data/2022-2023,S41G01N109,서울 SK,Away,자밀 워니,32,14,23,60.9,0,2,0.0,14,25,56.0,4,7,57.1,4,8,12,1,2,0,0,2,3,2
../kbl_data/2022-2023,S41G01N109,서울 SK,Away,김형빈,0,0,0,0.0,0,0,0.0,0,0,0.0,0,0,0.0,0,0,0,0,0,0,0,0,0,0
../kbl_data/2022-2023,S41G01N109,서울 SK,Away,오재현,3,0,1,0.0,1,2,50.0,1,3,33.3,0,0,0.0,0,0,0,0,0,0,0,0,0,1
../kbl_data/2022-2023,S41G01N110,창원 LG,Home,이관희,9,0,0,0.0,3,7,42.9,3,7,42.9,0,0,0.0,0,1,1,1,0,0,0,0,0,2
../kbl_data/2022-2023,S41G01N110,창원 LG,Home,정희재,6,1,2,50.0,1,2,50.0,2,4,50.0,1,2,50.0,1,2,3,1,0,0,0,0,1,3
../kbl_data/2022-2023,S41G01N110,창원 LG,Home,한상혁,0,0,0,0.0,0,0,0.0,0,0,0.0,0,0,0.0,0,0,0,0,0,0,0,0,0,0
../kbl_data/2022-2023,S41G01N110,창원 LG,Home,이재도,9,2,6,33.3,1,2,50.0,3,8,37.5,2,3,66.7,0,5,5,6,1,0,0,0,2,2
../kbl_data/2022-2023,S41G01N110,창원 LG,Home,김준일,14,6,9,66.7,0,0,0.0,6,9,66.7,2,5,40.0,4,4,8,0,0,1,0,0,1,2
../kbl_data/2022-2023,S41G01N110,창원 LG,Home,정인덕,10,4,5,80.0,0,0,0.0,4,5,80.0,2,3,66.7,0,0,0,0,0,0,0,0,0,3
../kbl_data/2022-2023,S41G01N110,창원 LG,Home,최승욱,0,0,1,0.0,0,0,0.0,0,1,0.0,0,0,0.0,0,0,0,0,0,0,0,0,0,0
../kbl_data/2022-2023,S41G01N110,창원 LG,Home,김준형,0,0,0,0.0,0,0,0.0,0,0,0.0,0,0,0.0,0,0,0,0,0,0,0,0,0,0
../kbl_data/2022-2023,S41G01N110,창원 LG,Home,윤원상,2,1,1,100.0,0,6,0.0,1,7,14.3,0,0,0.0,1,2,3,0,0,0,0,0,0,3
../kbl_data/2022-2023,S41G01N110,창원 LG,Home,아셈 마레이,14,5,11,45.5,0,0,0.0,5,11,45.5,4,8,50.0,5,9,14,2,2,0,0,0,1,2
../kbl_data/2022-2023,S41G01N110,창원 LG,Home,저스틴 구탕,10,5,7,71.4,0,0,0.0,5,7,71.4,0,0,0.0,2,3,5,4,2,0,0,1,3,2
../kbl_data/2022-2023,S41G01N110,창원 LG,Home,단테 커닝햄,5,2,9,22.2,0,0,0.0,2,9,22.2,1,2,50.0,1,5,6,2,0,1,0,1,3,0
../kbl_data/2022-2023,S41G01N110,고양 캐롯,Away,김강선,8,1,1,100.0,2,4,50.0,3,5,60.0,0,0,0.0,0,1,1,0,4,0,1,0,0,3
../kbl_data/2022-2023,S41G01N110,고양 캐롯,Away,이정제,0,0,0,0.0,0,0,0.0,0,0,0.0,0,0,0.0,0,0,0,0,0,0,0,0,0,0
../kbl_data/2022-2023,S41G01N110,고양 캐롯,Away,전성현,21,4,9,44.4,3,13,23.1,7,22,31.8,4,5,80.0,0,2,2,1,1,0,0,0,5,3
../kbl_data/2022-2023,S41G01N110,고양 캐롯,Away,정해원,0,0,0,0.0,0,0,0.0,0,0,0.0,0,0,0.0,0,0,0,0,0,0,0,0,0,0
../kbl_data/2022-2023,S41G01N110,고양 캐롯,Away,조한진,2,0,0,0.0,0,3,0.0,0,3,0.0,2,2,100.0,2,2,4,1,0,0,0,0,0,2
../kbl_data/2022-2023,S41G01N110,고양 캐롯,Away,김세창,8,2,3,66.7,0,0,0.0,2,3,66.7,4,7,57.1,2,1,3,2,2,0,0,0,1,2
../kbl_data/2022-2023,S41G01N110,고양 캐롯,Away,디드릭 로슨,12,3,7,42.9,2,4,50.0,5,11,45.5,0,0,0.0,1,13,14,9,1,0,0,0,1,3
../kbl_data/2022-2023,S41G01N110,고양 캐롯,Away,박진철,2,0,0,0.0,0,0,0.0,0,0,0.0,2,2,100.0,1,1,2,0,0,1,0,0,1,2
../kbl_data/2022-2023,S41G01N110,고양 캐롯,Away,이정현,6,3,9,33.3,0,2,0.0,3,11,27.3,0,0,0.0,0,0,0,1,1,0,0,0,1,3
../kbl_data/2022-2023,S41G01N110,고양 캐롯,Away,모리구치 히사시,0,0,0,0.0,0,0,0.0,0,0,0.0,0,0,0.0,0,0,0,0,0,0,0,0,0,0
../kbl_data/2022-2023,S41G01N110,고양 캐롯,Away,조재우,0,0,0,0.0,0,0,0.0,0,0,0.0,0,0,0.0,0,0,0,0,0,0,0,0,0,0
../kbl_data/2022-2023,S41G01N110,고양 캐롯,Away,안정욱,14,4,4,100.0,2,9,22.2,6,13,46.2,0,0,0.0,2,3,5,1,0,1,0,0,0,3
../kbl_data/2022-2023,S41G01N111,울산 현대모비스,Home,함지훈,6,2,4,50.0,0,0,0.0,2,4,50.0,2,6,33.3,1,1,2,3,2,0,0,0,1,0
../kbl_data/2022-2023,S41G01N111,울산 현대모비스,Home,김현민,0,0,0,0.0,0,0,0.0,0,0,0.0,0,0,0.0,0,0,0,0,0,0,0,0,0,0
../kbl_data/2022-2023,S41G01N111,울산 현대모비스,Home,장재석,13,6,8,75.0,0,0,0.0,6,8,75.0,1,2,50.0,0,2,2,3,2,0,0,1,2,4
../kbl_data/2022-2023,S41G01N111,울산 현대모비스,Home,김영현,0,0,1,0.0,0,1,0.0,0,2,0.0,0,0,0.0,0,1,1,0,0,1,1,0,0,4
../kbl_data/2022-2023,S41G01N111,울산 현대모비스,Home,김국찬,0,0,1,0.0,0,1,0.0,0,2,0.0,0,0,0.0,0,0,0,0,0,0,0,0,0,1
../kbl_data/2022-2023,S41G01N111,울산 현대모비스,Home,서명진,11,1,5,20.0,3,6,50.0,4,11,36.4,0,0,0.0,1,1,2,7,3,0,0,0,2,1
../kbl_data/2022-2023,S41G01N111,울산 현대모비스,Home,헨리 심스,1,0,0,0.0,0,0,0.0,0,0,0.0,1,2,50.0,1,0,1,0,0,0,0,0,1,1
../kbl_data/2022-2023,S41G01N111,울산 현대모비스,Home,이우석,2,1,4,25.0,0,2,0.0,1,6,16.7,0,0,0.0,0,4,4,1,0,0,0,0,1,3
../kbl_data/2022-2023,S41G01N111,울산 현대모비스,Home,신민석,0,0,0,0.0,0,0,0.0,0,0,0.0,0,0,0.0,0,0,0,0,0,0,0,0,0,0
../kbl_data/2022-2023,S41G01N111,울산 현대모비스,Home,김동준,8,1,2,50.0,2,3,66.7,3,5,60.0,0,2,0.0,0,0,0,0,0,0,0,0,1,0
../kbl_data/2022-2023,S41G01N111,울산 현대모비스,Home,론제이 아바리엔토스,2,1,4,25.0,0,5,0.0,1,9,11.1,0,0,0.0,0,0,0,2,0,0,0,0,4,3
../kbl_data/2022-2023,S41G01N111,울산 현대모비스,Home,게이지 프림,25,9,13,69.2,0,0,0.0,9,13,69.2,7,8,87.5,8,7,15,2,0,1,0,0,1,3
../kbl_data/2022-2023,S41G01N111,서울 삼성,Away,이정현,16,3,3,100.0,1,3,33.3,4,6,66.7,7,8,87.5,0,0,0,4,1,1,0,0,3,1
../kbl_data/2022-2023,S41G01N111,서울 삼성,Away,장민국,4,2,5,40.0,0,2,0.0,2,7,28.6,0,0,0.0,0,2,2,0,1,1,1,0,2,3
../kbl_data/2022-2023,S41G01N111,서울 삼성,Away,김시래,2,0,4,0.0,0,0,0.0,0,4,0.0,2,2,100.0,1,0,1,2,0,0,0,0,1,0
../kbl_data/2022-2023,S41G01N111,서울 삼성,Away,김현수,0,0,0,0.0,0,0,0.0,0,0,0.0,0,0,0.0,0,0,0,0,0,0,0,0,0,0
../kbl_data/2022-2023,S41G01N111,서울 삼성,Away,임동섭,10,2,2,100.0,2,3,66.7,4,5,80.0,0,0,0.0,2,1,3,0,0,0,0,0,0,2
../kbl_data/2022-2023,S41G01N111,서울 삼성,Away,이호현,3,1,1,100.0,0,0,0.0,1,1,100.0,1,4,25.0,0,1,1,4,0,0,0,0,2,0
../kbl_data/2022-2023,S41G01N111,서울 삼성,Away,김광철,7,3,4,75.0,0,0,0.0,3,4,75.0,1,1,100.0,1,1,2,2,1,0,0,0,1,2
../kbl_data/2022-2023,S41G01N111,서울 삼성,Away,김한솔,0,0,0,0.0,0,0,0.0,0,0,0.0,0,0,0.0,0,0,0,0,0,0,0,0,0,0
../kbl_data/2022-2023,S41G01N111,서울 삼성,Away,조우성,2,1,2,50.0,0,0,0.0,1,2,50.0,0,0,0.0,0,1,1,0,0,0,0,0,1,5
../kbl_data/2022-2023,S41G01N111,서울 삼성,Away,이매뉴얼 테리,10,5,7,71.4,0,0,0.0,5,7,71.4,0,0,0.0,1,6,7,2,2,1,0,3,1,2
../kbl_data/2022-2023,S41G01N111,서울 삼성,Away,신동혁,11,3,6,50.0,1,3,33.3,4,9,44.4,2,2,100.0,2,4,6,2,1,0,0,0,2,3
../kbl_data/2022-2023,S41G01N111,서울 삼성,Away,조나단 알렛지,13,3,7,42.9,1,4,25.0,4,11,36.4,4,5,80.0,2,2,4,1,0,0,2,0,1,2
../kbl_data/2022-2023,S41G01N112,전주 KCC,Home,정창영,4,2,4,50.0,0,1,0.0,2,5,40.0,0,0,0.0,0,1,1,1,0,1,1,0,0,1
../kbl_data/2022-2023,S41G01N112,전주 KCC,Home,라건아,30,10,15,66.7,2,3,66.7,12,18,66.7,4,5,80.0,4,9,13,4,0,3,0,0,4,1
../kbl_data/2022-2023,S41G01N112,전주 KCC,Home,박경상,1,0,0,0.0,0,1,0.0,0,1,0.0,1,2,50.0,0,2,2,0,1,0,0,0,1,2
../kbl_data/2022-2023,S41G01N112,전주 KCC,Home,김지완,11,2,5,40.0,2,3,66.7,4,8,50.0,1,2,50.0,0,2,2,3,1,0,0,0,1,1
../kbl_data/2022-2023,S41G01N112,전주 KCC,Home,김상규,2,1,1,100.0,0,1,0.0,1,2,50.0,0,0,0.0,0,1,1,0,0,0,0,0,1,0
../kbl_data/2022-2023,S41G01N112,전주 KCC,Home,전준범,2,1,3,33.3,0,2,0.0,1,5,20.0,0,0,0.0,0,0,0,0,1,0,0,0,0,2
../kbl_data/2022-2023,S41G01N112,전주 KCC,Home,허웅,14,3,4,75.0,2,7,28.6,5,11,45.5,2,2,100.0,0,2,2,3,0,0,0,0,3,1
../kbl_data/2022-2023,S41G01N112,전주 KCC,Home,이승현,8,4,6,66.7,0,0,0.0,4,6,66.7,0,0,0.0,0,1,1,4,1,1,0,0,0,1
../kbl_data/2022-2023,S41G01N112,전주 KCC,Home,곽정훈,3,0,1,0.0,1,1,100.0,1,2,50.0,0,0,0.0,1,0,1,0,0,0,0,0,0,1
../kbl_data/2022-2023,S41G01N112,전주 KCC,Home,이근휘,5,1,1,100.0,1,1,100.0,2,2,100.0,0,0,0.0,0,0,0,0,0,0,0,0,0,2
../kbl_data/2022-2023,S41G01N112,전주 KCC,Home,론데 홀리스 제퍼슨,9,4,5,80.0,0,0,0.0,4,5,80.0,1,2,50.0,3,3,6,4,1,0,0,1,1,3
../kbl_data/2022-2023,S41G01N112,전주 KCC,Home,송동훈,0,0,0,0.0,0,1,0.0,0,1,0.0,0,0,0.0,0,0,0,0,0,0,0,0,0,2
../kbl_data/2022-2023,S41G01N112,수원 KT,Away,김동욱,3,0,2,0.0,1,1,100.0,1,3,33.3,0,0,0.0,1,1,2,0,0,0,0,0,1,1
../kbl_data/2022-2023,S41G01N112,수원 KT,Away,김영환,2,1,3,33.3,0,3,0.0,1,6,16.7,0,0,0.0,0,2,2,2,0,0,0,0,0,1
../kbl_data/2022-2023,S41G01N112,수원 KT,Away,최창진,5,1,1,100.0,0,1,0.0,1,2,50.0,3,3,100.0,1,1,2,1,0,0,0,0,0,0
../kbl_data/2022-2023,S41G01N112,수원 KT,Away,이현석,0,0,0,0.0,0,1,0.0,0,1,0.0,0,0,0.0,1,1,2,0,0,0,0,0,0,1
../kbl_data/2022-2023,S41G01N112,수원 KT,Away,정성우,7,3,5,60.0,0,1,0.0,3,6,50.0,1,2,50.0,2,1,3,5,1,0,0,0,1,2
../kbl_data/2022-2023,S41G01N112,수원 KT,Away,최성모,1,0,2,0.0,0,3,0.0,0,5,0.0,1,2,50.0,0,0,0,0,2,1,0,0,0,1
../kbl_data/2022-2023,S41G01N112,수원 KT,Away,양홍석,0,0,4,0.0,0,0,0.0,0,4,0.0,0,0,0.0,2,1,3,2,0,0,0,0,1,2
../kbl_data/2022-2023,S41G01N112,수원 KT,Away,박지원,2,1,2,50.0,0,0,0.0,1,2,50.0,0,0,0.0,1,1,2,4,0,0,0,0,2,2
../kbl_data/2022-2023,S41G01N112,수원 KT,Away,하윤기,11,5,11,45.5,0,0,0.0,5,11,45.5,1,1,100.0,3,5,8,3,3,0,0,0,0,2
../kbl_data/2022-2023,S41G01N112,수원 KT,Away,이제이 아노시케,9,3,4,75.0,1,3,33.3,4,7,57.1,0,0,0.0,2,1,3,1,0,0,0,0,0,2
../kbl_data/2022-2023,S41G01N112,수원 KT,Away,이두원,6,3,5,60.0,0,0,0.0,3,5,60.0,0,0,0.0,2,1,3,1,1,0,0,1,2,2
../kbl_data/2022-2023,S41G01N112,수원 KT,Away,레스터 프로스퍼,31,7,14,50.0,4,7,57.1,11,21,52.4,5,6,83.3,2,2,4,1,1,0,0,1,3,2
../kbl_data/2022-2023,S41G01N113,대구 한국가스공사,Home,박지훈,0,0,0,0.0,0,0,0.0,0,0,0.0,0,0,0.0,0,0,0,0,0,0,0,0,0,0
../kbl_data/2022-2023,S41G01N113,대구 한국가스공사,Home,조상열,0,0,1,0.0,0,1,0.0,0,2,0.0,0,0,0.0,0,0,0,0,0,0,0,0,0,2
../kbl_data/2022-2023,S41G01N113,대구 한국가스공사,Home,이원대,0,0,1,0.0,0,0,0.0,0,1,0.0,0,0,0.0,0,0,0,1,0,0,0,0,1,2
../kbl_data/2022-2023,S41G01N113,대구 한국가스공사,Home,이대헌,10,5,7,71.4,0,4,0.0,5,11,45.5,0,0,0.0,1,2,3,3,0,0,0,0,0,3
../kbl_data/2022-2023,S41G01N113,대구 한국가스공사,Home,이대성,20,7,10,70.0,1,3,33.3,8,13,61.5,3,4,75.0,0,5,5,6,1,0,0,0,2,1
../kbl_data/2022-2023,S41G01N113,대구 한국가스공사,Home,정효근,9,0,1,0.0,3,6,50.0,3,7,42.9,0,0,0.0,0,2,2,1,2,1,0,0,3,2
../kbl_data/2022-2023,S41G01N113,대구 한국가스공사,Home,머피 할로웨이,6,3,6,50.0,0,0,0.0,3,6,50.0,0,2,0.0,3,11,14,2,0,2,0,0,4,3
../kbl_data/2022-2023,S41G01N113,대구 한국가스공사,Home,우동현,0,0,0,0.0,0,1,0.0,0,1,0.0,0,0,0.0,0,0,0,0,0,0,0,0,0,0
../kbl_data/2022-2023,S41G01N113,대구 한국가스공사,Home,전현우,9,3,5,60.0,1,3,33.3,4,8,50.0,0,0,0.0,1,2,3,0,2,0,0,0,0,2
../kbl_data/2022-2023,S41G01N113,대구 한국가스공사,Home,신승민,6,0,3,0.0,2,3,66.7,2,6,33.3,0,0,0.0,0,2,2,0,0,0,1,0,0,1
../kbl_data/2022-2023,S41G01N113,대구 한국가스공사,Home,샘조세프 벨란겔,10,5,6,83.3,0,3,0.0,5,9,55.6,0,0,0.0,0,1,1,1,2,0,0,0,1,1
../kbl_data/2022-2023,S41G01N113,대구 한국가스공사,Home,유슈 은도예,3,1,2,50.0,0,0,0.0,1,2,50.0,1,2,50.0,1,0,1,1,0,0,0,0,0,2
../kbl_data/2022-2023,S41G01N113,서울 SK,Away,양우섭,0,0,1,0.0,0,0,0.0,0,1,0.0,0,0,0.0,0,0,0,0,0,0,0,0,1,0
../kbl_data/2022-2023,S41G01N113,서울 SK,Away,허일영,3,0,3,0.0,1,1,100.0,1,4,25.0,0,0,0.0,1,2,3,0,1,0,0,0,0,2
../kbl_data/2022-2023,S41G01N113,서울 SK,Away,김선형,18,4,8,50.0,2,4,50.0,6,12,50.0,4,4,100.0,1,6,7,2,0,0,2,0,3,0
../kbl_data/2022-2023,S41G01N113,서울 SK,Away,홍경기,0,0,0,0.0,0,0,0.0,0,0,0.0,0,0,0.0,1,0,1,1,0,0,0,0,0,0
../kbl_data/2022-2023,S41G01N113,서울 SK,Away,최부경,6,2,3,66.7,0,0,0.0,2,3,66.7,2,2,100.0,1,2,3,0,1,0,0,0,0,3
../kbl_data/2022-2023,S41G01N113,서울 SK,Away,리온 윌리엄스,11,3,3,100.0,1,3,33.3,4,6,66.7,2,2,100.0,1,1,2,0,2,0,0,0,2,3
../kbl_data/2022-2023,S41G01N113,서울 SK,Away,최원혁,0,0,0,0.0,0,0,0.0,0,0,0.0,0,0,0.0,0,0,0,0,0,0,0,0,0,0
../kbl_data/2022-2023,S41G01N113,서울 SK,Away,최준용,8,4,6,66.7,0,5,0.0,4,11,36.4,0,2,0.0,0,6,6,5,2,0,0,0,2,2
../kbl_data/2022-2023,S41G01N113,서울 SK,Away,최성원,8,1,1,100.0,2,5,40.0,3,6,50.0,0,0,0.0,0,0,0,0,2,0,0,0,0,4
../kbl_data/2022-2023,S41G01N113,서울 SK,Away,자밀 워니,18,8,15,53.3,0,1,0.0,8,16,50.0,2,5,40.0,3,6,9,2,0,0,0,3,2,2
../kbl_data/2022-2023,S41G01N113,서울 SK,Away,김형빈,0,0,0,0.0,0,0,0.0,0,0,0.0,0,0,0.0,0,0,0,0,0,0,0,0,0,0
../kbl_data/2022-2023,S41G01N113,서울 SK,Away,오재현,6,0,3,0.0,2,3,66.7,2,6,33.3,0,0,0.0,0,5,5,2,0,0,0,0,0,1
../kbl_data/2022-2023,S41G01N114,고양 캐롯,Home,김강선,3,0,0,0.0,1,4,25.0,1,4,25.0,0,0,0.0,1,3,4,2,1,0,0,0,1,3
../kbl_data/2022-2023,S41G01N114,고양 캐롯,Home,최현민,15,0,1,0.0,5,6,83.3,5,7,71.4,0,0,0.0,2,4,6,1,0,0,0,0,0,1
../kbl_data/2022-2023,S41G01N114,고양 캐롯,Home,이정제,0,0,0,0.0,0,0,0.0,0,0,0.0,0,0,0.0,0,0,0,0,0,0,1,0,0,0
../kbl_data/2022-2023,S41G01N114,고양 캐롯,Home,전성현,31,6,7,85.7,5,7,71.4,11,14,78.6,4,5,80.0,1,1,2,2,0,0,0,0,1,2
../kbl_data/2022-2023,S41G01N114,고양 캐롯,Home,정해원,0,0,0,0.0,0,0,0.0,0,0,0.0,0,0,0.0,0,0,0,0,0,0,0,0,0,0
../kbl_data/2022-2023,S41G01N114,고양 캐롯,Home,조한진,0,0,0,0.0,0,2,0.0,0,2,0.0,0,0,0.0,0,0,0,1,1,0,0,0,0,2
../kbl_data/2022-2023,S41G01N114,고양 캐롯,Home,김세창,0,0,1,0.0,0,0,0.0,0,1,0.0,0,0,0.0,0,1,1,0,1,0,0,0,1,2
../kbl_data/2022-2023,S41G01N114,고양 캐롯,Home,디드릭 로슨,22,5,12,41.7,2,7,28.6,7,19,36.8,6,8,75.0,0,18,18,6,2,3,0,0,3,1
../kbl_data/2022-2023,S41G01N114,고양 캐롯,Home,박진철,0,0,0,0.0,0,0,0.0,0,0,0.0,0,0,0.0,0,0,0,0,0,0,0,0,0,0
../kbl_data/2022-2023,S41G01N114,고양 캐롯,Home,이정현,46,8,26,30.8,6,22,27.3,14,48,29.2,12,16,75.0,2,6,8,24,6,0,0,0,6,10
../kbl_data/2022-2023,S41G01N114,고양 캐롯,Home,모리구치 히사시,8,4,4,100.0,0,0,0.0,4,4,100.0,0,0,0.0,0,0,0,0,0,0,0,0,0,3
../kbl_data/2022-2023,S41G01N114,고양 캐롯,Home,안정욱,2,1,2,50.0,0,0,0.0,1,2,50.0,0,0,0.0,1,0,1,0,0,0,0,0,1,1
../kbl_data/2022-2023,S41G01N114,서울 삼성,Away,이정현,46,8,26,30.8,6,22,27.3,14,48,29.2,12,16,75.0,2,6,8,24,6,0,0,0,6,10
../kbl_data/2022-2023,S41G01N114,서울 삼성,Away,장민국,6,3,5,60.0,0,0,0.0,3,5,60.0,0,0,0.0,2,1,3,0,0,0,0,0,0,1
../kbl_data/2022-2023,S41G01N114,서울 삼성,Away,김시래,9,3,7,42.9,1,3,33.3,4,10,40.0,0,0,0.0,1,2,3,2,1,0,0,0,2,1
../kbl_data/2022-2023,S41G01N114,서울 삼성,Away,김현수,0,0,0,0.0,0,1,0.0,0,1,0.0,0,0,0.0,0,0,0,0,0,0,0,0,0,0
../kbl_data/2022-2023,S41G01N114,서울 삼성,Away,임동섭,9,0,1,0.0,3,5,60.0,3,6,50.0,0,0,0.0,0,3,3,1,0,0,0,0,0,3
../kbl_data/2022-2023,S41G01N114,서울 삼성,Away,이호현,6,3,7,42.9,0,1,0.0,3,8,37.5,0,0,0.0,0,1,1,1,0,0,0,0,0,3
../kbl_data/2022-2023,S41G01N114,서울 삼성,Away,김광철,2,0,1,0.0,0,0,0.0,0,1,0.0,2,2,100.0,0,1,1,1,0,0,0,0,2,0
../kbl_data/2022-2023,S41G01N114,서울 삼성,Away,김한솔,0,0,0,0.0,0,0,0.0,0,0,0.0,0,0,0.0,0,0,0,0,0,0,0,0,0,0
../kbl_data/2022-2023,S41G01N114,서울 삼성,Away,조우성,0,0,0,0.0,0,0,0.0,0,0,0.0,0,0,0.0,0,0,0,0,0,0,0,0,0,0
../kbl_data/2022-2023,S41G01N114,서울 삼성,Away,이매뉴얼 테리,4,2,5,40.0,0,0,0.0,2,5,40.0,0,0,0.0,2,4,6,1,1,0,0,1,2,1
../kbl_data/2022-2023,S41G01N114,서울 삼성,Away,신동혁,12,2,7,28.6,2,5,40.0,4,12,33.3,2,2,100.0,1,1,2,3,0,0,0,0,1,4
../kbl_data/2022-2023,S41G01N114,서울 삼성,Away,조나단 알렛지,13,1,2,50.0,1,1,100.0,2,3,66.7,8,8,100.0,2,6,8,2,2,1,0,0,1,2
../kbl_data/2022-2023,S41G01N115,원주 DB,Home,박찬희,0,0,0,0.0,0,0,0.0,0,0,0.0,0,0,0.0,0,0,0,0,0,0,0,0,0,0
../kbl_data/2022-2023,S41G01N115,원주 DB,Home,김현호,3,0,0,0.0,1,2,50.0,1,2,50.0,0,0,0.0,0,0,0,3,0,0,0,0,0,1
../kbl_data/2022-2023,S41G01N115,원주 DB,Home,두경민,12,4,7,57.1,0,2,0.0,4,9,44.4,4,7,57.1,1,1,2,4,0,0,0,0,4,0
../kbl_data/2022-2023,S41G01N115,원주 DB,Home,최승욱,2,0,12,0.0,0,6,0.0,0,18,0.0,2,4,50.0,4,4,8,4,6,0,0,0,2,4
../kbl_data/2022-2023,S41G01N115,원주 DB,Home,윤성원,12,4,6,66.7,1,4,25.0,5,10,50.0,1,2,50.0,3,2,5,1,1,0,0,0,1,3
../kbl_data/2022-2023,S41G01N115,원주 DB,Home,이준희,16,5,7,71.4,2,3,66.7,7,10,70.0,0,0,0.0,0,1,1,0,1,0,0,0,0,2
../kbl_data/2022-2023,S41G01N115,원주 DB,Home,레나드 프리먼,5,2,5,40.0,0,0,0.0,2,5,40.0,1,5,20.0,3,9,12,2,3,0,0,1,2,3
../kbl_data/2022-2023,S41G01N115,원주 DB,Home,정호영,0,0,2,0.0,0,1,0.0,0,3,0.0,0,2,0.0,0,0,0,0,0,1,0,0,0,1
../kbl_data/2022-2023,S41G01N115,원주 DB,Home,이선 알바노,4,2,7,28.6,0,2,0.0,2,9,22.2,0,0,0.0,0,1,1,5,1,0,0,0,1,3
../kbl_data/2022-2023,S41G01N115,원주 DB,Home,박인웅,8,1,2,50.0,2,3,66.7,3,5,60.0,0,0,0.0,1,2,3,0,1,0,0,0,4,1
../kbl_data/2022-2023,S41G01N115,원주 DB,Home,인승찬,4,2,3,66.7,0,2,0.0,2,5,40.0,0,0,0.0,1,1,2,1,0,0,0,0,2,1
../kbl_data/2022-2023,S41G01N115,원주 DB,Home,드미트리우스 트레드웰,8,3,4,75.0,0,0,0.0,3,4,75.0,2,2,100.0,2,4,6,0,1,0,0,1,2,2
../kbl_data/2022-2023,S41G01N115,창원 LG,Away,이관희,10,2,4,50.0,2,7,28.6,4,11,36.4,0,0,0.0,0,0,0,4,1,0,0,0,0,1
../kbl_data/2022-2023,S41G01N115,창원 LG,Away,정희재,3,0,0,0.0,1,3,33.3,1,3,33.3,0,0,0.0,0,3,3,2,1,0,0,0,1,2
../kbl_data/2022-2023,S41G01N115,창원 LG,Away,한상혁,7,2,3,66.7,1,1,100.0,3,4,75.0,0,0,0.0,0,1,1,2,2,0,0,0,1,3
../kbl_data/2022-2023,S41G01N115,창원 LG,Away,이재도,25,7,9,77.8,3,4,75.0,10,13,76.9,2,2,100.0,0,2,2,3,1,0,0,0,1,3
../kbl_data/2022-2023,S41G01N115,창원 LG,Away,김준일,10,5,10,50.0,0,0,0.0,5,10,50.0,0,0,0.0,3,5,8,3,2,0,0,0,5,1
../kbl_data/2022-2023,S41G01N115,창원 LG,Away,정인덕,8,4,4,100.0,0,0,0.0,4,4,100.0,0,0,0.0,0,1,1,1,0,0,0,0,1,2
../kbl_data/2022-2023,S41G01N115,창원 LG,Away,최승욱,2,0,12,0.0,0,6,0.0,0,18,0.0,2,4,50.0,4,4,8,4,6,0,0,0,2,4
../kbl_data/2022-2023,S41G01N115,창원 LG,Away,김준형,2,1,1,100.0,0,0,0.0,1,1,100.0,0,0,0.0,0,2,2,1,0,0,0,0,0,1
../kbl_data/2022-2023,S41G01N115,창원 LG,Away,윤원상,8,1,1,100.0,1,2,50.0,2,3,66.7,3,3,100.0,0,2,2,2,2,0,0,0,1,3
../kbl_data/2022-2023,S41G01N115,창원 LG,Away,아셈 마레이,12,4,10,40.0,0,0,0.0,4,10,40.0,4,7,57.1,5,7,12,5,3,1,0,1,0,2
../kbl_data/2022-2023,S41G01N115,창원 LG,Away,이승우,3,0,1,0.0,1,1,100.0,1,2,50.0,0,0,0.0,0,3,3,0,0,0,0,0,0,1
../kbl_data/2022-2023,S41G01N115,창원 LG,Away,단테 커닝햄,11,4,9,44.4,0,1,0.0,4,10,40.0,3,3,100.0,3,3,6,4,1,1,0,1,3,1
../kbl_data/2022-2023,S41G01N116,울산 현대모비스,Home,함지훈,11,4,6,66.7,1,1,100.0,5,7,71.4,0,0,0.0,2,5,7,7,0,0,1,0,0,2
../kbl_data/2022-2023,S41G01N116,울산 현대모비스,Home,김현민,0,0,0,0.0,0,0,0.0,0,0,0.0,0,0,0.0,0,0,0,0,0,0,0,0,0,0
../kbl_data/2022-2023,S41G01N116,울산 현대모비스,Home,장재석,2,0,1,0.0,0,0,0.0,0,1,0.0,2,2,100.0,2,0,2,0,0,0,0,0,3,3
../kbl_data/2022-2023,S41G01N116,울산 현대모비스,Home,김영현,3,0,0,0.0,1,4,25.0,1,4,25.0,0,0,0.0,0,0,0,0,0,0,0,0,0,1
../kbl_data/2022-2023,S41G01N116,울산 현대모비스,Home,김국찬,0,0,0,0.0,0,1,0.0,0,1,0.0,0,0,0.0,0,0,0,0,0,0,0,0,0,0
../kbl_data/2022-2023,S41G01N116,울산 현대모비스,Home,서명진,6,3,5,60.0,0,2,0.0,3,7,42.9,0,1,0.0,0,0,0,5,1,0,0,0,0,4
../kbl_data/2022-2023,S41G01N116,울산 현대모비스,Home,헨리 심스,3,1,3,33.3,0,0,0.0,1,3,33.3,1,1,100.0,2,3,5,1,0,0,0,0,1,0
../kbl_data/2022-2023,S41G01N116,울산 현대모비스,Home,이우석,24,8,15,53.3,2,3,66.7,10,18,55.6,2,2,100.0,1,7,8,2,2,0,0,0,1,2
../kbl_data/2022-2023,S41G01N116,울산 현대모비스,Home,신민석,5,1,1,100.0,1,2,50.0,2,3,66.7,0,0,0.0,0,0,0,1,0,0,0,0,0,2
../kbl_data/2022-2023,S41G01N116,울산 현대모비스,Home,김동준,0,0,0,0.0,0,0,0.0,0,0,0.0,0,0,0.0,0,0,0,0,0,0,0,0,0,0
../kbl_data/2022-2023,S41G01N116,울산 현대모비스,Home,론제이 아바리엔토스,3,1,5,20.0,0,6,0.0,1,11,9.1,1,2,50.0,0,3,3,6,0,1,0,0,2,1
../kbl_data/2022-2023,S41G01N116,울산 현대모비스,Home,게이지 프림,27,12,19,63.2,0,0,0.0,12,19,63.2,3,4,75.0,5,7,12,0,2,1,0,1,3,3
../kbl_data/2022-2023,S41G01N116,서울 SK,Away,양우섭,0,0,0,0.0,0,0,0.0,0,0,0.0,0,0,0.0,0,0,0,0,0,0,0,0,0,0
../kbl_data/2022-2023,S41G01N116,서울 SK,Away,허일영,4,0,1,0.0,1,4,25.0,1,5,20.0,1,2,50.0,1,4,5,4,1,0,0,0,1,3
../kbl_data/2022-2023,S41G01N116,서울 SK,Away,김선형,18,7,10,70.0,0,2,0.0,7,12,58.3,4,5,80.0,1,1,2,3,0,0,0,0,3,0
../kbl_data/2022-2023,S41G01N116,서울 SK,Away,홍경기,0,0,0,0.0,0,0,0.0,0,0,0.0,0,0,0.0,0,0,0,0,0,0,0,0,0,0
../kbl_data/2022-2023,S41G01N116,서울 SK,Away,최부경,2,0,2,0.0,0,0,0.0,0,2,0.0,2,2,100.0,3,3,6,0,0,1,0,0,0,1
../kbl_data/2022-2023,S41G01N116,서울 SK,Away,리온 윌리엄스,0,0,1,0.0,0,1,0.0,0,2,0.0,0,0,0.0,1,0,1,0,0,0,0,0,0,2
../kbl_data/2022-2023,S41G01N116,서울 SK,Away,최원혁,0,0,0,0.0,0,0,0.0,0,0,0.0,0,0,0.0,0,0,0,0,0,0,0,0,0,0
../kbl_data/2022-2023,S41G01N116,서울 SK,Away,최준용,15,3,5,60.0,2,7,28.6,5,12,41.7,3,4,75.0,3,6,9,5,0,1,0,0,2,4
../kbl_data/2022-2023,S41G01N116,서울 SK,Away,최성원,5,1,2,50.0,1,2,50.0,2,4,50.0,0,0,0.0,0,2,2,3,2,0,0,0,0,0
../kbl_data/2022-2023,S41G01N116,서울 SK,Away,자밀 워니,35,15,31,48.4,0,4,0.0,15,35,42.9,5,8,62.5,3,12,15,0,0,0,0,1,2,3
../kbl_data/2022-2023,S41G01N116,서울 SK,Away,김형빈,0,0,0,0.0,0,0,0.0,0,0,0.0,0,0,0.0,0,0,0,0,0,0,0,0,0,0
../kbl_data/2022-2023,S41G01N116,서울 SK,Away,오재현,2,1,2,50.0,0,0,0.0,1,2,50.0,0,0,0.0,2,0,2,1,2,0,0,0,1,2
../kbl_data/2022-2023,S41G01N117,수원 KT,Home,김동욱,8,0,0,0.0,2,3,66.7,2,3,66.7,2,3,66.7,0,2,2,2,1,0,0,0,2,4
../kbl_data/2022-2023,S41G01N117,수원 KT,Home,김영환,0,0,0,0.0,0,0,0.0,0,0,0.0,0,0,0.0,0,0,0,0,0,0,0,0,0,1
../kbl_data/2022-2023,S41G01N117,수원 KT,Home,한희원,4,1,3,33.3,0,3,0.0,1,6,16.7,2,2,100.0,1,0,1,1,2,0,0,0,0,2
../kbl_data/2022-2023,S41G01N117,수원 KT,Home,최창진,3,1,1,100.0,0,0,0.0,1,1,100.0,1,1,100.0,0,1,1,0,0,0,1,0,3,0
../kbl_data/2022-2023,S41G01N117,수원 KT,Home,정성우,14,1,1,100.0,4,7,57.1,5,8,62.5,0,1,0.0,1,4,5,3,3,0,0,0,0,4
../kbl_data/2022-2023,S41G01N117,수원 KT,Home,최성모,0,0,0,0.0,0,0,0.0,0,0,0.0,0,0,0.0,0,0,0,0,0,0,0,0,0,0
../kbl_data/2022-2023,S41G01N117,수원 KT,Home,양홍석,16,4,8,50.0,2,3,66.7,6,11,54.5,2,2,100.0,0,7,7,6,1,0,0,0,2,0
../kbl_data/2022-2023,S41G01N117,수원 KT,Home,박지원,1,0,0,0.0,0,1,0.0,0,1,0.0,1,2,50.0,0,0,0,0,0,0,1,0,0,3
../kbl_data/2022-2023,S41G01N117,수원 KT,Home,하윤기,12,4,10,40.0,0,0,0.0,4,10,40.0,4,4,100.0,1,1,2,0,1,1,0,0,0,4
../kbl_data/2022-2023,S41G01N117,수원 KT,Home,이두원,1,0,1,0.0,0,0,0.0,0,1,0.0,1,2,50.0,0,1,1,0,0,0,0,0,0,2
../kbl_data/2022-2023,S41G01N117,수원 KT,Home,레스터 프로스퍼,4,1,6,16.7,0,2,0.0,1,8,12.5,2,2,100.0,1,2,3,1,1,1,0,0,0,3
../kbl_data/2022-2023,S41G01N117,수원 KT,Home,재로드 존스,21,5,9,55.6,3,5,60.0,8,14,57.1,2,4,50.0,0,6,6,1,0,1,0,0,2,2
../kbl_data/2022-2023,S41G01N117,대구 한국가스공사,Away,박지훈,0,0,0,0.0,0,0,0.0,0,0,0.0,0,0,0.0,0,1,1,0,0,0,0,0,0,4
../kbl_data/2022-2023,S41G01N117,대구 한국가스공사,Away,이원대,0,0,0,0.0,0,0,0.0,0,0,0.0,0,0,0.0,0,0,0,0,0,0,0,0,0,0
../kbl_data/2022-2023,S41G01N117,대구 한국가스공사,Away,이대헌,17,4,8,50.0,2,3,66.7,6,11,54.5,3,6,50.0,2,3,5,3,1,0,0,0,1,2
../kbl_data/2022-2023,S41G01N117,대구 한국가스공사,Away,이대성,2,0,4,0.0,0,2,0.0,0,6,0.0,2,2,100.0,0,4,4,3,0,0,1,0,2,2
../kbl_data/2022-2023,S41G01N117,대구 한국가스공사,Away,정효근,11,2,5,40.0,1,6,16.7,3,11,27.3,4,6,66.7,3,1,4,0,0,1,0,0,0,4
../kbl_data/2022-2023,S41G01N117,대구 한국가스공사,Away,머피 할로웨이,12,6,11,54.5,0,0,0.0,6,11,54.5,0,1,0.0,4,7,11,6,3,1,0,2,2,0
../kbl_data/2022-2023,S41G01N117,대구 한국가스공사,Away,우동현,19,1,2,50.0,5,5,100.0,6,7,85.7,2,4,50.0,4,5,9,2,0,0,0,0,5,1
../kbl_data/2022-2023,S41G01N117,대구 한국가스공사,Away,전현우,6,0,0,0.0,2,6,33.3,2,6,33.3,0,0,0.0,1,1,2,1,0,0,0,0,0,2
../kbl_data/2022-2023,S41G01N117,대구 한국가스공사,Away,신승민,5,0,1,0.0,1,4,25.0,1,5,20.0,2,4,50.0,0,2,2,0,0,0,0,0,0,4
../kbl_data/2022-2023,S41G01N117,대구 한국가스공사,Away,샘조세프 벨란겔,4,2,2,100.0,0,1,0.0,2,3,66.7,0,0,0.0,0,0,0,0,0,0,0,0,2,1
../kbl_data/2022-2023,S41G01N117,대구 한국가스공사,Away,유슈 은도예,3,0,1,0.0,0,0,0.0,0,1,0.0,3,6,50.0,1,6,7,1,1,1,0,0,2,3
../kbl_data/2022-2023,S41G01N117,대구 한국가스공사,Away,염유성,0,0,0,0.0,0,0,0.0,0,0,0.0,0,0,0.0,0,0,0,0,0,0,0,0,0,0
../kbl_data/2022-2023,S41G01N118,원주 DB,Home,박찬희,0,0,0,0.0,0,0,0.0,0,0,0.0,0,0,0.0,0,1,1,1,0,0,0,0,0,0
../kbl_data/2022-2023,S41G01N118,원주 DB,Home,김현호,3,0,1,0.0,1,3,33.3,1,4,25.0,0,0,0.0,0,3,3,4,1,1,0,0,2,3
../kbl_data/2022-2023,S41G01N118,원주 DB,Home,두경민,10,0,7,0.0,2,7,28.6,2,14,14.3,4,5,80.0,1,3,4,3,3,0,1,0,1,3
../kbl_data/2022-2023,S41G01N118,원주 DB,Home,김종규,18,8,15,53.3,0,0,0.0,8,15,53.3,2,2,100.0,1,5,6,2,1,1,0,0,0,1
../kbl_data/2022-2023,S41G01N118,원주 DB,Home,최승욱,3,1,3,33.3,0,1,0.0,1,4,25.0,1,1,100.0,1,1,2,2,0,0,0,0,0,1
../kbl_data/2022-2023,S41G01N118,원주 DB,Home,윤성원,5,1,2,50.0,1,2,50.0,2,4,50.0,0,0,0.0,0,1,1,2,0,0,0,0,0,1
../kbl_data/2022-2023,S41G01N118,원주 DB,Home,이준희,2,1,1,100.0,0,1,0.0,1,2,50.0,0,2,0.0,0,0,0,0,0,0,0,0,0,2
../kbl_data/2022-2023,S41G01N118,원주 DB,Home,레나드 프리먼,10,3,6,50.0,0,0,0.0,3,6,50.0,4,7,57.1,4,2,6,0,0,0,0,0,0,1
../kbl_data/2022-2023,S41G01N118,원주 DB,Home,이선 알바노,12,1,3,33.3,2,4,50.0,3,7,42.9,4,4,100.0,2,5,7,5,2,0,0,0,0,4
../kbl_data/2022-2023,S41G01N118,원주 DB,Home,드완 에르난데스,15,5,9,55.6,0,0,0.0,5,9,55.6,5,10,50.0,1,4,5,2,0,0,0,2,0,1
../kbl_data/2022-2023,S41G01N118,원주 DB,Home,박인웅,2,1,1,100.0,0,0,0.0,1,1,100.0,0,0,0.0,0,2,2,0,0,0,0,0,0,0
../kbl_data/2022-2023,S41G01N118,원주 DB,Home,인승찬,0,0,0,0.0,0,0,0.0,0,0,0.0,0,0,0.0,0,0,0,0,0,0,0,0,0,0
../kbl_data/2022-2023,S41G01N118,서울 삼성,Away,이정현,21,3,10,30.0,3,11,27.3,6,21,28.6,6,6,100.0,0,7,7,5,0,0,1,0,3,4
../kbl_data/2022-2023,S41G01N118,서울 삼성,Away,장민국,2,1,1,100.0,0,1,0.0,1,2,50.0,0,0,0.0,0,1,1,1,0,0,0,0,0,4
../kbl_data/2022-2023,S41G01N118,서울 삼성,Away,김시래,8,3,5,60.0,0,2,0.0,3,7,42.9,2,2,100.0,2,5,7,6,1,0,0,0,2,3
../kbl_data/2022-2023,S41G01N118,서울 삼성,Away,김현수,0,0,0,0.0,0,0,0.0,0,0,0.0,0,0,0.0,0,0,0,0,0,0,0,0,0,0
../kbl_data/2022-2023,S41G01N118,서울 삼성,Away,임동섭,0,0,0,0.0,0,1,0.0,0,1,0.0,0,0,0.0,0,0,0,0,0,0,0,0,0,0
../kbl_data/2022-2023,S41G01N118,서울 삼성,Away,이호현,6,3,6,50.0,0,2,0.0,3,8,37.5,0,0,0.0,2,1,3,2,0,0,0,0,2,2
../kbl_data/2022-2023,S41G01N118,서울 삼성,Away,김광철,0,0,0,0.0,0,0,0.0,0,0,0.0,0,0,0.0,0,0,0,1,0,0,0,0,0,0
../kbl_data/2022-2023,S41G01N118,서울 삼성,Away,김한솔,0,0,0,0.0,0,0,0.0,0,0,0.0,0,0,0.0,0,0,0,0,0,0,0,0,0,0
../kbl_data/2022-2023,S41G01N118,서울 삼성,Away,조우성,9,4,5,80.0,0,0,0.0,4,5,80.0,1,3,33.3,5,7,12,3,1,0,0,0,1,4
../kbl_data/2022-2023,S41G01N118,서울 삼성,Away,이매뉴얼 테리,10,5,10,50.0,0,0,0.0,5,10,50.0,0,0,0.0,2,5,7,1,0,1,0,3,0,3
../kbl_data/2022-2023,S41G01N118,서울 삼성,Away,신동혁,3,0,1,0.0,1,3,33.3,1,4,25.0,0,0,0.0,1,1,2,0,0,0,0,0,1,1
../kbl_data/2022-2023,S41G01N118,서울 삼성,Away,조나단 알렛지,20,3,7,42.9,4,5,80.0,7,12,58.3,2,2,100.0,1,5,6,1,0,0,0,0,0,2
../kbl_data/2022-2023,S41G01N119,전주 KCC,Home,정창영,11,4,5,80.0,1,4,25.0,5,9,55.6,0,0,0.0,2,1,3,2,1,0,0,0,1,1
../kbl_data/2022-2023,S41G01N119,전주 KCC,Home,라건아,18,8,15,53.3,0,1,0.0,8,16,50.0,2,2,100.0,3,6,9,3,1,1,0,0,4,2
../kbl_data/2022-2023,S41G01N119,전주 KCC,Home,박경상,9,0,0,0.0,3,6,50.0,3,6,50.0,0,0,0.0,3,4,7,3,0,0,1,0,1,3
../kbl_data/2022-2023,S41G01N119,전주 KCC,Home,김지완,10,2,3,66.7,1,2,50.0,3,5,60.0,3,3,100.0,0,1,1,1,1,0,1,0,2,3
../kbl_data/2022-2023,S41G01N119,전주 KCC,Home,김상규,3,1,1,100.0,0,1,0.0,1,2,50.0,1,1,100.0,0,1,1,1,0,0,0,0,0,1
../kbl_data/2022-2023,S41G01N119,전주 KCC,Home,전준범,0,0,0,0.0,0,0,0.0,0,0,0.0,0,0,0.0,0,0,0,0,0,0,0,0,0,0
../kbl_data/2022-2023,S41G01N119,전주 KCC,Home,허웅,14,1,5,20.0,4,9,44.4,5,14,35.7,0,0,0.0,0,4,4,6,0,0,0,0,3,2
../kbl_data/2022-2023,S41G01N119,전주 KCC,Home,이승현,11,3,5,60.0,0,1,0.0,3,6,50.0,5,6,83.3,5,6,11,2,0,0,0,0,0,1
../kbl_data/2022-2023,S41G01N119,전주 KCC,Home,곽정훈,0,0,0,0.0,0,0,0.0,0,0,0.0,0,0,0.0,0,0,0,0,0,0,0,0,0,0
../kbl_data/2022-2023,S41G01N119,전주 KCC,Home,이근휘,3,0,0,0.0,1,5,20.0,1,5,20.0,0,0,0.0,0,4,4,0,0,0,0,0,0,2
../kbl_data/2022-2023,S41G01N119,전주 KCC,Home,론데 홀리스 제퍼슨,10,4,7,57.1,0,0,0.0,4,7,57.1,2,2,100.0,0,2,2,3,2,0,0,2,2,1
../kbl_data/2022-2023,S41G01N119,전주 KCC,Home,송동훈,1,0,0,0.0,0,0,0.0,0,0,0.0,1,2,50.0,0,0,0,0,0,0,0,0,0,0
../kbl_data/2022-2023,S41G01N119,고양 캐롯,Away,김강선,2,1,1,100.0,0,3,0.0,1,4,25.0,0,0,0.0,0,1,1,2,0,0,0,0,0,1
../kbl_data/2022-2023,S41G01N119,고양 캐롯,Away,최현민,3,0,1,0.0,1,4,25.0,1,5,20.0,0,0,0.0,1,4,5,1,1,0,0,0,0,4
../kbl_data/2022-2023,S41G01N119,고양 캐롯,Away,이정제,2,1,2,50.0,0,0,0.0,1,2,50.0,0,0,0.0,0,0,0,0,1,0,0,0,0,2
../kbl_data/2022-2023,S41G01N119,고양 캐롯,Away,전성현,33,2,4,50.0,9,12,75.0,11,16,68.8,2,2,100.0,1,2,3,2,2,0,0,0,2,1
../kbl_data/2022-2023,S41G01N119,고양 캐롯,Away,조한진,5,1,1,100.0,1,3,33.3,2,4,50.0,0,0,0.0,0,3,3,0,1,0,0,0,0,3
../kbl_data/2022-2023,S41G01N119,고양 캐롯,Away,김세창,0,0,0,0.0,0,0,0.0,0,0,0.0,0,0,0.0,0,0,0,0,0,0,0,0,3,0
../kbl_data/2022-2023,S41G01N119,고양 캐롯,Away,디드릭 로슨,26,7,10,70.0,3,8,37.5,10,18,55.6,3,5,60.0,2,3,5,2,4,3,0,0,2,1
../kbl_data/2022-2023,S41G01N119,고양 캐롯,Away,박진철,0,0,0,0.0,0,0,0.0,0,0,0.0,0,0,0.0,0,0,0,0,0,0,0,0,0,3
../kbl_data/2022-2023,S41G01N119,고양 캐롯,Away,이정현,9,1,4,25.0,1,8,12.5,2,12,16.7,4,4,100.0,0,5,5,6,1,0,0,0,3,4
../kbl_data/2022-2023,S41G01N119,고양 캐롯,Away,모리구치 히사시,0,0,2,0.0,0,0,0.0,0,2,0.0,0,0,0.0,2,0,2,0,1,0,0,0,0,0
../kbl_data/2022-2023,S41G01N119,고양 캐롯,Away,안정욱,3,0,0,0.0,1,2,50.0,1,2,50.0,0,0,0.0,0,0,0,0,0,0,0,0,0,3
../kbl_data/2022-2023,S41G01N119,고양 캐롯,Away,드미트리우스 트레드웰,0,0,0,0.0,0,0,0.0,0,0,0.0,0,0,0.0,0,2,2,0,0,0,0,0,3,1
../kbl_data/2022-2023,S41G01N120,안양 KGC,Home,양희종,5,1,1,100.0,1,2,50.0,2,3,66.7,0,0,0.0,0,2,2,1,0,0,0,0,2,1
../kbl_data/2022-2023,S41G01N120,안양 KGC,Home,오세근,18,6,8,75.0,1,2,50.0,7,10,70.0,3,3,100.0,1,1,2,4,1,0,1,0,1,1
../kbl_data/2022-2023,S41G01N120,안양 KGC,Home,정준원,0,0,0,0.0,0,0,0.0,0,0,0.0,0,0,0.0,0,0,0,0,0,0,0,0,0,0
../kbl_data/2022-2023,S41G01N120,안양 KGC,Home,배병준,4,2,3,66.7,0,2,0.0,2,5,40.0,0,0,0.0,1,3,4,0,0,0,0,0,1,0
../kbl_data/2022-2023,S41G01N120,안양 KGC,Home,문성곤,9,2,3,66.7,1,4,25.0,3,7,42.9,2,4,50.0,2,7,9,4,3,0,1,0,1,3
../kbl_data/2022-2023,S41G01N120,안양 KGC,Home,박지훈,10,5,8,62.5,0,0,0.0,5,8,62.5,0,0,0.0,0,1,1,1,0,0,0,0,0,3
../kbl_data/2022-2023,S41G01N120,안양 KGC,Home,대릴 먼로,5,2,2,100.0,0,2,0.0,2,4,50.0,1,2,50.0,0,1,1,3,1,0,0,1,1,2
../kbl_data/2022-2023,S41G01N120,안양 KGC,Home,변준형,12,2,4,50.0,1,1,100.0,3,5,60.0,5,6,83.3,0,1,1,1,2,0,0,0,4,5
../kbl_data/2022-2023,S41G01N120,안양 KGC,Home,한승희,0,0,0,0.0,0,0,0.0,0,0,0.0,0,0,0.0,0,0,0,0,0,0,0,0,0,2
../kbl_data/2022-2023,S41G01N120,안양 KGC,Home,오마리 스펠맨,7,2,6,33.3,1,5,20.0,3,11,27.3,0,0,0.0,2,4,6,2,1,1,0,1,3,4
../kbl_data/2022-2023,S41G01N120,안양 KGC,Home,조은후,1,0,1,0.0,0,0,0.0,0,1,0.0,1,2,50.0,0,0,0,0,1,0,0,0,0,1
../kbl_data/2022-2023,S41G01N120,안양 KGC,Home,렌즈 아반도,2,1,4,25.0,0,0,0.0,1,4,25.0,0,2,0.0,1,1,2,1,1,0,0,0,0,1
../kbl_data/2022-2023,S41G01N120,창원 LG,Away,이관희,13,3,5,60.0,1,4,25.0,4,9,44.4,4,4,100.0,2,4,6,3,2,1,0,0,2,1
../kbl_data/2022-2023,S41G01N120,창원 LG,Away,정희재,3,0,2,0.0,1,4,25.0,1,6,16.7,0,0,0.0,0,1,1,1,1,0,0,0,1,4
../kbl_data/2022-2023,S41G01N120,창원 LG,Away,한상혁,2,1,1,100.0,0,0,0.0,1,1,100.0,0,0,0.0,1,0,1,0,0,0,0,0,0,0
../kbl_data/2022-2023,S41G01N120,창원 LG,Away,이재도,17,4,7,57.1,2,3,66.7,6,10,60.0,3,4,75.0,0,8,8,3,2,0,0,0,5,2
../kbl_data/2022-2023,S41G01N120,창원 LG,Away,김준일,10,4,7,57.1,0,0,0.0,4,7,57.1,2,3,66.7,1,1,2,0,0,1,0,0,2,1
../kbl_data/2022-2023,S41G01N120,창원 LG,Away,정인덕,7,0,1,0.0,2,2,100.0,2,3,66.7,1,2,50.0,1,1,2,0,0,0,0,0,1,3
../kbl_data/2022-2023,S41G01N120,창원 LG,Away,최승욱,0,0,0,0.0,0,0,0.0,0,0,0.0,0,0,0.0,0,0,0,0,0,0,0,0,0,0
../kbl_data/2022-2023,S41G01N120,창원 LG,Away,김준형,0,0,0,0.0,0,0,0.0,0,0,0.0,0,0,0.0,0,0,0,0,0,0,0,0,0,0
../kbl_data/2022-2023,S41G01N120,창원 LG,Away,윤원상,6,2,3,66.7,0,0,0.0,2,3,66.7,2,2,100.0,1,2,3,1,1,0,1,0,1,1
../kbl_data/2022-2023,S41G01N120,창원 LG,Away,아셈 마레이,16,7,13,53.8,0,0,0.0,7,13,53.8,2,4,50.0,4,4,8,2,2,0,0,0,2,4
../kbl_data/2022-2023,S41G01N120,창원 LG,Away,이승우,0,0,0,0.0,0,0,0.0,0,0,0.0,0,0,0.0,0,0,0,0,0,0,0,0,0,0
../kbl_data/2022-2023,S41G01N120,창원 LG,Away,단테 커닝햄,5,2,6,33.3,0,0,0.0,2,6,33.3,1,1,100.0,0,4,4,1,0,3,0,1,2,3
../kbl_data/2022-2023,S41G01N121,수원 KT,Home,김동욱,8,1,1,100.0,2,4,50.0,3,5,60.0,0,0,0.0,1,1,2,3,0,0,0,0,1,0
../kbl_data/2022-2023,S41G01N121,수원 KT,Home,김영환,0,0,1,0.0,0,1,0.0,0,2,0.0,0,0,0.0,0,0,0,1,1,0,0,0,2,3
../kbl_data/2022-2023,S41G01N121,수원 KT,Home,한희원,0,0,0,0.0,0,1,0.0,0,1,0.0,0,0,0.0,0,2,2,0,0,0,0,0,0,1
../kbl_data/2022-2023,S41G01N121,수원 KT,Home,최창진,0,0,0,0.0,0,1,0.0,0,1,0.0,0,0,0.0,0,1,1,2,0,0,0,0,0,0
../kbl_data/2022-2023,S41G01N121,수원 KT,Home,정성우,7,3,5,60.0,0,2,0.0,3,7,42.9,1,1,100.0,0,2,2,1,0,0,0,0,2,2
../kbl_data/2022-2023,S41G01N121,수원 KT,Home,최성모,0,0,1,0.0,0,1,0.0,0,2,0.0,0,0,0.0,0,0,0,0,0,0,0,0,0,0
../kbl_data/2022-2023,S41G01N121,수원 KT,Home,양홍석,11,4,5,80.0,1,3,33.3,5,8,62.5,0,0,0.0,2,5,7,3,2,1,0,0,1,1
../kbl_data/2022-2023,S41G01N121,수원 KT,Home,박지원,0,0,3,0.0,0,2,0.0,0,5,0.0,0,0,0.0,4,3,7,3,1,0,0,0,0,3
../kbl_data/2022-2023,S41G01N121,수원 KT,Home,하윤기,17,6,13,46.2,0,0,0.0,6,13,46.2,5,6,83.3,7,7,14,2,0,2,0,1,2,1
../kbl_data/2022-2023,S41G01N121,수원 KT,Home,이두원,0,0,0,0.0,0,0,0.0,0,0,0.0,0,0,0.0,1,1,2,0,1,0,0,0,0,4
../kbl_data/2022-2023,S41G01N121,수원 KT,Home,레스터 프로스퍼,17,6,8,75.0,1,4,25.0,7,12,58.3,2,2,100.0,0,5,5,0,0,3,0,0,1,3
../kbl_data/2022-2023,S41G01N121,수원 KT,Home,재로드 존스,17,4,12,33.3,3,7,42.9,7,19,36.8,0,0,0.0,3,5,8,1,1,0,1,0,4,1
../kbl_data/2022-2023,S41G01N121,원주 DB,Away,박찬희,0,0,1,0.0,0,0,0.0,0,1,0.0,0,0,0.0,1,2,3,3,1,0,0,0,0,0
../kbl_data/2022-2023,S41G01N121,원주 DB,Away,김현호,2,1,1,100.0,0,0,0.0,1,1,100.0,0,0,0.0,1,1,2,1,0,0,0,0,0,2
../kbl_data/2022-2023,S41G01N121,원주 DB,Away,두경민,3,0,5,0.0,0,2,0.0,0,7,0.0,3,3,100.0,0,1,1,0,1,0,0,0,2,0
../kbl_data/2022-2023,S41G01N121,원주 DB,Away,김종규,20,8,13,61.5,0,3,0.0,8,16,50.0,4,4,100.0,1,4,5,3,1,4,0,1,0,3
../kbl_data/2022-2023,S41G01N121,원주 DB,Away,최승욱,4,2,4,50.0,0,2,0.0,2,6,33.3,0,2,0.0,0,0,0,1,1,0,0,0,0,0
../kbl_data/2022-2023,S41G01N121,원주 DB,Away,윤성원,3,0,0,0.0,1,4,25.0,1,4,25.0,0,0,0.0,2,1,3,0,1,0,0,0,0,1
../kbl_data/2022-2023,S41G01N121,원주 DB,Away,이준희,2,0,1,0.0,0,0,0.0,0,1,0.0,2,2,100.0,0,0,0,1,1,0,0,0,0,1
../kbl_data/2022-2023,S41G01N121,원주 DB,Away,레나드 프리먼,4,2,4,50.0,0,0,0.0,2,4,50.0,0,0,0.0,1,5,6,1,0,0,0,0,0,3
../kbl_data/2022-2023,S41G01N121,원주 DB,Away,이선 알바노,14,4,8,50.0,0,3,0.0,4,11,36.4,6,6,100.0,0,0,0,4,0,0,0,0,4,4
../kbl_data/2022-2023,S41G01N121,원주 DB,Away,드완 에르난데스,10,4,6,66.7,0,1,0.0,4,7,57.1,2,5,40.0,3,6,9,0,2,0,0,1,3,1
../kbl_data/2022-2023,S41G01N121,원주 DB,Away,박인웅,2,1,3,33.3,0,2,0.0,1,5,20.0,0,0,0.0,1,0,1,0,0,0,1,0,0,0
../kbl_data/2022-2023,S41G01N121,원주 DB,Away,인승찬,0,0,0,0.0,0,0,0.0,0,0,0.0,0,0,0.0,0,0,0,0,0,0,0,0,0,0
../kbl_data/2022-2023,S41G01N122,울산 현대모비스,Home,함지훈,9,3,5,60.0,0,1,0.0,3,6,50.0,3,4,75.0,5,5,10,6,0,1,0,0,0,1
../kbl_data/2022-2023,S41G01N122,울산 현대모비스,Home,김현민,0,0,1,0.0,0,0,0.0,0,1,0.0,0,0,0.0,0,0,0,1,0,0,0,0,0,0
../kbl_data/2022-2023,S41G01N122,울산 현대모비스,Home,장재석,8,2,6,33.3,0,0,0.0,2,6,33.3,4,9,44.4,5,2,7,3,0,2,0,0,1,4
../kbl_data/2022-2023,S41G01N122,울산 현대모비스,Home,김영현,3,0,1,0.0,1,7,14.3,1,8,12.5,0,0,0.0,2,3,5,0,0,0,0,0,0,1
../kbl_data/2022-2023,S41G01N122,울산 현대모비스,Home,김국찬,0,0,0,0.0,0,0,0.0,0,0,0.0,0,0,0.0,0,0,0,0,0,0,0,0,0,0
../kbl_data/2022-2023,S41G01N122,울산 현대모비스,Home,서명진,9,3,5,60.0,1,5,20.0,4,10,40.0,0,0,0.0,2,1,3,7,1,0,0,0,2,3
../kbl_data/2022-2023,S41G01N122,울산 현대모비스,Home,헨리 심스,4,2,5,40.0,0,0,0.0,2,5,40.0,0,0,0.0,2,2,4,0,0,0,0,0,1,2
../kbl_data/2022-2023,S41G01N122,울산 현대모비스,Home,이우석,13,2,8,25.0,2,5,40.0,4,13,30.8,3,4,75.0,2,10,12,2,1,1,0,0,0,2
../kbl_data/2022-2023,S41G01N122,울산 현대모비스,Home,신민석,4,0,1,0.0,1,2,50.0,1,3,33.3,1,2,50.0,0,3,3,1,2,0,0,0,1,1
../kbl_data/2022-2023,S41G01N122,울산 현대모비스,Home,김동준,0,0,0,0.0,0,0,0.0,0,0,0.0,0,0,0.0,0,0,0,0,0,0,0,0,0,0
../kbl_data/2022-2023,S41G01N122,울산 현대모비스,Home,론제이 아바리엔토스,12,1,5,20.0,1,6,16.7,2,11,18.2,7,9,77.8,0,3,3,0,1,0,0,0,0,0
../kbl_data/2022-2023,S41G01N122,울산 현대모비스,Home,게이지 프림,14,6,11,54.5,0,0,0.0,6,11,54.5,2,2,100.0,0,3,3,1,1,0,1,0,1,4
../kbl_data/2022-2023,S41G01N122,대구 한국가스공사,Away,박지훈,0,0,0,0.0,0,2,0.0,0,2,0.0,0,0,0.0,0,1,1,1,0,0,0,0,0,2
../kbl_data/2022-2023,S41G01N122,대구 한국가스공사,Away,이원대,0,0,0,0.0,0,0,0.0,0,0,0.0,0,0,0.0,0,0,0,0,0,0,0,0,0,0
../kbl_data/2022-2023,S41G01N122,대구 한국가스공사,Away,이대헌,7,3,8,37.5,0,2,0.0,3,10,30.0,1,2,50.0,0,2,2,1,0,0,0,0,1,1
../kbl_data/2022-2023,S41G01N122,대구 한국가스공사,Away,이대성,27,8,14,57.1,2,4,50.0,10,18,55.6,5,7,71.4,1,3,4,3,1,1,0,0,3,3
../kbl_data/2022-2023,S41G01N122,대구 한국가스공사,Away,정효근,12,2,4,50.0,2,4,50.0,4,8,50.0,2,2,100.0,1,2,3,0,0,0,0,0,0,3
../kbl_data/2022-2023,S41G01N122,대구 한국가스공사,Away,머피 할로웨이,16,8,16,50.0,0,2,0.0,8,18,44.4,0,1,0.0,4,14,18,1,1,0,0,0,1,3
../kbl_data/2022-2023,S41G01N122,대구 한국가스공사,Away,우동현,3,0,1,0.0,1,3,33.3,1,4,25.0,0,0,0.0,0,4,4,1,1,0,1,0,2,4
../kbl_data/2022-2023,S41G01N122,대구 한국가스공사,Away,전현우,0,0,0,0.0,0,1,0.0,0,1,0.0,0,0,0.0,1,1,2,1,0,0,0,0,0,2
../kbl_data/2022-2023,S41G01N122,대구 한국가스공사,Away,신승민,0,0,0,0.0,0,0,0.0,0,0,0.0,0,0,0.0,0,0,0,0,0,0,0,0,0,2
../kbl_data/2022-2023,S41G01N122,대구 한국가스공사,Away,샘조세프 벨란겔,3,0,1,0.0,1,3,33.3,1,4,25.0,0,0,0.0,0,1,1,2,0,0,0,0,2,0
../kbl_data/2022-2023,S41G01N122,대구 한국가스공사,Away,유슈 은도예,2,1,1,100.0,0,0,0.0,1,1,100.0,0,0,0.0,1,3,4,0,0,1,1,0,1,3
../kbl_data/2022-2023,S41G01N122,대구 한국가스공사,Away,염유성,0,0,0,0.0,0,0,0.0,0,0,0.0,0,0,0.0,0,0,0,0,0,0,0,0,0,0
../kbl_data/2022-2023,S41G01N123,서울 SK,Home,양우섭,0,0,0,0.0,0,0,0.0,0,0,0.0,0,0,0.0,0,0,0,0,0,0,0,0,0,1
../kbl_data/2022-2023,S41G01N123,서울 SK,Home,허일영,3,0,0,0.0,1,4,25.0,1,4,25.0,0,0,0.0,2,4,6,1,0,0,0,0,0,2
../kbl_data/2022-2023,S41G01N123,서울 SK,Home,김선형,12,2,6,33.3,2,4,50.0,4,10,40.0,2,3,66.7,1,3,4,8,2,1,0,0,2,4
../kbl_data/2022-2023,S41G01N123,서울 SK,Home,홍경기,0,0,0,0.0,0,0,0.0,0,0,0.0,0,0,0.0,0,0,0,0,0,0,0,0,0,0
../kbl_data/2022-2023,S41G01N123,서울 SK,Home,최부경,7,3,3,100.0,0,0,0.0,3,3,100.0,1,1,100.0,1,0,1,1,1,0,1,1,1,2
../kbl_data/2022-2023,S41G01N123,서울 SK,Home,리온 윌리엄스,0,0,0,0.0,0,0,0.0,0,0,0.0,0,0,0.0,0,0,0,0,0,0,0,0,0,0
../kbl_data/2022-2023,S41G01N123,서울 SK,Home,최원혁,0,0,0,0.0,0,0,0.0,0,0,0.0,0,0,0.0,0,0,0,0,0,0,0,0,0,0
../kbl_data/2022-2023,S41G01N123,서울 SK,Home,최준용,20,6,12,50.0,2,5,40.0,8,17,47.1,2,6,33.3,0,7,7,2,0,1,0,0,2,1
../kbl_data/2022-2023,S41G01N123,서울 SK,Home,최성원,2,1,1,100.0,0,2,0.0,1,3,33.3,0,0,0.0,1,2,3,3,0,0,0,0,0,2
../kbl_data/2022-2023,S41G01N123,서울 SK,Home,자밀 워니,34,15,26,57.7,0,1,0.0,15,27,55.6,4,7,57.1,3,9,12,2,2,2,0,3,3,3
../kbl_data/2022-2023,S41G01N123,서울 SK,Home,김형빈,0,0,1,0.0,0,0,0.0,0,1,0.0,0,0,0.0,0,0,0,0,0,0,0,0,0,0
../kbl_data/2022-2023,S41G01N123,서울 SK,Home,오재현,4,1,1,100.0,0,1,0.0,1,2,50.0,2,3,66.7,0,4,4,0,1,1,0,0,0,5
../kbl_data/2022-2023,S41G01N123,서울 삼성,Away,이정현,11,1,1,100.0,0,4,0.0,1,5,20.0,9,10,90.0,0,2,2,2,0,0,0,0,4,2
../kbl_data/2022-2023,S41G01N123,서울 삼성,Away,장민국,7,1,4,25.0,1,7,14.3,2,11,18.2,2,2,100.0,1,4,5,2,0,0,1,0,0,1
../kbl_data/2022-2023,S41G01N123,서울 삼성,Away,김시래,7,1,7,14.3,1,2,50.0,2,9,22.2,2,4,50.0,0,0,0,2,2,0,0,0,1,2
../kbl_data/2022-2023,S41G01N123,서울 삼성,Away,임동섭,6,1,1,100.0,1,3,33.3,2,4,50.0,1,3,33.3,1,2,3,0,0,0,0,0,0,3
../kbl_data/2022-2023,S41G01N123,서울 삼성,Away,이호현,9,3,4,75.0,1,2,50.0,4,6,66.7,0,0,0.0,1,0,1,4,2,0,0,0,3,1
../kbl_data/2022-2023,S41G01N123,서울 삼성,Away,김광철,0,0,0,0.0,0,0,0.0,0,0,0.0,0,0,0.0,0,0,0,0,0,0,0,0,0,0
../kbl_data/2022-2023,S41G01N123,서울 삼성,Away,김진영,4,1,5,20.0,0,2,0.0,1,7,14.3,2,2,100.0,1,2,3,2,1,0,0,0,1,3
../kbl_data/2022-2023,S41G01N123,서울 삼성,Away,조우성,0,0,1,0.0,0,0,0.0,0,1,0.0,0,0,0.0,1,0,1,0,1,0,0,0,0,2
../kbl_data/2022-2023,S41G01N123,서울 삼성,Away,이원석,0,0,0,0.0,0,0,0.0,0,0,0.0,0,0,0.0,0,0,0,0,0,0,0,0,0,0
../kbl_data/2022-2023,S41G01N123,서울 삼성,Away,이매뉴얼 테리,20,10,16,62.5,0,0,0.0,10,16,62.5,0,1,0.0,3,18,21,2,1,0,0,4,2,3
../kbl_data/2022-2023,S41G01N123,서울 삼성,Away,신동혁,0,0,2,0.0,0,1,0.0,0,3,0.0,0,0,0.0,0,0,0,0,0,0,0,0,0,1
../kbl_data/2022-2023,S41G01N123,서울 삼성,Away,조나단 알렛지,0,0,2,0.0,0,0,0.0,0,2,0.0,0,0,0.0,0,2,2,0,0,0,0,0,1,3
../kbl_data/2022-2023,S41G01N124,창원 LG,Home,이관희,8,2,4,50.0,1,3,33.3,3,7,42.9,1,1,100.0,0,3,3,0,1,1,0,0,1,0
../kbl_data/2022-2023,S41G01N124,창원 LG,Home,정희재,0,0,0,0.0,0,2,0.0,0,2,0.0,0,0,0.0,0,1,1,0,1,0,0,0,1,2
../kbl_data/2022-2023,S41G01N124,창원 LG,Home,한상혁,4,2,2,100.0,0,1,0.0,2,3,66.7,0,0,0.0,0,0,0,1,0,0,0,0,0,0
../kbl_data/2022-2023,S41G01N124,창원 LG,Home,이재도,22,6,7,85.7,1,5,20.0,7,12,58.3,7,9,77.8,0,1,1,7,0,0,0,0,0,2
../kbl_data/2022-2023,S41G01N124,창원 LG,Home,김준일,12,6,8,75.0,0,1,0.0,6,9,66.7,0,0,0.0,0,1,1,3,0,0,0,1,3,4
../kbl_data/2022-2023,S41G01N124,창원 LG,Home,정인덕,3,0,0,0.0,1,1,100.0,1,1,100.0,0,0,0.0,1,0,1,0,0,0,0,0,0,0
../kbl_data/2022-2023,S41G01N124,창원 LG,Home,최승욱,3,1,2,50.0,0,0,0.0,1,2,50.0,1,2,50.0,1,2,3,0,1,0,0,0,0,0
../kbl_data/2022-2023,S41G01N124,창원 LG,Home,김준형,3,0,0,0.0,1,2,50.0,1,2,50.0,0,0,0.0,0,0,0,0,0,0,0,0,0,0
../kbl_data/2022-2023,S41G01N124,창원 LG,Home,윤원상,6,0,1,0.0,2,7,28.6,2,8,25.0,0,0,0.0,1,0,1,2,0,0,0,0,0,3
../kbl_data/2022-2023,S41G01N124,창원 LG,Home,아셈 마레이,11,4,9,44.4,0,0,0.0,4,9,44.4,3,6,50.0,2,7,9,3,4,0,0,1,2,1
../kbl_data/2022-2023,S41G01N124,창원 LG,Home,저스틴 구탕,9,4,4,100.0,0,1,0.0,4,5,80.0,1,1,100.0,0,1,1,3,1,0,0,1,1,3
../kbl_data/2022-2023,S41G01N124,창원 LG,Home,단테 커닝햄,4,2,2,100.0,0,0,0.0,2,2,100.0,0,0,0.0,0,2,2,0,1,1,0,0,1,0
../kbl_data/2022-2023,S41G01N124,전주 KCC,Away,정창영,8,1,3,33.3,2,6,33.3,3,9,33.3,0,0,0.0,1,2,3,4,0,0,0,0,0,2
../kbl_data/2022-2023,S41G01N124,전주 KCC,Away,라건아,23,10,14,71.4,1,2,50.0,11,16,68.8,0,0,0.0,8,10,18,6,0,1,0,0,1,5
../kbl_data/2022-2023,S41G01N124,전주 KCC,Away,박경상,0,0,0,0.0,0,0,0.0,0,0,0.0,0,0,0.0,0,0,0,0,0,0,0,0,0,0
../kbl_data/2022-2023,S41G01N124,전주 KCC,Away,김지완,15,3,3,100.0,3,4,75.0,6,7,85.7,0,0,0.0,0,2,2,3,0,1,0,0,1,3
../kbl_data/2022-2023,S41G01N124,전주 KCC,Away,김상규,0,0,4,0.0,0,1,0.0,0,5,0.0,0,0,0.0,0,0,0,0,0,0,0,0,0,0
../kbl_data/2022-2023,S41G01N124,전주 KCC,Away,전준범,0,0,0,0.0,0,0,0.0,0,0,0.0,0,0,0.0,0,0,0,0,0,0,0,0,1,0
../kbl_data/2022-2023,S41G01N124,전주 KCC,Away,허웅,23,6,8,75.0,3,4,75.0,9,12,75.0,2,3,66.7,0,2,2,4,3,0,0,0,4,1
../kbl_data/2022-2023,S41G01N124,전주 KCC,Away,이승현,15,6,10,60.0,0,1,0.0,6,11,54.5,3,5,60.0,1,3,4,5,0,0,0,0,1,2
../kbl_data/2022-2023,S41G01N124,전주 KCC,Away,곽정훈,0,0,0,0.0,0,0,0.0,0,0,0.0,0,0,0.0,0,0,0,0,0,0,0,0,0,0
../kbl_data/2022-2023,S41G01N124,전주 KCC,Away,이근휘,9,0,0,0.0,3,4,75.0,3,4,75.0,0,0,0.0,0,3,3,1,0,0,0,0,0,2
../kbl_data/2022-2023,S41G01N124,전주 KCC,Away,론데 홀리스 제퍼슨,8,3,6,50.0,0,0,0.0,3,6,50.0,2,2,100.0,1,1,2,1,1,0,0,1,1,1
../kbl_data/2022-2023,S41G01N124,전주 KCC,Away,송동훈,0,0,0,0.0,0,0,0.0,0,0,0.0,0,0,0.0,1,1,2,1,1,0,1,0,2,3
../kbl_data/2022-2023,S41G01N125,안양 KGC,Home,양희종,7,1,3,33.3,1,2,50.0,2,5,40.0,2,2,100.0,0,1,1,2,0,1,0,0,2,4
../kbl_data/2022-2023,S41G01N125,안양 KGC,Home,오세근,17,7,11,63.6,0,0,0.0,7,11,63.6,3,5,60.0,2,7,9,3,2,2,0,0,3,1
../kbl_data/2022-2023,S41G01N125,안양 KGC,Home,정준원,3,0,0,0.0,1,2,50.0,1,2,50.0,0,0,0.0,0,1,1,1,0,0,0,0,0,0
../kbl_data/2022-2023,S41G01N125,안양 KGC,Home,배병준,13,0,3,0.0,3,4,75.0,3,7,42.9,4,4,100.0,0,4,4,1,1,0,0,0,1,4
../kbl_data/2022-2023,S41G01N125,안양 KGC,Home,문성곤,2,1,1,100.0,0,4,0.0,1,5,20.0,0,0,0.0,0,4,4,4,1,0,0,0,2,3
../kbl_data/2022-2023,S41G01N125,안양 KGC,Home,박지훈,17,6,8,75.0,1,3,33.3,7,11,63.6,2,2,100.0,1,2,3,3,4,0,0,0,0,3
../kbl_data/2022-2023,S41G01N125,안양 KGC,Home,대릴 먼로,8,3,5,60.0,0,0,0.0,3,5,60.0,2,4,50.0,1,3,4,0,3,0,0,0,3,2
../kbl_data/2022-2023,S41G01N125,안양 KGC,Home,변준형,14,5,8,62.5,0,2,0.0,5,10,50.0,4,4,100.0,0,2,2,5,0,0,1,0,2,5
../kbl_data/2022-2023,S41G01N125,안양 KGC,Home,한승희,0,0,0,0.0,0,0,0.0,0,0,0.0,0,0,0.0,0,0,0,0,0,0,0,0,0,0
../kbl_data/2022-2023,S41G01N125,안양 KGC,Home,오마리 스펠맨,3,0,2,0.0,1,3,33.3,1,5,20.0,0,0,0.0,1,2,3,0,0,0,0,0,1,0
../kbl_data/2022-2023,S41G01N125,안양 KGC,Home,조은후,0,0,0,0.0,0,0,0.0,0,0,0.0,0,0,0.0,0,0,0,0,0,0,0,0,0,0
../kbl_data/2022-2023,S41G01N125,안양 KGC,Home,렌즈 아반도,0,0,0,0.0,0,0,0.0,0,0,0.0,0,0,0.0,0,0,0,0,0,0,0,0,0,0
../kbl_data/2022-2023,S41G01N125,고양 캐롯,Away,김강선,5,1,2,50.0,1,6,16.7,2,8,25.0,0,0,0.0,2,2,4,2,1,0,0,0,0,5
../kbl_data/2022-2023,S41G01N125,고양 캐롯,Away,최현민,6,0,0,0.0,1,6,16.7,1,6,16.7,3,4,75.0,0,4,4,1,1,0,0,0,1,2
../kbl_data/2022-2023,S41G01N125,고양 캐롯,Away,전성현,23,2,5,40.0,5,13,38.5,7,18,38.9,4,5,80.0,1,0,1,3,0,0,0,0,5,2
../kbl_data/2022-2023,S41G01N125,고양 캐롯,Away,조한진,9,0,0,0.0,3,4,75.0,3,4,75.0,0,0,0.0,1,4,5,0,3,0,0,0,2,3
../kbl_data/2022-2023,S41G01N125,고양 캐롯,Away,김세창,0,0,0,0.0,0,0,0.0,0,0,0.0,0,0,0.0,0,1,1,0,1,0,0,0,1,0
../kbl_data/2022-2023,S41G01N125,고양 캐롯,Away,디드릭 로슨,20,5,6,83.3,2,5,40.0,7,11,63.6,4,4,100.0,3,12,15,3,2,1,0,2,3,1
../kbl_data/2022-2023,S41G01N125,고양 캐롯,Away,박진철,0,0,0,0.0,0,0,0.0,0,0,0.0,0,0,0.0,0,0,0,0,0,0,0,0,0,1
../kbl_data/2022-2023,S41G01N125,고양 캐롯,Away,이정현,19,5,10,50.0,1,7,14.3,6,17,35.3,6,8,75.0,1,2,3,8,2,0,1,0,1,4
../kbl_data/2022-2023,S41G01N125,고양 캐롯,Away,모리구치 히사시,0,0,0,0.0,0,0,0.0,0,0,0.0,0,0,0.0,0,0,0,0,0,0,0,0,0,0
../kbl_data/2022-2023,S41G01N125,고양 캐롯,Away,조재우,0,0,0,0.0,0,0,0.0,0,0,0.0,0,0,0.0,0,0,0,0,0,0,0,0,0,0
../kbl_data/2022-2023,S41G01N125,고양 캐롯,Away,안정욱,0,0,0,0.0,0,0,0.0,0,0,0.0,0,0,0.0,0,0,0,0,0,0,0,0,0,0
../kbl_data/2022-2023,S41G01N125,고양 캐롯,Away,드미트리우스 트레드웰,0,0,0,0.0,0,0,0.0,0,0,0.0,0,0,0.0,0,0,0,0,0,0,0,0,0,0
../kbl_data/2022-2023,S41G01N126,수원 KT,Home,김동욱,6,0,0,0.0,2,3,66.7,2,3,66.7,0,0,0.0,0,2,2,2,0,0,0,0,1,1
../kbl_data/2022-2023,S41G01N126,수원 KT,Home,김영환,3,1,3,33.3,0,1,0.0,1,4,25.0,1,1,100.0,1,1,2,4,1,0,0,0,2,2
../kbl_data/2022-2023,S41G01N126,수원 KT,Home,한희원,0,0,0,0.0,0,0,0.0,0,0,0.0,0,0,0.0,0,0,0,0,0,0,0,0,0,0
../kbl_data/2022-2023,S41G01N126,수원 KT,Home,최창진,0,0,0,0.0,0,0,0.0,0,0,0.0,0,0,0.0,0,0,0,0,0,0,0,0,0,0
../kbl_data/2022-2023,S41G01N126,수원 KT,Home,정성우,8,2,3,66.7,1,4,25.0,3,7,42.9,1,2,50.0,1,3,4,11,2,0,1,0,2,2
../kbl_data/2022-2023,S41G01N126,수원 KT,Home,최성모,0,0,0,0.0,0,0,0.0,0,0,0.0,0,0,0.0,0,0,0,0,0,0,0,0,0,1
../kbl_data/2022-2023,S41G01N126,수원 KT,Home,양홍석,22,6,8,75.0,2,5,40.0,8,13,61.5,4,4,100.0,1,3,4,4,1,0,0,0,0,0
../kbl_data/2022-2023,S41G01N126,수원 KT,Home,박지원,3,1,3,33.3,0,1,0.0,1,4,25.0,1,2,50.0,0,2,2,5,0,0,0,0,2,2
../kbl_data/2022-2023,S41G01N126,수원 KT,Home,하윤기,27,10,12,83.3,0,0,0.0,10,12,83.3,7,8,87.5,1,5,6,0,1,1,0,1,1,1
../kbl_data/2022-2023,S41G01N126,수원 KT,Home,이두원,3,1,2,50.0,0,0,0.0,1,2,50.0,1,2,50.0,0,0,0,2,0,0,0,0,0,3
../kbl_data/2022-2023,S41G01N126,수원 KT,Home,레스터 프로스퍼,8,1,3,33.3,2,6,33.3,3,9,33.3,0,0,0.0,1,3,4,1,0,1,0,0,3,5
../kbl_data/2022-2023,S41G01N126,수원 KT,Home,재로드 존스,21,6,9,66.7,3,5,60.0,9,14,64.3,0,0,0.0,2,3,5,1,2,0,0,2,1,4
../kbl_data/2022-2023,S41G01N126,울산 현대모비스,Away,함지훈,2,1,3,33.3,0,1,0.0,1,4,25.0,0,0,0.0,1,2,3,1,0,0,0,0,0,3
../kbl_data/2022-2023,S41G01N126,울산 현대모비스,Away,김현민,0,0,0,0.0,0,1,0.0,0,1,0.0,0,0,0.0,0,1,1,0,0,0,0,0,0,0
../kbl_data/2022-2023,S41G01N126,울산 현대모비스,Away,장재석,6,3,4,75.0,0,0,0.0,3,4,75.0,0,0,0.0,0,2,2,0,2,0,0,0,3,3
../kbl_data/2022-2023,S41G01N126,울산 현대모비스,Away,김영현,5,1,2,50.0,1,3,33.3,2,5,40.0,0,0,0.0,0,2,2,2,1,0,0,0,0,1
../kbl_data/2022-2023,S41G01N126,울산 현대모비스,Away,김국찬,2,1,1,100.0,0,0,0.0,1,1,100.0,0,0,0.0,1,1,2,0,0,0,0,0,1,0
../kbl_data/2022-2023,S41G01N126,울산 현대모비스,Away,서명진,7,1,4,25.0,1,3,33.3,2,7,28.6,2,2,100.0,1,1,2,3,0,0,0,0,2,2
../kbl_data/2022-2023,S41G01N126,울산 현대모비스,Away,헨리 심스,4,1,1,100.0,0,0,0.0,1,1,100.0,2,2,100.0,1,0,1,0,0,0,0,0,0,0
../kbl_data/2022-2023,S41G01N126,울산 현대모비스,Away,이우석,7,3,5,60.0,0,2,0.0,3,7,42.9,1,2,50.0,2,2,4,2,0,0,0,0,2,4
../kbl_data/2022-2023,S41G01N126,울산 현대모비스,Away,신민석,0,0,0,0.0,0,3,0.0,0,3,0.0,0,0,0.0,0,0,0,1,2,0,0,0,1,1
../kbl_data/2022-2023,S41G01N126,울산 현대모비스,Away,론제이 아바리엔토스,29,3,4,75.0,7,12,58.3,10,16,62.5,2,2,100.0,0,1,1,4,2,0,0,0,0,2
../kbl_data/2022-2023,S41G01N126,울산 현대모비스,Away,게이지 프림,29,9,14,64.3,0,0,0.0,9,14,64.3,11,14,78.6,2,11,13,2,1,0,0,0,2,2
../kbl_data/2022-2023,S41G01N126,울산 현대모비스,Away,김태완,0,0,0,0.0,0,0,0.0,0,0,0.0,0,0,0.0,0,0,0,0,0,0,0,0,0,0
../kbl_data/2022-2023,S41G01N127,안양 KGC,Home,양희종,2,1,1,100.0,0,0,0.0,1,1,100.0,0,0,0.0,0,1,1,0,0,0,0,0,0,1
../kbl_data/2022-2023,S41G01N127,안양 KGC,Home,오세근,9,2,8,25.0,1,2,50.0,3,10,30.0,2,3,66.7,1,5,6,2,0,0,0,0,0,1
../kbl_data/2022-2023,S41G01N127,안양 KGC,Home,정준원,7,2,5,40.0,1,1,100.0,3,6,50.0,0,0,0.0,0,3,3,1,0,0,0,0,0,1
../kbl_data/2022-2023,S41G01N127,안양 KGC,Home,배병준,13,2,4,50.0,3,6,50.0,5,10,50.0,0,0,0.0,1,2,3,2,3,0,0,0,0,0
../kbl_data/2022-2023,S41G01N127,안양 KGC,Home,문성곤,4,1,3,33.3,0,0,0.0,1,3,33.3,2,3,66.7,0,4,4,0,0,0,0,0,2,2
../kbl_data/2022-2023,S41G01N127,안양 KGC,Home,박지훈,9,3,5,60.0,0,2,0.0,3,7,42.9,3,4,75.0,1,3,4,2,1,0,0,0,0,3
../kbl_data/2022-2023,S41G01N127,안양 KGC,Home,이우정,0,0,0,0.0,0,1,0.0,0,1,0.0,0,0,0.0,0,0,0,0,0,0,0,0,0,2
../kbl_data/2022-2023,S41G01N127,안양 KGC,Home,대릴 먼로,0,0,0,0.0,0,1,0.0,0,1,0.0,0,0,0.0,0,1,1,0,0,0,0,0,0,0
../kbl_data/2022-2023,S41G01N127,안양 KGC,Home,변준형,4,2,5,40.0,0,3,0.0,2,8,25.0,0,0,0.0,0,0,0,7,0,0,1,0,0,1
../kbl_data/2022-2023,S41G01N127,안양 KGC,Home,김경원,4,2,3,66.7,0,0,0.0,2,3,66.7,0,0,0.0,1,0,1,0,0,2,0,0,1,0
../kbl_data/2022-2023,S41G01N127,안양 KGC,Home,오마리 스펠맨,38,8,13,61.5,7,10,70.0,15,23,65.2,1,2,50.0,3,10,13,2,2,1,0,2,0,1
../kbl_data/2022-2023,S41G01N127,안양 KGC,Home,렌즈 아반도,2,1,4,25.0,0,1,0.0,1,5,20.0,0,0,0.0,0,2,2,1,0,0,0,0,0,1
../kbl_data/2022-2023,S41G01N127,원주 DB,Away,박찬희,0,0,1,0.0,0,1,0.0,0,2,0.0,0,0,0.0,0,1,1,0,0,0,0,0,1,1
../kbl_data/2022-2023,S41G01N127,원주 DB,Away,김현호,14,3,5,60.0,2,4,50.0,5,9,55.6,2,2,100.0,2,3,5,2,0,0,0,0,1,3
../kbl_data/2022-2023,S41G01N127,원주 DB,Away,김종규,22,4,11,36.4,4,4,100.0,8,15,53.3,2,4,50.0,3,10,13,1,0,2,0,0,2,3
../kbl_data/2022-2023,S41G01N127,원주 DB,Away,최승욱,2,1,5,20.0,0,1,0.0,1,6,16.7,0,0,0.0,2,1,3,0,0,0,0,0,2,2
../kbl_data/2022-2023,S41G01N127,원주 DB,Away,윤성원,0,0,0,0.0,0,2,0.0,0,2,0.0,0,0,0.0,0,1,1,0,0,0,0,0,0,0
../kbl_data/2022-2023,S41G01N127,원주 DB,Away,이준희,3,1,1,100.0,0,3,0.0,1,4,25.0,1,1,100.0,0,1,1,2,0,0,0,0,1,3
../kbl_data/2022-2023,S41G01N127,원주 DB,Away,레나드 프리먼,10,5,8,62.5,0,0,0.0,5,8,62.5,0,0,0.0,4,3,7,1,0,0,0,1,1,1
../kbl_data/2022-2023,S41G01N127,원주 DB,Away,정호영,0,0,0,0.0,0,0,0.0,0,0,0.0,0,0,0.0,0,0,0,0,0,0,0,0,0,0
../kbl_data/2022-2023,S41G01N127,원주 DB,Away,이선 알바노,11,4,9,44.4,1,8,12.5,5,17,29.4,0,0,0.0,1,5,6,10,1,0,0,0,2,0
../kbl_data/2022-2023,S41G01N127,원주 DB,Away,드완 에르난데스,6,3,7,42.9,0,0,0.0,3,7,42.9,0,0,0.0,0,5,5,0,0,1,0,2,2,0
../kbl_data/2022-2023,S41G01N127,원주 DB,Away,박인웅,6,3,5,60.0,0,2,0.0,3,7,42.9,0,2,0.0,2,2,4,0,0,0,0,0,1,1
../kbl_data/2022-2023,S41G01N127,원주 DB,Away,인승찬,0,0,0,0.0,0,0,0.0,0,0,0.0,0,0,0.0,0,0,0,0,0,0,0,0,0,0
../kbl_data/2022-2023,S41G01N128,전주 KCC,Home,정창영,9,3,7,42.9,0,4,0.0,3,11,27.3,3,3,100.0,1,2,3,4,3,1,0,0,0,1
../kbl_data/2022-2023,S41G01N128,전주 KCC,Home,라건아,19,6,7,85.7,1,4,25.0,7,11,63.6,4,4,100.0,5,14,19,3,0,1,0,0,1,0
../kbl_data/2022-2023,S41G01N128,전주 KCC,Home,박경상,1,0,0,0.0,0,0,0.0,0,0,0.0,1,2,50.0,0,1,1,1,0,0,0,0,0,1
../kbl_data/2022-2023,S41G01N128,전주 KCC,Home,김지완,8,2,3,66.7,1,2,50.0,3,5,60.0,1,2,50.0,1,1,2,0,0,0,0,0,1,2
../kbl_data/2022-2023,S41G01N128,전주 KCC,Home,김상규,1,0,0,0.0,0,0,0.0,0,0,0.0,1,2,50.0,1,1,2,0,0,0,0,0,0,0
../kbl_data/2022-2023,S41G01N128,전주 KCC,Home,전준범,6,0,1,0.0,2,3,66.7,2,4,50.0,0,0,0.0,0,0,0,0,0,1,0,0,0,3
../kbl_data/2022-2023,S41G01N128,전주 KCC,Home,허웅,22,2,5,40.0,5,8,62.5,7,13,53.8,3,4,75.0,0,4,4,1,0,0,0,0,4,3
../kbl_data/2022-2023,S41G01N128,전주 KCC,Home,이승현,16,6,10,60.0,1,1,100.0,7,11,63.6,1,3,33.3,1,4,5,8,0,1,0,0,2,1
../kbl_data/2022-2023,S41G01N128,전주 KCC,Home,곽정훈,0,0,0,0.0,0,0,0.0,0,0,0.0,0,0,0.0,0,0,0,0,0,0,0,0,0,0
../kbl_data/2022-2023,S41G01N128,전주 KCC,Home,이근휘,0,0,0,0.0,0,1,0.0,0,1,0.0,0,0,0.0,0,0,0,0,0,0,0,0,0,0
../kbl_data/2022-2023,S41G01N128,전주 KCC,Home,론데 홀리스 제퍼슨,0,0,2,0.0,0,0,0.0,0,2,0.0,0,2,0.0,0,0,0,0,0,0,0,0,0,2
../kbl_data/2022-2023,S41G01N128,전주 KCC,Home,송동훈,0,0,0,0.0,0,0,0.0,0,0,0.0,0,0,0.0,0,0,0,0,0,0,0,0,0,0
../kbl_data/2022-2023,S41G01N128,대구 한국가스공사,Away,차바위,2,1,1,100.0,0,2,0.0,1,3,33.3,0,0,0.0,0,2,2,3,1,0,0,0,2,3
../kbl_data/2022-2023,S41G01N128,대구 한국가스공사,Away,박지훈,6,0,1,0.0,2,3,66.7,2,4,50.0,0,0,0.0,0,0,0,0,0,0,0,0,0,2
../kbl_data/2022-2023,S41G01N128,대구 한국가스공사,Away,조상열,6,0,0,0.0,2,3,66.7,2,3,66.7,0,0,0.0,1,1,2,3,1,0,0,0,0,3
../kbl_data/2022-2023,S41G01N128,대구 한국가스공사,Away,이대헌,17,7,8,87.5,1,3,33.3,8,11,72.7,0,0,0.0,2,4,6,1,3,0,0,0,1,3
../kbl_data/2022-2023,S41G01N128,대구 한국가스공사,Away,이대성,17,4,12,33.3,3,8,37.5,7,20,35.0,0,0,0.0,0,2,2,2,0,1,0,0,1,2
../kbl_data/2022-2023,S41G01N128,대구 한국가스공사,Away,정효근,0,0,0,0.0,0,0,0.0,0,0,0.0,0,0,0.0,0,0,0,0,0,0,0,0,0,0
../kbl_data/2022-2023,S41G01N128,대구 한국가스공사,Away,머피 할로웨이,8,4,10,40.0,0,0,0.0,4,10,40.0,0,0,0.0,5,5,10,0,1,0,0,2,1,2
../kbl_data/2022-2023,S41G01N128,대구 한국가스공사,Away,우동현,3,0,0,0.0,1,2,50.0,1,2,50.0,0,0,0.0,0,0,0,1,0,0,0,0,0,1
../kbl_data/2022-2023,S41G01N128,대구 한국가스공사,Away,전현우,0,0,0,0.0,0,1,0.0,0,1,0.0,0,0,0.0,0,0,0,0,0,0,0,0,0,0
../kbl_data/2022-2023,S41G01N128,대구 한국가스공사,Away,신승민,0,0,1,0.0,0,1,0.0,0,2,0.0,0,0,0.0,1,0,1,0,0,0,0,0,0,1
../kbl_data/2022-2023,S41G01N128,대구 한국가스공사,Away,샘조세프 벨란겔,10,2,5,40.0,2,4,50.0,4,9,44.4,0,0,0.0,0,0,0,3,0,0,0,0,0,1
../kbl_data/2022-2023,S41G01N128,대구 한국가스공사,Away,유슈 은도예,4,2,3,66.7,0,0,0.0,2,3,66.7,0,0,0.0,0,4,4,0,0,1,0,2,2,3
../kbl_data/2022-2023,S41G01N129,수원 KT,Home,김동욱,8,1,1,100.0,2,3,66.7,3,4,75.0,0,0,0.0,0,2,2,2,2,0,0,0,1,0
../kbl_data/2022-2023,S41G01N129,수원 KT,Home,김영환,5,0,0,0.0,1,1,100.0,1,1,100.0,2,2,100.0,0,4,4,5,0,0,0,0,2,1
../kbl_data/2022-2023,S41G01N129,수원 KT,Home,한희원,0,0,2,0.0,0,0,0.0,0,2,0.0,0,0,0.0,2,1,3,0,0,0,0,0,0,4
../kbl_data/2022-2023,S41G01N129,수원 KT,Home,최창진,0,0,0,0.0,0,0,0.0,0,0,0.0,0,0,0.0,0,0,0,0,1,0,0,0,1,0
../kbl_data/2022-2023,S41G01N129,수원 KT,Home,정성우,5,2,3,66.7,0,0,0.0,2,3,66.7,1,2,50.0,0,0,0,6,3,0,0,0,2,2
../kbl_data/2022-2023,S41G01N129,수원 KT,Home,최성모,10,2,2,100.0,2,5,40.0,4,7,57.1,0,0,0.0,3,0,3,4,1,0,0,0,3,1
../kbl_data/2022-2023,S41G01N129,수원 KT,Home,양홍석,8,1,1,100.0,2,7,28.6,3,8,37.5,0,0,0.0,0,2,2,1,1,0,0,0,1,0
../kbl_data/2022-2023,S41G01N129,수원 KT,Home,박지원,0,0,1,0.0,0,0,0.0,0,1,0.0,0,0,0.0,0,1,1,0,0,0,0,0,1,0
../kbl_data/2022-2023,S41G01N129,수원 KT,Home,하윤기,23,8,9,88.9,0,1,0.0,8,10,80.0,7,8,87.5,0,2,2,3,0,1,0,3,0,3
../kbl_data/2022-2023,S41G01N129,수원 KT,Home,이두원,0,0,0,0.0,0,0,0.0,0,0,0.0,0,0,0.0,0,0,0,0,0,1,0,0,1,3
../kbl_data/2022-2023,S41G01N129,수원 KT,Home,레스터 프로스퍼,10,5,9,55.6,0,1,0.0,5,10,50.0,0,0,0.0,1,2,3,0,1,0,0,1,1,3
../kbl_data/2022-2023,S41G01N129,수원 KT,Home,재로드 존스,19,5,8,62.5,3,8,37.5,8,16,50.0,0,0,0.0,1,5,6,4,1,0,0,0,1,4
../kbl_data/2022-2023,S41G01N129,서울 삼성,Away,이정현,12,3,3,100.0,2,5,40.0,5,8,62.5,0,0,0.0,0,1,1,2,0,0,0,0,1,1
../kbl_data/2022-2023,S41G01N129,서울 삼성,Away,장민국,3,1,3,33.3,0,3,0.0,1,6,16.7,1,2,50.0,1,2,3,1,0,0,0,0,0,1
../kbl_data/2022-2023,S41G01N129,서울 삼성,Away,김시래,11,3,4,75.0,0,1,0.0,3,5,60.0,5,5,100.0,1,0,1,1,1,0,0,0,1,3
../kbl_data/2022-2023,S41G01N129,서울 삼성,Away,임동섭,0,0,0,0.0,0,0,0.0,0,0,0.0,0,0,0.0,0,0,0,0,0,0,0,0,1,2
../kbl_data/2022-2023,S41G01N129,서울 삼성,Away,이호현,11,3,5,60.0,1,2,50.0,4,7,57.1,2,2,100.0,1,3,4,2,0,0,0,0,2,0
../kbl_data/2022-2023,S41G01N129,서울 삼성,Away,김진영,9,3,4,75.0,1,2,50.0,4,6,66.7,0,0,0.0,0,0,0,1,3,0,0,2,7,3
../kbl_data/2022-2023,S41G01N129,서울 삼성,Away,전형준,0,0,0,0.0,0,0,0.0,0,0,0.0,0,0,0.0,0,0,0,0,0,0,0,0,0,0
../kbl_data/2022-2023,S41G01N129,서울 삼성,Away,조우성,2,1,2,50.0,0,0,0.0,1,2,50.0,0,1,0.0,0,0,0,1,0,0,1,0,0,1
../kbl_data/2022-2023,S41G01N129,서울 삼성,Away,이원석,6,3,4,75.0,0,0,0.0,3,4,75.0,0,0,0.0,3,2,5,0,0,1,0,0,3,3
../kbl_data/2022-2023,S41G01N129,서울 삼성,Away,이매뉴얼 테리,8,4,7,57.1,0,0,0.0,4,7,57.1,0,0,0.0,0,5,5,1,2,1,1,2,0,1
../kbl_data/2022-2023,S41G01N129,서울 삼성,Away,신동혁,5,1,2,50.0,1,1,100.0,2,3,66.7,0,0,0.0,0,1,1,2,0,0,0,0,3,1
../kbl_data/2022-2023,S41G01N129,서울 삼성,Away,조나단 알렛지,11,4,9,44.4,0,2,0.0,4,11,36.4,3,3,100.0,2,1,3,0,0,0,0,0,0,1
../kbl_data/2022-2023,S41G01N130,고양 캐롯,Home,김강선,8,1,1,100.0,2,4,50.0,3,5,60.0,0,0,0.0,0,4,4,1,2,0,0,0,2,3
../kbl_data/2022-2023,S41G01N130,고양 캐롯,Home,최현민,3,0,2,0.0,1,2,50.0,1,4,25.0,0,0,0.0,1,0,1,0,0,0,1,0,0,3
../kbl_data/2022-2023,S41G01N130,고양 캐롯,Home,전성현,24,3,6,50.0,5,10,50.0,8,16,50.0,3,3,100.0,0,1,1,3,2,0,0,0,2,3
../kbl_data/2022-2023,S41G01N130,고양 캐롯,Home,김진유,0,0,0,0.0,0,1,0.0,0,1,0.0,0,0,0.0,0,1,1,0,1,1,1,0,0,1
../kbl_data/2022-2023,S41G01N130,고양 캐롯,Home,조한진,13,3,6,50.0,2,6,33.3,5,12,41.7,1,1,100.0,2,2,4,2,2,0,0,0,1,3
../kbl_data/2022-2023,S41G01N130,고양 캐롯,Home,김세창,0,0,0,0.0,0,0,0.0,0,0,0.0,0,0,0.0,0,0,0,0,0,0,0,0,0,0
../kbl_data/2022-2023,S41G01N130,고양 캐롯,Home,디드릭 로슨,20,6,8,75.0,2,7,28.6,8,15,53.3,2,4,50.0,3,11,14,2,2,0,0,2,3,3
../kbl_data/2022-2023,S41G01N130,고양 캐롯,Home,박진철,0,0,0,0.0,0,0,0.0,0,0,0.0,0,0,0.0,0,0,0,0,0,0,0,0,0,0
../kbl_data/2022-2023,S41G01N130,고양 캐롯,Home,이정현,13,4,7,57.1,1,4,25.0,5,11,45.5,2,2,100.0,0,2,2,4,1,0,1,0,3,4
../kbl_data/2022-2023,S41G01N130,고양 캐롯,Home,조재우,0,0,0,0.0,0,0,0.0,0,0,0.0,0,0,0.0,0,0,0,0,0,0,0,0,0,0
../kbl_data/2022-2023,S41G01N130,고양 캐롯,Home,안정욱,0,0,0,0.0,0,1,0.0,0,1,0.0,0,0,0.0,0,0,0,0,0,0,0,0,0,3
../kbl_data/2022-2023,S41G01N130,고양 캐롯,Home,드미트리우스 트레드웰,0,0,0,0.0,0,0,0.0,0,0,0.0,0,0,0.0,0,0,0,0,0,0,0,0,0,0
../kbl_data/2022-2023,S41G01N130,대구 한국가스공사,Away,차바위,7,2,3,66.7,1,1,100.0,3,4,75.0,0,0,0.0,3,5,8,1,0,0,0,0,3,4
../kbl_data/2022-2023,S41G01N130,대구 한국가스공사,Away,박지훈,4,2,3,66.7,0,1,0.0,2,4,50.0,0,0,0.0,1,1,2,0,0,0,0,0,1,2
../kbl_data/2022-2023,S41G01N130,대구 한국가스공사,Away,조상열,5,1,4,25.0,1,6,16.7,2,10,20.0,0,0,0.0,0,1,1,1,0,0,0,0,2,3
../kbl_data/2022-2023,S41G01N130,대구 한국가스공사,Away,이대헌,3,0,0,0.0,0,0,0.0,0,0,0.0,3,4,75.0,0,0,0,0,0,0,0,0,1,0
../kbl_data/2022-2023,S41G01N130,대구 한국가스공사,Away,이대성,31,5,12,41.7,4,4,100.0,9,16,56.2,9,12,75.0,0,4,4,3,2,0,1,0,4,1
../kbl_data/2022-2023,S41G01N130,대구 한국가스공사,Away,임준수,0,0,0,0.0,0,0,0.0,0,0,0.0,0,0,0.0,0,0,0,0,0,0,0,0,0,0
../kbl_data/2022-2023,S41G01N130,대구 한국가스공사,Away,머피 할로웨이,23,10,13,76.9,0,0,0.0,10,13,76.9,3,7,42.9,3,13,16,2,0,0,0,1,4,3
../kbl_data/2022-2023,S41G01N130,대구 한국가스공사,Away,우동현,0,0,1,0.0,0,0,0.0,0,1,0.0,0,0,0.0,0,1,1,0,0,0,0,0,0,2
../kbl_data/2022-2023,S41G01N130,대구 한국가스공사,Away,전현우,0,0,0,0.0,0,0,0.0,0,0,0.0,0,0,0.0,0,0,0,0,0,0,0,0,0,1
../kbl_data/2022-2023,S41G01N130,대구 한국가스공사,Away,신승민,11,5,7,71.4,0,1,0.0,5,8,62.5,1,1,100.0,3,2,5,5,2,0,1,0,0,2
../kbl_data/2022-2023,S41G01N130,대구 한국가스공사,Away,샘조세프 벨란겔,0,0,0,0.0,0,0,0.0,0,0,0.0,0,0,0.0,0,0,0,0,0,0,0,0,0,0
../kbl_data/2022-2023,S41G01N130,대구 한국가스공사,Away,유슈 은도예,0,0,2,0.0,0,0,0.0,0,2,0.0,0,0,0.0,0,1,1,0,0,0,0,0,0,1
../kbl_data/2022-2023,S41G01N131,울산 현대모비스,Home,함지훈,4,1,1,100.0,0,1,0.0,1,2,50.0,2,3,66.7,0,1,1,1,0,0,0,0,0,0
../kbl_data/2022-2023,S41G01N131,울산 현대모비스,Home,김현민,6,0,0,0.0,1,1,100.0,1,1,100.0,3,4,75.0,1,1,2,0,1,0,0,0,0,1
../kbl_data/2022-2023,S41G01N131,울산 현대모비스,Home,장재석,6,3,4,75.0,0,0,0.0,3,4,75.0,0,0,0.0,2,2,4,0,0,0,0,0,0,2
../kbl_data/2022-2023,S41G01N131,울산 현대모비스,Home,김영현,0,0,0,0.0,0,3,0.0,0,3,0.0,0,0,0.0,0,1,1,0,0,1,0,0,0,1
../kbl_data/2022-2023,S41G01N131,울산 현대모비스,Home,김국찬,2,1,1,100.0,0,1,0.0,1,2,50.0,0,0,0.0,1,0,1,0,0,0,0,0,0,3
../kbl_data/2022-2023,S41G01N131,울산 현대모비스,Home,서명진,6,2,3,66.7,0,2,0.0,2,5,40.0,2,2,100.0,0,1,1,2,1,0,0,0,1,2
../kbl_data/2022-2023,S41G01N131,울산 현대모비스,Home,헨리 심스,0,0,4,0.0,0,1,0.0,0,5,0.0,0,0,0.0,0,2,2,0,0,0,0,0,0,0
../kbl_data/2022-2023,S41G01N131,울산 현대모비스,Home,이우석,9,1,6,16.7,1,2,50.0,2,8,25.0,4,4,100.0,1,3,4,2,0,0,0,0,0,0
../kbl_data/2022-2023,S41G01N131,울산 현대모비스,Home,신민석,3,0,0,0.0,1,2,50.0,1,2,50.0,0,0,0.0,0,1,1,1,1,0,0,0,1,3
../kbl_data/2022-2023,S41G01N131,울산 현대모비스,Home,김동준,4,2,5,40.0,0,2,0.0,2,7,28.6,0,0,0.0,0,1,1,3,1,0,1,0,2,1
../kbl_data/2022-2023,S41G01N131,울산 현대모비스,Home,론제이 아바리엔토스,12,3,3,100.0,2,8,25.0,5,11,45.5,0,0,0.0,0,4,4,7,1,0,0,0,3,0
../kbl_data/2022-2023,S41G01N131,울산 현대모비스,Home,게이지 프림,16,8,17,47.1,0,0,0.0,8,17,47.1,0,2,0.0,4,8,12,0,2,1,0,0,0,3
../kbl_data/2022-2023,S41G01N131,안양 KGC,Away,양희종,0,0,0,0.0,0,0,0.0,0,0,0.0,0,0,0.0,0,0,0,0,1,0,0,0,1,0
../kbl_data/2022-2023,S41G01N131,안양 KGC,Away,오세근,13,6,12,50.0,0,2,0.0,6,14,42.9,1,1,100.0,1,4,5,2,1,1,0,0,0,0
../kbl_data/2022-2023,S41G01N131,안양 KGC,Away,정준원,1,0,1,0.0,0,0,0.0,0,1,0.0,1,2,50.0,0,0,0,0,0,0,0,0,0,0
../kbl_data/2022-2023,S41G01N131,안양 KGC,Away,배병준,0,0,0,0.0,0,1,0.0,0,1,0.0,0,0,0.0,1,0,1,1,0,0,0,0,1,0
../kbl_data/2022-2023,S41G01N131,안양 KGC,Away,문성곤,15,3,3,100.0,3,5,60.0,6,8,75.0,0,0,0.0,4,6,10,2,0,0,0,0,2,5
../kbl_data/2022-2023,S41G01N131,안양 KGC,Away,박지훈,9,2,4,50.0,1,1,100.0,3,5,60.0,2,2,100.0,1,1,2,6,2,0,0,0,1,2
../kbl_data/2022-2023,S41G01N131,안양 KGC,Away,이우정,0,0,1,0.0,0,0,0.0,0,1,0.0,0,0,0.0,0,0,0,0,0,0,0,0,0,2
../kbl_data/2022-2023,S41G01N131,안양 KGC,Away,대릴 먼로,0,0,0,0.0,0,0,0.0,0,0,0.0,0,0,0.0,0,1,1,0,0,0,0,0,0,0
../kbl_data/2022-2023,S41G01N131,안양 KGC,Away,변준형,14,4,10,40.0,2,5,40.0,6,15,40.0,0,0,0.0,1,2,3,2,0,0,1,0,6,4
../kbl_data/2022-2023,S41G01N131,안양 KGC,Away,김경원,5,1,1,100.0,1,1,100.0,2,2,100.0,0,0,0.0,0,3,3,1,0,0,0,0,0,0
../kbl_data/2022-2023,S41G01N131,안양 KGC,Away,오마리 스펠맨,16,5,12,41.7,2,9,22.2,7,21,33.3,0,2,0.0,2,15,17,5,0,3,0,1,0,4
../kbl_data/2022-2023,S41G01N131,안양 KGC,Away,렌즈 아반도,4,2,2,100.0,0,1,0.0,2,3,66.7,0,0,0.0,0,1,1,1,0,1,0,0,1,2
../kbl_data/2022-2023,S41G01N132,원주 DB,Home,김현호,8,2,3,66.7,1,3,33.3,3,6,50.0,1,2,50.0,0,3,3,5,1,0,0,0,1,2
../kbl_data/2022-2023,S41G01N132,원주 DB,Home,김종규,15,4,6,66.7,2,2,100.0,6,8,75.0,1,1,100.0,0,4,4,2,0,0,0,0,0,1
../kbl_data/2022-2023,S41G01N132,원주 DB,Home,최승욱,8,4,7,57.1,0,2,0.0,4,9,44.4,0,0,0.0,3,3,6,2,0,0,0,0,0,2
../kbl_data/2022-2023,S41G01N132,원주 DB,Home,강상재,2,0,4,0.0,0,1,0.0,0,5,0.0,2,2,100.0,0,5,5,1,0,0,0,0,2,2
../kbl_data/2022-2023,S41G01N132,원주 DB,Home,윤성원,0,0,0,0.0,0,0,0.0,0,0,0.0,0,0,0.0,0,0,0,0,0,0,0,0,0,0
../kbl_data/2022-2023,S41G01N132,원주 DB,Home,이준희,1,0,0,0.0,0,1,0.0,0,1,0.0,1,2,50.0,0,0,0,0,0,0,0,0,1,0
../kbl_data/2022-2023,S41G01N132,원주 DB,Home,레나드 프리먼,12,6,8,75.0,0,0,0.0,6,8,75.0,0,0,0.0,1,4,5,2,1,0,0,2,2,2
../kbl_data/2022-2023,S41G01N132,원주 DB,Home,정호영,15,3,3,100.0,2,2,100.0,5,5,100.0,3,4,75.0,1,0,1,5,4,0,1,0,1,3
../kbl_data/2022-2023,S41G01N132,원주 DB,Home,이선 알바노,19,5,9,55.6,1,2,50.0,6,11,54.5,6,8,75.0,0,4,4,3,2,0,0,0,0,3
../kbl_data/2022-2023,S41G01N132,원주 DB,Home,드완 에르난데스,20,8,13,61.5,1,2,50.0,9,15,60.0,1,1,100.0,4,4,8,2,1,1,1,1,3,1
../kbl_data/2022-2023,S41G01N132,원주 DB,Home,박인웅,2,1,1,100.0,0,0,0.0,1,1,100.0,0,0,0.0,1,0,1,0,0,0,0,0,0,1
../kbl_data/2022-2023,S41G01N132,원주 DB,Home,인승찬,0,0,0,0.0,0,0,0.0,0,0,0.0,0,0,0.0,0,0,0,0,0,0,0,0,0,0
../kbl_data/2022-2023,S41G01N132,전주 KCC,Away,정창영,2,1,2,50.0,0,1,0.0,1,3,33.3,0,0,0.0,0,1,1,4,1,1,0,0,1,1
../kbl_data/2022-2023,S41G01N132,전주 KCC,Away,라건아,18,8,15,53.3,0,2,0.0,8,17,47.1,2,4,50.0,7,5,12,0,0,0,0,1,1,1
../kbl_data/2022-2023,S41G01N132,전주 KCC,Away,박경상,9,1,1,100.0,2,3,66.7,3,4,75.0,1,2,50.0,0,1,1,0,0,0,0,0,1,4
../kbl_data/2022-2023,S41G01N132,전주 KCC,Away,김지완,8,2,4,50.0,1,2,50.0,3,6,50.0,1,2,50.0,0,0,0,1,3,0,0,0,2,4
../kbl_data/2022-2023,S41G01N132,전주 KCC,Away,김상규,0,0,1,0.0,0,2,0.0,0,3,0.0,0,0,0.0,0,1,1,1,1,0,0,0,1,2
../kbl_data/2022-2023,S41G01N132,전주 KCC,Away,전준범,4,2,2,100.0,0,3,0.0,2,5,40.0,0,0,0.0,0,1,1,0,0,0,0,0,0,0
../kbl_data/2022-2023,S41G01N132,전주 KCC,Away,허웅,17,4,5,80.0,3,7,42.9,7,12,58.3,0,0,0.0,0,3,3,3,2,0,0,0,2,1
../kbl_data/2022-2023,S41G01N132,전주 KCC,Away,이승현,8,4,7,57.1,0,0,0.0,4,7,57.1,0,0,0.0,2,3,5,0,0,0,0,0,0,1
../kbl_data/2022-2023,S41G01N132,전주 KCC,Away,곽정훈,0,0,0,0.0,0,1,0.0,0,1,0.0,0,0,0.0,0,1,1,0,0,0,0,0,0,0
../kbl_data/2022-2023,S41G01N132,전주 KCC,Away,이근휘,0,0,0,0.0,0,3,0.0,0,3,0.0,0,0,0.0,0,1,1,0,0,0,0,0,0,0
../kbl_data/2022-2023,S41G01N132,전주 KCC,Away,론데 홀리스 제퍼슨,24,8,12,66.7,1,1,100.0,9,13,69.2,5,7,71.4,3,5,8,2,0,0,0,1,2,2
../kbl_data/2022-2023,S41G01N132,전주 KCC,Away,송동훈,0,0,0,0.0,0,0,0.0,0,0,0.0,0,0,0.0,0,0,0,1,0,0,0,0,1,2
../kbl_data/2022-2023,S41G01N133,고양 캐롯,Home,김강선,12,0,0,0.0,4,5,80.0,4,5,80.0,0,0,0.0,1,1,2,2,2,0,0,0,0,4
../kbl_data/2022-2023,S41G01N133,고양 캐롯,Home,최현민,3,0,1,0.0,1,5,20.0,1,6,16.7,0,0,0.0,2,2,4,0,0,0,0,0,0,1
../kbl_data/2022-2023,S41G01N133,고양 캐롯,Home,전성현,19,5,9,55.6,3,9,33.3,8,18,44.4,0,0,0.0,0,0,0,4,0,0,0,0,3,1
../kbl_data/2022-2023,S41G01N133,고양 캐롯,Home,이종현,2,1,2,50.0,0,0,0.0,1,2,50.0,0,0,0.0,0,0,0,0,0,0,0,0,0,0
../kbl_data/2022-2023,S41G01N133,고양 캐롯,Home,김진유,2,1,2,50.0,0,0,0.0,1,2,50.0,0,0,0.0,2,2,4,4,0,0,0,0,0,2
../kbl_data/2022-2023,S41G01N133,고양 캐롯,Home,조한진,3,1,2,50.0,0,3,0.0,1,5,20.0,1,1,100.0,0,1,1,0,1,1,0,0,0,2
../kbl_data/2022-2023,S41G01N133,고양 캐롯,Home,김세창,0,0,0,0.0,0,0,0.0,0,0,0.0,0,0,0.0,0,0,0,0,0,0,0,0,0,0
../kbl_data/2022-2023,S41G01N133,고양 캐롯,Home,디드릭 로슨,15,6,9,66.7,0,8,0.0,6,17,35.3,3,4,75.0,2,7,9,5,1,0,0,1,2,2
../kbl_data/2022-2023,S41G01N133,고양 캐롯,Home,박진철,0,0,0,0.0,0,0,0.0,0,0,0.0,0,0,0.0,0,0,0,0,0,0,0,0,0,0
../kbl_data/2022-2023,S41G01N133,고양 캐롯,Home,이정현,21,3,4,75.0,4,10,40.0,7,14,50.0,3,3,100.0,0,1,1,1,4,0,1,0,0,2
../kbl_data/2022-2023,S41G01N133,고양 캐롯,Home,안정욱,0,0,0,0.0,0,0,0.0,0,0,0.0,0,0,0.0,0,0,0,0,0,0,0,0,0,1
../kbl_data/2022-2023,S41G01N133,고양 캐롯,Home,드미트리우스 트레드웰,0,0,0,0.0,0,0,0.0,0,0,0.0,0,0,0.0,0,0,0,0,0,0,0,0,1,1
../kbl_data/2022-2023,S41G01N133,수원 KT,Away,김동욱,4,0,0,0.0,1,2,50.0,1,2,50.0,1,2,50.0,0,1,1,0,0,0,0,0,0,2
../kbl_data/2022-2023,S41G01N133,수원 KT,Away,김영환,0,0,0,0.0,0,1,0.0,0,1,0.0,0,0,0.0,0,5,5,2,0,0,0,0,0,2
../kbl_data/2022-2023,S41G01N133,수원 KT,Away,한희원,16,4,5,80.0,2,4,50.0,6,9,66.7,2,2,100.0,1,3,4,3,1,0,0,0,2,3
../kbl_data/2022-2023,S41G01N133,수원 KT,Away,최창진,0,0,0,0.0,0,0,0.0,0,0,0.0,0,0,0.0,0,0,0,0,0,0,0,0,0,0
../kbl_data/2022-2023,S41G01N133,수원 KT,Away,정성우,5,1,1,100.0,0,2,0.0,1,3,33.3,3,4,75.0,0,2,2,8,0,0,0,0,1,4
../kbl_data/2022-2023,S41G01N133,수원 KT,Away,최성모,13,3,3,100.0,2,4,50.0,5,7,71.4,1,1,100.0,1,1,2,2,2,1,0,0,1,1
../kbl_data/2022-2023,S41G01N133,수원 KT,Away,양홍석,24,5,9,55.6,4,6,66.7,9,15,60.0,2,2,100.0,3,7,10,4,2,0,0,0,2,1
../kbl_data/2022-2023,S41G01N133,수원 KT,Away,박지원,0,0,0,0.0,0,0,0.0,0,0,0.0,0,0,0.0,0,0,0,0,0,0,0,0,0,0
../kbl_data/2022-2023,S41G01N133,수원 KT,Away,하윤기,4,1,1,100.0,0,0,0.0,1,1,100.0,2,2,100.0,0,2,2,1,0,0,0,0,1,4
../kbl_data/2022-2023,S41G01N133,수원 KT,Away,이두원,0,0,0,0.0,0,0,0.0,0,0,0.0,0,0,0.0,0,0,0,0,0,0,0,0,0,0
../kbl_data/2022-2023,S41G01N133,수원 KT,Away,레스터 프로스퍼,0,0,1,0.0,0,0,0.0,0,1,0.0,0,0,0.0,0,2,2,0,0,0,0,0,1,0
../kbl_data/2022-2023,S41G01N133,수원 KT,Away,재로드 존스,24,6,10,60.0,4,7,57.1,10,17,58.8,0,0,0.0,1,11,12,2,1,0,0,0,6,0
../kbl_data/2022-2023,S41G01N134,서울 삼성,Home,이정현,12,4,10,40.0,1,6,16.7,5,16,31.2,1,2,50.0,1,2,3,3,0,0,0,0,2,1
../kbl_data/2022-2023,S41G01N134,서울 삼성,Home,장민국,2,1,2,50.0,0,0,0.0,1,2,50.0,0,0,0.0,0,0,0,1,0,0,0,0,0,0
../kbl_data/2022-2023,S41G01N134,서울 삼성,Home,김시래,0,0,1,0.0,0,2,0.0,0,3,0.0,0,0,0.0,0,1,1,2,0,0,0,0,0,2
../kbl_data/2022-2023,S41G01N134,서울 삼성,Home,임동섭,7,2,3,66.7,1,2,50.0,3,5,60.0,0,0,0.0,0,3,3,0,1,0,0,0,0,1
../kbl_data/2022-2023,S41G01N134,서울 삼성,Home,이호현,4,0,2,0.0,1,1,100.0,1,3,33.3,1,2,50.0,0,1,1,4,0,0,0,0,1,2
../kbl_data/2022-2023,S41G01N134,서울 삼성,Home,김진영,2,1,2,50.0,0,3,0.0,1,5,20.0,0,0,0.0,0,1,1,2,1,0,0,0,2,2
../kbl_data/2022-2023,S41G01N134,서울 삼성,Home,전형준,0,0,0,0.0,0,1,0.0,0,1,0.0,0,0,0.0,0,0,0,1,0,0,0,0,0,0
../kbl_data/2022-2023,S41G01N134,서울 삼성,Home,조우성,0,0,0,0.0,0,0,0.0,0,0,0.0,0,0,0.0,0,0,0,0,0,0,0,0,0,0
../kbl_data/2022-2023,S41G01N134,서울 삼성,Home,이원석,11,2,7,28.6,1,3,33.3,3,10,30.0,4,6,66.7,4,5,9,2,0,0,0,0,1,3
../kbl_data/2022-2023,S41G01N134,서울 삼성,Home,이매뉴얼 테리,9,4,8,50.0,0,0,0.0,4,8,50.0,1,2,50.0,0,5,5,1,0,0,0,1,1,1
../kbl_data/2022-2023,S41G01N134,서울 삼성,Home,신동혁,2,1,1,100.0,0,1,0.0,1,2,50.0,0,0,0.0,0,1,1,1,0,0,0,0,1,2
../kbl_data/2022-2023,S41G01N134,서울 삼성,Home,조나단 알렛지,18,3,7,42.9,4,5,80.0,7,12,58.3,0,0,0.0,2,6,8,0,2,0,0,0,0,1
../kbl_data/2022-2023,S41G01N134,서울 SK,Away,양우섭,0,0,0,0.0,0,0,0.0,0,0,0.0,0,0,0.0,0,0,0,0,0,0,0,0,0,0
../kbl_data/2022-2023,S41G01N134,서울 SK,Away,허일영,12,3,5,60.0,2,5,40.0,5,10,50.0,0,0,0.0,1,3,4,3,0,0,0,0,0,2
../kbl_data/2022-2023,S41G01N134,서울 SK,Away,김선형,13,4,7,57.1,1,3,33.3,5,10,50.0,2,4,50.0,0,1,1,5,0,0,0,0,0,1
../kbl_data/2022-2023,S41G01N134,서울 SK,Away,홍경기,2,1,2,50.0,0,1,0.0,1,3,33.3,0,0,0.0,1,0,1,0,1,0,0,0,0,1
../kbl_data/2022-2023,S41G01N134,서울 SK,Away,최부경,4,2,5,40.0,0,0,0.0,2,5,40.0,0,0,0.0,2,5,7,2,1,1,0,0,0,3
../kbl_data/2022-2023,S41G01N134,서울 SK,Away,리온 윌리엄스,2,1,3,33.3,0,1,0.0,1,4,25.0,0,0,0.0,1,2,3,0,0,2,0,0,0,1
../kbl_data/2022-2023,S41G01N134,서울 SK,Away,최원혁,0,0,0,0.0,0,0,0.0,0,0,0.0,0,0,0.0,1,0,1,0,0,0,0,0,0,2
../kbl_data/2022-2023,S41G01N134,서울 SK,Away,최준용,11,3,6,50.0,0,3,0.0,3,9,33.3,5,8,62.5,0,6,6,2,1,0,0,0,1,2
../kbl_data/2022-2023,S41G01N134,서울 SK,Away,최성원,9,0,0,0.0,3,6,50.0,3,6,50.0,0,0,0.0,0,0,0,1,1,0,0,0,0,2
../kbl_data/2022-2023,S41G01N134,서울 SK,Away,자밀 워니,25,11,17,64.7,1,2,50.0,12,19,63.2,0,1,0.0,5,12,17,4,1,2,0,2,1,1
../kbl_data/2022-2023,S41G01N134,서울 SK,Away,김형빈,0,0,0,0.0,0,0,0.0,0,0,0.0,0,0,0.0,0,0,0,0,0,0,0,0,1,1
../kbl_data/2022-2023,S41G01N134,서울 SK,Away,오재현,8,2,3,66.7,1,2,50.0,3,5,60.0,1,2,50.0,0,3,3,0,1,0,1,0,3,2
../kbl_data/2022-2023,S41G01N135,창원 LG,Home,이관희,14,4,6,66.7,1,4,25.0,5,10,50.0,3,3,100.0,0,1,1,1,1,0,0,0,1,1
../kbl_data/2022-2023,S41G01N135,창원 LG,Home,정희재,3,1,2,50.0,0,2,0.0,1,4,25.0,1,2,50.0,0,2,2,1,0,1,0,0,0,3
../kbl_data/2022-2023,S41G01N135,창원 LG,Home,한상혁,0,0,0,0.0,0,0,0.0,0,0,0.0,0,0,0.0,0,0,0,0,0,0,0,0,0,0
../kbl_data/2022-2023,S41G01N135,창원 LG,Home,이재도,10,2,8,25.0,0,6,0.0,2,14,14.3,6,6,100.0,3,3,6,5,2,0,0,0,1,3
../kbl_data/2022-2023,S41G01N135,창원 LG,Home,김준일,13,3,9,33.3,0,0,0.0,3,9,33.3,7,8,87.5,1,5,6,3,0,1,0,0,0,2
../kbl_data/2022-2023,S41G01N135,창원 LG,Home,박인태,2,1,1,100.0,0,0,0.0,1,1,100.0,0,0,0.0,0,0,0,0,0,0,0,0,0,1
../kbl_data/2022-2023,S41G01N135,창원 LG,Home,정인덕,3,0,0,0.0,1,2,50.0,1,2,50.0,0,0,0.0,0,0,0,0,0,0,0,0,1,1
../kbl_data/2022-2023,S41G01N135,창원 LG,Home,최승욱,0,0,0,0.0,0,0,0.0,0,0,0.0,0,0,0.0,0,0,0,0,0,0,0,0,0,0
../kbl_data/2022-2023,S41G01N135,창원 LG,Home,윤원상,0,0,1,0.0,0,3,0.0,0,4,0.0,0,0,0.0,0,1,1,0,0,0,0,0,0,0
../kbl_data/2022-2023,S41G01N135,창원 LG,Home,아셈 마레이,17,7,13,53.8,0,0,0.0,7,13,53.8,3,6,50.0,5,10,15,0,1,0,0,0,3,5
../kbl_data/2022-2023,S41G01N135,창원 LG,Home,저스틴 구탕,2,1,3,33.3,0,0,0.0,1,3,33.3,0,0,0.0,1,2,3,7,2,0,0,0,1,2
../kbl_data/2022-2023,S41G01N135,창원 LG,Home,단테 커닝햄,9,4,8,50.0,0,0,0.0,4,8,50.0,1,2,50.0,2,4,6,0,0,1,0,0,2,3
../kbl_data/2022-2023,S41G01N135,울산 현대모비스,Away,함지훈,6,1,4,25.0,0,1,0.0,1,5,20.0,4,4,100.0,2,3,5,0,0,0,0,0,1,3
../kbl_data/2022-2023,S41G01N135,울산 현대모비스,Away,김현민,0,0,0,0.0,0,0,0.0,0,0,0.0,0,0,0.0,0,0,0,0,0,0,0,0,0,0
../kbl_data/2022-2023,S41G01N135,울산 현대모비스,Away,장재석,16,7,15,46.7,0,0,0.0,7,15,46.7,2,3,66.7,3,8,11,2,3,0,0,0,0,4
../kbl_data/2022-2023,S41G01N135,울산 현대모비스,Away,김영현,0,0,0,0.0,0,0,0.0,0,0,0.0,0,0,0.0,1,1,2,0,0,0,0,0,0,3
../kbl_data/2022-2023,S41G01N135,울산 현대모비스,Away,서명진,18,3,5,60.0,4,9,44.4,7,14,50.0,0,0,0.0,1,2,3,4,1,0,0,0,1,2
../kbl_data/2022-2023,S41G01N135,울산 현대모비스,Away,헨리 심스,6,2,2,100.0,0,0,0.0,2,2,100.0,2,2,100.0,2,2,4,0,0,0,0,0,0,2
../kbl_data/2022-2023,S41G01N135,울산 현대모비스,Away,이우석,5,1,6,16.7,1,2,50.0,2,8,25.0,0,0,0.0,0,4,4,0,0,0,0,0,0,2
../kbl_data/2022-2023,S41G01N135,울산 현대모비스,Away,신민석,0,0,0,0.0,0,0,0.0,0,0,0.0,0,0,0.0,0,0,0,0,1,0,0,0,0,2
../kbl_data/2022-2023,S41G01N135,울산 현대모비스,Away,김동준,4,2,4,50.0,0,0,0.0,2,4,50.0,0,2,0.0,0,2,2,3,0,0,1,0,3,3
../kbl_data/2022-2023,S41G01N135,울산 현대모비스,Away,론제이 아바리엔토스,6,2,5,40.0,0,1,0.0,2,6,33.3,2,2,100.0,1,3,4,3,0,0,0,0,1,0
../kbl_data/2022-2023,S41G01N135,울산 현대모비스,Away,게이지 프림,16,7,17,41.2,0,0,0.0,7,17,41.2,2,2,100.0,5,8,13,1,0,2,0,1,4,5
../kbl_data/2022-2023,S41G01N135,울산 현대모비스,Away,김태완,0,0,0,0.0,0,1,0.0,0,1,0.0,0,0,0.0,0,0,0,0,0,0,0,0,0,0
../kbl_data/2022-2023,S41G01N136,원주 DB,Home,김현호,15,3,5,60.0,3,5,60.0,6,10,60.0,0,0,0.0,2,1,3,0,0,0,0,0,3,3
../kbl_data/2022-2023,S41G01N136,원주 DB,Home,김종규,14,6,10,60.0,0,2,0.0,6,12,50.0,2,3,66.7,0,3,3,3,0,0,0,1,5,3
../kbl_data/2022-2023,S41G01N136,원주 DB,Home,최승욱,0,0,0,0.0,0,0,0.0,0,0,0.0,0,0,0.0,1,1,2,0,0,0,0,0,0,0
../kbl_data/2022-2023,S41G01N136,원주 DB,Home,강상재,9,0,2,0.0,2,4,50.0,2,6,33.3,3,4,75.0,2,5,7,1,0,0,0,0,0,0
../kbl_data/2022-2023,S41G01N136,원주 DB,Home,윤성원,0,0,0,0.0,0,0,0.0,0,0,0.0,0,0,0.0,0,0,0,0,0,0,0,0,0,0
../kbl_data/2022-2023,S41G01N136,원주 DB,Home,이준희,3,0,2,0.0,1,2,50.0,1,4,25.0,0,0,0.0,0,0,0,3,0,0,0,0,4,1
../kbl_data/2022-2023,S41G01N136,원주 DB,Home,레나드 프리먼,4,1,3,33.3,0,0,0.0,1,3,33.3,2,4,50.0,2,7,9,2,0,0,0,0,1,0
../kbl_data/2022-2023,S41G01N136,원주 DB,Home,정호영,2,1,2,50.0,0,0,0.0,1,2,50.0,0,0,0.0,0,0,0,1,0,0,0,0,2,2
../kbl_data/2022-2023,S41G01N136,원주 DB,Home,이선 알바노,15,5,9,55.6,1,4,25.0,6,13,46.2,2,2,100.0,1,5,6,8,3,0,0,0,2,2
../kbl_data/2022-2023,S41G01N136,원주 DB,Home,드완 에르난데스,8,4,8,50.0,0,0,0.0,4,8,50.0,0,3,0.0,2,3,5,0,0,0,0,1,2,1
../kbl_data/2022-2023,S41G01N136,원주 DB,Home,박인웅,0,0,0,0.0,0,1,0.0,0,1,0.0,0,0,0.0,0,2,2,0,0,0,0,0,0,2
../kbl_data/2022-2023,S41G01N136,원주 DB,Home,인승찬,0,0,0,0.0,0,0,0.0,0,0,0.0,0,0,0.0,0,0,0,0,0,0,0,0,0,0
../kbl_data/2022-2023,S41G01N136,안양 KGC,Away,양희종,2,1,2,50.0,0,2,0.0,1,4,25.0,0,0,0.0,0,0,0,0,0,0,0,0,0,3
../kbl_data/2022-2023,S41G01N136,안양 KGC,Away,오세근,16,8,10,80.0,0,2,0.0,8,12,66.7,0,1,0.0,1,6,7,4,0,0,0,0,1,4
../kbl_data/2022-2023,S41G01N136,안양 KGC,Away,정준원,6,3,4,75.0,0,1,0.0,3,5,60.0,0,0,0.0,0,0,0,0,0,0,0,0,0,0
../kbl_data/2022-2023,S41G01N136,안양 KGC,Away,배병준,5,1,2,50.0,1,2,50.0,2,4,50.0,0,0,0.0,0,0,0,2,2,0,0,0,0,0
../kbl_data/2022-2023,S41G01N136,안양 KGC,Away,문성곤,7,2,3,66.7,1,2,50.0,3,5,60.0,0,0,0.0,1,4,5,2,2,0,1,0,3,4
../kbl_data/2022-2023,S41G01N136,안양 KGC,Away,박지훈,8,4,5,80.0,0,1,0.0,4,6,66.7,0,0,0.0,1,1,2,2,1,0,0,0,0,2
../kbl_data/2022-2023,S41G01N136,안양 KGC,Away,이우정,3,0,1,0.0,1,1,100.0,1,2,50.0,0,0,0.0,0,0,0,0,0,0,0,0,0,0
../kbl_data/2022-2023,S41G01N136,안양 KGC,Away,대릴 먼로,2,1,1,100.0,0,0,0.0,1,1,100.0,0,0,0.0,1,1,2,2,0,0,0,0,0,2
../kbl_data/2022-2023,S41G01N136,안양 KGC,Away,변준형,20,6,8,75.0,2,4,50.0,8,12,66.7,2,2,100.0,0,1,1,5,3,0,0,0,1,0
../kbl_data/2022-2023,S41G01N136,안양 KGC,Away,김경원,2,1,3,33.3,0,0,0.0,1,3,33.3,0,0,0.0,1,0,1,1,0,1,1,0,0,2
../kbl_data/2022-2023,S41G01N136,안양 KGC,Away,오마리 스펠맨,11,4,10,40.0,1,6,16.7,5,16,31.2,0,0,0.0,4,10,14,3,1,2,0,1,1,0
../kbl_data/2022-2023,S41G01N136,안양 KGC,Away,렌즈 아반도,4,2,3,66.7,0,3,0.0,2,6,33.3,0,0,0.0,0,1,1,2,0,1,0,0,0,1
../kbl_data/2022-2023,S41G01N137,전주 KCC,Home,정창영,9,2,4,50.0,1,2,50.0,3,6,50.0,2,2,100.0,1,1,2,3,1,0,0,0,1,3
../kbl_data/2022-2023,S41G01N137,전주 KCC,Home,라건아,15,6,9,66.7,0,0,0.0,6,9,66.7,3,3,100.0,4,3,7,3,2,0,0,0,2,1
../kbl_data/2022-2023,S41G01N137,전주 KCC,Home,박경상,0,0,0,0.0,0,0,0.0,0,0,0.0,0,0,0.0,0,1,1,1,0,0,0,0,1,2
../kbl_data/2022-2023,S41G01N137,전주 KCC,Home,김지완,0,0,1,0.0,0,2,0.0,0,3,0.0,0,0,0.0,0,1,1,0,0,0,0,0,0,4
../kbl_data/2022-2023,S41G01N137,전주 KCC,Home,김상규,0,0,0,0.0,0,0,0.0,0,0,0.0,0,0,0.0,0,0,0,0,0,0,0,0,0,0
../kbl_data/2022-2023,S41G01N137,전주 KCC,Home,전준범,6,3,4,75.0,0,2,0.0,3,6,50.0,0,0,0.0,1,1,2,2,1,0,0,0,2,1
../kbl_data/2022-2023,S41G01N137,전주 KCC,Home,허웅,13,3,6,50.0,2,6,33.3,5,12,41.7,1,2,50.0,0,4,4,6,4,0,0,0,4,3
../kbl_data/2022-2023,S41G01N137,전주 KCC,Home,이승현,14,5,8,62.5,1,1,100.0,6,9,66.7,1,1,100.0,3,11,14,3,0,1,0,0,3,0
../kbl_data/2022-2023,S41G01N137,전주 KCC,Home,이진욱,0,0,0,0.0,0,0,0.0,0,0,0.0,0,0,0.0,0,0,0,0,0,0,0,0,0,0
../kbl_data/2022-2023,S41G01N137,전주 KCC,Home,이근휘,9,0,1,0.0,3,4,75.0,3,5,60.0,0,0,0.0,0,3,3,0,0,0,0,0,0,3
../kbl_data/2022-2023,S41G01N137,전주 KCC,Home,김동현,0,0,0,0.0,0,0,0.0,0,0,0.0,0,0,0.0,0,0,0,0,0,0,0,0,0,1
../kbl_data/2022-2023,S41G01N137,전주 KCC,Home,론데 홀리스 제퍼슨,13,5,7,71.4,0,2,0.0,5,9,55.6,3,5,60.0,0,2,2,3,0,0,0,1,0,1
../kbl_data/2022-2023,S41G01N137,고양 캐롯,Away,김강선,2,1,1,100.0,0,1,0.0,1,2,50.0,0,0,0.0,0,0,0,1,0,0,0,0,0,0
../kbl_data/2022-2023,S41G01N137,고양 캐롯,Away,최현민,2,1,1,100.0,0,5,0.0,1,6,16.7,0,0,0.0,0,1,1,0,0,0,0,0,0,2
../kbl_data/2022-2023,S41G01N137,고양 캐롯,Away,전성현,20,1,7,14.3,4,11,36.4,5,18,27.8,6,7,85.7,0,1,1,2,1,0,0,0,4,1
../kbl_data/2022-2023,S41G01N137,고양 캐롯,Away,이종현,7,2,2,100.0,1,2,50.0,3,4,75.0,0,0,0.0,0,5,5,3,1,0,0,0,1,0
../kbl_data/2022-2023,S41G01N137,고양 캐롯,Away,김진유,4,2,2,100.0,0,1,0.0,2,3,66.7,0,0,0.0,2,3,5,1,4,0,0,0,1,4
../kbl_data/2022-2023,S41G01N137,고양 캐롯,Away,조한진,5,1,1,100.0,1,3,33.3,2,4,50.0,0,0,0.0,0,1,1,0,1,0,0,0,0,2
../kbl_data/2022-2023,S41G01N137,고양 캐롯,Away,김세창,3,0,0,0.0,0,0,0.0,0,0,0.0,3,3,100.0,0,0,0,0,0,0,0,0,0,0
../kbl_data/2022-2023,S41G01N137,고양 캐롯,Away,디드릭 로슨,12,6,9,66.7,0,4,0.0,6,13,46.2,0,0,0.0,5,3,8,3,1,0,0,0,2,4
../kbl_data/2022-2023,S41G01N137,고양 캐롯,Away,박진철,0,0,0,0.0,0,0,0.0,0,0,0.0,0,0,0.0,0,0,0,0,0,0,0,0,0,1
../kbl_data/2022-2023,S41G01N137,고양 캐롯,Away,이정현,17,1,4,25.0,4,9,44.4,5,13,38.5,3,4,75.0,0,3,3,5,2,0,0,0,2,4
../kbl_data/2022-2023,S41G01N137,고양 캐롯,Away,안정욱,0,0,0,0.0,0,0,0.0,0,0,0.0,0,0,0.0,0,0,0,0,0,0,0,0,0,0
../kbl_data/2022-2023,S41G01N137,고양 캐롯,Away,드미트리우스 트레드웰,0,0,0,0.0,0,0,0.0,0,0,0.0,0,0,0.0,0,1,1,1,0,0,0,0,0,0
../kbl_data/2022-2023,S41G01N138,서울 SK,Home,양우섭,0,0,0,0.0,0,0,0.0,0,0,0.0,0,0,0.0,0,0,0,0,0,0,0,0,0,0
../kbl_data/2022-2023,S41G01N138,서울 SK,Home,허일영,7,3,4,75.0,0,1,0.0,3,5,60.0,1,2,50.0,2,6,8,1,0,0,0,0,0,2
../kbl_data/2022-2023,S41G01N138,서울 SK,Home,김선형,11,4,6,66.7,1,1,100.0,5,7,71.4,0,0,0.0,0,2,2,7,0,1,0,0,2,2
../kbl_data/2022-2023,S41G01N138,서울 SK,Home,홍경기,3,0,1,0.0,1,2,50.0,1,3,33.3,0,0,0.0,0,0,0,1,2,0,0,0,0,4
../kbl_data/2022-2023,S41G01N138,서울 SK,Home,최부경,6,3,7,42.9,0,0,0.0,3,7,42.9,0,0,0.0,1,2,3,0,4,0,0,0,0,1
../kbl_data/2022-2023,S41G01N138,서울 SK,Home,리온 윌리엄스,9,1,2,50.0,1,2,50.0,2,4,50.0,4,4,100.0,1,3,4,0,0,0,0,0,0,2
../kbl_data/2022-2023,S41G01N138,서울 SK,Home,최원혁,0,0,0,0.0,0,0,0.0,0,0,0.0,0,0,0.0,0,0,0,0,0,0,0,0,0,0
../kbl_data/2022-2023,S41G01N138,서울 SK,Home,최준용,17,3,4,75.0,3,6,50.0,6,10,60.0,2,2,100.0,0,3,3,2,0,1,0,0,1,2
../kbl_data/2022-2023,S41G01N138,서울 SK,Home,최성원,8,1,1,100.0,2,8,25.0,3,9,33.3,0,0,0.0,0,3,3,1,0,0,0,0,0,2
../kbl_data/2022-2023,S41G01N138,서울 SK,Home,자밀 워니,29,14,20,70.0,0,2,0.0,14,22,63.6,1,4,25.0,4,10,14,7,2,1,0,3,2,0
../kbl_data/2022-2023,S41G01N138,서울 SK,Home,김형빈,3,0,1,0.0,1,1,100.0,1,2,50.0,0,0,0.0,0,2,2,0,0,0,0,0,0,0
../kbl_data/2022-2023,S41G01N138,서울 SK,Home,오재현,4,0,2,0.0,0,4,0.0,0,6,0.0,4,5,80.0,0,2,2,2,3,1,0,0,1,2
../kbl_data/2022-2023,S41G01N138,원주 DB,Away,김현호,2,0,1,0.0,0,4,0.0,0,5,0.0,2,2,100.0,0,4,4,3,0,0,0,0,4,2
../kbl_data/2022-2023,S41G01N138,원주 DB,Away,김종규,10,4,11,36.4,0,2,0.0,4,13,30.8,2,4,50.0,1,5,6,2,0,0,0,0,2,4
../kbl_data/2022-2023,S41G01N138,원주 DB,Away,최승욱,4,2,3,66.7,0,0,0.0,2,3,66.7,0,1,0.0,1,0,1,0,2,0,0,0,0,1
../kbl_data/2022-2023,S41G01N138,원주 DB,Away,강상재,10,3,6,50.0,1,3,33.3,4,9,44.4,1,2,50.0,2,0,2,0,0,0,0,0,0,0
../kbl_data/2022-2023,S41G01N138,원주 DB,Away,윤성원,0,0,0,0.0,0,0,0.0,0,0,0.0,0,0,0.0,0,0,0,0,0,0,0,0,0,0
../kbl_data/2022-2023,S41G01N138,원주 DB,Away,원종훈,2,1,2,50.0,0,1,0.0,1,3,33.3,0,0,0.0,1,3,4,4,0,0,0,0,3,5
../kbl_data/2022-2023,S41G01N138,원주 DB,Away,박상권,0,0,0,0.0,0,1,0.0,0,1,0.0,0,0,0.0,0,0,0,0,0,0,0,0,0,0
../kbl_data/2022-2023,S41G01N138,원주 DB,Away,이준희,10,3,7,42.9,1,3,33.3,4,10,40.0,1,1,100.0,0,0,0,2,1,0,0,0,0,5
../kbl_data/2022-2023,S41G01N138,원주 DB,Away,레나드 프리먼,8,4,9,44.4,0,0,0.0,4,9,44.4,0,2,0.0,5,8,13,2,0,0,0,1,0,1
../kbl_data/2022-2023,S41G01N138,원주 DB,Away,드완 에르난데스,10,5,8,62.5,0,2,0.0,5,10,50.0,0,0,0.0,1,5,6,0,0,0,0,3,2,1
../kbl_data/2022-2023,S41G01N138,원주 DB,Away,박인웅,7,2,5,40.0,0,3,0.0,2,8,25.0,3,4,75.0,0,1,1,1,1,0,1,0,2,1
../kbl_data/2022-2023,S41G01N138,원주 DB,Away,인승찬,0,0,0,0.0,0,0,0.0,0,0,0.0,0,0,0.0,0,0,0,0,0,0,0,0,0,0
../kbl_data/2022-2023,S41G01N139,고양 캐롯,Home,김강선,5,1,1,100.0,1,2,50.0,2,3,66.7,0,0,0.0,0,0,0,1,0,0,0,0,0,1
../kbl_data/2022-2023,S41G01N139,고양 캐롯,Home,최현민,0,0,1,0.0,0,0,0.0,0,1,0.0,0,0,0.0,0,1,1,0,0,0,1,0,0,1
../kbl_data/2022-2023,S41G01N139,고양 캐롯,Home,전성현,22,4,9,44.4,4,11,36.4,8,20,40.0,2,4,50.0,0,3,3,0,1,0,0,0,1,1
../kbl_data/2022-2023,S41G01N139,고양 캐롯,Home,이종현,11,3,5,60.0,1,1,100.0,4,6,66.7,2,2,100.0,2,4,6,2,0,2,0,0,1,4
../kbl_data/2022-2023,S41G01N139,고양 캐롯,Home,김진유,6,0,0,0.0,2,3,66.7,2,3,66.7,0,0,0.0,2,2,4,1,3,0,0,0,1,5
../kbl_data/2022-2023,S41G01N139,고양 캐롯,Home,정해원,0,0,0,0.0,0,0,0.0,0,0,0.0,0,0,0.0,0,0,0,0,0,0,0,0,0,0
../kbl_data/2022-2023,S41G01N139,고양 캐롯,Home,김세창,0,0,0,0.0,0,0,0.0,0,0,0.0,0,0,0.0,0,0,0,0,0,0,0,0,0,0
../kbl_data/2022-2023,S41G01N139,고양 캐롯,Home,디드릭 로슨,15,4,10,40.0,0,1,0.0,4,11,36.4,7,8,87.5,4,7,11,9,0,2,0,0,2,0
../kbl_data/2022-2023,S41G01N139,고양 캐롯,Home,박진철,0,0,0,0.0,0,0,0.0,0,0,0.0,0,0,0.0,0,0,0,0,0,0,0,0,0,0
../kbl_data/2022-2023,S41G01N139,고양 캐롯,Home,이정현,18,4,6,66.7,2,10,20.0,6,16,37.5,4,7,57.1,0,2,2,4,3,0,0,0,2,3
../kbl_data/2022-2023,S41G01N139,고양 캐롯,Home,안정욱,0,0,0,0.0,0,0,0.0,0,0,0.0,0,0,0.0,0,0,0,0,0,0,0,0,0,0
../kbl_data/2022-2023,S41G01N139,고양 캐롯,Home,드미트리우스 트레드웰,3,1,3,33.3,0,0,0.0,1,3,33.3,1,2,50.0,1,0,1,0,1,0,1,0,0,1
../kbl_data/2022-2023,S41G01N139,울산 현대모비스,Away,함지훈,6,2,4,50.0,0,0,0.0,2,4,50.0,2,3,66.7,3,2,5,2,0,0,0,0,1,2
../kbl_data/2022-2023,S41G01N139,울산 현대모비스,Away,김현민,0,0,0,0.0,0,0,0.0,0,0,0.0,0,0,0.0,0,0,0,0,0,0,0,0,0,1
../kbl_data/2022-2023,S41G01N139,울산 현대모비스,Away,장재석,15,7,10,70.0,0,0,0.0,7,10,70.0,1,2,50.0,4,2,6,2,0,0,0,1,1,2
../kbl_data/2022-2023,S41G01N139,울산 현대모비스,Away,김영현,15,0,1,0.0,5,8,62.5,5,9,55.6,0,0,0.0,1,2,3,2,0,0,0,0,1,0
../kbl_data/2022-2023,S41G01N139,울산 현대모비스,Away,김국찬,0,0,0,0.0,0,1,0.0,0,1,0.0,0,0,0.0,0,1,1,0,0,0,0,0,0,0
../kbl_data/2022-2023,S41G01N139,울산 현대모비스,Away,서명진,8,1,3,33.3,2,4,50.0,3,7,42.9,0,0,0.0,0,2,2,0,0,0,0,0,2,2
../kbl_data/2022-2023,S41G01N139,울산 현대모비스,Away,헨리 심스,7,3,3,100.0,0,0,0.0,3,3,100.0,1,2,50.0,3,6,9,0,0,0,0,1,0,4
../kbl_data/2022-2023,S41G01N139,울산 현대모비스,Away,이우석,3,0,5,0.0,1,3,33.3,1,8,12.5,0,0,0.0,0,2,2,1,0,0,0,0,2,2
../kbl_data/2022-2023,S41G01N139,울산 현대모비스,Away,신민석,0,0,0,0.0,0,1,0.0,0,1,0.0,0,0,0.0,0,0,0,0,0,0,0,0,0,1
../kbl_data/2022-2023,S41G01N139,울산 현대모비스,Away,김동준,0,0,0,0.0,0,0,0.0,0,0,0.0,0,0,0.0,0,0,0,0,0,0,0,0,0,0
../kbl_data/2022-2023,S41G01N139,울산 현대모비스,Away,론제이 아바리엔토스,10,3,5,60.0,1,6,16.7,4,11,36.4,1,2,50.0,1,1,2,5,4,0,0,0,3,2
../kbl_data/2022-2023,S41G01N139,울산 현대모비스,Away,게이지 프림,13,5,13,38.5,0,0,0.0,5,13,38.5,3,3,100.0,4,3,7,1,0,1,0,0,2,4
../kbl_data/2022-2023,S41G01N140,서울 삼성,Home,이정현,13,3,7,42.9,2,2,100.0,5,9,55.6,1,2,50.0,0,3,3,1,1,0,0,0,1,1
../kbl_data/2022-2023,S41G01N140,서울 삼성,Home,장민국,7,2,4,50.0,1,4,25.0,3,8,37.5,0,0,0.0,0,1,1,0,0,0,0,0,0,0
../kbl_data/2022-2023,S41G01N140,서울 삼성,Home,김시래,0,0,5,0.0,0,2,0.0,0,7,0.0,0,0,0.0,1,1,2,5,1,0,1,0,4,4
../kbl_data/2022-2023,S41G01N140,서울 삼성,Home,임동섭,4,0,1,0.0,0,1,0.0,0,2,0.0,4,5,80.0,2,0,2,0,0,1,0,0,0,1
../kbl_data/2022-2023,S41G01N140,서울 삼성,Home,이호현,4,1,3,33.3,0,0,0.0,1,3,33.3,2,2,100.0,1,3,4,1,1,0,0,0,2,3
../kbl_data/2022-2023,S41G01N140,서울 삼성,Home,김진영,0,0,0,0.0,0,0,0.0,0,0,0.0,0,0,0.0,0,0,0,0,0,0,0,0,1,0
../kbl_data/2022-2023,S41G01N140,서울 삼성,Home,전형준,0,0,0,0.0,0,0,0.0,0,0,0.0,0,2,0.0,0,0,0,0,0,0,0,0,0,3
../kbl_data/2022-2023,S41G01N140,서울 삼성,Home,조우성,0,0,0,0.0,0,0,0.0,0,0,0.0,0,0,0.0,0,0,0,0,0,0,0,0,0,0
../kbl_data/2022-2023,S41G01N140,서울 삼성,Home,이원석,16,6,11,54.5,0,1,0.0,6,12,50.0,4,5,80.0,1,7,8,1,0,4,1,0,4,4
../kbl_data/2022-2023,S41G01N140,서울 삼성,Home,이매뉴얼 테리,6,3,6,50.0,0,0,0.0,3,6,50.0,0,0,0.0,2,7,9,0,1,0,0,0,2,3
../kbl_data/2022-2023,S41G01N140,서울 삼성,Home,신동혁,7,2,2,100.0,1,3,33.3,3,5,60.0,0,0,0.0,2,2,4,1,0,0,0,0,1,1
../kbl_data/2022-2023,S41G01N140,서울 삼성,Home,조나단 알렛지,11,2,4,50.0,1,4,25.0,3,8,37.5,4,6,66.7,1,4,5,0,0,0,0,0,0,2
../kbl_data/2022-2023,S41G01N140,창원 LG,Away,이관희,17,3,6,50.0,3,7,42.9,6,13,46.2,2,5,40.0,0,6,6,3,0,0,0,0,3,0
../kbl_data/2022-2023,S41G01N140,창원 LG,Away,정희재,5,1,3,33.3,1,6,16.7,2,9,22.2,0,0,0.0,0,1,1,2,1,0,0,0,0,3
../kbl_data/2022-2023,S41G01N140,창원 LG,Away,한상혁,4,2,2,100.0,0,0,0.0,2,2,100.0,0,0,0.0,0,0,0,1,0,0,0,0,0,0
../kbl_data/2022-2023,S41G01N140,창원 LG,Away,이재도,19,5,10,50.0,2,5,40.0,7,15,46.7,3,4,75.0,1,6,7,7,2,0,0,0,0,4
../kbl_data/2022-2023,S41G01N140,창원 LG,Away,김준일,12,4,5,80.0,0,0,0.0,4,5,80.0,4,4,100.0,0,1,1,1,0,0,0,1,1,1
../kbl_data/2022-2023,S41G01N140,창원 LG,Away,박인태,0,0,0,0.0,0,0,0.0,0,0,0.0,0,0,0.0,0,0,0,0,0,0,0,0,0,1
../kbl_data/2022-2023,S41G01N140,창원 LG,Away,정인덕,0,0,1,0.0,0,0,0.0,0,1,0.0,0,0,0.0,1,0,1,0,0,0,0,0,0,2
../kbl_data/2022-2023,S41G01N140,창원 LG,Away,최승욱,0,0,0,0.0,0,0,0.0,0,0,0.0,0,2,0.0,0,0,0,0,0,0,0,0,0,1
../kbl_data/2022-2023,S41G01N140,창원 LG,Away,윤원상,5,1,2,50.0,1,1,100.0,2,3,66.7,0,0,0.0,0,0,0,2,0,0,1,0,0,2
../kbl_data/2022-2023,S41G01N140,창원 LG,Away,아셈 마레이,8,3,12,25.0,0,0,0.0,3,12,25.0,2,4,50.0,2,10,12,1,2,0,0,0,3,2
../kbl_data/2022-2023,S41G01N140,창원 LG,Away,저스틴 구탕,6,3,6,50.0,0,0,0.0,3,6,50.0,0,0,0.0,2,1,3,3,2,0,0,1,1,5
../kbl_data/2022-2023,S41G01N140,창원 LG,Away,단테 커닝햄,3,1,1,100.0,0,0,0.0,1,1,100.0,1,2,50.0,0,3,3,3,1,0,0,1,0,2
../kbl_data/2022-2023,S41G01N141,전주 KCC,Home,정창영,3,0,5,0.0,1,4,25.0,1,9,11.1,0,0,0.0,1,3,4,3,0,0,0,0,2,2
../kbl_data/2022-2023,S41G01N141,전주 KCC,Home,라건아,25,8,14,57.1,2,3,66.7,10,17,58.8,3,3,100.0,3,11,14,3,0,2,0,0,2,0
../kbl_data/2022-2023,S41G01N141,전주 KCC,Home,박경상,5,1,1,100.0,1,3,33.3,2,4,50.0,0,0,0.0,1,3,4,2,2,0,0,0,0,2
../kbl_data/2022-2023,S41G01N141,전주 KCC,Home,김상규,0,0,0,0.0,0,0,0.0,0,0,0.0,0,0,0.0,0,0,0,0,0,0,0,0,0,0
../kbl_data/2022-2023,S41G01N141,전주 KCC,Home,유병훈,0,0,0,0.0,0,0,0.0,0,0,0.0,0,0,0.0,0,0,0,0,0,0,0,0,0,0
../kbl_data/2022-2023,S41G01N141,전주 KCC,Home,전준범,0,0,2,0.0,0,0,0.0,0,2,0.0,0,0,0.0,0,2,2,0,0,0,0,0,0,3
../kbl_data/2022-2023,S41G01N141,전주 KCC,Home,허웅,13,2,7,28.6,2,7,28.6,4,14,28.6,3,3,100.0,1,3,4,1,2,0,0,0,2,1
../kbl_data/2022-2023,S41G01N141,전주 KCC,Home,이승현,11,4,10,40.0,1,2,50.0,5,12,41.7,0,0,0.0,4,0,4,5,0,0,0,0,3,1
../kbl_data/2022-2023,S41G01N141,전주 KCC,Home,이진욱,0,0,0,0.0,0,0,0.0,0,0,0.0,0,0,0.0,0,0,0,0,0,0,0,0,0,0
../kbl_data/2022-2023,S41G01N141,전주 KCC,Home,이근휘,6,0,1,0.0,2,7,28.6,2,8,25.0,0,0,0.0,2,2,4,0,0,0,0,0,0,2
../kbl_data/2022-2023,S41G01N141,전주 KCC,Home,김동현,0,0,1,0.0,0,0,0.0,0,1,0.0,0,0,0.0,0,0,0,0,0,0,0,0,0,1
../kbl_data/2022-2023,S41G01N141,전주 KCC,Home,론데 홀리스 제퍼슨,7,3,5,60.0,0,0,0.0,3,5,60.0,1,2,50.0,1,3,4,0,2,0,0,0,2,4
../kbl_data/2022-2023,S41G01N141,서울 SK,Away,양우섭,0,0,0,0.0,0,0,0.0,0,0,0.0,0,0,0.0,1,0,1,0,0,0,0,0,0,1
../kbl_data/2022-2023,S41G01N141,서울 SK,Away,허일영,11,2,4,50.0,0,2,0.0,2,6,33.3,7,7,100.0,0,1,1,0,0,0,1,0,2,3
../kbl_data/2022-2023,S41G01N141,서울 SK,Away,김선형,16,3,7,42.9,3,6,50.0,6,13,46.2,1,1,100.0,0,2,2,11,0,0,0,0,2,1
../kbl_data/2022-2023,S41G01N141,서울 SK,Away,홍경기,3,0,0,0.0,1,1,100.0,1,1,100.0,0,0,0.0,0,0,0,0,1,0,0,0,0,1
../kbl_data/2022-2023,S41G01N141,서울 SK,Away,최부경,10,4,5,80.0,0,0,0.0,4,5,80.0,2,2,100.0,1,5,6,2,0,0,0,0,0,0
../kbl_data/2022-2023,S41G01N141,서울 SK,Away,리온 윌리엄스,5,1,1,100.0,1,2,50.0,2,3,66.7,0,0,0.0,0,1,1,0,0,0,0,0,0,1
../kbl_data/2022-2023,S41G01N141,서울 SK,Away,최원혁,0,0,1,0.0,0,0,0.0,0,1,0.0,0,0,0.0,0,0,0,0,0,0,0,0,0,1
../kbl_data/2022-2023,S41G01N141,서울 SK,Away,최준용,14,2,8,25.0,3,5,60.0,5,13,38.5,1,3,33.3,0,6,6,2,2,0,0,0,2,2
../kbl_data/2022-2023,S41G01N141,서울 SK,Away,최성원,3,0,2,0.0,1,1,100.0,1,3,33.3,0,0,0.0,0,1,1,3,0,0,0,0,0,4
../kbl_data/2022-2023,S41G01N141,서울 SK,Away,자밀 워니,14,6,17,35.3,0,0,0.0,6,17,35.3,2,2,100.0,5,8,13,4,2,1,0,0,2,0
../kbl_data/2022-2023,S41G01N141,서울 SK,Away,김형빈,0,0,0,0.0,0,0,0.0,0,0,0.0,0,0,0.0,0,0,0,0,0,0,0,0,0,0
../kbl_data/2022-2023,S41G01N141,서울 SK,Away,오재현,2,1,1,100.0,0,0,0.0,1,1,100.0,0,0,0.0,0,1,1,0,1,0,0,0,0,2
../kbl_data/2022-2023,S41G01N142,안양 KGC,Home,양희종,0,0,1,0.0,0,1,0.0,0,2,0.0,0,0,0.0,0,0,0,1,0,0,0,0,0,1
../kbl_data/2022-2023,S41G01N142,안양 KGC,Home,오세근,13,4,8,50.0,1,3,33.3,5,11,45.5,2,2,100.0,3,11,14,1,1,1,0,0,1,2
../kbl_data/2022-2023,S41G01N142,안양 KGC,Home,정준원,2,1,2,50.0,0,0,0.0,1,2,50.0,0,0,0.0,1,0,1,0,0,0,0,0,0,1
../kbl_data/2022-2023,S41G01N142,안양 KGC,Home,배병준,3,0,0,0.0,1,3,33.3,1,3,33.3,0,0,0.0,0,0,0,1,0,0,0,0,1,1
../kbl_data/2022-2023,S41G01N142,안양 KGC,Home,문성곤,12,2,5,40.0,2,4,50.0,4,9,44.4,2,4,50.0,1,3,4,5,3,0,1,0,2,1
../kbl_data/2022-2023,S41G01N142,안양 KGC,Home,박지훈,11,5,7,71.4,0,1,0.0,5,8,62.5,1,2,50.0,3,4,7,2,2,0,0,0,2,2
../kbl_data/2022-2023,S41G01N142,안양 KGC,Home,이우정,0,0,0,0.0,0,0,0.0,0,0,0.0,0,0,0.0,0,0,0,0,0,0,0,0,0,0
../kbl_data/2022-2023,S41G01N142,안양 KGC,Home,대릴 먼로,0,0,1,0.0,0,0,0.0,0,1,0.0,0,0,0.0,0,0,0,0,0,0,0,0,1,0
../kbl_data/2022-2023,S41G01N142,안양 KGC,Home,변준형,15,2,4,50.0,3,6,50.0,5,10,50.0,2,2,100.0,1,0,1,6,0,0,0,0,4,3
../kbl_data/2022-2023,S41G01N142,안양 KGC,Home,김경원,2,1,1,100.0,0,0,0.0,1,1,100.0,0,0,0.0,2,0,2,0,0,0,0,0,0,2
../kbl_data/2022-2023,S41G01N142,안양 KGC,Home,오마리 스펠맨,22,6,11,54.5,3,7,42.9,9,18,50.0,1,5,20.0,1,5,6,3,0,0,0,2,0,3
../kbl_data/2022-2023,S41G01N142,안양 KGC,Home,렌즈 아반도,3,0,1,0.0,1,3,33.3,1,4,25.0,0,0,0.0,0,0,0,1,0,0,0,0,0,1
../kbl_data/2022-2023,S41G01N142,수원 KT,Away,김동욱,0,0,0,0.0,0,0,0.0,0,0,0.0,0,0,0.0,0,0,0,0,0,0,0,0,0,0
../kbl_data/2022-2023,S41G01N142,수원 KT,Away,김영환,4,2,5,40.0,0,2,0.0,2,7,28.6,0,0,0.0,1,1,2,5,2,0,0,0,0,3
../kbl_data/2022-2023,S41G01N142,수원 KT,Away,한희원,18,3,6,50.0,4,5,80.0,7,11,63.6,0,0,0.0,1,1,2,0,0,2,0,0,0,2
../kbl_data/2022-2023,S41G01N142,수원 KT,Away,최창진,0,0,0,0.0,0,0,0.0,0,0,0.0,0,0,0.0,0,0,0,0,0,0,0,0,0,0
../kbl_data/2022-2023,S41G01N142,수원 KT,Away,정성우,3,0,3,0.0,1,7,14.3,1,10,10.0,0,0,0.0,2,1,3,2,2,0,1,0,2,2
../kbl_data/2022-2023,S41G01N142,수원 KT,Away,최성모,9,2,3,66.7,1,2,50.0,3,5,60.0,2,4,50.0,0,1,1,4,0,0,0,0,1,5
../kbl_data/2022-2023,S41G01N142,수원 KT,Away,양홍석,16,3,6,50.0,3,3,100.0,6,9,66.7,1,2,50.0,5,5,10,4,1,0,0,0,1,1
../kbl_data/2022-2023,S41G01N142,수원 KT,Away,박지원,0,0,0,0.0,0,0,0.0,0,0,0.0,0,0,0.0,0,0,0,0,0,0,0,0,0,0
../kbl_data/2022-2023,S41G01N142,수원 KT,Away,하윤기,14,7,9,77.8,0,0,0.0,7,9,77.8,0,0,0.0,4,4,8,1,1,0,0,0,4,1
../kbl_data/2022-2023,S41G01N142,수원 KT,Away,이두원,2,1,2,50.0,0,0,0.0,1,2,50.0,0,0,0.0,0,0,0,0,0,0,0,0,0,0
../kbl_data/2022-2023,S41G01N142,수원 KT,Away,레스터 프로스퍼,5,1,1,100.0,1,4,25.0,2,5,40.0,0,0,0.0,0,2,2,0,1,0,0,0,1,1
../kbl_data/2022-2023,S41G01N142,수원 KT,Away,재로드 존스,14,4,9,44.4,1,7,14.3,5,16,31.2,3,4,75.0,0,13,13,4,0,0,0,1,0,3
../kbl_data/2022-2023,S41G01N143,울산 현대모비스,Home,함지훈,5,1,3,33.3,1,2,50.0,2,5,40.0,0,0,0.0,3,1,4,3,0,1,0,0,3,2
../kbl_data/2022-2023,S41G01N143,울산 현대모비스,Home,김현민,0,0,0,0.0,0,0,0.0,0,0,0.0,0,0,0.0,0,0,0,0,0,0,0,0,0,0
../kbl_data/2022-2023,S41G01N143,울산 현대모비스,Home,장재석,4,2,4,50.0,0,0,0.0,2,4,50.0,0,0,0.0,2,0,2,2,1,0,0,0,0,2
../kbl_data/2022-2023,S41G01N143,울산 현대모비스,Home,김영현,0,0,0,0.0,0,1,0.0,0,1,0.0,0,0,0.0,1,0,1,0,0,0,0,0,0,1
../kbl_data/2022-2023,S41G01N143,울산 현대모비스,Home,서명진,4,2,3,66.7,0,4,0.0,2,7,28.6,0,0,0.0,1,1,2,1,1,0,0,0,0,1
../kbl_data/2022-2023,S41G01N143,울산 현대모비스,Home,헨리 심스,3,1,4,25.0,0,1,0.0,1,5,20.0,1,2,50.0,1,6,7,1,0,2,0,0,2,1
../kbl_data/2022-2023,S41G01N143,울산 현대모비스,Home,이우석,23,4,8,50.0,3,7,42.9,7,15,46.7,6,9,66.7,1,5,6,6,0,0,0,0,1,2
../kbl_data/2022-2023,S41G01N143,울산 현대모비스,Home,신민석,8,1,4,25.0,2,7,28.6,3,11,27.3,0,0,0.0,2,4,6,0,0,0,0,0,0,5
../kbl_data/2022-2023,S41G01N143,울산 현대모비스,Home,김동준,0,0,0,0.0,0,1,0.0,0,1,0.0,0,0,0.0,0,0,0,0,0,0,0,0,0,0
../kbl_data/2022-2023,S41G01N143,울산 현대모비스,Home,론제이 아바리엔토스,21,0,2,0.0,7,14,50.0,7,16,43.8,0,0,0.0,1,1,2,5,1,0,0,0,3,2
../kbl_data/2022-2023,S41G01N143,울산 현대모비스,Home,게이지 프림,19,7,13,53.8,0,0,0.0,7,13,53.8,5,8,62.5,4,10,14,2,2,0,0,0,4,4
../kbl_data/2022-2023,S41G01N143,울산 현대모비스,Home,김태완,3,0,0,0.0,1,2,50.0,1,2,50.0,0,0,0.0,0,0,0,1,0,0,0,0,1,1
../kbl_data/2022-2023,S41G01N143,원주 DB,Away,김종규,18,7,12,58.3,0,1,0.0,7,13,53.8,4,5,80.0,2,7,9,1,1,2,0,0,2,4
../kbl_data/2022-2023,S41G01N143,원주 DB,Away,최승욱,15,6,12,50.0,0,1,0.0,6,13,46.2,3,4,75.0,0,1,1,2,2,0,0,0,2,0
../kbl_data/2022-2023,S41G01N143,원주 DB,Away,강상재,17,6,11,54.5,0,2,0.0,6,13,46.2,5,6,83.3,3,5,8,6,1,1,0,0,2,0
../kbl_data/2022-2023,S41G01N143,원주 DB,Away,윤성원,0,0,0,0.0,0,0,0.0,0,0,0.0,0,0,0.0,0,0,0,0,0,0,0,0,0,0
../kbl_data/2022-2023,S41G01N143,원주 DB,Away,원종훈,2,1,1,100.0,0,1,0.0,1,2,50.0,0,0,0.0,0,0,0,3,0,0,1,0,1,3
../kbl_data/2022-2023,S41G01N143,원주 DB,Away,이준희,0,0,0,0.0,0,0,0.0,0,0,0.0,0,0,0.0,0,0,0,0,0,0,0,0,0,0
../kbl_data/2022-2023,S41G01N143,원주 DB,Away,레나드 프리먼,9,4,6,66.7,0,1,0.0,4,7,57.1,1,4,25.0,2,8,10,1,0,1,0,1,1,3
../kbl_data/2022-2023,S41G01N143,원주 DB,Away,이민석,0,0,0,0.0,0,0,0.0,0,0,0.0,0,0,0.0,0,0,0,0,0,0,0,0,0,0
../kbl_data/2022-2023,S41G01N143,원주 DB,Away,이선 알바노,9,2,6,33.3,1,6,16.7,3,12,25.0,2,3,66.7,0,3,3,8,3,0,0,0,0,2
../kbl_data/2022-2023,S41G01N143,원주 DB,Away,드완 에르난데스,18,9,13,69.2,0,0,0.0,9,13,69.2,0,0,0.0,0,2,2,2,0,0,0,2,1,4
../kbl_data/2022-2023,S41G01N143,원주 DB,Away,박인웅,6,0,1,0.0,2,2,100.0,2,3,66.7,0,0,0.0,1,1,2,1,0,0,0,0,1,2
../kbl_data/2022-2023,S41G01N143,원주 DB,Away,인승찬,0,0,0,0.0,0,0,0.0,0,0,0.0,0,0,0.0,0,0,0,0,0,0,0,0,0,0
../kbl_data/2022-2023,S41G01N144,창원 LG,Home,이관희,8,4,5,80.0,0,5,0.0,4,10,40.0,0,0,0.0,0,4,4,1,0,0,0,0,4,3
../kbl_data/2022-2023,S41G01N144,창원 LG,Home,정희재,7,2,3,66.7,1,5,20.0,3,8,37.5,0,0,0.0,1,4,5,1,0,0,0,0,1,4
../kbl_data/2022-2023,S41G01N144,창원 LG,Home,한상혁,0,0,0,0.0,0,0,0.0,0,0,0.0,0,0,0.0,0,0,0,0,0,0,0,0,0,0
../kbl_data/2022-2023,S41G01N144,창원 LG,Home,이재도,15,5,8,62.5,0,2,0.0,5,10,50.0,5,7,71.4,2,1,3,2,0,0,0,0,1,0
../kbl_data/2022-2023,S41G01N144,창원 LG,Home,박인태,0,0,1,0.0,0,1,0.0,0,2,0.0,0,0,0.0,0,0,0,1,0,0,0,0,0,1
../kbl_data/2022-2023,S41G01N144,창원 LG,Home,정인덕,0,0,0,0.0,0,0,0.0,0,0,0.0,0,0,0.0,0,0,0,0,0,0,0,0,0,0
../kbl_data/2022-2023,S41G01N144,창원 LG,Home,최승욱,0,0,0,0.0,0,1,0.0,0,1,0.0,0,0,0.0,0,0,0,0,0,0,0,0,1,2
../kbl_data/2022-2023,S41G01N144,창원 LG,Home,이광진,0,0,0,0.0,0,1,0.0,0,1,0.0,0,0,0.0,0,4,4,0,0,0,0,0,0,0
../kbl_data/2022-2023,S41G01N144,창원 LG,Home,윤원상,3,0,2,0.0,1,5,20.0,1,7,14.3,0,0,0.0,1,0,1,2,0,0,0,0,0,3
../kbl_data/2022-2023,S41G01N144,창원 LG,Home,아셈 마레이,18,7,16,43.8,0,0,0.0,7,16,43.8,4,8,50.0,13,9,22,4,2,0,0,0,1,4
../kbl_data/2022-2023,S41G01N144,창원 LG,Home,저스틴 구탕,8,4,7,57.1,0,2,0.0,4,9,44.4,0,0,0.0,2,6,8,0,0,0,0,0,3,1
../kbl_data/2022-2023,S41G01N144,창원 LG,Home,단테 커닝햄,5,2,3,66.7,0,0,0.0,2,3,66.7,1,2,50.0,0,1,1,1,0,0,0,0,0,1
../kbl_data/2022-2023,S41G01N144,고양 캐롯,Away,김강선,0,0,1,0.0,0,3,0.0,0,4,0.0,0,0,0.0,1,1,2,0,0,0,0,0,0,2
../kbl_data/2022-2023,S41G01N144,고양 캐롯,Away,최현민,0,0,0,0.0,0,2,0.0,0,2,0.0,0,0,0.0,0,0,0,0,0,0,0,0,0,2
../kbl_data/2022-2023,S41G01N144,고양 캐롯,Away,전성현,21,2,11,18.2,5,11,45.5,7,22,31.8,2,3,66.7,0,2,2,3,0,0,0,0,1,2
../kbl_data/2022-2023,S41G01N144,고양 캐롯,Away,이종현,4,2,2,100.0,0,1,0.0,2,3,66.7,0,0,0.0,3,2,5,0,0,0,0,0,0,1
../kbl_data/2022-2023,S41G01N144,고양 캐롯,Away,김진유,6,0,1,0.0,2,5,40.0,2,6,33.3,0,0,0.0,2,4,6,2,0,0,1,0,1,4
../kbl_data/2022-2023,S41G01N144,고양 캐롯,Away,정해원,0,0,0,0.0,0,0,0.0,0,0,0.0,0,0,0.0,0,0,0,0,0,0,0,0,0,0
../kbl_data/2022-2023,S41G01N144,고양 캐롯,Away,김세창,3,0,2,0.0,1,2,50.0,1,4,25.0,0,0,0.0,0,1,1,2,0,0,0,0,0,3
../kbl_data/2022-2023,S41G01N144,고양 캐롯,Away,디드릭 로슨,27,9,12,75.0,1,2,50.0,10,14,71.4,6,6,100.0,3,8,11,1,1,1,0,1,1,0
../kbl_data/2022-2023,S41G01N144,고양 캐롯,Away,박진철,0,0,0,0.0,0,0,0.0,0,0,0.0,0,0,0.0,0,0,0,0,0,0,0,0,0,0
../kbl_data/2022-2023,S41G01N144,고양 캐롯,Away,이정현,12,2,7,28.6,2,8,25.0,4,15,26.7,2,2,100.0,1,5,6,3,2,0,0,0,1,4
../kbl_data/2022-2023,S41G01N144,고양 캐롯,Away,안정욱,0,0,0,0.0,0,0,0.0,0,0,0.0,0,0,0.0,0,0,0,0,0,0,0,0,0,0
../kbl_data/2022-2023,S41G01N144,고양 캐롯,Away,드미트리우스 트레드웰,0,0,0,0.0,0,0,0.0,0,0,0.0,0,2,0.0,1,0,1,0,0,0,0,0,0,2
../kbl_data/2022-2023,S41G01N145,대구 한국가스공사,Home,차바위,9,0,2,0.0,3,4,75.0,3,6,50.0,0,0,0.0,1,1,2,1,0,0,0,0,0,1
../kbl_data/2022-2023,S41G01N145,대구 한국가스공사,Home,박지훈,5,0,1,0.0,1,2,50.0,1,3,33.3,2,2,100.0,0,1,1,0,1,0,0,0,0,5
../kbl_data/2022-2023,S41G01N145,대구 한국가스공사,Home,조상열,5,1,1,100.0,1,4,25.0,2,5,40.0,0,0,0.0,1,1,2,1,1,0,0,0,0,3
../kbl_data/2022-2023,S41G01N145,대구 한국가스공사,Home,이원대,0,0,0,0.0,0,0,0.0,0,0,0.0,0,0,0.0,0,0,0,0,0,0,0,0,0,0
../kbl_data/2022-2023,S41G01N145,대구 한국가스공사,Home,이대헌,15,6,8,75.0,0,1,0.0,6,9,66.7,3,5,60.0,1,0,1,2,1,0,0,0,1,1
../kbl_data/2022-2023,S41G01N145,대구 한국가스공사,Home,이대성,12,3,12,25.0,2,3,66.7,5,15,33.3,0,0,0.0,2,2,4,3,0,0,0,0,1,1
../kbl_data/2022-2023,S41G01N145,대구 한국가스공사,Home,머피 할로웨이,12,6,8,75.0,0,0,0.0,6,8,75.0,0,0,0.0,1,7,8,4,0,0,0,0,2,3
../kbl_data/2022-2023,S41G01N145,대구 한국가스공사,Home,우동현,8,0,3,0.0,2,3,66.7,2,6,33.3,2,2,100.0,0,2,2,4,2,0,2,0,1,5
../kbl_data/2022-2023,S41G01N145,대구 한국가스공사,Home,전현우,0,0,0,0.0,0,0,0.0,0,0,0.0,0,0,0.0,0,0,0,0,0,0,0,0,0,0
../kbl_data/2022-2023,S41G01N145,대구 한국가스공사,Home,데본 스캇,15,4,6,66.7,1,1,100.0,5,7,71.4,4,6,66.7,1,7,8,2,1,1,0,0,1,3
../kbl_data/2022-2023,S41G01N145,대구 한국가스공사,Home,신승민,2,0,0,0.0,0,1,0.0,0,1,0.0,2,2,100.0,1,0,1,0,0,0,0,0,0,1
../kbl_data/2022-2023,S41G01N145,대구 한국가스공사,Home,샘조세프 벨란겔,0,0,0,0.0,0,0,0.0,0,0,0.0,0,0,0.0,0,0,0,0,0,0,0,0,0,0
../kbl_data/2022-2023,S41G01N145,서울 삼성,Away,이정현,8,2,5,40.0,1,5,20.0,3,10,30.0,1,2,50.0,1,4,5,9,2,0,0,0,2,3
../kbl_data/2022-2023,S41G01N145,서울 삼성,Away,장민국,4,2,4,50.0,0,0,0.0,2,4,50.0,0,1,0.0,1,0,1,0,0,0,0,0,0,1
../kbl_data/2022-2023,S41G01N145,서울 삼성,Away,김시래,13,0,1,0.0,3,7,42.9,3,8,37.5,4,4,100.0,2,3,5,7,0,0,0,0,4,3
../kbl_data/2022-2023,S41G01N145,서울 삼성,Away,임동섭,0,0,1,0.0,0,1,0.0,0,2,0.0,0,0,0.0,0,0,0,0,0,0,0,0,0,1
../kbl_data/2022-2023,S41G01N145,서울 삼성,Away,이호현,0,0,0,0.0,0,0,0.0,0,0,0.0,0,0,0.0,0,0,0,0,0,0,0,0,0,2
../kbl_data/2022-2023,S41G01N145,서울 삼성,Away,김진영,8,1,4,25.0,2,4,50.0,3,8,37.5,0,0,0.0,0,1,1,0,1,0,0,0,0,2
../kbl_data/2022-2023,S41G01N145,서울 삼성,Away,전형준,0,0,0,0.0,0,0,0.0,0,0,0.0,0,0,0.0,0,0,0,0,0,0,0,0,0,0
../kbl_data/2022-2023,S41G01N145,서울 삼성,Away,조우성,0,0,0,0.0,0,0,0.0,0,0,0.0,0,0,0.0,0,0,0,0,0,0,0,0,0,0
../kbl_data/2022-2023,S41G01N145,서울 삼성,Away,이원석,14,4,8,50.0,0,0,0.0,4,8,50.0,6,10,60.0,2,3,5,1,0,1,0,1,2,3
../kbl_data/2022-2023,S41G01N145,서울 삼성,Away,이매뉴얼 테리,13,5,7,71.4,0,0,0.0,5,7,71.4,3,5,60.0,2,12,14,1,0,0,0,2,2,3
../kbl_data/2022-2023,S41G01N145,서울 삼성,Away,신동혁,10,2,2,100.0,2,3,66.7,4,5,80.0,0,0,0.0,0,0,0,0,0,0,0,0,0,0
../kbl_data/2022-2023,S41G01N145,서울 삼성,Away,조나단 알렛지,7,1,2,50.0,1,2,50.0,2,4,50.0,2,2,100.0,0,2,2,2,0,0,0,0,0,2
../kbl_data/2022-2023,S41G01N146,울산 현대모비스,Home,함지훈,8,3,6,50.0,0,1,0.0,3,7,42.9,2,2,100.0,2,2,4,4,0,0,0,0,0,2
../kbl_data/2022-2023,S41G01N146,울산 현대모비스,Home,김현민,0,0,0,0.0,0,1,0.0,0,1,0.0,0,0,0.0,0,0,0,1,1,0,0,0,0,3
../kbl_data/2022-2023,S41G01N146,울산 현대모비스,Home,최진수,7,2,3,66.7,0,1,0.0,2,4,50.0,3,4,75.0,2,0,2,0,2,0,0,1,0,4
../kbl_data/2022-2023,S41G01N146,울산 현대모비스,Home,장재석,9,4,7,57.1,0,0,0.0,4,7,57.1,1,1,100.0,2,2,4,0,1,0,0,0,1,4
../kbl_data/2022-2023,S41G01N146,울산 현대모비스,Home,김영현,0,0,0,0.0,0,0,0.0,0,0,0.0,0,0,0.0,0,0,0,0,0,0,0,0,0,0
../kbl_data/2022-2023,S41G01N146,울산 현대모비스,Home,서명진,4,2,3,66.7,0,3,0.0,2,6,33.3,0,0,0.0,0,0,0,5,0,0,0,0,1,1
../kbl_data/2022-2023,S41G01N146,울산 현대모비스,Home,헨리 심스,8,4,4,100.0,0,0,0.0,4,4,100.0,0,2,0.0,1,2,3,1,1,0,0,0,1,2
../kbl_data/2022-2023,S41G01N146,울산 현대모비스,Home,이우석,18,6,11,54.5,2,4,50.0,8,15,53.3,0,0,0.0,1,3,4,2,0,0,0,0,0,0
../kbl_data/2022-2023,S41G01N146,울산 현대모비스,Home,신민석,0,0,2,0.0,0,1,0.0,0,3,0.0,0,0,0.0,0,0,0,0,2,0,0,0,0,3
../kbl_data/2022-2023,S41G01N146,울산 현대모비스,Home,론제이 아바리엔토스,14,1,4,25.0,3,9,33.3,4,13,30.8,3,4,75.0,1,3,4,5,1,1,0,0,1,0
../kbl_data/2022-2023,S41G01N146,울산 현대모비스,Home,게이지 프림,21,8,14,57.1,0,0,0.0,8,14,57.1,5,6,83.3,6,8,14,2,0,0,0,0,0,3
../kbl_data/2022-2023,S41G01N146,울산 현대모비스,Home,김태완,0,0,0,0.0,0,0,0.0,0,0,0.0,0,0,0.0,0,0,0,0,0,0,0,0,0,0
../kbl_data/2022-2023,S41G01N146,수원 KT,Away,김동욱,3,0,0,0.0,1,1,100.0,1,1,100.0,0,0,0.0,0,1,1,2,1,0,0,0,2,1
../kbl_data/2022-2023,S41G01N146,수원 KT,Away,김영환,5,1,2,50.0,1,1,100.0,2,3,66.7,0,0,0.0,0,2,2,1,0,0,0,0,1,2
../kbl_data/2022-2023,S41G01N146,수원 KT,Away,한희원,0,0,2,0.0,0,0,0.0,0,2,0.0,0,0,0.0,0,0,0,1,1,0,0,0,0,3
../kbl_data/2022-2023,S41G01N146,수원 KT,Away,최창진,0,0,0,0.0,0,0,0.0,0,0,0.0,0,0,0.0,0,0,0,0,0,0,0,0,0,0
../kbl_data/2022-2023,S41G01N146,수원 KT,Away,정성우,3,0,4,0.0,1,3,33.3,1,7,14.3,0,0,0.0,0,3,3,3,0,0,1,0,2,2
../kbl_data/2022-2023,S41G01N146,수원 KT,Away,최성모,0,0,0,0.0,0,0,0.0,0,0,0.0,0,0,0.0,0,0,0,5,0,0,0,0,0,1
../kbl_data/2022-2023,S41G01N146,수원 KT,Away,양홍석,13,5,7,71.4,1,3,33.3,6,10,60.0,0,0,0.0,2,2,4,2,1,0,0,0,3,1
../kbl_data/2022-2023,S41G01N146,수원 KT,Away,박지원,0,0,0,0.0,0,0,0.0,0,0,0.0,0,0,0.0,0,0,0,0,0,0,0,0,0,0
../kbl_data/2022-2023,S41G01N146,수원 KT,Away,하윤기,26,11,15,73.3,0,0,0.0,11,15,73.3,4,5,80.0,4,5,9,2,0,0,0,2,1,4
../kbl_data/2022-2023,S41G01N146,수원 KT,Away,이두원,1,0,1,0.0,0,0,0.0,0,1,0.0,1,2,50.0,0,0,0,0,0,0,0,0,0,2
../kbl_data/2022-2023,S41G01N146,수원 KT,Away,레스터 프로스퍼,13,1,6,16.7,3,5,60.0,4,11,36.4,2,2,100.0,2,4,6,0,0,0,0,0,1,3
../kbl_data/2022-2023,S41G01N146,수원 KT,Away,재로드 존스,19,4,7,57.1,2,3,66.7,6,10,60.0,5,7,71.4,0,2,2,2,0,0,0,1,1,1
../kbl_data/2022-2023,S41G01N147,안양 KGC,Home,양희종,0,0,0,0.0,0,3,0.0,0,3,0.0,0,0,0.0,0,3,3,3,0,0,1,0,0,1
../kbl_data/2022-2023,S41G01N147,안양 KGC,Home,오세근,13,5,9,55.6,1,2,50.0,6,11,54.5,0,0,0.0,1,5,6,2,1,0,0,0,1,2
../kbl_data/2022-2023,S41G01N147,안양 KGC,Home,정준원,0,0,0,0.0,0,0,0.0,0,0,0.0,0,0,0.0,0,0,0,0,0,0,0,0,0,0
../kbl_data/2022-2023,S41G01N147,안양 KGC,Home,배병준,0,0,1,0.0,0,0,0.0,0,1,0.0,0,0,0.0,0,0,0,1,0,0,0,0,0,0
../kbl_data/2022-2023,S41G01N147,안양 KGC,Home,문성곤,2,0,0,0.0,0,2,0.0,0,2,0.0,2,4,50.0,4,3,7,1,0,0,0,0,0,4
../kbl_data/2022-2023,S41G01N147,안양 KGC,Home,박지훈,10,4,5,80.0,0,0,0.0,4,5,80.0,2,2,100.0,1,2,3,0,1,0,0,0,1,2
../kbl_data/2022-2023,S41G01N147,안양 KGC,Home,이우정,0,0,0,0.0,0,0,0.0,0,0,0.0,0,0,0.0,0,0,0,0,0,0,0,0,0,0
../kbl_data/2022-2023,S41G01N147,안양 KGC,Home,대릴 먼로,0,0,0,0.0,0,0,0.0,0,0,0.0,0,0,0.0,0,0,0,0,0,0,0,0,0,0
../kbl_data/2022-2023,S41G01N147,안양 KGC,Home,변준형,14,3,9,33.3,2,5,40.0,5,14,35.7,2,3,66.7,0,2,2,8,0,0,0,0,2,2
../kbl_data/2022-2023,S41G01N147,안양 KGC,Home,한승희,0,0,0,0.0,0,0,0.0,0,0,0.0,0,0,0.0,0,0,0,0,0,0,0,0,0,0
../kbl_data/2022-2023,S41G01N147,안양 KGC,Home,오마리 스펠맨,29,7,12,58.3,5,12,41.7,12,24,50.0,0,0,0.0,1,16,17,4,2,1,0,5,2,4
../kbl_data/2022-2023,S41G01N147,안양 KGC,Home,렌즈 아반도,15,4,9,44.4,2,2,100.0,6,11,54.5,1,2,50.0,0,3,3,2,0,0,0,0,0,5
../kbl_data/2022-2023,S41G01N147,서울 SK,Away,양우섭,0,0,0,0.0,0,0,0.0,0,0,0.0,0,0,0.0,0,0,0,0,0,0,0,0,0,0
../kbl_data/2022-2023,S41G01N147,서울 SK,Away,허일영,18,2,2,100.0,3,6,50.0,5,8,62.5,5,5,100.0,0,3,3,1,1,0,0,0,0,3
../kbl_data/2022-2023,S41G01N147,서울 SK,Away,김선형,15,4,8,50.0,1,5,20.0,5,13,38.5,4,5,80.0,0,2,2,8,0,1,0,0,1,3
../kbl_data/2022-2023,S41G01N147,서울 SK,Away,홍경기,0,0,0,0.0,0,1,0.0,0,1,0.0,0,0,0.0,0,0,0,0,0,0,0,0,0,1
../kbl_data/2022-2023,S41G01N147,서울 SK,Away,최부경,6,3,9,33.3,0,0,0.0,3,9,33.3,0,0,0.0,5,5,10,1,0,0,0,0,1,1
../kbl_data/2022-2023,S41G01N147,서울 SK,Away,리온 윌리엄스,0,0,2,0.0,0,0,0.0,0,2,0.0,0,0,0.0,1,3,4,0,0,0,0,0,0,0
../kbl_data/2022-2023,S41G01N147,서울 SK,Away,최원혁,0,0,0,0.0,0,0,0.0,0,0,0.0,0,0,0.0,0,0,0,0,0,0,0,0,0,0
../kbl_data/2022-2023,S41G01N147,서울 SK,Away,최준용,9,2,5,40.0,1,5,20.0,3,10,30.0,2,6,33.3,0,5,5,1,0,1,0,0,2,2
../kbl_data/2022-2023,S41G01N147,서울 SK,Away,최성원,6,0,1,0.0,2,4,50.0,2,5,40.0,0,0,0.0,0,1,1,2,0,0,0,0,1,4
../kbl_data/2022-2023,S41G01N147,서울 SK,Away,자밀 워니,20,8,15,53.3,0,1,0.0,8,16,50.0,4,8,50.0,4,7,11,2,0,0,0,0,2,1
../kbl_data/2022-2023,S41G01N147,서울 SK,Away,김형빈,0,0,0,0.0,0,0,0.0,0,0,0.0,0,0,0.0,0,0,0,0,0,0,0,0,0,0
../kbl_data/2022-2023,S41G01N147,서울 SK,Away,오재현,6,1,3,33.3,1,2,50.0,2,5,40.0,1,2,50.0,0,4,4,1,1,0,0,0,0,1
../kbl_data/2022-2023,S41G01N148,서울 삼성,Home,이정현,0,0,2,0.0,0,4,0.0,0,6,0.0,0,2,0.0,2,2,4,3,1,0,0,0,0,1
../kbl_data/2022-2023,S41G01N148,서울 삼성,Home,장민국,0,0,0,0.0,0,1,0.0,0,1,0.0,0,0,0.0,0,0,0,0,0,0,0,0,0,2
../kbl_data/2022-2023,S41G01N148,서울 삼성,Home,김시래,6,3,4,75.0,0,2,0.0,3,6,50.0,0,0,0.0,3,2,5,1,1,0,0,0,2,2
../kbl_data/2022-2023,S41G01N148,서울 삼성,Home,임동섭,4,2,2,100.0,0,2,0.0,2,4,50.0,0,0,0.0,1,2,3,1,0,0,0,0,0,3
../kbl_data/2022-2023,S41G01N148,서울 삼성,Home,이호현,11,2,6,33.3,2,2,100.0,4,8,50.0,1,2,50.0,0,2,2,3,0,0,0,0,0,0
../kbl_data/2022-2023,S41G01N148,서울 삼성,Home,강바일,0,0,1,0.0,0,0,0.0,0,1,0.0,0,0,0.0,0,0,0,0,0,0,0,0,0,0
../kbl_data/2022-2023,S41G01N148,서울 삼성,Home,김진영,13,5,8,62.5,1,4,25.0,6,12,50.0,0,0,0.0,5,2,7,2,2,1,0,0,0,3
../kbl_data/2022-2023,S41G01N148,서울 삼성,Home,전형준,0,0,0,0.0,0,0,0.0,0,0,0.0,0,0,0.0,0,0,0,0,0,0,0,0,0,0
../kbl_data/2022-2023,S41G01N148,서울 삼성,Home,조우성,2,1,1,100.0,0,0,0.0,1,1,100.0,0,0,0.0,0,1,1,0,0,0,0,0,0,2
../kbl_data/2022-2023,S41G01N148,서울 삼성,Home,이원석,5,2,4,50.0,0,0,0.0,2,4,50.0,1,4,25.0,3,3,6,2,1,2,0,0,6,3
../kbl_data/2022-2023,S41G01N148,서울 삼성,Home,신동혁,2,1,4,25.0,0,1,0.0,1,5,20.0,0,0,0.0,1,0,1,1,1,0,0,0,0,3
../kbl_data/2022-2023,S41G01N148,서울 삼성,Home,조나단 알렛지,15,5,15,33.3,1,7,14.3,6,22,27.3,2,2,100.0,2,10,12,0,1,1,0,0,1,3
../kbl_data/2022-2023,S41G01N148,전주 KCC,Away,정창영,5,1,4,25.0,1,4,25.0,2,8,25.0,0,0,0.0,0,1,1,1,1,0,0,0,0,4
../kbl_data/2022-2023,S41G01N148,전주 KCC,Away,라건아,14,3,8,37.5,2,3,66.7,5,11,45.5,2,2,100.0,4,9,13,2,0,1,0,0,3,0
../kbl_data/2022-2023,S41G01N148,전주 KCC,Away,박경상,2,1,1,100.0,0,2,0.0,1,3,33.3,0,0,0.0,0,0,0,2,0,0,2,0,0,2
../kbl_data/2022-2023,S41G01N148,전주 KCC,Away,김상규,2,0,1,0.0,0,0,0.0,0,1,0.0,2,4,50.0,1,1,2,1,0,0,0,0,1,0
../kbl_data/2022-2023,S41G01N148,전주 KCC,Away,유병훈,0,0,0,0.0,0,0,0.0,0,0,0.0,0,0,0.0,0,0,0,0,0,0,0,0,0,0
../kbl_data/2022-2023,S41G01N148,전주 KCC,Away,전준범,0,0,0,0.0,0,0,0.0,0,0,0.0,0,0,0.0,0,0,0,1,0,0,0,0,0,1
../kbl_data/2022-2023,S41G01N148,전주 KCC,Away,허웅,10,1,4,25.0,2,5,40.0,3,9,33.3,2,2,100.0,0,2,2,4,1,0,0,0,3,2
../kbl_data/2022-2023,S41G01N148,전주 KCC,Away,이승현,10,2,7,28.6,2,4,50.0,4,11,36.4,0,0,0.0,5,5,10,3,0,2,0,0,1,1
../kbl_data/2022-2023,S41G01N148,전주 KCC,Away,이진욱,9,4,5,80.0,0,0,0.0,4,5,80.0,1,1,100.0,0,0,0,1,1,0,0,0,1,1
../kbl_data/2022-2023,S41G01N148,전주 KCC,Away,이근휘,6,0,0,0.0,2,4,50.0,2,4,50.0,0,0,0.0,0,3,3,0,0,0,0,0,0,1
../kbl_data/2022-2023,S41G01N148,전주 KCC,Away,김동현,0,0,0,0.0,0,0,0.0,0,0,0.0,0,0,0.0,0,0,0,0,0,0,0,0,0,0
../kbl_data/2022-2023,S41G01N148,전주 KCC,Away,론데 홀리스 제퍼슨,10,3,6,50.0,0,1,0.0,3,7,42.9,4,5,80.0,0,4,4,1,0,0,0,0,1,4
../kbl_data/2022-2023,S41G01N149,고양 캐롯,Home,김강선,5,1,2,50.0,1,7,14.3,2,9,22.2,0,0,0.0,0,1,1,0,0,0,2,0,0,2
../kbl_data/2022-2023,S41G01N149,고양 캐롯,Home,최현민,6,0,1,0.0,1,2,50.0,1,3,33.3,3,3,100.0,0,2,2,0,0,0,0,0,0,2
../kbl_data/2022-2023,S41G01N149,고양 캐롯,Home,전성현,20,1,5,20.0,5,11,45.5,6,16,37.5,3,4,75.0,2,3,5,4,0,0,0,0,2,1
../kbl_data/2022-2023,S41G01N149,고양 캐롯,Home,이종현,8,4,4,100.0,0,0,0.0,4,4,100.0,0,1,0.0,1,1,2,4,1,1,0,0,0,1
../kbl_data/2022-2023,S41G01N149,고양 캐롯,Home,김진유,0,0,0,0.0,0,2,0.0,0,2,0.0,0,0,0.0,2,1,3,2,0,1,0,0,0,5
../kbl_data/2022-2023,S41G01N149,고양 캐롯,Home,정해원,0,0,0,0.0,0,1,0.0,0,1,0.0,0,0,0.0,0,0,0,0,0,0,0,0,0,0
../kbl_data/2022-2023,S41G01N149,고양 캐롯,Home,김세창,0,0,0,0.0,0,1,0.0,0,1,0.0,0,0,0.0,0,0,0,0,0,0,0,0,0,0
../kbl_data/2022-2023,S41G01N149,고양 캐롯,Home,디드릭 로슨,17,7,13,53.8,0,1,0.0,7,14,50.0,3,4,75.0,5,6,11,4,1,2,0,0,2,2
../kbl_data/2022-2023,S41G01N149,고양 캐롯,Home,박진철,0,0,0,0.0,0,0,0.0,0,0,0.0,0,0,0.0,0,0,0,0,0,0,0,0,0,0
../kbl_data/2022-2023,S41G01N149,고양 캐롯,Home,이정현,31,1,4,25.0,9,11,81.8,10,15,66.7,2,2,100.0,1,2,3,5,1,0,0,0,1,3
../kbl_data/2022-2023,S41G01N149,고양 캐롯,Home,안정욱,0,0,0,0.0,0,0,0.0,0,0,0.0,0,0,0.0,0,0,0,0,0,0,0,0,0,1
../kbl_data/2022-2023,S41G01N149,고양 캐롯,Home,드미트리우스 트레드웰,0,0,0,0.0,0,0,0.0,0,0,0.0,0,0,0.0,0,2,2,0,0,0,0,0,1,0
../kbl_data/2022-2023,S41G01N149,대구 한국가스공사,Away,차바위,3,0,0,0.0,1,3,33.3,1,3,33.3,0,0,0.0,1,4,5,1,0,0,0,0,0,3
../kbl_data/2022-2023,S41G01N149,대구 한국가스공사,Away,박지훈,2,1,3,33.3,0,0,0.0,1,3,33.3,0,0,0.0,1,2,3,0,2,0,0,0,0,2
../kbl_data/2022-2023,S41G01N149,대구 한국가스공사,Away,조상열,0,0,0,0.0,0,0,0.0,0,0,0.0,0,0,0.0,0,0,0,0,0,0,0,0,0,4
../kbl_data/2022-2023,S41G01N149,대구 한국가스공사,Away,이원대,0,0,0,0.0,0,0,0.0,0,0,0.0,0,0,0.0,0,0,0,0,0,0,0,0,0,0
../kbl_data/2022-2023,S41G01N149,대구 한국가스공사,Away,이대헌,24,10,15,66.7,1,2,50.0,11,17,64.7,1,1,100.0,3,2,5,2,1,0,0,0,0,2
../kbl_data/2022-2023,S41G01N149,대구 한국가스공사,Away,이대성,19,6,12,50.0,1,4,25.0,7,16,43.8,4,6,66.7,0,3,3,2,1,0,0,0,3,4
../kbl_data/2022-2023,S41G01N149,대구 한국가스공사,Away,머피 할로웨이,12,6,11,54.5,0,0,0.0,6,11,54.5,0,0,0.0,5,2,7,2,0,1,0,1,1,1
../kbl_data/2022-2023,S41G01N149,대구 한국가스공사,Away,우동현,2,1,1,100.0,0,0,0.0,1,1,100.0,0,0,0.0,1,1,2,2,0,0,0,0,0,2
../kbl_data/2022-2023,S41G01N149,대구 한국가스공사,Away,전현우,0,0,0,0.0,0,1,0.0,0,1,0.0,0,0,0.0,0,0,0,0,0,0,0,0,0,0
../kbl_data/2022-2023,S41G01N149,대구 한국가스공사,Away,데본 스캇,6,3,7,42.9,0,0,0.0,3,7,42.9,0,0,0.0,1,4,5,1,1,0,0,0,0,1
../kbl_data/2022-2023,S41G01N149,대구 한국가스공사,Away,신승민,6,1,2,50.0,1,4,25.0,2,6,33.3,1,2,50.0,2,2,4,2,1,0,0,0,1,1
../kbl_data/2022-2023,S41G01N149,대구 한국가스공사,Away,샘조세프 벨란겔,2,1,1,100.0,0,0,0.0,1,1,100.0,0,0,0.0,0,0,0,1,0,0,0,0,1,1
../kbl_data/2022-2023,S41G01N150,수원 KT,Home,김동욱,3,0,1,0.0,1,2,50.0,1,3,33.3,0,0,0.0,0,0,0,1,1,0,0,0,2,1
../kbl_data/2022-2023,S41G01N150,수원 KT,Home,김영환,2,0,3,0.0,0,1,0.0,0,4,0.0,2,2,100.0,0,3,3,1,2,0,0,0,0,2
../kbl_data/2022-2023,S41G01N150,수원 KT,Home,한희원,9,3,6,50.0,1,2,50.0,4,8,50.0,0,4,0.0,5,1,6,1,0,0,0,0,0,2
../kbl_data/2022-2023,S41G01N150,수원 KT,Home,최창진,0,0,0,0.0,0,0,0.0,0,0,0.0,0,0,0.0,0,0,0,0,0,0,0,0,0,0
../kbl_data/2022-2023,S41G01N150,수원 KT,Home,정성우,5,1,3,33.3,0,3,0.0,1,6,16.7,3,5,60.0,0,2,2,1,1,0,0,0,3,2
../kbl_data/2022-2023,S41G01N150,수원 KT,Home,최성모,6,1,5,20.0,1,2,50.0,2,7,28.6,1,2,50.0,3,4,7,4,4,0,0,0,1,3
../kbl_data/2022-2023,S41G01N150,수원 KT,Home,양홍석,1,0,0,0.0,0,0,0.0,0,0,0.0,1,2,50.0,0,1,1,0,0,0,0,0,0,0
../kbl_data/2022-2023,S41G01N150,수원 KT,Home,박지원,0,0,0,0.0,0,1,0.0,0,1,0.0,0,0,0.0,2,2,4,2,0,0,0,0,1,1
../kbl_data/2022-2023,S41G01N150,수원 KT,Home,하윤기,13,4,13,30.8,0,0,0.0,4,13,30.8,5,6,83.3,2,4,6,1,0,1,0,1,2,1
../kbl_data/2022-2023,S41G01N150,수원 KT,Home,이두원,0,0,0,0.0,0,0,0.0,0,0,0.0,0,0,0.0,0,0,0,0,0,0,0,0,0,0
../kbl_data/2022-2023,S41G01N150,수원 KT,Home,레스터 프로스퍼,7,3,5,60.0,0,1,0.0,3,6,50.0,1,2,50.0,1,0,1,0,0,0,0,1,0,3
../kbl_data/2022-2023,S41G01N150,수원 KT,Home,재로드 존스,14,4,12,33.3,2,8,25.0,6,20,30.0,0,0,0.0,2,2,4,2,0,0,0,0,0,1
../kbl_data/2022-2023,S41G01N150,전주 KCC,Away,정창영,0,0,0,0.0,0,0,0.0,0,0,0.0,0,0,0.0,0,1,1,1,1,0,0,0,1,2
../kbl_data/2022-2023,S41G01N150,전주 KCC,Away,라건아,24,7,14,50.0,2,3,66.7,9,17,52.9,4,6,66.7,6,14,20,4,2,2,0,1,3,3
../kbl_data/2022-2023,S41G01N150,전주 KCC,Away,박경상,12,0,1,0.0,3,4,75.0,3,5,60.0,3,3,100.0,0,0,0,2,0,0,0,0,0,1
../kbl_data/2022-2023,S41G01N150,전주 KCC,Away,김상규,0,0,1,0.0,0,0,0.0,0,1,0.0,0,0,0.0,0,1,1,0,1,0,0,0,0,1
../kbl_data/2022-2023,S41G01N150,전주 KCC,Away,유병훈,0,0,0,0.0,0,0,0.0,0,0,0.0,0,0,0.0,0,0,0,0,0,0,0,0,0,0
../kbl_data/2022-2023,S41G01N150,전주 KCC,Away,전준범,7,2,6,33.3,1,1,100.0,3,7,42.9,0,0,0.0,1,5,6,3,1,0,0,0,1,4
../kbl_data/2022-2023,S41G01N150,전주 KCC,Away,허웅,19,6,9,66.7,0,5,0.0,6,14,42.9,7,11,63.6,1,4,5,7,0,0,0,0,1,1
../kbl_data/2022-2023,S41G01N150,전주 KCC,Away,이승현,12,3,5,60.0,2,4,50.0,5,9,55.6,0,0,0.0,1,4,5,1,0,0,0,0,3,3
../kbl_data/2022-2023,S41G01N150,전주 KCC,Away,이진욱,3,0,1,0.0,1,2,50.0,1,3,33.3,0,0,0.0,0,2,2,1,1,0,0,0,1,2
../kbl_data/2022-2023,S41G01N150,전주 KCC,Away,이근휘,0,0,0,0.0,0,0,0.0,0,0,0.0,0,0,0.0,0,0,0,0,0,0,0,0,1,2
../kbl_data/2022-2023,S41G01N150,전주 KCC,Away,김동현,0,0,0,0.0,0,0,0.0,0,0,0.0,0,0,0.0,0,0,0,0,0,0,0,0,0,0
../kbl_data/2022-2023,S41G01N150,전주 KCC,Away,론데 홀리스 제퍼슨,2,1,3,33.3,0,0,0.0,1,3,33.3,0,0,0.0,0,2,2,0,0,1,0,0,1,0
../kbl_data/2022-2023,S41G01N151,서울 SK,Home,양우섭,0,0,1,0.0,0,1,0.0,0,2,0.0,0,0,0.0,0,0,0,2,1,0,0,0,0,0
../kbl_data/2022-2023,S41G01N151,서울 SK,Home,허일영,2,1,5,20.0,0,0,0.0,1,5,20.0,0,0,0.0,3,4,7,0,0,0,0,0,1,3
../kbl_data/2022-2023,S41G01N151,서울 SK,Home,김선형,6,3,4,75.0,0,3,0.0,3,7,42.9,0,0,0.0,0,0,0,1,0,2,0,0,1,1
../kbl_data/2022-2023,S41G01N151,서울 SK,Home,홍경기,0,0,0,0.0,0,0,0.0,0,0,0.0,0,0,0.0,0,0,0,0,0,0,0,0,0,0
../kbl_data/2022-2023,S41G01N151,서울 SK,Home,최부경,16,5,7,71.4,0,1,0.0,5,8,62.5,6,9,66.7,4,3,7,0,1,1,0,0,0,3
../kbl_data/2022-2023,S41G01N151,서울 SK,Home,리온 윌리엄스,9,2,3,66.7,1,4,25.0,3,7,42.9,2,2,100.0,0,8,8,0,1,1,0,0,2,4
../kbl_data/2022-2023,S41G01N151,서울 SK,Home,최원혁,0,0,0,0.0,0,0,0.0,0,0,0.0,0,0,0.0,0,0,0,0,0,0,0,0,0,0
../kbl_data/2022-2023,S41G01N151,서울 SK,Home,최준용,8,1,8,12.5,2,8,25.0,3,16,18.8,0,0,0.0,3,4,7,5,0,2,1,0,2,3
../kbl_data/2022-2023,S41G01N151,서울 SK,Home,최성원,0,0,2,0.0,0,4,0.0,0,6,0.0,0,0,0.0,0,1,1,4,0,0,1,0,2,3
../kbl_data/2022-2023,S41G01N151,서울 SK,Home,자밀 워니,4,2,9,22.2,0,0,0.0,2,9,22.2,0,0,0.0,1,8,9,2,0,0,0,0,1,2
../kbl_data/2022-2023,S41G01N151,서울 SK,Home,김형빈,0,0,0,0.0,0,0,0.0,0,0,0.0,0,0,0.0,0,0,0,0,0,0,0,0,0,0
../kbl_data/2022-2023,S41G01N151,서울 SK,Home,오재현,16,5,8,62.5,1,4,25.0,6,12,50.0,3,7,42.9,2,2,4,3,2,0,0,0,1,3
../kbl_data/2022-2023,S41G01N151,창원 LG,Away,이관희,16,2,9,22.2,4,8,50.0,6,17,35.3,0,0,0.0,1,3,4,4,3,1,0,0,0,3
../kbl_data/2022-2023,S41G01N151,창원 LG,Away,정희재,6,1,2,50.0,1,3,33.3,2,5,40.0,1,2,50.0,1,8,9,2,0,0,1,0,2,1
../kbl_data/2022-2023,S41G01N151,창원 LG,Away,서민수,0,0,0,0.0,0,0,0.0,0,0,0.0,0,0,0.0,0,0,0,0,0,0,0,0,1,5
../kbl_data/2022-2023,S41G01N151,창원 LG,Away,한상혁,6,1,1,100.0,1,1,100.0,2,2,100.0,1,2,50.0,0,2,2,0,0,0,0,0,1,0
../kbl_data/2022-2023,S41G01N151,창원 LG,Away,이재도,19,5,9,55.6,2,5,40.0,7,14,50.0,3,5,60.0,1,3,4,2,1,0,0,0,3,1
../kbl_data/2022-2023,S41G01N151,창원 LG,Away,박인태,0,0,2,0.0,0,0,0.0,0,2,0.0,0,0,0.0,0,1,1,0,0,1,0,0,0,0
../kbl_data/2022-2023,S41G01N151,창원 LG,Away,정인덕,11,1,2,50.0,2,3,66.7,3,5,60.0,3,4,75.0,1,3,4,1,0,0,0,0,1,4
../kbl_data/2022-2023,S41G01N151,창원 LG,Away,윤원상,0,0,0,0.0,0,4,0.0,0,4,0.0,0,0,0.0,0,0,0,0,0,0,0,0,0,3
../kbl_data/2022-2023,S41G01N151,창원 LG,Away,아셈 마레이,14,7,11,63.6,0,0,0.0,7,11,63.6,0,5,0.0,5,14,19,7,1,1,0,0,1,1
../kbl_data/2022-2023,S41G01N151,창원 LG,Away,이승우,2,1,1,100.0,0,0,0.0,1,1,100.0,0,0,0.0,0,0,0,1,0,0,0,0,0,1
../kbl_data/2022-2023,S41G01N151,창원 LG,Away,저스틴 구탕,7,3,5,60.0,0,1,0.0,3,6,50.0,1,2,50.0,0,1,1,4,0,0,0,0,0,3
../kbl_data/2022-2023,S41G01N151,창원 LG,Away,단테 커닝햄,4,2,2,100.0,0,0,0.0,2,2,100.0,0,0,0.0,1,2,3,0,1,0,0,1,0,0
../kbl_data/2022-2023,S41G01N152,울산 현대모비스,Home,함지훈,8,2,4,50.0,0,0,0.0,2,4,50.0,4,4,100.0,2,1,3,0,0,0,0,0,1,0
../kbl_data/2022-2023,S41G01N152,울산 현대모비스,Home,김현민,6,0,1,0.0,2,3,66.7,2,4,50.0,0,0,0.0,1,1,2,1,0,0,0,0,1,3
../kbl_data/2022-2023,S41G01N152,울산 현대모비스,Home,최진수,11,1,2,50.0,1,1,100.0,2,3,66.7,6,7,85.7,0,1,1,2,0,0,0,0,0,1
../kbl_data/2022-2023,S41G01N152,울산 현대모비스,Home,장재석,5,2,5,40.0,0,0,0.0,2,5,40.0,1,1,100.0,2,0,2,1,0,0,0,0,0,4
../kbl_data/2022-2023,S41G01N152,울산 현대모비스,Home,김영현,0,0,0,0.0,0,0,0.0,0,0,0.0,0,0,0.0,1,0,1,1,0,0,0,0,0,2
../kbl_data/2022-2023,S41G01N152,울산 현대모비스,Home,서명진,2,1,6,16.7,0,2,0.0,1,8,12.5,0,0,0.0,0,0,0,1,0,0,0,0,2,0
../kbl_data/2022-2023,S41G01N152,울산 현대모비스,Home,헨리 심스,3,1,2,50.0,0,1,0.0,1,3,33.3,1,2,50.0,0,0,0,0,0,0,0,1,0,1
../kbl_data/2022-2023,S41G01N152,울산 현대모비스,Home,이우석,10,2,6,33.3,1,3,33.3,3,9,33.3,3,4,75.0,1,3,4,4,1,0,0,0,3,1
../kbl_data/2022-2023,S41G01N152,울산 현대모비스,Home,신민석,7,1,3,33.3,1,6,16.7,2,9,22.2,2,2,100.0,3,5,8,0,2,0,1,0,0,1
../kbl_data/2022-2023,S41G01N152,울산 현대모비스,Home,김동준,5,1,3,33.3,1,2,50.0,2,5,40.0,0,0,0.0,0,0,0,0,0,0,0,0,1,1
../kbl_data/2022-2023,S41G01N152,울산 현대모비스,Home,론제이 아바리엔토스,6,0,2,0.0,2,9,22.2,2,11,18.2,0,0,0.0,0,0,0,4,3,0,0,0,1,4
../kbl_data/2022-2023,S41G01N152,울산 현대모비스,Home,게이지 프림,23,9,13,69.2,1,1,100.0,10,14,71.4,2,3,66.7,7,3,10,3,2,1,0,0,0,0
../kbl_data/2022-2023,S41G01N152,안양 KGC,Away,양희종,3,0,0,0.0,1,1,100.0,1,1,100.0,0,0,0.0,1,1,2,2,0,0,1,0,1,2
../kbl_data/2022-2023,S41G01N152,안양 KGC,Away,오세근,18,6,11,54.5,2,3,66.7,8,14,57.1,0,0,0.0,0,6,6,6,0,1,0,0,2,3
../kbl_data/2022-2023,S41G01N152,안양 KGC,Away,정준원,4,2,2,100.0,0,1,0.0,2,3,66.7,0,0,0.0,1,2,3,1,0,0,0,0,2,1
../kbl_data/2022-2023,S41G01N152,안양 KGC,Away,배병준,4,2,4,50.0,0,0,0.0,2,4,50.0,0,0,0.0,0,1,1,1,1,0,0,0,0,0
../kbl_data/2022-2023,S41G01N152,안양 KGC,Away,문성곤,9,0,2,0.0,3,3,100.0,3,5,60.0,0,0,0.0,2,2,4,0,1,0,0,0,0,1
../kbl_data/2022-2023,S41G01N152,안양 KGC,Away,박지훈,4,2,5,40.0,0,0,0.0,2,5,40.0,0,0,0.0,2,3,5,5,0,0,0,0,1,3
../kbl_data/2022-2023,S41G01N152,안양 KGC,Away,이우정,2,1,1,100.0,0,0,0.0,1,1,100.0,0,0,0.0,0,0,0,0,0,0,0,0,1,0
../kbl_data/2022-2023,S41G01N152,안양 KGC,Away,대릴 먼로,10,4,5,80.0,0,1,0.0,4,6,66.7,2,2,100.0,1,2,3,2,1,0,0,0,2,1
../kbl_data/2022-2023,S41G01N152,안양 KGC,Away,변준형,9,3,5,60.0,1,3,33.3,4,8,50.0,0,0,0.0,0,1,1,2,1,0,0,0,2,3
../kbl_data/2022-2023,S41G01N152,안양 KGC,Away,김경원,0,0,1,0.0,0,0,0.0,0,1,0.0,0,0,0.0,0,0,0,0,0,0,0,0,0,2
../kbl_data/2022-2023,S41G01N152,안양 KGC,Away,오마리 스펠맨,17,3,5,60.0,3,4,75.0,6,9,66.7,2,4,50.0,1,6,7,3,0,0,0,2,1,2
../kbl_data/2022-2023,S41G01N152,안양 KGC,Away,렌즈 아반도,20,6,6,100.0,1,4,25.0,7,10,70.0,5,6,83.3,1,2,3,1,2,2,0,1,1,2
../kbl_data/2022-2023,S41G01N153,원주 DB,Home,박찬희,0,0,0,0.0,0,0,0.0,0,0,0.0,0,0,0.0,0,0,0,0,0,0,0,0,0,0
../kbl_data/2022-2023,S41G01N153,원주 DB,Home,최승욱,7,2,6,33.3,1,2,50.0,3,8,37.5,0,0,0.0,0,2,2,0,0,0,0,0,0,2
../kbl_data/2022-2023,S41G01N153,원주 DB,Home,강상재,8,4,8,50.0,0,6,0.0,4,14,28.6,0,0,0.0,1,3,4,3,2,1,0,0,2,2
../kbl_data/2022-2023,S41G01N153,원주 DB,Home,윤성원,7,2,2,100.0,1,1,100.0,3,3,100.0,0,0,0.0,0,0,0,1,0,0,0,0,0,0
../kbl_data/2022-2023,S41G01N153,원주 DB,Home,원종훈,3,0,0,0.0,1,4,25.0,1,4,25.0,0,0,0.0,0,1,1,3,1,0,0,0,2,1
../kbl_data/2022-2023,S41G01N153,원주 DB,Home,이준희,0,0,0,0.0,0,0,0.0,0,0,0.0,0,0,0.0,0,0,0,0,0,0,0,0,0,0
../kbl_data/2022-2023,S41G01N153,원주 DB,Home,레나드 프리먼,10,5,7,71.4,0,0,0.0,5,7,71.4,0,0,0.0,3,13,16,1,0,0,0,1,1,1
../kbl_data/2022-2023,S41G01N153,원주 DB,Home,정호영,6,2,5,40.0,0,1,0.0,2,6,33.3,2,2,100.0,3,3,6,5,0,0,0,0,2,3
../kbl_data/2022-2023,S41G01N153,원주 DB,Home,이선 알바노,14,3,10,30.0,2,2,100.0,5,12,41.7,2,3,66.7,0,2,2,10,2,0,1,0,1,4
../kbl_data/2022-2023,S41G01N153,원주 DB,Home,드완 에르난데스,16,6,7,85.7,0,1,0.0,6,8,75.0,4,6,66.7,0,2,2,1,0,2,0,2,2,2
../kbl_data/2022-2023,S41G01N153,원주 DB,Home,박인웅,10,2,3,66.7,2,3,66.7,4,6,66.7,0,0,0.0,1,1,2,0,0,0,0,0,1,1
../kbl_data/2022-2023,S41G01N153,원주 DB,Home,인승찬,0,0,0,0.0,0,0,0.0,0,0,0.0,0,0,0.0,0,0,0,0,0,0,0,0,0,0
../kbl_data/2022-2023,S41G01N153,창원 LG,Away,이관희,13,1,3,33.3,3,6,50.0,4,9,44.4,2,4,50.0,0,6,6,3,0,0,1,0,0,1
../kbl_data/2022-2023,S41G01N153,창원 LG,Away,정희재,3,0,0,0.0,1,3,33.3,1,3,33.3,0,0,0.0,0,2,2,0,0,0,0,0,0,1
../kbl_data/2022-2023,S41G01N153,창원 LG,Away,서민수,0,0,0,0.0,0,1,0.0,0,1,0.0,0,0,0.0,0,0,0,0,0,0,0,0,0,0
../kbl_data/2022-2023,S41G01N153,창원 LG,Away,한상혁,2,1,1,100.0,0,1,0.0,1,2,50.0,0,0,0.0,0,0,0,2,0,0,0,0,0,2
../kbl_data/2022-2023,S41G01N153,창원 LG,Away,이재도,9,2,8,25.0,1,2,50.0,3,10,30.0,2,2,100.0,0,0,0,5,2,0,0,0,2,1
../kbl_data/2022-2023,S41G01N153,창원 LG,Away,김준일,18,9,12,75.0,0,0,0.0,9,12,75.0,0,0,0.0,0,2,2,1,0,0,0,0,0,1
../kbl_data/2022-2023,S41G01N153,창원 LG,Away,정인덕,0,0,0,0.0,0,1,0.0,0,1,0.0,0,0,0.0,0,0,0,1,0,0,0,0,2,0
../kbl_data/2022-2023,S41G01N153,창원 LG,Away,윤원상,6,0,1,0.0,2,4,50.0,2,5,40.0,0,0,0.0,0,1,1,0,0,0,0,0,0,3
../kbl_data/2022-2023,S41G01N153,창원 LG,Away,아셈 마레이,17,7,11,63.6,0,0,0.0,7,11,63.6,3,3,100.0,4,5,9,1,3,0,0,0,2,4
../kbl_data/2022-2023,S41G01N153,창원 LG,Away,이승우,0,0,0,0.0,0,0,0.0,0,0,0.0,0,0,0.0,0,0,0,0,0,0,0,0,0,0
../kbl_data/2022-2023,S41G01N153,창원 LG,Away,저스틴 구탕,8,4,7,57.1,0,0,0.0,4,7,57.1,0,0,0.0,0,2,2,8,0,0,0,0,0,1
../kbl_data/2022-2023,S41G01N153,창원 LG,Away,단테 커닝햄,6,3,8,37.5,0,0,0.0,3,8,37.5,0,0,0.0,3,5,8,0,3,0,0,1,2,0
../kbl_data/2022-2023,S41G01N154,고양 캐롯,Home,김강선,12,3,3,100.0,2,6,33.3,5,9,55.6,0,0,0.0,1,3,4,1,0,0,0,0,1,2
../kbl_data/2022-2023,S41G01N154,고양 캐롯,Home,최현민,13,0,1,0.0,4,5,80.0,4,6,66.7,1,1,100.0,2,2,4,0,1,0,0,0,0,2
../kbl_data/2022-2023,S41G01N154,고양 캐롯,Home,한호빈,0,0,0,0.0,0,0,0.0,0,0,0.0,0,0,0.0,0,0,0,1,0,0,0,0,0,0
../kbl_data/2022-2023,S41G01N154,고양 캐롯,Home,전성현,3,0,7,0.0,1,7,14.3,1,14,7.1,0,0,0.0,2,2,4,5,2,0,0,0,1,1
../kbl_data/2022-2023,S41G01N154,고양 캐롯,Home,이종현,2,1,1,100.0,0,1,0.0,1,2,50.0,0,0,0.0,1,2,3,1,0,3,0,0,1,2
../kbl_data/2022-2023,S41G01N154,고양 캐롯,Home,김진유,9,0,0,0.0,3,5,60.0,3,5,60.0,0,0,0.0,2,0,2,3,2,1,0,0,0,4
../kbl_data/2022-2023,S41G01N154,고양 캐롯,Home,조한진,0,0,0,0.0,0,0,0.0,0,0,0.0,0,0,0.0,0,0,0,0,0,0,0,0,0,0
../kbl_data/2022-2023,S41G01N154,고양 캐롯,Home,김세창,0,0,0,0.0,0,0,0.0,0,0,0.0,0,0,0.0,0,0,0,0,0,0,0,0,0,0
../kbl_data/2022-2023,S41G01N154,고양 캐롯,Home,디드릭 로슨,40,14,20,70.0,2,6,33.3,16,26,61.5,6,6,100.0,4,5,9,7,2,3,0,1,1,1
../kbl_data/2022-2023,S41G01N154,고양 캐롯,Home,이정현,3,0,4,0.0,1,8,12.5,1,12,8.3,0,0,0.0,2,3,5,7,2,0,1,0,0,3
../kbl_data/2022-2023,S41G01N154,고양 캐롯,Home,안정욱,0,0,0,0.0,0,0,0.0,0,0,0.0,0,0,0.0,0,0,0,0,0,0,0,0,0,0
../kbl_data/2022-2023,S41G01N154,고양 캐롯,Home,조나단 알렛지,5,1,3,33.3,1,1,100.0,2,4,50.0,0,0,0.0,0,1,1,0,0,0,0,0,0,0
../kbl_data/2022-2023,S41G01N154,원주 DB,Away,윤호영,0,0,2,0.0,0,0,0.0,0,2,0.0,0,0,0.0,0,0,0,1,0,0,0,0,3,4
../kbl_data/2022-2023,S41G01N154,원주 DB,Away,박찬희,0,0,0,0.0,0,0,0.0,0,0,0.0,0,0,0.0,0,0,0,0,0,0,0,0,0,0
../kbl_data/2022-2023,S41G01N154,원주 DB,Away,최승욱,9,4,7,57.1,0,1,0.0,4,8,50.0,1,2,50.0,0,2,2,3,0,2,0,0,1,1
../kbl_data/2022-2023,S41G01N154,원주 DB,Away,강상재,21,6,13,46.2,2,6,33.3,8,19,42.1,3,3,100.0,1,6,7,4,0,0,0,0,3,0
../kbl_data/2022-2023,S41G01N154,원주 DB,Away,윤성원,0,0,0,0.0,0,0,0.0,0,0,0.0,0,0,0.0,0,0,0,0,0,0,0,0,0,0
../kbl_data/2022-2023,S41G01N154,원주 DB,Away,원종훈,0,0,0,0.0,0,1,0.0,0,1,0.0,0,0,0.0,0,1,1,1,0,0,0,0,0,0
../kbl_data/2022-2023,S41G01N154,원주 DB,Away,이준희,0,0,0,0.0,0,0,0.0,0,0,0.0,0,0,0.0,0,0,0,0,0,0,0,0,0,0
../kbl_data/2022-2023,S41G01N154,원주 DB,Away,레나드 프리먼,13,5,8,62.5,0,0,0.0,5,8,62.5,3,4,75.0,7,7,14,2,1,0,0,0,1,3
../kbl_data/2022-2023,S41G01N154,원주 DB,Away,정호영,8,4,6,66.7,0,1,0.0,4,7,57.1,0,0,0.0,1,2,3,2,1,0,0,1,3,0
../kbl_data/2022-2023,S41G01N154,원주 DB,Away,이선 알바노,13,4,5,80.0,1,4,25.0,5,9,55.6,2,2,100.0,0,3,3,3,0,0,0,0,2,2
../kbl_data/2022-2023,S41G01N154,원주 DB,Away,드완 에르난데스,6,3,3,100.0,0,0,0.0,3,3,100.0,0,0,0.0,1,3,4,0,1,1,0,1,2,1
../kbl_data/2022-2023,S41G01N154,원주 DB,Away,박인웅,2,1,3,33.3,0,2,0.0,1,5,20.0,0,0,0.0,1,3,4,1,0,0,0,0,0,3
../kbl_data/2022-2023,S41G01N155,서울 삼성,Home,이정현,13,1,4,25.0,2,6,33.3,3,10,30.0,5,6,83.3,1,3,4,4,0,0,0,0,3,4
../kbl_data/2022-2023,S41G01N155,서울 삼성,Home,장민국,0,0,1,0.0,0,3,0.0,0,4,0.0,0,0,0.0,2,2,4,1,1,0,0,0,0,2
../kbl_data/2022-2023,S41G01N155,서울 삼성,Home,김시래,7,2,4,50.0,1,1,100.0,3,5,60.0,0,2,0.0,1,1,2,0,2,0,0,0,1,1
../kbl_data/2022-2023,S41G01N155,서울 삼성,Home,이동엽,2,1,3,33.3,0,1,0.0,1,4,25.0,0,0,0.0,0,1,1,2,0,0,0,0,1,1
../kbl_data/2022-2023,S41G01N155,서울 삼성,Home,이호현,8,4,4,100.0,0,1,0.0,4,5,80.0,0,0,0.0,2,2,4,2,0,0,0,0,0,0
../kbl_data/2022-2023,S41G01N155,서울 삼성,Home,최승욱,2,0,1,0.0,0,1,0.0,0,2,0.0,2,2,100.0,2,1,3,2,2,0,1,0,0,4
../kbl_data/2022-2023,S41G01N155,서울 삼성,Home,김진영,2,1,2,50.0,0,0,0.0,1,2,50.0,0,0,0.0,0,1,1,0,0,0,1,0,0,0
../kbl_data/2022-2023,S41G01N155,서울 삼성,Home,김무성,0,0,0,0.0,0,0,0.0,0,0,0.0,0,0,0.0,0,0,0,0,0,0,0,0,0,0
../kbl_data/2022-2023,S41G01N155,서울 삼성,Home,이원석,2,1,3,33.3,0,0,0.0,1,3,33.3,0,0,0.0,1,3,4,0,0,1,0,0,2,4
../kbl_data/2022-2023,S41G01N155,서울 삼성,Home,신동혁,0,0,2,0.0,0,0,0.0,0,2,0.0,0,0,0.0,0,0,0,0,0,0,0,0,0,1
../kbl_data/2022-2023,S41G01N155,서울 삼성,Home,다랄 윌리스,24,7,19,36.8,2,4,50.0,9,23,39.1,4,4,100.0,4,5,9,1,1,0,0,0,3,3
../kbl_data/2022-2023,S41G01N155,서울 삼성,Home,앤서니 모스,6,3,6,50.0,0,0,0.0,3,6,50.0,0,0,0.0,1,2,3,0,1,0,0,0,0,3
../kbl_data/2022-2023,S41G01N155,수원 KT,Away,김동욱,9,0,1,0.0,3,5,60.0,3,6,50.0,0,0,0.0,0,2,2,4,0,0,0,0,1,0
../kbl_data/2022-2023,S41G01N155,수원 KT,Away,김영환,4,2,2,100.0,0,0,0.0,2,2,100.0,0,1,0.0,0,0,0,1,0,0,0,0,1,2
../kbl_data/2022-2023,S41G01N155,수원 KT,Away,한희원,6,1,3,33.3,1,5,20.0,2,8,25.0,1,2,50.0,3,3,6,2,0,0,0,0,1,5
../kbl_data/2022-2023,S41G01N155,수원 KT,Away,정성우,10,2,3,66.7,1,5,20.0,3,8,37.5,3,5,60.0,2,2,4,2,2,0,0,0,2,2
../kbl_data/2022-2023,S41G01N155,수원 KT,Away,최성모,4,0,0,0.0,0,1,0.0,0,1,0.0,4,5,80.0,1,0,1,1,2,0,0,0,2,0
../kbl_data/2022-2023,S41G01N155,수원 KT,Away,양홍석,13,3,7,42.9,1,4,25.0,4,11,36.4,4,5,80.0,1,5,6,4,1,0,0,0,0,4
../kbl_data/2022-2023,S41G01N155,수원 KT,Away,박지원,0,0,0,0.0,0,0,0.0,0,0,0.0,0,0,0.0,0,0,0,0,0,0,0,0,0,0
../kbl_data/2022-2023,S41G01N155,수원 KT,Away,하윤기,5,2,3,66.7,0,0,0.0,2,3,66.7,1,2,50.0,2,2,4,1,0,0,0,0,2,3
../kbl_data/2022-2023,S41G01N155,수원 KT,Away,이두원,0,0,0,0.0,0,0,0.0,0,0,0.0,0,0,0.0,0,2,2,0,0,0,0,0,2,0
../kbl_data/2022-2023,S41G01N155,수원 KT,Away,레스터 프로스퍼,6,3,3,100.0,0,1,0.0,3,4,75.0,0,2,0.0,5,5,10,0,1,1,0,0,2,2
../kbl_data/2022-2023,S41G01N155,수원 KT,Away,재로드 존스,15,5,13,38.5,1,3,33.3,6,16,37.5,2,2,100.0,3,2,5,2,0,1,1,0,1,1
../kbl_data/2022-2023,S41G01N155,수원 KT,Away,데이브 일데폰소,5,1,3,33.3,1,1,100.0,2,4,50.0,0,0,0.0,1,3,4,0,0,0,0,0,0,1
../kbl_data/2022-2023,S41G01N156,창원 LG,Home,이관희,12,2,3,66.7,2,9,22.2,4,12,33.3,2,2,100.0,0,0,0,0,2,0,0,0,0,3
../kbl_data/2022-2023,S41G01N156,창원 LG,Home,정희재,2,1,1,100.0,0,1,0.0,1,2,50.0,0,0,0.0,1,0,1,2,0,0,0,0,0,4
../kbl_data/2022-2023,S41G01N156,창원 LG,Home,서민수,0,0,0,0.0,0,0,0.0,0,0,0.0,0,0,0.0,0,0,0,1,0,0,0,0,1,2
../kbl_data/2022-2023,S41G01N156,창원 LG,Home,한상혁,2,1,2,50.0,0,0,0.0,1,2,50.0,0,0,0.0,0,0,0,0,0,0,0,0,0,0
../kbl_data/2022-2023,S41G01N156,창원 LG,Home,이재도,18,6,10,60.0,1,6,16.7,7,16,43.8,3,4,75.0,1,4,5,6,0,0,0,0,2,0
../kbl_data/2022-2023,S41G01N156,창원 LG,Home,김준일,4,2,4,50.0,0,0,0.0,2,4,50.0,0,0,0.0,2,2,4,5,0,1,0,0,2,4
../kbl_data/2022-2023,S41G01N156,창원 LG,Home,정인덕,0,0,0,0.0,0,1,0.0,0,1,0.0,0,0,0.0,0,2,2,1,0,0,0,0,0,2
../kbl_data/2022-2023,S41G01N156,창원 LG,Home,윤원상,12,1,2,50.0,3,5,60.0,4,7,57.1,1,2,50.0,1,0,1,2,0,0,1,0,0,2
../kbl_data/2022-2023,S41G01N156,창원 LG,Home,아셈 마레이,4,1,5,20.0,0,0,0.0,1,5,20.0,2,3,66.7,2,10,12,1,0,0,0,0,3,2
../kbl_data/2022-2023,S41G01N156,창원 LG,Home,이승우,0,0,0,0.0,0,2,0.0,0,2,0.0,0,0,0.0,0,1,1,0,0,0,0,0,1,0
../kbl_data/2022-2023,S41G01N156,창원 LG,Home,저스틴 구탕,5,2,7,28.6,0,2,0.0,2,9,22.2,1,2,50.0,0,2,2,3,2,0,0,0,1,1
../kbl_data/2022-2023,S41G01N156,창원 LG,Home,단테 커닝햄,10,4,5,80.0,0,1,0.0,4,6,66.7,2,2,100.0,0,7,7,0,0,1,0,0,0,1
../kbl_data/2022-2023,S41G01N156,대구 한국가스공사,Away,차바위,2,1,1,100.0,0,3,0.0,1,4,25.0,0,0,0.0,1,2,3,1,0,0,0,0,0,3
../kbl_data/2022-2023,S41G01N156,대구 한국가스공사,Away,박지훈,0,0,1,0.0,0,0,0.0,0,1,0.0,0,0,0.0,0,0,0,1,1,0,0,0,0,1
../kbl_data/2022-2023,S41G01N156,대구 한국가스공사,Away,조상열,0,0,0,0.0,0,0,0.0,0,0,0.0,0,0,0.0,0,0,0,0,0,0,0,0,0,2
../kbl_data/2022-2023,S41G01N156,대구 한국가스공사,Away,이대헌,11,4,8,50.0,1,2,50.0,5,10,50.0,0,0,0.0,1,4,5,5,0,0,0,0,1,1
../kbl_data/2022-2023,S41G01N156,대구 한국가스공사,Away,이대성,10,3,7,42.9,1,3,33.3,4,10,40.0,1,2,50.0,1,3,4,2,1,0,0,0,1,2
../kbl_data/2022-2023,S41G01N156,대구 한국가스공사,Away,정효근,3,0,4,0.0,0,4,0.0,0,8,0.0,3,6,50.0,1,2,3,0,1,0,0,0,3,2
../kbl_data/2022-2023,S41G01N156,대구 한국가스공사,Away,머피 할로웨이,12,5,8,62.5,0,0,0.0,5,8,62.5,2,4,50.0,1,7,8,1,2,1,0,1,0,0
../kbl_data/2022-2023,S41G01N156,대구 한국가스공사,Away,우동현,2,1,1,100.0,0,0,0.0,1,1,100.0,0,0,0.0,0,1,1,2,0,0,0,0,0,2
../kbl_data/2022-2023,S41G01N156,대구 한국가스공사,Away,전현우,7,2,3,66.7,1,8,12.5,3,11,27.3,0,0,0.0,0,1,1,0,1,0,0,0,0,4
../kbl_data/2022-2023,S41G01N156,대구 한국가스공사,Away,데본 스캇,9,4,7,57.1,0,2,0.0,4,9,44.4,1,2,50.0,3,8,11,1,1,0,0,0,1,2
../kbl_data/2022-2023,S41G01N156,대구 한국가스공사,Away,신승민,0,0,0,0.0,0,0,0.0,0,0,0.0,0,0,0.0,0,0,0,0,0,0,0,0,0,0
../kbl_data/2022-2023,S41G01N156,대구 한국가스공사,Away,샘조세프 벨란겔,8,3,4,75.0,0,2,0.0,3,6,50.0,2,4,50.0,1,1,2,2,0,0,1,0,2,1
../kbl_data/2022-2023,S41G01N157,울산 현대모비스,Home,함지훈,14,6,6,100.0,0,1,0.0,6,7,85.7,2,2,100.0,2,4,6,3,1,0,0,0,1,0
../kbl_data/2022-2023,S41G01N157,울산 현대모비스,Home,김현민,0,0,0,0.0,0,0,0.0,0,0,0.0,0,0,0.0,0,0,0,0,0,0,0,0,0,0
../kbl_data/2022-2023,S41G01N157,울산 현대모비스,Home,장재석,4,1,4,25.0,0,0,0.0,1,4,25.0,2,2,100.0,1,2,3,0,1,1,0,0,2,2
../kbl_data/2022-2023,S41G01N157,울산 현대모비스,Home,김영현,8,1,1,100.0,2,5,40.0,3,6,50.0,0,0,0.0,0,0,0,0,1,0,0,0,0,3
../kbl_data/2022-2023,S41G01N157,울산 현대모비스,Home,김지후,0,0,2,0.0,0,0,0.0,0,2,0.0,0,0,0.0,1,0,1,0,0,0,0,0,0,0
../kbl_data/2022-2023,S41G01N157,울산 현대모비스,Home,서명진,2,1,3,33.3,0,0,0.0,1,3,33.3,0,0,0.0,0,2,2,3,0,0,0,0,4,3
../kbl_data/2022-2023,S41G01N157,울산 현대모비스,Home,헨리 심스,2,1,2,50.0,0,0,0.0,1,2,50.0,0,0,0.0,0,2,2,0,0,0,0,0,0,1
../kbl_data/2022-2023,S41G01N157,울산 현대모비스,Home,이우석,9,2,10,20.0,1,4,25.0,3,14,21.4,2,2,100.0,1,6,7,3,1,0,0,0,2,3
../kbl_data/2022-2023,S41G01N157,울산 현대모비스,Home,신민석,2,1,1,100.0,0,0,0.0,1,1,100.0,0,0,0.0,0,1,1,0,0,0,0,0,0,0
../kbl_data/2022-2023,S41G01N157,울산 현대모비스,Home,론제이 아바리엔토스,4,1,2,50.0,0,5,0.0,1,7,14.3,2,2,100.0,1,5,6,7,0,0,0,0,1,1
../kbl_data/2022-2023,S41G01N157,울산 현대모비스,Home,게이지 프림,19,8,14,57.1,0,1,0.0,8,15,53.3,3,4,75.0,3,17,20,2,1,1,0,2,5,2
../kbl_data/2022-2023,S41G01N157,울산 현대모비스,Home,김태완,2,1,2,50.0,0,1,0.0,1,3,33.3,0,0,0.0,0,0,0,0,0,0,0,0,0,0
../kbl_data/2022-2023,S41G01N157,전주 KCC,Away,정창영,2,1,1,100.0,0,2,0.0,1,3,33.3,0,0,0.0,0,2,2,0,0,0,0,0,2,0
../kbl_data/2022-2023,S41G01N157,전주 KCC,Away,라건아,14,6,8,75.0,0,3,0.0,6,11,54.5,2,2,100.0,3,9,12,1,1,0,0,0,2,3
../kbl_data/2022-2023,S41G01N157,전주 KCC,Away,박경상,0,0,0,0.0,0,0,0.0,0,0,0.0,0,0,0.0,0,0,0,1,0,0,0,0,0,0
../kbl_data/2022-2023,S41G01N157,전주 KCC,Away,김지완,0,0,2,0.0,0,3,0.0,0,5,0.0,0,0,0.0,0,1,1,1,0,0,0,0,0,2
../kbl_data/2022-2023,S41G01N157,전주 KCC,Away,김상규,0,0,0,0.0,0,0,0.0,0,0,0.0,0,0,0.0,0,1,1,1,0,0,0,0,0,2
../kbl_data/2022-2023,S41G01N157,전주 KCC,Away,전준범,8,1,2,50.0,2,4,50.0,3,6,50.0,0,0,0.0,1,1,2,0,1,0,1,0,0,1
../kbl_data/2022-2023,S41G01N157,전주 KCC,Away,허웅,9,2,8,25.0,0,4,0.0,2,12,16.7,5,6,83.3,0,1,1,3,1,0,0,0,1,1
../kbl_data/2022-2023,S41G01N157,전주 KCC,Away,이승현,2,1,10,10.0,0,3,0.0,1,13,7.7,0,0,0.0,2,7,9,1,0,0,0,0,0,2
../kbl_data/2022-2023,S41G01N157,전주 KCC,Away,이진욱,11,4,5,80.0,1,1,100.0,5,6,83.3,0,0,0.0,1,0,1,1,1,0,1,0,0,3
../kbl_data/2022-2023,S41G01N157,전주 KCC,Away,이근휘,3,0,1,0.0,1,1,100.0,1,2,50.0,0,0,0.0,0,0,0,0,1,0,0,0,0,0
../kbl_data/2022-2023,S41G01N157,전주 KCC,Away,론데 홀리스 제퍼슨,13,5,15,33.3,1,3,33.3,6,18,33.3,0,1,0.0,4,3,7,0,1,0,0,0,0,0
../kbl_data/2022-2023,S41G01N157,전주 KCC,Away,칼빈 제프리 에피스톨라,2,1,2,50.0,0,0,0.0,1,2,50.0,0,0,0.0,1,0,1,2,0,0,0,0,0,1
../kbl_data/2022-2023,S41G01N158,수원 KT,Home,김동욱,0,0,0,0.0,0,0,0.0,0,0,0.0,0,0,0.0,0,0,0,0,0,0,0,0,0,0
../kbl_data/2022-2023,S41G01N158,수원 KT,Home,김영환,3,0,0,0.0,1,2,50.0,1,2,50.0,0,0,0.0,0,0,0,1,0,0,0,0,0,2
../kbl_data/2022-2023,S41G01N158,수원 KT,Home,한희원,4,2,3,66.7,0,0,0.0,2,3,66.7,0,0,0.0,0,0,0,3,1,0,0,0,1,3
../kbl_data/2022-2023,S41G01N158,수원 KT,Home,최창진,0,0,0,0.0,0,0,0.0,0,0,0.0,0,0,0.0,0,0,0,0,0,0,0,0,0,0
../kbl_data/2022-2023,S41G01N158,수원 KT,Home,최성모,9,0,3,0.0,3,4,75.0,3,7,42.9,0,0,0.0,3,3,6,5,1,0,0,0,1,3
../kbl_data/2022-2023,S41G01N158,수원 KT,Home,양홍석,3,0,0,0.0,1,6,16.7,1,6,16.7,0,0,0.0,0,0,0,0,0,1,0,0,2,2
../kbl_data/2022-2023,S41G01N158,수원 KT,Home,박지원,0,0,0,0.0,0,0,0.0,0,0,0.0,0,0,0.0,0,0,0,0,0,1,0,0,0,3
../kbl_data/2022-2023,S41G01N158,수원 KT,Home,하윤기,20,10,19,52.6,0,0,0.0,10,19,52.6,0,0,0.0,4,9,13,5,1,0,0,4,4,1
../kbl_data/2022-2023,S41G01N158,수원 KT,Home,이두원,0,0,0,0.0,0,0,0.0,0,0,0.0,0,0,0.0,0,0,0,0,0,0,0,0,0,0
../kbl_data/2022-2023,S41G01N158,수원 KT,Home,레스터 프로스퍼,3,0,2,0.0,1,2,50.0,1,4,25.0,0,0,0.0,0,4,4,0,0,0,0,0,1,0
../kbl_data/2022-2023,S41G01N158,수원 KT,Home,재로드 존스,26,7,13,53.8,2,7,28.6,9,20,45.0,6,8,75.0,2,12,14,3,2,2,0,1,5,2
../kbl_data/2022-2023,S41G01N158,수원 KT,Home,데이브 일데폰소,5,2,3,66.7,0,1,0.0,2,4,50.0,1,2,50.0,1,1,2,0,0,0,0,0,3,4
../kbl_data/2022-2023,S41G01N158,서울 SK,Away,양우섭,0,0,0,0.0,0,0,0.0,0,0,0.0,0,0,0.0,0,0,0,0,0,0,0,0,0,0
../kbl_data/2022-2023,S41G01N158,서울 SK,Away,허일영,11,3,4,75.0,1,5,20.0,4,9,44.4,2,3,66.7,1,2,3,1,2,0,0,0,0,1
../kbl_data/2022-2023,S41G01N158,서울 SK,Away,김선형,16,6,11,54.5,0,4,0.0,6,15,40.0,4,4,100.0,3,2,5,6,2,0,0,1,2,1
../kbl_data/2022-2023,S41G01N158,서울 SK,Away,홍경기,0,0,0,0.0,0,0,0.0,0,0,0.0,0,0,0.0,0,0,0,0,0,0,0,0,0,0
../kbl_data/2022-2023,S41G01N158,서울 SK,Away,최부경,10,3,5,60.0,0,0,0.0,3,5,60.0,4,6,66.7,2,3,5,2,0,0,0,0,0,4
../kbl_data/2022-2023,S41G01N158,서울 SK,Away,리온 윌리엄스,0,0,3,0.0,0,0,0.0,0,3,0.0,0,0,0.0,1,0,1,0,1,0,0,0,0,0
../kbl_data/2022-2023,S41G01N158,서울 SK,Away,최원혁,0,0,0,0.0,0,0,0.0,0,0,0.0,0,0,0.0,0,0,0,0,0,0,0,0,0,0
../kbl_data/2022-2023,S41G01N158,서울 SK,Away,최준용,6,0,4,0.0,1,5,20.0,1,9,11.1,3,4,75.0,1,3,4,5,1,1,0,0,3,4
../kbl_data/2022-2023,S41G01N158,서울 SK,Away,최성원,3,0,1,0.0,1,4,25.0,1,5,20.0,0,0,0.0,0,2,2,2,0,0,0,0,2,3
../kbl_data/2022-2023,S41G01N158,서울 SK,Away,자밀 워니,23,11,21,52.4,0,1,0.0,11,22,50.0,1,1,100.0,4,12,16,5,5,0,0,0,2,1
../kbl_data/2022-2023,S41G01N158,서울 SK,Away,김형빈,0,0,0,0.0,0,0,0.0,0,0,0.0,0,0,0.0,0,0,0,0,0,0,0,0,0,0
../kbl_data/2022-2023,S41G01N158,서울 SK,Away,오재현,7,2,3,66.7,1,1,100.0,3,4,75.0,0,2,0.0,1,1,2,0,3,0,0,0,0,1
../kbl_data/2022-2023,S41G01N159,고양 캐롯,Home,김강선,11,1,3,33.3,3,9,33.3,4,12,33.3,0,0,0.0,2,2,4,1,1,0,0,0,0,5
../kbl_data/2022-2023,S41G01N159,고양 캐롯,Home,최현민,0,0,1,0.0,0,3,0.0,0,4,0.0,0,0,0.0,1,1,2,1,0,0,0,0,0,3
../kbl_data/2022-2023,S41G01N159,고양 캐롯,Home,임종일,0,0,0,0.0,0,0,0.0,0,0,0.0,0,0,0.0,0,0,0,0,0,0,0,0,0,0
../kbl_data/2022-2023,S41G01N159,고양 캐롯,Home,전성현,23,2,6,33.3,5,14,35.7,7,20,35.0,4,5,80.0,3,4,7,4,0,1,0,0,2,0
../kbl_data/2022-2023,S41G01N159,고양 캐롯,Home,이종현,0,0,0,0.0,0,0,0.0,0,0,0.0,0,0,0.0,0,0,0,0,0,0,0,0,0,0
../kbl_data/2022-2023,S41G01N159,고양 캐롯,Home,김진유,12,3,4,75.0,2,5,40.0,5,9,55.6,0,0,0.0,4,13,17,0,0,1,0,0,0,2
../kbl_data/2022-2023,S41G01N159,고양 캐롯,Home,조한진,3,0,0,0.0,1,1,100.0,1,1,100.0,0,0,0.0,1,1,2,0,0,1,0,0,0,0
../kbl_data/2022-2023,S41G01N159,고양 캐롯,Home,김세창,0,0,0,0.0,0,0,0.0,0,0,0.0,0,0,0.0,0,0,0,0,0,0,0,0,0,0
../kbl_data/2022-2023,S41G01N159,고양 캐롯,Home,디드릭 로슨,23,4,7,57.1,3,6,50.0,7,13,53.8,6,6,100.0,5,3,8,3,3,0,0,1,2,1
../kbl_data/2022-2023,S41G01N159,고양 캐롯,Home,이정현,5,0,5,0.0,1,5,20.0,1,10,10.0,2,2,100.0,0,2,2,5,1,0,1,0,1,2
../kbl_data/2022-2023,S41G01N159,고양 캐롯,Home,안정욱,0,0,0,0.0,0,0,0.0,0,0,0.0,0,0,0.0,0,0,0,0,0,0,0,0,0,0
../kbl_data/2022-2023,S41G01N159,고양 캐롯,Home,조나단 알렛지,8,1,4,25.0,2,3,66.7,3,7,42.9,0,0,0.0,1,0,1,0,1,0,0,0,0,2
../kbl_data/2022-2023,S41G01N159,안양 KGC,Away,양희종,5,1,2,50.0,1,2,50.0,2,4,50.0,0,0,0.0,0,2,2,2,0,1,0,0,0,4
../kbl_data/2022-2023,S41G01N159,안양 KGC,Away,함준후,0,0,0,0.0,0,0,0.0,0,0,0.0,0,0,0.0,0,0,0,0,0,0,0,0,0,0
../kbl_data/2022-2023,S41G01N159,안양 KGC,Away,오세근,8,4,5,80.0,0,2,0.0,4,7,57.1,0,2,0.0,1,4,5,1,0,0,0,0,0,0
../kbl_data/2022-2023,S41G01N159,안양 KGC,Away,정준원,2,1,1,100.0,0,1,0.0,1,2,50.0,0,0,0.0,0,2,2,0,0,1,0,0,1,0
../kbl_data/2022-2023,S41G01N159,안양 KGC,Away,배병준,3,0,1,0.0,1,2,50.0,1,3,33.3,0,0,0.0,0,2,2,1,0,0,0,0,0,1
../kbl_data/2022-2023,S41G01N159,안양 KGC,Away,문성곤,5,1,2,50.0,1,6,16.7,2,8,25.0,0,0,0.0,1,1,2,2,0,1,0,0,1,2
../kbl_data/2022-2023,S41G01N159,안양 KGC,Away,박지훈,6,3,5,60.0,0,1,0.0,3,6,50.0,0,0,0.0,0,3,3,2,1,0,0,0,1,3
../kbl_data/2022-2023,S41G01N159,안양 KGC,Away,이우정,3,0,0,0.0,1,1,100.0,1,1,100.0,0,0,0.0,0,0,0,1,0,0,0,0,0,1
../kbl_data/2022-2023,S41G01N159,안양 KGC,Away,대릴 먼로,7,2,3,66.7,1,2,50.0,3,5,60.0,0,0,0.0,0,0,0,0,0,0,0,0,2,1
../kbl_data/2022-2023,S41G01N159,안양 KGC,Away,변준형,13,5,8,62.5,1,4,25.0,6,12,50.0,0,0,0.0,1,5,6,7,2,0,0,0,2,2
../kbl_data/2022-2023,S41G01N159,안양 KGC,Away,한승희,2,1,1,100.0,0,0,0.0,1,1,100.0,0,0,0.0,0,0,0,0,0,0,0,0,0,0
../kbl_data/2022-2023,S41G01N159,안양 KGC,Away,오마리 스펠맨,11,3,7,42.9,1,5,20.0,4,12,33.3,2,6,33.3,3,9,12,2,0,0,0,2,3,2
../kbl_data/2022-2023,S41G01N160,서울 삼성,Home,이정현,14,4,7,57.1,1,6,16.7,5,13,38.5,3,4,75.0,0,1,1,6,2,1,0,0,3,3
../kbl_data/2022-2023,S41G01N160,서울 삼성,Home,장민국,2,1,2,50.0,0,1,0.0,1,3,33.3,0,0,0.0,1,0,1,0,0,0,0,0,0,2
../kbl_data/2022-2023,S41G01N160,서울 삼성,Home,김시래,0,0,1,0.0,0,1,0.0,0,2,0.0,0,0,0.0,0,0,0,0,1,0,0,0,0,1
../kbl_data/2022-2023,S41G01N160,서울 삼성,Home,이동엽,11,2,4,50.0,1,1,100.0,3,5,60.0,4,4,100.0,3,2,5,5,3,0,0,0,2,3
../kbl_data/2022-2023,S41G01N160,서울 삼성,Home,이호현,6,2,3,66.7,0,2,0.0,2,5,40.0,2,2,100.0,0,5,5,5,0,0,0,0,0,0
../kbl_data/2022-2023,S41G01N160,서울 삼성,Home,최승욱,18,6,12,50.0,2,6,33.3,8,18,44.4,0,0,0.0,4,2,6,2,0,0,0,0,0,0
../kbl_data/2022-2023,S41G01N160,서울 삼성,Home,김진영,0,0,0,0.0,0,0,0.0,0,0,0.0,0,0,0.0,0,0,0,0,0,0,0,0,0,0
../kbl_data/2022-2023,S41G01N160,서울 삼성,Home,김무성,0,0,0,0.0,0,0,0.0,0,0,0.0,0,0,0.0,0,0,0,0,0,0,0,0,0,0
../kbl_data/2022-2023,S41G01N160,서울 삼성,Home,이원석,17,6,10,60.0,0,0,0.0,6,10,60.0,5,7,71.4,5,4,9,0,1,0,2,0,0,4
../kbl_data/2022-2023,S41G01N160,서울 삼성,Home,신동혁,0,0,3,0.0,0,0,0.0,0,3,0.0,0,0,0.0,0,1,1,1,0,0,0,0,0,0
../kbl_data/2022-2023,S41G01N160,서울 삼성,Home,다랄 윌리스,26,10,18,55.6,2,4,50.0,12,22,54.5,0,0,0.0,0,6,6,0,3,0,0,2,3,4
../kbl_data/2022-2023,S41G01N160,서울 삼성,Home,앤서니 모스,6,3,7,42.9,0,0,0.0,3,7,42.9,0,0,0.0,2,0,2,1,2,2,0,0,1,1
../kbl_data/2022-2023,S41G01N160,원주 DB,Away,윤호영,0,0,0,0.0,0,0,0.0,0,0,0.0,0,0,0.0,0,0,0,0,0,0,0,0,0,0
../kbl_data/2022-2023,S41G01N160,원주 DB,Away,최승욱,18,6,12,50.0,2,6,33.3,8,18,44.4,0,0,0.0,4,2,6,2,0,0,0,0,0,0
../kbl_data/2022-2023,S41G01N160,원주 DB,Away,강상재,22,6,9,66.7,3,4,75.0,9,13,69.2,1,2,50.0,0,4,4,6,0,0,0,0,2,3
../kbl_data/2022-2023,S41G01N160,원주 DB,Away,윤성원,0,0,0,0.0,0,0,0.0,0,0,0.0,0,0,0.0,0,0,0,0,0,1,0,0,1,2
../kbl_data/2022-2023,S41G01N160,원주 DB,Away,원종훈,2,1,1,100.0,0,0,0.0,1,1,100.0,0,0,0.0,0,0,0,1,1,0,0,0,0,1
../kbl_data/2022-2023,S41G01N160,원주 DB,Away,이준희,2,1,2,50.0,0,0,0.0,1,2,50.0,0,2,0.0,0,2,2,2,1,0,0,0,4,3
../kbl_data/2022-2023,S41G01N160,원주 DB,Away,레나드 프리먼,10,5,5,100.0,0,0,0.0,5,5,100.0,0,3,0.0,1,2,3,1,3,0,0,2,3,2
../kbl_data/2022-2023,S41G01N160,원주 DB,Away,정호영,11,1,3,33.3,3,6,50.0,4,9,44.4,0,0,0.0,1,0,1,2,2,0,0,0,1,1
../kbl_data/2022-2023,S41G01N160,원주 DB,Away,이선 알바노,12,3,7,42.9,1,2,50.0,4,9,44.4,3,3,100.0,0,3,3,2,0,0,0,0,0,4
../kbl_data/2022-2023,S41G01N160,원주 DB,Away,드완 에르난데스,14,2,7,28.6,0,0,0.0,2,7,28.6,10,11,90.9,2,6,8,1,1,1,0,0,4,1
../kbl_data/2022-2023,S41G01N160,원주 DB,Away,박인웅,3,0,0,0.0,1,2,50.0,1,2,50.0,0,0,0.0,0,1,1,1,0,0,0,0,1,3
../kbl_data/2022-2023,S41G01N160,원주 DB,Away,인승찬,0,0,0,0.0,0,0,0.0,0,0,0.0,0,0,0.0,0,0,0,0,0,0,0,0,0,0
../kbl_data/2022-2023,S41G01N161,대구 한국가스공사,Home,차바위,0,0,0,0.0,0,1,0.0,0,1,0.0,0,0,0.0,0,0,0,0,0,0,0,0,0,2
../kbl_data/2022-2023,S41G01N161,대구 한국가스공사,Home,박지훈,0,0,0,0.0,0,0,0.0,0,0,0.0,0,0,0.0,0,0,0,0,0,0,0,0,0,0
../kbl_data/2022-2023,S41G01N161,대구 한국가스공사,Home,조상열,3,0,1,0.0,1,1,100.0,1,2,50.0,0,0,0.0,1,2,3,5,2,1,2,0,1,5
../kbl_data/2022-2023,S41G01N161,대구 한국가스공사,Home,이대헌,16,4,9,44.4,2,3,66.7,6,12,50.0,2,8,25.0,3,2,5,0,1,1,0,0,1,2
../kbl_data/2022-2023,S41G01N161,대구 한국가스공사,Home,이대성,20,6,13,46.2,2,4,50.0,8,17,47.1,2,2,100.0,0,1,1,2,1,0,0,0,3,3
../kbl_data/2022-2023,S41G01N161,대구 한국가스공사,Home,정효근,3,1,6,16.7,0,3,0.0,1,9,11.1,1,2,50.0,0,1,1,2,1,0,0,0,0,4
../kbl_data/2022-2023,S41G01N161,대구 한국가스공사,Home,머피 할로웨이,8,4,7,57.1,0,0,0.0,4,7,57.1,0,1,0.0,2,3,5,0,0,0,0,0,1,2
../kbl_data/2022-2023,S41G01N161,대구 한국가스공사,Home,우동현,0,0,0,0.0,0,0,0.0,0,0,0.0,0,0,0.0,0,0,0,0,0,0,0,0,0,0
../kbl_data/2022-2023,S41G01N161,대구 한국가스공사,Home,전현우,3,0,1,0.0,1,3,33.3,1,4,25.0,0,0,0.0,0,0,0,0,0,0,0,0,0,0
../kbl_data/2022-2023,S41G01N161,대구 한국가스공사,Home,데본 스캇,24,7,8,87.5,2,4,50.0,9,12,75.0,4,4,100.0,3,5,8,3,1,0,0,0,3,2
../kbl_data/2022-2023,S41G01N161,대구 한국가스공사,Home,신승민,0,0,0,0.0,0,0,0.0,0,0,0.0,0,0,0.0,0,0,0,2,0,0,0,0,0,0
../kbl_data/2022-2023,S41G01N161,대구 한국가스공사,Home,샘조세프 벨란겔,9,2,5,40.0,1,2,50.0,3,7,42.9,2,2,100.0,1,0,1,3,1,0,0,0,1,3
../kbl_data/2022-2023,S41G01N161,울산 현대모비스,Away,함지훈,8,4,5,80.0,0,0,0.0,4,5,80.0,0,0,0.0,1,1,2,2,1,0,0,0,2,1
../kbl_data/2022-2023,S41G01N161,울산 현대모비스,Away,김현민,0,0,0,0.0,0,0,0.0,0,0,0.0,0,0,0.0,0,0,0,0,0,0,0,0,0,0
../kbl_data/2022-2023,S41G01N161,울산 현대모비스,Away,최진수,4,2,3,66.7,0,0,0.0,2,3,66.7,0,0,0.0,0,1,1,0,0,0,0,1,0,1
../kbl_data/2022-2023,S41G01N161,울산 현대모비스,Away,장재석,11,4,5,80.0,0,0,0.0,4,5,80.0,3,4,75.0,3,3,6,3,2,1,0,0,3,3
../kbl_data/2022-2023,S41G01N161,울산 현대모비스,Away,김영현,0,0,0,0.0,0,2,0.0,0,2,0.0,0,0,0.0,0,0,0,0,0,0,0,0,0,4
../kbl_data/2022-2023,S41G01N161,울산 현대모비스,Away,서명진,24,4,5,80.0,3,8,37.5,7,13,53.8,7,7,100.0,2,2,4,4,1,0,0,0,3,3
../kbl_data/2022-2023,S41G01N161,울산 현대모비스,Away,헨리 심스,2,1,1,100.0,0,0,0.0,1,1,100.0,0,0,0.0,0,1,1,1,0,0,0,0,2,3
../kbl_data/2022-2023,S41G01N161,울산 현대모비스,Away,이우석,14,4,7,57.1,2,6,33.3,6,13,46.2,0,0,0.0,1,5,6,3,1,0,0,0,4,2
../kbl_data/2022-2023,S41G01N161,울산 현대모비스,Away,신민석,0,0,0,0.0,0,1,0.0,0,1,0.0,0,0,0.0,0,0,0,0,0,0,0,0,0,0
../kbl_data/2022-2023,S41G01N161,울산 현대모비스,Away,론제이 아바리엔토스,17,4,7,57.1,3,5,60.0,7,12,58.3,0,2,0.0,1,2,3,4,2,1,0,0,0,1
../kbl_data/2022-2023,S41G01N161,울산 현대모비스,Away,게이지 프림,13,5,9,55.6,0,0,0.0,5,9,55.6,3,5,60.0,4,10,14,4,1,1,0,0,0,1
../kbl_data/2022-2023,S41G01N161,울산 현대모비스,Away,김태완,0,0,0,0.0,0,0,0.0,0,0,0.0,0,0,0.0,0,1,1,0,0,0,0,0,0,0
../kbl_data/2022-2023,S41G01N162,창원 LG,Home,이관희,17,3,4,75.0,3,5,60.0,6,9,66.7,2,4,50.0,0,2,2,5,2,0,0,0,0,0
../kbl_data/2022-2023,S41G01N162,창원 LG,Home,정희재,8,0,0,0.0,2,5,40.0,2,5,40.0,2,4,50.0,1,2,3,0,0,0,0,0,0,3
../kbl_data/2022-2023,S41G01N162,창원 LG,Home,임동섭,3,0,1,0.0,1,4,25.0,1,5,20.0,0,0,0.0,3,1,4,2,0,0,0,0,0,3
../kbl_data/2022-2023,S41G01N162,창원 LG,Home,서민수,0,0,0,0.0,0,0,0.0,0,0,0.0,0,0,0.0,0,0,0,0,0,0,0,0,0,0
../kbl_data/2022-2023,S41G01N162,창원 LG,Home,한상혁,0,0,0,0.0,0,0,0.0,0,0,0.0,0,0,0.0,0,0,0,2,0,0,0,0,1,1
../kbl_data/2022-2023,S41G01N162,창원 LG,Home,이재도,11,1,4,25.0,2,2,100.0,3,6,50.0,3,4,75.0,0,6,6,6,1,1,0,0,0,1
../kbl_data/2022-2023,S41G01N162,창원 LG,Home,김준일,10,5,8,62.5,0,0,0.0,5,8,62.5,0,0,0.0,2,3,5,3,0,0,0,0,0,1
../kbl_data/2022-2023,S41G01N162,창원 LG,Home,윤원상,11,1,2,50.0,3,6,50.0,4,8,50.0,0,0,0.0,0,0,0,1,0,0,0,0,0,1
../kbl_data/2022-2023,S41G01N162,창원 LG,Home,아셈 마레이,19,9,12,75.0,0,0,0.0,9,12,75.0,1,5,20.0,3,4,7,2,0,0,0,2,3,3
../kbl_data/2022-2023,S41G01N162,창원 LG,Home,저스틴 구탕,0,0,1,0.0,0,0,0.0,0,1,0.0,0,0,0.0,0,1,1,2,0,0,0,0,1,2
../kbl_data/2022-2023,S41G01N162,창원 LG,Home,양준석,0,0,0,0.0,0,1,0.0,0,1,0.0,0,0,0.0,0,0,0,0,0,0,0,0,0,2
../kbl_data/2022-2023,S41G01N162,창원 LG,Home,단테 커닝햄,14,7,13,53.8,0,0,0.0,7,13,53.8,0,0,0.0,2,9,11,1,1,2,0,2,2,1
../kbl_data/2022-2023,S41G01N162,전주 KCC,Away,정창영,2,1,2,50.0,0,3,0.0,1,5,20.0,0,0,0.0,1,2,3,3,0,0,0,0,1,3
../kbl_data/2022-2023,S41G01N162,전주 KCC,Away,라건아,12,3,4,75.0,2,3,66.7,5,7,71.4,0,0,0.0,1,5,6,1,0,0,0,0,0,1
../kbl_data/2022-2023,S41G01N162,전주 KCC,Away,박경상,0,0,0,0.0,0,1,0.0,0,1,0.0,0,0,0.0,0,1,1,0,0,0,0,0,0,2
../kbl_data/2022-2023,S41G01N162,전주 KCC,Away,김지완,4,2,3,66.7,0,1,0.0,2,4,50.0,0,1,0.0,1,0,1,0,0,2,0,0,1,1
../kbl_data/2022-2023,S41G01N162,전주 KCC,Away,김상규,7,2,2,100.0,1,1,100.0,3,3,100.0,0,0,0.0,0,0,0,0,0,0,0,0,1,1
../kbl_data/2022-2023,S41G01N162,전주 KCC,Away,전준범,7,2,3,66.7,1,3,33.3,3,6,50.0,0,0,0.0,0,6,6,1,0,1,0,0,0,1
../kbl_data/2022-2023,S41G01N162,전주 KCC,Away,허웅,7,1,4,25.0,1,2,50.0,2,6,33.3,2,2,100.0,0,1,1,1,0,0,0,0,2,3
../kbl_data/2022-2023,S41G01N162,전주 KCC,Away,이승현,6,3,6,50.0,0,3,0.0,3,9,33.3,0,0,0.0,1,2,3,2,1,0,0,0,0,0
../kbl_data/2022-2023,S41G01N162,전주 KCC,Away,이진욱,0,0,0,0.0,0,1,0.0,0,1,0.0,0,0,0.0,0,0,0,0,0,0,0,0,0,1
../kbl_data/2022-2023,S41G01N162,전주 KCC,Away,이근휘,0,0,0,0.0,0,2,0.0,0,2,0.0,0,0,0.0,0,0,0,0,0,0,0,0,0,0
../kbl_data/2022-2023,S41G01N162,전주 KCC,Away,론데 홀리스 제퍼슨,19,5,10,50.0,2,4,50.0,7,14,50.0,3,4,75.0,1,3,4,1,0,0,0,1,0,3
../kbl_data/2022-2023,S41G01N162,전주 KCC,Away,칼빈 제프리 에피스톨라,10,1,3,33.3,2,4,50.0,3,7,42.9,2,2,100.0,0,2,2,3,1,0,0,0,1,1
../kbl_data/2022-2023,S41G01N163,안양 KGC,Home,양희종,0,0,0,0.0,0,0,0.0,0,0,0.0,0,0,0.0,0,0,0,1,0,0,0,0,0,0
../kbl_data/2022-2023,S41G01N163,안양 KGC,Home,오세근,9,3,8,37.5,1,1,100.0,4,9,44.4,0,0,0.0,0,2,2,2,1,1,0,0,1,2
../kbl_data/2022-2023,S41G01N163,안양 KGC,Home,정준원,7,2,3,66.7,1,2,50.0,3,5,60.0,0,0,0.0,0,1,1,0,1,0,0,0,0,0
../kbl_data/2022-2023,S41G01N163,안양 KGC,Home,배병준,7,0,1,0.0,2,3,66.7,2,4,50.0,1,2,50.0,0,1,1,1,1,0,0,0,0,2
../kbl_data/2022-2023,S41G01N163,안양 KGC,Home,문성곤,15,3,5,60.0,3,4,75.0,6,9,66.7,0,0,0.0,1,6,7,1,1,0,0,0,2,3
../kbl_data/2022-2023,S41G01N163,안양 KGC,Home,박지훈,11,4,6,66.7,1,2,50.0,5,8,62.5,0,2,0.0,0,3,3,7,2,0,0,0,0,3
../kbl_data/2022-2023,S41G01N163,안양 KGC,Home,이우정,0,0,1,0.0,0,0,0.0,0,1,0.0,0,0,0.0,0,0,0,0,0,0,0,0,0,0
../kbl_data/2022-2023,S41G01N163,안양 KGC,Home,대릴 먼로,6,0,1,0.0,0,0,0.0,0,1,0.0,6,6,100.0,1,2,3,1,3,0,0,0,1,4
../kbl_data/2022-2023,S41G01N163,안양 KGC,Home,변준형,3,0,3,0.0,0,3,0.0,0,6,0.0,3,4,75.0,2,1,3,7,1,0,0,0,0,1
../kbl_data/2022-2023,S41G01N163,안양 KGC,Home,김경원,2,1,3,33.3,0,0,0.0,1,3,33.3,0,0,0.0,0,2,2,0,0,1,0,0,1,1
../kbl_data/2022-2023,S41G01N163,안양 KGC,Home,오마리 스펠맨,23,8,12,66.7,1,5,20.0,9,17,52.9,4,6,66.7,4,9,13,0,1,0,0,3,1,1
../kbl_data/2022-2023,S41G01N163,안양 KGC,Home,고찬혁,8,3,3,100.0,0,1,0.0,3,4,75.0,2,3,66.7,0,0,0,1,0,0,0,0,1,2
../kbl_data/2022-2023,S41G01N163,서울 삼성,Away,이정현,0,0,1,0.0,0,2,0.0,0,3,0.0,0,0,0.0,1,1,2,2,1,0,0,0,2,2
../kbl_data/2022-2023,S41G01N163,서울 삼성,Away,장민국,0,0,2,0.0,0,2,0.0,0,4,0.0,0,0,0.0,0,0,0,0,0,0,0,0,0,1
../kbl_data/2022-2023,S41G01N163,서울 삼성,Away,김시래,4,1,4,25.0,0,1,0.0,1,5,20.0,2,2,100.0,0,1,1,2,0,0,0,0,1,1
../kbl_data/2022-2023,S41G01N163,서울 삼성,Away,이동엽,4,2,4,50.0,0,2,0.0,2,6,33.3,0,0,0.0,3,1,4,0,0,0,0,0,0,1
../kbl_data/2022-2023,S41G01N163,서울 삼성,Away,이호현,0,0,1,0.0,0,3,0.0,0,4,0.0,0,0,0.0,0,0,0,0,1,0,0,0,0,3
../kbl_data/2022-2023,S41G01N163,서울 삼성,Away,최승욱,2,1,2,50.0,0,1,0.0,1,3,33.3,0,0,0.0,1,1,2,1,0,0,0,0,3,1
../kbl_data/2022-2023,S41G01N163,서울 삼성,Away,김진영,12,2,4,50.0,2,3,66.7,4,7,57.1,2,2,100.0,1,1,2,0,0,0,0,0,1,2
../kbl_data/2022-2023,S41G01N163,서울 삼성,Away,김무성,0,0,0,0.0,0,0,0.0,0,0,0.0,0,0,0.0,0,0,0,0,0,0,0,0,0,0
../kbl_data/2022-2023,S41G01N163,서울 삼성,Away,이원석,11,3,5,60.0,0,0,0.0,3,5,60.0,5,8,62.5,5,8,13,0,0,0,0,0,3,1
../kbl_data/2022-2023,S41G01N163,서울 삼성,Away,신동혁,7,2,4,50.0,1,2,50.0,3,6,50.0,0,0,0.0,2,1,3,0,0,1,0,0,0,3
../kbl_data/2022-2023,S41G01N163,서울 삼성,Away,다랄 윌리스,22,7,11,63.6,1,2,50.0,8,13,61.5,5,5,100.0,1,2,3,0,1,0,0,2,3,1
../kbl_data/2022-2023,S41G01N163,서울 삼성,Away,앤서니 모스,4,1,10,10.0,0,1,0.0,1,11,9.1,2,2,100.0,2,4,6,1,0,1,0,1,1,3
../kbl_data/2022-2023,S41G01N164,원주 DB,Home,박찬희,0,0,1,0.0,0,0,0.0,0,1,0.0,0,0,0.0,0,2,2,5,0,0,0,0,1,2
../kbl_data/2022-2023,S41G01N164,원주 DB,Home,김현호,5,1,1,100.0,1,2,50.0,2,3,66.7,0,0,0.0,0,0,0,1,0,0,1,0,1,4
../kbl_data/2022-2023,S41G01N164,원주 DB,Home,김종규,7,1,5,20.0,0,0,0.0,1,5,20.0,5,6,83.3,1,5,6,1,0,3,0,0,0,1
../kbl_data/2022-2023,S41G01N164,원주 DB,Home,최승욱,8,2,6,33.3,1,3,33.3,3,9,33.3,1,2,50.0,3,1,4,1,0,0,0,0,1,0
../kbl_data/2022-2023,S41G01N164,원주 DB,Home,강상재,16,5,13,38.5,2,6,33.3,7,19,36.8,0,0,0.0,5,5,10,3,3,1,0,0,3,3
../kbl_data/2022-2023,S41G01N164,원주 DB,Home,윤성원,0,0,0,0.0,0,1,0.0,0,1,0.0,0,0,0.0,0,1,1,1,0,0,0,0,1,2
../kbl_data/2022-2023,S41G01N164,원주 DB,Home,레나드 프리먼,14,6,9,66.7,0,0,0.0,6,9,66.7,2,2,100.0,2,6,8,0,0,0,1,0,2,2
../kbl_data/2022-2023,S41G01N164,원주 DB,Home,정호영,2,1,1,100.0,0,0,0.0,1,1,100.0,0,0,0.0,1,1,2,0,0,0,0,0,1,1
../kbl_data/2022-2023,S41G01N164,원주 DB,Home,이민석,0,0,0,0.0,0,1,0.0,0,1,0.0,0,0,0.0,0,0,0,0,0,0,0,0,0,1
../kbl_data/2022-2023,S41G01N164,원주 DB,Home,이선 알바노,17,3,7,42.9,2,3,66.7,5,10,50.0,5,6,83.3,0,4,4,6,1,1,0,0,3,2
../kbl_data/2022-2023,S41G01N164,원주 DB,Home,드완 에르난데스,11,5,9,55.6,0,0,0.0,5,9,55.6,1,1,100.0,2,1,3,1,0,0,0,0,0,1
../kbl_data/2022-2023,S41G01N164,원주 DB,Home,인승찬,0,0,0,0.0,0,0,0.0,0,0,0.0,0,0,0.0,0,0,0,0,0,0,0,0,0,0
../kbl_data/2022-2023,S41G01N164,수원 KT,Away,김동욱,2,1,1,100.0,0,1,0.0,1,2,50.0,0,0,0.0,0,0,0,0,0,0,0,0,0,0
../kbl_data/2022-2023,S41G01N164,수원 KT,Away,김영환,3,1,2,50.0,0,2,0.0,1,4,25.0,1,2,50.0,1,0,1,1,1,0,0,0,0,0
../kbl_data/2022-2023,S41G01N164,수원 KT,Away,한희원,0,0,3,0.0,0,2,0.0,0,5,0.0,0,2,0.0,0,0,0,0,1,1,0,0,0,1
../kbl_data/2022-2023,S41G01N164,수원 KT,Away,최창진,0,0,0,0.0,0,0,0.0,0,0,0.0,0,0,0.0,0,0,0,0,0,0,0,0,0,0
../kbl_data/2022-2023,S41G01N164,수원 KT,Away,최성모,14,2,2,100.0,2,8,25.0,4,10,40.0,4,4,100.0,4,2,6,3,4,0,0,0,0,3
../kbl_data/2022-2023,S41G01N164,수원 KT,Away,양홍석,2,1,5,20.0,0,5,0.0,1,10,10.0,0,0,0.0,3,2,5,1,0,0,0,0,3,2
../kbl_data/2022-2023,S41G01N164,수원 KT,Away,박지원,1,0,0,0.0,0,1,0.0,0,1,0.0,1,2,50.0,2,1,3,3,1,0,0,0,2,2
../kbl_data/2022-2023,S41G01N164,수원 KT,Away,하윤기,24,10,16,62.5,0,0,0.0,10,16,62.5,4,5,80.0,3,3,6,3,1,0,0,1,1,3
../kbl_data/2022-2023,S41G01N164,수원 KT,Away,이두원,0,0,0,0.0,0,0,0.0,0,0,0.0,0,0,0.0,0,0,0,0,0,0,0,0,0,0
../kbl_data/2022-2023,S41G01N164,수원 KT,Away,레스터 프로스퍼,13,5,8,62.5,1,4,25.0,6,12,50.0,0,0,0.0,4,8,12,0,1,1,0,1,1,1
../kbl_data/2022-2023,S41G01N164,수원 KT,Away,재로드 존스,11,1,8,12.5,3,10,30.0,4,18,22.2,0,0,0.0,1,3,4,2,2,1,0,0,1,2
../kbl_data/2022-2023,S41G01N164,수원 KT,Away,데이브 일데폰소,6,3,3,100.0,0,2,0.0,3,5,60.0,0,2,0.0,4,3,7,0,1,0,0,0,0,3
../kbl_data/2022-2023,S41G01N165,서울 SK,Home,양우섭,0,0,1,0.0,0,1,0.0,0,2,0.0,0,0,0.0,0,0,0,0,0,0,0,0,0,0
../kbl_data/2022-2023,S41G01N165,서울 SK,Home,허일영,11,2,3,66.7,2,6,33.3,4,9,44.4,1,1,100.0,0,2,2,1,2,0,1,0,0,3
../kbl_data/2022-2023,S41G01N165,서울 SK,Home,김선형,11,3,6,50.0,0,3,0.0,3,9,33.3,5,5,100.0,0,3,3,6,1,0,0,0,4,2
../kbl_data/2022-2023,S41G01N165,서울 SK,Home,홍경기,0,0,0,0.0,0,0,0.0,0,0,0.0,0,0,0.0,0,0,0,0,0,0,0,0,0,0
../kbl_data/2022-2023,S41G01N165,서울 SK,Home,최부경,14,6,9,66.7,0,0,0.0,6,9,66.7,2,3,66.7,2,2,4,1,0,0,2,1,0,4
../kbl_data/2022-2023,S41G01N165,서울 SK,Home,리온 윌리엄스,0,0,0,0.0,0,0,0.0,0,0,0.0,0,0,0.0,0,0,0,0,0,0,0,0,0,0
../kbl_data/2022-2023,S41G01N165,서울 SK,Home,최원혁,0,0,0,0.0,0,0,0.0,0,0,0.0,0,0,0.0,0,0,0,0,0,0,0,0,0,0
../kbl_data/2022-2023,S41G01N165,서울 SK,Home,최준용,11,4,7,57.1,0,3,0.0,4,10,40.0,3,3,100.0,2,7,9,2,0,0,0,0,1,3
../kbl_data/2022-2023,S41G01N165,서울 SK,Home,최성원,3,0,0,0.0,1,6,16.7,1,6,16.7,0,0,0.0,1,1,2,0,0,0,0,0,0,4
../kbl_data/2022-2023,S41G01N165,서울 SK,Home,자밀 워니,29,12,24,50.0,0,1,0.0,12,25,48.0,5,6,83.3,10,6,16,5,1,1,0,1,2,2
../kbl_data/2022-2023,S41G01N165,서울 SK,Home,김형빈,0,0,0,0.0,0,0,0.0,0,0,0.0,0,0,0.0,0,0,0,0,0,0,0,0,0,0
../kbl_data/2022-2023,S41G01N165,서울 SK,Home,오재현,3,0,0,0.0,1,2,50.0,1,2,50.0,0,0,0.0,1,0,1,0,0,0,0,0,0,1
../kbl_data/2022-2023,S41G01N165,고양 캐롯,Away,김강선,2,1,1,100.0,0,3,0.0,1,4,25.0,0,0,0.0,0,1,1,1,0,0,0,0,1,2
../kbl_data/2022-2023,S41G01N165,고양 캐롯,Away,최현민,3,0,0,0.0,0,2,0.0,0,2,0.0,3,3,100.0,0,1,1,0,1,1,0,0,1,4
../kbl_data/2022-2023,S41G01N165,고양 캐롯,Away,임종일,0,0,0,0.0,0,0,0.0,0,0,0.0,0,0,0.0,0,0,0,0,0,0,0,0,0,0
../kbl_data/2022-2023,S41G01N165,고양 캐롯,Away,전성현,22,5,6,83.3,3,10,30.0,8,16,50.0,3,5,60.0,1,1,2,2,1,0,0,0,3,2
../kbl_data/2022-2023,S41G01N165,고양 캐롯,Away,이종현,10,4,4,100.0,0,0,0.0,4,4,100.0,2,2,100.0,0,3,3,0,0,1,0,0,0,2
../kbl_data/2022-2023,S41G01N165,고양 캐롯,Away,김진유,0,0,0,0.0,0,5,0.0,0,5,0.0,0,0,0.0,2,4,6,5,2,0,1,0,2,2
../kbl_data/2022-2023,S41G01N165,고양 캐롯,Away,조한진,0,0,1,0.0,0,0,0.0,0,1,0.0,0,0,0.0,0,0,0,0,0,0,0,0,0,0
../kbl_data/2022-2023,S41G01N165,고양 캐롯,Away,김세창,0,0,0,0.0,0,0,0.0,0,0,0.0,0,0,0.0,0,0,0,0,0,0,0,0,0,0
../kbl_data/2022-2023,S41G01N165,고양 캐롯,Away,디드릭 로슨,19,6,8,75.0,2,5,40.0,8,13,61.5,1,1,100.0,2,6,8,3,0,0,0,0,2,4
../kbl_data/2022-2023,S41G01N165,고양 캐롯,Away,이정현,7,0,1,0.0,1,4,25.0,1,5,20.0,4,4,100.0,1,1,2,5,1,0,0,0,0,1
../kbl_data/2022-2023,S41G01N165,고양 캐롯,Away,안정욱,0,0,0,0.0,0,1,0.0,0,1,0.0,0,0,0.0,0,0,0,0,0,0,0,0,0,1
../kbl_data/2022-2023,S41G01N165,고양 캐롯,Away,조나단 알렛지,17,1,3,33.3,5,6,83.3,6,9,66.7,0,0,0.0,0,3,3,0,0,1,0,0,2,2
../kbl_data/2022-2023,S41G01N166,울산 현대모비스,Home,함지훈,11,4,6,66.7,0,0,0.0,4,6,66.7,3,3,100.0,2,0,2,2,0,0,0,0,0,1
../kbl_data/2022-2023,S41G01N166,울산 현대모비스,Home,김현민,0,0,0,0.0,0,0,0.0,0,0,0.0,0,0,0.0,0,0,0,0,0,0,0,0,0,0
../kbl_data/2022-2023,S41G01N166,울산 현대모비스,Home,최진수,0,0,0,0.0,0,0,0.0,0,0,0.0,0,0,0.0,0,0,0,0,0,0,0,0,0,1
../kbl_data/2022-2023,S41G01N166,울산 현대모비스,Home,장재석,8,3,7,42.9,0,0,0.0,3,7,42.9,2,2,100.0,3,2,5,3,1,1,0,0,3,4
../kbl_data/2022-2023,S41G01N166,울산 현대모비스,Home,김영현,0,0,1,0.0,0,0,0.0,0,1,0.0,0,0,0.0,0,0,0,1,1,0,0,0,1,3
../kbl_data/2022-2023,S41G01N166,울산 현대모비스,Home,서명진,14,2,6,33.3,3,5,60.0,5,11,45.5,1,2,50.0,0,2,2,2,0,0,0,0,1,3
../kbl_data/2022-2023,S41G01N166,울산 현대모비스,Home,헨리 심스,7,3,4,75.0,0,0,0.0,3,4,75.0,1,2,50.0,1,0,1,0,0,0,0,1,0,1
../kbl_data/2022-2023,S41G01N166,울산 현대모비스,Home,이우석,9,3,6,50.0,1,1,100.0,4,7,57.1,0,0,0.0,0,3,3,3,3,0,1,0,1,2
../kbl_data/2022-2023,S41G01N166,울산 현대모비스,Home,신민석,3,0,0,0.0,1,2,50.0,1,2,50.0,0,0,0.0,0,4,4,1,0,0,0,0,0,0
../kbl_data/2022-2023,S41G01N166,울산 현대모비스,Home,론제이 아바리엔토스,6,0,1,0.0,0,3,0.0,0,4,0.0,6,8,75.0,0,2,2,4,3,0,0,0,1,1
../kbl_data/2022-2023,S41G01N166,울산 현대모비스,Home,게이지 프림,24,9,15,60.0,0,0,0.0,9,15,60.0,6,8,75.0,2,8,10,2,1,0,0,0,1,1
../kbl_data/2022-2023,S41G01N166,울산 현대모비스,Home,김태완,0,0,1,0.0,0,0,0.0,0,1,0.0,0,0,0.0,1,1,2,4,1,0,0,0,3,2
../kbl_data/2022-2023,S41G01N166,창원 LG,Away,이관희,10,1,4,25.0,2,8,25.0,3,12,25.0,2,2,100.0,0,5,5,3,1,0,1,0,2,1
../kbl_data/2022-2023,S41G01N166,창원 LG,Away,정희재,12,2,3,66.7,2,3,66.7,4,6,66.7,2,2,100.0,2,3,5,0,1,0,1,0,0,3
../kbl_data/2022-2023,S41G01N166,창원 LG,Away,임동섭,0,0,1,0.0,0,1,0.0,0,2,0.0,0,0,0.0,2,3,5,0,0,0,0,0,1,1
../kbl_data/2022-2023,S41G01N166,창원 LG,Away,서민수,2,0,0,0.0,0,0,0.0,0,0,0.0,2,2,100.0,1,0,1,0,0,0,0,0,0,3
../kbl_data/2022-2023,S41G01N166,창원 LG,Away,이재도,15,3,13,23.1,2,5,40.0,5,18,27.8,3,4,75.0,1,4,5,7,0,0,0,0,0,1
../kbl_data/2022-2023,S41G01N166,창원 LG,Away,김준일,4,1,3,33.3,0,0,0.0,1,3,33.3,2,2,100.0,2,2,4,2,0,0,0,0,1,5
../kbl_data/2022-2023,S41G01N166,창원 LG,Away,정인덕,0,0,0,0.0,0,1,0.0,0,1,0.0,0,0,0.0,0,0,0,1,1,0,0,0,0,0
../kbl_data/2022-2023,S41G01N166,창원 LG,Away,윤원상,3,1,1,100.0,0,3,0.0,1,4,25.0,1,2,50.0,0,0,0,2,2,0,0,0,0,1
../kbl_data/2022-2023,S41G01N166,창원 LG,Away,아셈 마레이,13,6,7,85.7,0,0,0.0,6,7,85.7,1,3,33.3,1,2,3,2,0,0,0,0,5,4
../kbl_data/2022-2023,S41G01N166,창원 LG,Away,저스틴 구탕,0,0,0,0.0,0,0,0.0,0,0,0.0,0,0,0.0,0,0,0,0,0,0,0,0,3,1
../kbl_data/2022-2023,S41G01N166,창원 LG,Away,양준석,0,0,1,0.0,0,0,0.0,0,1,0.0,0,0,0.0,0,0,0,0,0,0,0,0,1,0
../kbl_data/2022-2023,S41G01N166,창원 LG,Away,단테 커닝햄,16,7,10,70.0,0,0,0.0,7,10,70.0,2,2,100.0,4,1,5,0,0,1,0,2,1,3
../kbl_data/2022-2023,S41G01N167,전주 KCC,Home,정창영,21,2,8,25.0,5,9,55.6,7,17,41.2,2,3,66.7,1,1,2,0,2,0,0,0,3,4
../kbl_data/2022-2023,S41G01N167,전주 KCC,Home,라건아,9,3,4,75.0,0,1,0.0,3,5,60.0,3,3,100.0,1,13,14,3,0,1,0,0,1,1
../kbl_data/2022-2023,S41G01N167,전주 KCC,Home,박경상,0,0,1,0.0,0,1,0.0,0,2,0.0,0,0,0.0,0,0,0,0,0,0,0,0,0,0
../kbl_data/2022-2023,S41G01N167,전주 KCC,Home,김지완,9,0,3,0.0,3,5,60.0,3,8,37.5,0,0,0.0,1,2,3,4,2,0,0,0,3,2
../kbl_data/2022-2023,S41G01N167,전주 KCC,Home,김상규,0,0,0,0.0,0,2,0.0,0,2,0.0,0,0,0.0,1,3,4,0,1,0,0,0,1,2
../kbl_data/2022-2023,S41G01N167,전주 KCC,Home,전준범,2,1,2,50.0,0,0,0.0,1,2,50.0,0,0,0.0,0,1,1,2,1,0,0,0,1,0
../kbl_data/2022-2023,S41G01N167,전주 KCC,Home,허웅,13,4,6,66.7,0,8,0.0,4,14,28.6,5,5,100.0,1,1,2,4,1,0,0,0,3,3
../kbl_data/2022-2023,S41G01N167,전주 KCC,Home,이승현,4,2,6,33.3,0,0,0.0,2,6,33.3,0,0,0.0,3,3,6,0,1,1,0,0,0,0
../kbl_data/2022-2023,S41G01N167,전주 KCC,Home,이진욱,0,0,0,0.0,0,1,0.0,0,1,0.0,0,0,0.0,0,0,0,0,0,0,0,0,0,1
../kbl_data/2022-2023,S41G01N167,전주 KCC,Home,이근휘,0,0,0,0.0,0,0,0.0,0,0,0.0,0,0,0.0,0,0,0,0,0,0,0,0,0,0
../kbl_data/2022-2023,S41G01N167,전주 KCC,Home,론데 홀리스 제퍼슨,9,3,5,60.0,0,1,0.0,3,6,50.0,3,4,75.0,0,0,0,0,1,0,0,0,1,2
../kbl_data/2022-2023,S41G01N167,전주 KCC,Home,칼빈 제프리 에피스톨라,0,0,0,0.0,0,0,0.0,0,0,0.0,0,0,0.0,0,0,0,0,0,0,0,0,0,0
../kbl_data/2022-2023,S41G01N167,대구 한국가스공사,Away,차바위,7,2,2,100.0,1,4,25.0,3,6,50.0,0,0,0.0,0,3,3,2,1,0,0,0,0,1
../kbl_data/2022-2023,S41G01N167,대구 한국가스공사,Away,박지훈,0,0,0,0.0,0,0,0.0,0,0,0.0,0,0,0.0,0,1,1,0,0,0,0,0,0,1
../kbl_data/2022-2023,S41G01N167,대구 한국가스공사,Away,조상열,5,1,1,100.0,1,3,33.3,2,4,50.0,0,0,0.0,0,0,0,0,1,0,0,0,0,2
../kbl_data/2022-2023,S41G01N167,대구 한국가스공사,Away,이대헌,15,5,7,71.4,1,3,33.3,6,10,60.0,2,2,100.0,4,4,8,4,2,0,0,0,2,2
../kbl_data/2022-2023,S41G01N167,대구 한국가스공사,Away,이대성,23,7,12,58.3,3,8,37.5,10,20,50.0,0,0,0.0,0,6,6,3,0,1,0,0,3,4
../kbl_data/2022-2023,S41G01N167,대구 한국가스공사,Away,정효근,2,0,0,0.0,0,0,0.0,0,0,0.0,2,2,100.0,1,3,4,0,1,0,0,0,0,1
../kbl_data/2022-2023,S41G01N167,대구 한국가스공사,Away,머피 할로웨이,10,3,10,30.0,0,0,0.0,3,10,30.0,4,6,66.7,2,9,11,2,1,1,0,1,1,3
../kbl_data/2022-2023,S41G01N167,대구 한국가스공사,Away,우동현,0,0,1,0.0,0,0,0.0,0,1,0.0,0,0,0.0,0,0,0,0,1,0,0,0,0,1
../kbl_data/2022-2023,S41G01N167,대구 한국가스공사,Away,전현우,0,0,0,0.0,0,0,0.0,0,0,0.0,0,0,0.0,0,0,0,0,0,0,0,0,0,0
../kbl_data/2022-2023,S41G01N167,대구 한국가스공사,Away,데본 스캇,5,1,2,50.0,1,2,50.0,2,4,50.0,0,0,0.0,0,4,4,1,0,0,0,0,4,1
../kbl_data/2022-2023,S41G01N167,대구 한국가스공사,Away,신승민,0,0,0,0.0,0,0,0.0,0,0,0.0,0,0,0.0,0,0,0,0,0,0,0,0,0,0
../kbl_data/2022-2023,S41G01N167,대구 한국가스공사,Away,샘조세프 벨란겔,5,2,4,50.0,0,1,0.0,2,5,40.0,1,1,100.0,0,3,3,2,0,0,0,0,2,2
../kbl_data/2022-2023,S41G01N168,원주 DB,Home,박찬희,9,3,6,50.0,1,3,33.3,4,9,44.4,0,0,0.0,1,2,3,4,1,0,0,0,0,4
../kbl_data/2022-2023,S41G01N168,원주 DB,Home,김현호,0,0,2,0.0,0,2,0.0,0,4,0.0,0,0,0.0,1,2,3,5,1,0,0,0,1,3
../kbl_data/2022-2023,S41G01N168,원주 DB,Home,김종규,6,3,6,50.0,0,0,0.0,3,6,50.0,0,0,0.0,2,5,7,1,0,0,0,1,3,2
../kbl_data/2022-2023,S41G01N168,원주 DB,Home,최승욱,0,0,3,0.0,0,3,0.0,0,6,0.0,0,0,0.0,2,3,5,1,0,1,0,0,1,4
../kbl_data/2022-2023,S41G01N168,원주 DB,Home,강상재,18,5,7,71.4,2,6,33.3,7,13,53.8,2,2,100.0,1,1,2,1,3,0,0,0,3,0
../kbl_data/2022-2023,S41G01N168,원주 DB,Home,윤성원,0,0,0,0.0,0,0,0.0,0,0,0.0,0,0,0.0,0,0,0,0,0,0,0,0,0,0
../kbl_data/2022-2023,S41G01N168,원주 DB,Home,레나드 프리먼,8,4,6,66.7,0,0,0.0,4,6,66.7,0,0,0.0,2,6,8,0,2,1,0,0,3,2
../kbl_data/2022-2023,S41G01N168,원주 DB,Home,정호영,0,0,0,0.0,0,0,0.0,0,0,0.0,0,0,0.0,0,0,0,0,0,0,0,0,0,1
../kbl_data/2022-2023,S41G01N168,원주 DB,Home,이민석,3,0,2,0.0,1,3,33.3,1,5,20.0,0,0,0.0,1,0,1,2,0,0,0,0,0,0
../kbl_data/2022-2023,S41G01N168,원주 DB,Home,이선 알바노,15,5,7,71.4,1,6,16.7,6,13,46.2,2,2,100.0,1,7,8,5,3,0,0,0,4,2
../kbl_data/2022-2023,S41G01N168,원주 DB,Home,드완 에르난데스,12,6,7,85.7,0,0,0.0,6,7,85.7,0,0,0.0,1,4,5,0,0,1,0,3,1,1
../kbl_data/2022-2023,S41G01N168,원주 DB,Home,인승찬,0,0,0,0.0,0,0,0.0,0,0,0.0,0,0,0.0,0,0,0,0,0,0,0,0,0,0
../kbl_data/2022-2023,S41G01N168,대구 한국가스공사,Away,차바위,2,1,1,100.0,0,0,0.0,1,1,100.0,0,0,0.0,1,1,2,1,0,0,0,0,1,2
../kbl_data/2022-2023,S41G01N168,대구 한국가스공사,Away,박지훈,0,0,0,0.0,0,0,0.0,0,0,0.0,0,0,0.0,0,0,0,0,0,0,0,0,0,0
../kbl_data/2022-2023,S41G01N168,대구 한국가스공사,Away,조상열,3,0,0,0.0,1,1,100.0,1,1,100.0,0,0,0.0,0,0,0,0,0,0,0,0,0,0
../kbl_data/2022-2023,S41G01N168,대구 한국가스공사,Away,이대헌,8,2,8,25.0,1,3,33.3,3,11,27.3,1,2,50.0,1,1,2,1,0,0,1,0,1,1
../kbl_data/2022-2023,S41G01N168,대구 한국가스공사,Away,이대성,21,7,8,87.5,1,7,14.3,8,15,53.3,4,6,66.7,1,2,3,3,3,0,0,0,2,1
../kbl_data/2022-2023,S41G01N168,대구 한국가스공사,Away,정효근,8,0,1,0.0,2,5,40.0,2,6,33.3,2,2,100.0,0,1,1,0,1,1,0,0,3,2
../kbl_data/2022-2023,S41G01N168,대구 한국가스공사,Away,머피 할로웨이,6,3,5,60.0,0,0,0.0,3,5,60.0,0,0,0.0,1,8,9,1,4,1,0,0,1,0
../kbl_data/2022-2023,S41G01N168,대구 한국가스공사,Away,우동현,3,1,1,100.0,0,1,0.0,1,2,50.0,1,2,50.0,0,1,1,0,0,0,0,0,1,0
../kbl_data/2022-2023,S41G01N168,대구 한국가스공사,Away,전현우,3,0,1,0.0,1,2,50.0,1,3,33.3,0,0,0.0,0,1,1,0,0,0,0,0,0,3
../kbl_data/2022-2023,S41G01N168,대구 한국가스공사,Away,데본 스캇,2,0,3,0.0,0,2,0.0,0,5,0.0,2,2,100.0,2,2,4,0,0,0,0,0,2,1
../kbl_data/2022-2023,S41G01N168,대구 한국가스공사,Away,신승민,3,0,2,0.0,1,4,25.0,1,6,16.7,0,0,0.0,1,1,2,0,1,0,0,0,1,2
../kbl_data/2022-2023,S41G01N168,대구 한국가스공사,Away,샘조세프 벨란겔,6,3,5,60.0,0,3,0.0,3,8,37.5,0,0,0.0,2,2,4,2,2,0,0,0,2,3
../kbl_data/2022-2023,S41G01N169,서울 삼성,Home,이정현,7,1,2,50.0,0,1,0.0,1,3,33.3,5,5,100.0,0,0,0,0,0,0,0,0,2,1
../kbl_data/2022-2023,S41G01N169,서울 삼성,Home,장민국,2,1,3,33.3,0,2,0.0,1,5,20.0,0,0,0.0,2,0,2,1,0,0,0,0,1,5
../kbl_data/2022-2023,S41G01N169,서울 삼성,Home,김시래,6,0,1,0.0,0,1,0.0,0,2,0.0,6,9,66.7,0,3,3,5,1,0,0,0,1,1
../kbl_data/2022-2023,S41G01N169,서울 삼성,Home,이동엽,9,3,6,50.0,1,3,33.3,4,9,44.4,0,2,0.0,0,1,1,2,4,0,0,0,0,4
../kbl_data/2022-2023,S41G01N169,서울 삼성,Home,이호현,9,3,8,37.5,1,1,100.0,4,9,44.4,0,0,0.0,0,2,2,4,0,0,0,0,1,2
../kbl_data/2022-2023,S41G01N169,서울 삼성,Home,김한솔,0,0,1,0.0,0,0,0.0,0,1,0.0,0,2,0.0,0,2,2,0,0,0,0,0,0,4
../kbl_data/2022-2023,S41G01N169,서울 삼성,Home,김진영,0,0,2,0.0,0,1,0.0,0,3,0.0,0,0,0.0,1,1,2,1,0,0,0,0,0,0
../kbl_data/2022-2023,S41G01N169,서울 삼성,Home,김무성,0,0,0,0.0,0,0,0.0,0,0,0.0,0,0,0.0,0,0,0,0,0,0,0,0,0,0
../kbl_data/2022-2023,S41G01N169,서울 삼성,Home,차민석,4,2,3,66.7,0,0,0.0,2,3,66.7,0,0,0.0,0,1,1,0,0,0,0,0,0,4
../kbl_data/2022-2023,S41G01N169,서울 삼성,Home,신동혁,2,1,2,50.0,0,0,0.0,1,2,50.0,0,0,0.0,2,0,2,0,0,0,0,0,0,1
../kbl_data/2022-2023,S41G01N169,서울 삼성,Home,다랄 윌리스,26,10,14,71.4,2,6,33.3,12,20,60.0,0,0,0.0,2,6,8,1,0,0,0,2,4,3
../kbl_data/2022-2023,S41G01N169,서울 삼성,Home,앤서니 모스,5,2,3,66.7,0,0,0.0,2,3,66.7,1,1,100.0,1,4,5,0,0,0,0,1,1,1
../kbl_data/2022-2023,S41G01N169,울산 현대모비스,Away,함지훈,9,2,3,66.7,0,0,0.0,2,3,66.7,5,6,83.3,1,5,6,1,0,0,0,0,0,1
../kbl_data/2022-2023,S41G01N169,울산 현대모비스,Away,김현민,0,0,0,0.0,0,0,0.0,0,0,0.0,0,0,0.0,1,1,2,0,0,0,0,0,0,0
../kbl_data/2022-2023,S41G01N169,울산 현대모비스,Away,최진수,0,0,0,0.0,0,0,0.0,0,0,0.0,0,0,0.0,0,0,0,0,0,0,0,0,0,0
../kbl_data/2022-2023,S41G01N169,울산 현대모비스,Away,장재석,15,6,8,75.0,0,0,0.0,6,8,75.0,3,7,42.9,2,2,4,1,0,2,0,0,1,3
../kbl_data/2022-2023,S41G01N169,울산 현대모비스,Away,김영현,3,0,0,0.0,1,3,33.3,1,3,33.3,0,0,0.0,0,0,0,0,1,0,0,0,1,3
../kbl_data/2022-2023,S41G01N169,울산 현대모비스,Away,서명진,10,2,4,50.0,2,5,40.0,4,9,44.4,0,0,0.0,0,0,0,6,0,0,0,0,0,3
../kbl_data/2022-2023,S41G01N169,울산 현대모비스,Away,헨리 심스,4,1,1,100.0,0,0,0.0,1,1,100.0,2,2,100.0,2,5,7,0,1,0,0,0,1,0
../kbl_data/2022-2023,S41G01N169,울산 현대모비스,Away,이우석,14,5,8,62.5,1,2,50.0,6,10,60.0,1,2,50.0,1,2,3,1,0,0,0,0,1,3
../kbl_data/2022-2023,S41G01N169,울산 현대모비스,Away,신민석,2,1,1,100.0,0,3,0.0,1,4,25.0,0,0,0.0,0,3,3,0,3,0,0,0,0,1
../kbl_data/2022-2023,S41G01N169,울산 현대모비스,Away,론제이 아바리엔토스,2,1,2,50.0,0,6,0.0,1,8,12.5,0,0,0.0,0,0,0,6,1,0,0,0,3,0
../kbl_data/2022-2023,S41G01N169,울산 현대모비스,Away,게이지 프림,24,8,13,61.5,0,0,0.0,8,13,61.5,8,9,88.9,4,7,11,2,1,1,0,0,3,3
../kbl_data/2022-2023,S41G01N169,울산 현대모비스,Away,김태완,2,0,0,0.0,0,0,0.0,0,0,0.0,2,2,100.0,0,1,1,0,0,0,0,0,1,3
../kbl_data/2022-2023,S41G01N170,수원 KT,Home,김동욱,0,0,0,0.0,0,4,0.0,0,4,0.0,0,0,0.0,0,1,1,1,0,0,0,0,0,2
../kbl_data/2022-2023,S41G01N170,수원 KT,Home,김영환,10,2,2,100.0,1,2,50.0,3,4,75.0,3,3,100.0,0,0,0,1,0,0,0,0,1,1
../kbl_data/2022-2023,S41G01N170,수원 KT,Home,한희원,0,0,0,0.0,0,0,0.0,0,0,0.0,0,0,0.0,0,0,0,1,1,0,0,0,0,3
../kbl_data/2022-2023,S41G01N170,수원 KT,Home,정성우,8,0,3,0.0,2,4,50.0,2,7,28.6,2,2,100.0,0,0,0,4,3,0,0,0,1,2
../kbl_data/2022-2023,S41G01N170,수원 KT,Home,최성모,4,1,1,100.0,0,2,0.0,1,3,33.3,2,2,100.0,0,4,4,3,3,1,0,0,4,3
../kbl_data/2022-2023,S41G01N170,수원 KT,Home,양홍석,16,7,9,77.8,0,2,0.0,7,11,63.6,2,2,100.0,1,11,12,6,1,0,0,0,3,1
../kbl_data/2022-2023,S41G01N170,수원 KT,Home,박지원,0,0,0,0.0,0,0,0.0,0,0,0.0,0,0,0.0,0,0,0,0,0,0,0,0,0,0
../kbl_data/2022-2023,S41G01N170,수원 KT,Home,하윤기,22,7,10,70.0,0,0,0.0,7,10,70.0,8,9,88.9,2,0,2,2,1,0,0,1,2,1
../kbl_data/2022-2023,S41G01N170,수원 KT,Home,이두원,8,4,5,80.0,0,0,0.0,4,5,80.0,0,0,0.0,2,0,2,2,0,0,0,0,2,1
../kbl_data/2022-2023,S41G01N170,수원 KT,Home,레스터 프로스퍼,4,2,6,33.3,0,0,0.0,2,6,33.3,0,0,0.0,0,4,4,0,0,0,0,1,0,0
../kbl_data/2022-2023,S41G01N170,수원 KT,Home,재로드 존스,18,4,8,50.0,3,4,75.0,7,12,58.3,1,1,100.0,5,8,13,5,1,2,0,1,5,4
../kbl_data/2022-2023,S41G01N170,수원 KT,Home,데이브 일데폰소,0,0,0,0.0,0,0,0.0,0,0,0.0,0,0,0.0,0,0,0,0,0,0,0,0,0,0
../kbl_data/2022-2023,S41G01N170,고양 캐롯,Away,김강선,21,0,0,0.0,7,15,46.7,7,15,46.7,0,0,0.0,1,3,4,1,1,0,1,0,1,5
../kbl_data/2022-2023,S41G01N170,고양 캐롯,Away,최현민,2,1,1,100.0,0,1,0.0,1,2,50.0,0,0,0.0,1,1,2,1,0,0,1,0,0,0
../kbl_data/2022-2023,S41G01N170,고양 캐롯,Away,임종일,5,2,2,100.0,0,0,0.0,2,2,100.0,1,1,100.0,2,1,3,0,0,0,0,0,0,0
../kbl_data/2022-2023,S41G01N170,고양 캐롯,Away,전성현,20,4,6,66.7,4,10,40.0,8,16,50.0,0,0,0.0,0,2,2,1,0,0,0,0,2,3
../kbl_data/2022-2023,S41G01N170,고양 캐롯,Away,이종현,2,1,2,50.0,0,1,0.0,1,3,33.3,0,0,0.0,0,2,2,0,0,0,0,0,0,2
../kbl_data/2022-2023,S41G01N170,고양 캐롯,Away,김진유,0,0,0,0.0,0,3,0.0,0,3,0.0,0,0,0.0,2,0,2,0,2,0,1,0,1,3
../kbl_data/2022-2023,S41G01N170,고양 캐롯,Away,정해원,1,0,0,0.0,0,1,0.0,0,1,0.0,1,2,50.0,0,0,0,0,1,0,0,0,0,1
../kbl_data/2022-2023,S41G01N170,고양 캐롯,Away,김세창,0,0,0,0.0,0,0,0.0,0,0,0.0,0,0,0.0,0,0,0,1,0,0,0,0,1,1
../kbl_data/2022-2023,S41G01N170,고양 캐롯,Away,디드릭 로슨,4,2,3,66.7,0,4,0.0,2,7,28.6,0,0,0.0,1,2,3,5,0,0,0,1,5,1
../kbl_data/2022-2023,S41G01N170,고양 캐롯,Away,이정현,11,2,3,66.7,2,5,40.0,4,8,50.0,1,2,50.0,1,0,1,2,4,1,1,0,2,3
../kbl_data/2022-2023,S41G01N170,고양 캐롯,Away,안정욱,0,0,0,0.0,0,0,0.0,0,0,0.0,0,0,0.0,0,0,0,0,0,0,0,0,0,0
../kbl_data/2022-2023,S41G01N170,고양 캐롯,Away,조나단 알렛지,10,1,2,50.0,2,7,28.6,3,9,33.3,2,3,66.7,0,5,5,2,1,2,0,0,2,0
../kbl_data/2022-2023,S41G01N171,서울 SK,Home,양우섭,0,0,1,0.0,0,1,0.0,0,2,0.0,0,0,0.0,0,1,1,0,0,0,0,0,0,0
../kbl_data/2022-2023,S41G01N171,서울 SK,Home,허일영,6,2,4,50.0,0,3,0.0,2,7,28.6,2,4,50.0,0,3,3,1,0,1,0,0,0,4
../kbl_data/2022-2023,S41G01N171,서울 SK,Home,김선형,47,14,17,82.4,4,9,44.4,18,26,69.2,7,8,87.5,1,3,4,3,0,1,0,0,1,4
../kbl_data/2022-2023,S41G01N171,서울 SK,Home,홍경기,0,0,0,0.0,0,0,0.0,0,0,0.0,0,0,0.0,0,0,0,0,0,0,0,0,0,0
../kbl_data/2022-2023,S41G01N171,서울 SK,Home,최부경,0,0,1,0.0,0,0,0.0,0,1,0.0,0,0,0.0,0,0,0,0,0,0,0,0,0,2
../kbl_data/2022-2023,S41G01N171,서울 SK,Home,리온 윌리엄스,4,1,2,50.0,0,1,0.0,1,3,33.3,2,2,100.0,2,3,5,0,0,1,0,0,0,0
../kbl_data/2022-2023,S41G01N171,서울 SK,Home,최원혁,2,1,1,100.0,0,1,0.0,1,2,50.0,0,0,0.0,0,1,1,0,1,0,0,0,0,3
../kbl_data/2022-2023,S41G01N171,서울 SK,Home,최준용,13,5,9,55.6,1,8,12.5,6,17,35.3,0,5,0.0,1,4,5,3,1,1,0,0,4,4
../kbl_data/2022-2023,S41G01N171,서울 SK,Home,최성원,10,2,3,66.7,2,7,28.6,4,10,40.0,0,1,0.0,0,0,0,0,1,0,0,0,1,4
../kbl_data/2022-2023,S41G01N171,서울 SK,Home,자밀 워니,24,9,17,52.9,0,1,0.0,9,18,50.0,6,6,100.0,7,13,20,6,1,1,0,0,2,4
../kbl_data/2022-2023,S41G01N171,서울 SK,Home,김형빈,0,0,0,0.0,0,0,0.0,0,0,0.0,0,0,0.0,0,0,0,0,0,0,0,0,0,0
../kbl_data/2022-2023,S41G01N171,서울 SK,Home,오재현,12,2,2,100.0,2,2,100.0,4,4,100.0,2,2,100.0,0,4,4,3,1,0,1,0,1,3
../kbl_data/2022-2023,S41G01N171,대구 한국가스공사,Away,차바위,5,0,2,0.0,1,1,100.0,1,3,33.3,2,2,100.0,3,1,4,2,1,0,0,0,0,1
../kbl_data/2022-2023,S41G01N171,대구 한국가스공사,Away,박지훈,0,0,0,0.0,0,0,0.0,0,0,0.0,0,0,0.0,0,0,0,0,0,0,0,0,0,0
../kbl_data/2022-2023,S41G01N171,대구 한국가스공사,Away,이원대,0,0,0,0.0,0,0,0.0,0,0,0.0,0,0,0.0,0,0,0,0,0,1,0,0,0,0
../kbl_data/2022-2023,S41G01N171,대구 한국가스공사,Away,이대헌,16,6,8,75.0,1,3,33.3,7,11,63.6,1,2,50.0,4,3,7,2,2,0,0,1,1,4
../kbl_data/2022-2023,S41G01N171,대구 한국가스공사,Away,이대성,30,7,14,50.0,2,7,28.6,9,21,42.9,10,12,83.3,1,2,3,6,0,1,0,0,5,3
../kbl_data/2022-2023,S41G01N171,대구 한국가스공사,Away,정효근,19,3,9,33.3,3,10,30.0,6,19,31.6,4,6,66.7,1,7,8,0,0,2,0,0,0,4
../kbl_data/2022-2023,S41G01N171,대구 한국가스공사,Away,머피 할로웨이,10,4,10,40.0,0,0,0.0,4,10,40.0,2,4,50.0,6,10,16,3,1,0,0,0,2,4
../kbl_data/2022-2023,S41G01N171,대구 한국가스공사,Away,우동현,0,0,0,0.0,0,0,0.0,0,0,0.0,0,0,0.0,1,0,1,1,0,0,1,0,1,1
../kbl_data/2022-2023,S41G01N171,대구 한국가스공사,Away,전현우,3,0,0,0.0,1,2,50.0,1,2,50.0,0,0,0.0,0,0,0,0,0,0,0,0,0,0
../kbl_data/2022-2023,S41G01N171,대구 한국가스공사,Away,데본 스캇,11,4,7,57.1,1,2,50.0,5,9,55.6,0,1,0.0,2,6,8,5,1,0,0,0,1,5
../kbl_data/2022-2023,S41G01N171,대구 한국가스공사,Away,신승민,0,0,0,0.0,0,0,0.0,0,0,0.0,0,0,0.0,0,0,0,0,0,0,0,0,0,0
../kbl_data/2022-2023,S41G01N171,대구 한국가스공사,Away,샘조세프 벨란겔,22,4,6,66.7,4,9,44.4,8,15,53.3,2,2,100.0,1,3,4,5,1,0,0,0,2,3
../kbl_data/2022-2023,S41G01N172,창원 LG,Home,이관희,13,4,6,66.7,1,6,16.7,5,12,41.7,2,3,66.7,0,3,3,2,1,1,0,0,3,2
../kbl_data/2022-2023,S41G01N172,창원 LG,Home,정희재,9,1,2,50.0,1,4,25.0,2,6,33.3,4,4,100.0,1,2,3,3,0,0,0,0,3,3
../kbl_data/2022-2023,S41G01N172,창원 LG,Home,임동섭,2,1,1,100.0,0,1,0.0,1,2,50.0,0,0,0.0,0,0,0,2,0,0,0,0,0,1
../kbl_data/2022-2023,S41G01N172,창원 LG,Home,서민수,0,0,0,0.0,0,0,0.0,0,0,0.0,0,0,0.0,0,0,0,0,0,0,0,0,0,0
../kbl_data/2022-2023,S41G01N172,창원 LG,Home,이재도,2,0,4,0.0,0,2,0.0,0,6,0.0,2,2,100.0,2,5,7,2,1,0,0,0,2,1
../kbl_data/2022-2023,S41G01N172,창원 LG,Home,김준일,6,3,6,50.0,0,0,0.0,3,6,50.0,0,0,0.0,1,2,3,5,1,1,0,0,2,2
../kbl_data/2022-2023,S41G01N172,창원 LG,Home,정인덕,0,0,0,0.0,0,0,0.0,0,0,0.0,0,0,0.0,0,1,1,0,0,0,0,0,0,0
../kbl_data/2022-2023,S41G01N172,창원 LG,Home,윤원상,11,1,4,25.0,3,9,33.3,4,13,30.8,0,0,0.0,0,3,3,2,1,0,1,0,3,2
../kbl_data/2022-2023,S41G01N172,창원 LG,Home,아셈 마레이,12,5,8,62.5,0,0,0.0,5,8,62.5,2,6,33.3,4,10,14,0,4,1,0,0,4,4
../kbl_data/2022-2023,S41G01N172,창원 LG,Home,저스틴 구탕,2,1,3,33.3,0,0,0.0,1,3,33.3,0,0,0.0,1,3,4,0,0,0,0,0,3,1
../kbl_data/2022-2023,S41G01N172,창원 LG,Home,양준석,0,0,0,0.0,0,0,0.0,0,0,0.0,0,0,0.0,0,0,0,0,0,0,0,0,0,0
../kbl_data/2022-2023,S41G01N172,창원 LG,Home,단테 커닝햄,11,4,6,66.7,0,0,0.0,4,6,66.7,3,4,75.0,0,4,4,1,0,0,0,0,0,1
../kbl_data/2022-2023,S41G01N172,안양 KGC,Away,양희종,5,1,1,100.0,1,5,20.0,2,6,33.3,0,0,0.0,0,2,2,0,0,0,1,0,1,2
../kbl_data/2022-2023,S41G01N172,안양 KGC,Away,오세근,13,6,13,46.2,0,1,0.0,6,14,42.9,1,2,50.0,0,8,8,1,1,0,0,0,0,2
../kbl_data/2022-2023,S41G01N172,안양 KGC,Away,정준원,2,1,1,100.0,0,0,0.0,1,1,100.0,0,0,0.0,0,0,0,0,0,0,0,0,0,1
../kbl_data/2022-2023,S41G01N172,안양 KGC,Away,배병준,0,0,1,0.0,0,0,0.0,0,1,0.0,0,0,0.0,0,2,2,0,0,0,1,0,0,1
../kbl_data/2022-2023,S41G01N172,안양 KGC,Away,문성곤,4,2,2,100.0,0,5,0.0,2,7,28.6,0,0,0.0,3,2,5,2,2,0,1,0,2,4
../kbl_data/2022-2023,S41G01N172,안양 KGC,Away,박지훈,6,3,7,42.9,0,0,0.0,3,7,42.9,0,0,0.0,2,1,3,1,1,0,0,0,3,4
../kbl_data/2022-2023,S41G01N172,안양 KGC,Away,이우정,0,0,0,0.0,0,0,0.0,0,0,0.0,0,0,0.0,0,0,0,0,0,0,0,0,0,0
../kbl_data/2022-2023,S41G01N172,안양 KGC,Away,대릴 먼로,0,0,0,0.0,0,0,0.0,0,0,0.0,0,0,0.0,0,1,1,2,0,0,0,0,2,1
../kbl_data/2022-2023,S41G01N172,안양 KGC,Away,변준형,21,6,7,85.7,2,7,28.6,8,14,57.1,3,4,75.0,2,1,3,3,4,1,1,0,3,4
../kbl_data/2022-2023,S41G01N172,안양 KGC,Away,김경원,0,0,0,0.0,0,0,0.0,0,0,0.0,0,0,0.0,0,0,0,0,0,0,0,0,0,0
../kbl_data/2022-2023,S41G01N172,안양 KGC,Away,오마리 스펠맨,12,2,10,20.0,1,7,14.3,3,17,17.6,5,5,100.0,1,5,6,1,2,2,0,0,1,2
../kbl_data/2022-2023,S41G01N172,안양 KGC,Away,고찬혁,0,0,0,0.0,0,0,0.0,0,0,0.0,0,0,0.0,0,0,0,0,0,0,0,0,0,0
../kbl_data/2022-2023,S41G01N173,원주 DB,Home,박찬희,6,3,3,100.0,0,4,0.0,3,7,42.9,0,0,0.0,1,4,5,6,3,0,0,0,0,3
../kbl_data/2022-2023,S41G01N173,원주 DB,Home,김현호,12,6,7,85.7,0,0,0.0,6,7,85.7,0,1,0.0,0,3,3,5,0,0,0,0,1,3
../kbl_data/2022-2023,S41G01N173,원주 DB,Home,김종규,12,5,6,83.3,0,0,0.0,5,6,83.3,2,2,100.0,2,4,6,1,0,2,0,2,0,3
../kbl_data/2022-2023,S41G01N173,원주 DB,Home,최승욱,2,1,3,33.3,0,1,0.0,1,4,25.0,0,0,0.0,3,0,3,3,0,0,0,0,1,2
../kbl_data/2022-2023,S41G01N173,원주 DB,Home,강상재,11,4,9,44.4,1,3,33.3,5,12,41.7,0,0,0.0,1,3,4,3,0,0,0,0,1,1
../kbl_data/2022-2023,S41G01N173,원주 DB,Home,윤성원,0,0,0,0.0,0,0,0.0,0,0,0.0,0,0,0.0,0,0,0,0,0,0,0,0,0,0
../kbl_data/2022-2023,S41G01N173,원주 DB,Home,이준희,0,0,0,0.0,0,0,0.0,0,0,0.0,0,0,0.0,0,0,0,0,0,0,0,0,0,0
../kbl_data/2022-2023,S41G01N173,원주 DB,Home,레나드 프리먼,10,3,5,60.0,1,1,100.0,4,6,66.7,1,2,50.0,0,2,2,0,1,0,0,1,0,0
../kbl_data/2022-2023,S41G01N173,원주 DB,Home,정호영,9,3,5,60.0,1,3,33.3,4,8,50.0,0,0,0.0,1,1,2,4,0,0,0,0,0,1
../kbl_data/2022-2023,S41G01N173,원주 DB,Home,이민석,0,0,0,0.0,0,1,0.0,0,1,0.0,0,0,0.0,0,0,0,0,0,0,0,0,0,0
../kbl_data/2022-2023,S41G01N173,원주 DB,Home,이선 알바노,15,5,11,45.5,1,3,33.3,6,14,42.9,2,2,100.0,2,1,3,4,4,0,0,0,1,3
../kbl_data/2022-2023,S41G01N173,원주 DB,Home,드완 에르난데스,12,6,9,66.7,0,0,0.0,6,9,66.7,0,0,0.0,3,6,9,0,1,3,0,3,1,1
../kbl_data/2022-2023,S41G01N173,전주 KCC,Away,정창영,0,0,2,0.0,0,2,0.0,0,4,0.0,0,0,0.0,1,0,1,3,1,0,0,0,0,3
../kbl_data/2022-2023,S41G01N173,전주 KCC,Away,라건아,10,4,10,40.0,0,3,0.0,4,13,30.8,2,2,100.0,8,9,17,2,1,1,0,0,3,2
../kbl_data/2022-2023,S41G01N173,전주 KCC,Away,박경상,0,0,1,0.0,0,1,0.0,0,2,0.0,0,0,0.0,0,0,0,0,0,0,0,0,0,0
../kbl_data/2022-2023,S41G01N173,전주 KCC,Away,김지완,7,2,3,66.7,1,2,50.0,3,5,60.0,0,0,0.0,0,0,0,1,1,0,0,0,1,0
../kbl_data/2022-2023,S41G01N173,전주 KCC,Away,김상규,9,3,3,100.0,1,3,33.3,4,6,66.7,0,0,0.0,3,2,5,3,1,0,0,0,3,2
../kbl_data/2022-2023,S41G01N173,전주 KCC,Away,전준범,4,2,4,50.0,0,3,0.0,2,7,28.6,0,0,0.0,0,1,1,1,0,0,0,0,1,3
../kbl_data/2022-2023,S41G01N173,전주 KCC,Away,허웅,32,5,10,50.0,6,8,75.0,11,18,61.1,4,5,80.0,0,3,3,2,0,0,0,0,2,0
../kbl_data/2022-2023,S41G01N173,전주 KCC,Away,이진욱,2,1,1,100.0,0,0,0.0,1,1,100.0,0,0,0.0,0,0,0,1,0,0,0,0,0,2
../kbl_data/2022-2023,S41G01N173,전주 KCC,Away,이근휘,0,0,0,0.0,0,0,0.0,0,0,0.0,0,0,0.0,0,1,1,0,0,0,0,0,0,0
../kbl_data/2022-2023,S41G01N173,전주 KCC,Away,서정현,0,0,0,0.0,0,0,0.0,0,0,0.0,0,0,0.0,0,0,0,0,0,0,0,0,0,0
../kbl_data/2022-2023,S41G01N173,전주 KCC,Away,론데 홀리스 제퍼슨,4,1,5,20.0,0,0,0.0,1,5,20.0,2,2,100.0,1,2,3,0,0,0,0,0,1,0
../kbl_data/2022-2023,S41G01N173,전주 KCC,Away,칼빈 제프리 에피스톨라,5,1,2,50.0,1,3,33.3,2,5,40.0,0,0,0.0,0,4,4,1,0,0,0,0,1,1
../kbl_data/2022-2023,S41G01N174,수원 KT,Home,김동욱,3,0,0,0.0,1,3,33.3,1,3,33.3,0,0,0.0,0,1,1,3,0,0,0,0,1,2
../kbl_data/2022-2023,S41G01N174,수원 KT,Home,김영환,0,0,0,0.0,0,1,0.0,0,1,0.0,0,0,0.0,0,0,0,0,1,0,0,0,1,0
../kbl_data/2022-2023,S41G01N174,수원 KT,Home,한희원,0,0,0,0.0,0,0,0.0,0,0,0.0,0,0,0.0,0,0,0,0,0,0,0,0,0,0
../kbl_data/2022-2023,S41G01N174,수원 KT,Home,정성우,10,3,6,50.0,1,6,16.7,4,12,33.3,1,2,50.0,1,1,2,3,3,0,0,0,3,3
../kbl_data/2022-2023,S41G01N174,수원 KT,Home,최성모,2,1,2,50.0,0,2,0.0,1,4,25.0,0,0,0.0,2,0,2,1,0,0,1,0,1,2
../kbl_data/2022-2023,S41G01N174,수원 KT,Home,양홍석,26,8,13,61.5,2,6,33.3,10,19,52.6,4,4,100.0,3,2,5,5,1,0,0,0,0,1
../kbl_data/2022-2023,S41G01N174,수원 KT,Home,박지원,0,0,0,0.0,0,0,0.0,0,0,0.0,0,0,0.0,0,0,0,0,0,0,0,0,0,0
../kbl_data/2022-2023,S41G01N174,수원 KT,Home,하윤기,18,9,13,69.2,0,0,0.0,9,13,69.2,0,1,0.0,2,6,8,1,1,0,0,2,5,2
../kbl_data/2022-2023,S41G01N174,수원 KT,Home,이두원,0,0,0,0.0,0,0,0.0,0,0,0.0,0,0,0.0,0,0,0,0,0,0,0,0,0,0
../kbl_data/2022-2023,S41G01N174,수원 KT,Home,레스터 프로스퍼,5,1,3,33.3,1,1,100.0,2,4,50.0,0,0,0.0,2,2,4,0,0,0,0,0,0,3
../kbl_data/2022-2023,S41G01N174,수원 KT,Home,재로드 존스,15,3,7,42.9,2,4,50.0,5,11,45.5,3,3,100.0,2,8,10,6,1,2,0,0,1,3
../kbl_data/2022-2023,S41G01N174,수원 KT,Home,데이브 일데폰소,1,0,1,0.0,0,1,0.0,0,2,0.0,1,2,50.0,1,1,2,0,0,0,0,0,0,1
../kbl_data/2022-2023,S41G01N174,창원 LG,Away,이관희,9,0,2,0.0,3,9,33.3,3,11,27.3,0,0,0.0,0,4,4,4,2,0,0,0,2,0
../kbl_data/2022-2023,S41G01N174,창원 LG,Away,정희재,11,1,2,50.0,3,6,50.0,4,8,50.0,0,0,0.0,3,2,5,1,3,0,1,0,1,4
../kbl_data/2022-2023,S41G01N174,창원 LG,Away,임동섭,2,1,1,100.0,0,0,0.0,1,1,100.0,0,0,0.0,1,2,3,0,0,0,0,0,1,2
../kbl_data/2022-2023,S41G01N174,창원 LG,Away,서민수,0,0,0,0.0,0,0,0.0,0,0,0.0,0,0,0.0,0,0,0,0,0,0,0,0,0,0
../kbl_data/2022-2023,S41G01N174,창원 LG,Away,이재도,19,8,12,66.7,1,6,16.7,9,18,50.0,0,0,0.0,3,2,5,5,0,0,0,0,2,2
../kbl_data/2022-2023,S41G01N174,창원 LG,Away,김준일,6,3,4,75.0,0,0,0.0,3,4,75.0,0,0,0.0,0,1,1,2,0,0,0,0,0,3
../kbl_data/2022-2023,S41G01N174,창원 LG,Away,정인덕,4,2,6,33.3,0,2,0.0,2,8,25.0,0,0,0.0,2,1,3,1,1,0,0,0,0,1
../kbl_data/2022-2023,S41G01N174,창원 LG,Away,윤원상,2,1,1,100.0,0,0,0.0,1,1,100.0,0,0,0.0,0,0,0,0,0,0,0,0,0,1
../kbl_data/2022-2023,S41G01N174,창원 LG,Away,아셈 마레이,22,9,13,69.2,0,0,0.0,9,13,69.2,4,8,50.0,6,3,9,6,2,1,0,3,4,0
../kbl_data/2022-2023,S41G01N174,창원 LG,Away,저스틴 구탕,2,1,1,100.0,0,1,0.0,1,2,50.0,0,0,0.0,0,3,3,2,0,0,0,0,0,1
../kbl_data/2022-2023,S41G01N174,창원 LG,Away,양준석,0,0,0,0.0,0,0,0.0,0,0,0.0,0,0,0.0,0,0,0,0,0,0,0,0,0,0
../kbl_data/2022-2023,S41G01N174,창원 LG,Away,단테 커닝햄,4,1,5,20.0,0,0,0.0,1,5,20.0,2,2,100.0,1,3,4,0,1,0,0,0,1,2
../kbl_data/2022-2023,S41G01N175,안양 KGC,Home,양희종,0,0,0,0.0,0,3,0.0,0,3,0.0,0,0,0.0,1,0,1,1,0,0,0,0,1,3
../kbl_data/2022-2023,S41G01N175,안양 KGC,Home,오세근,18,5,8,62.5,1,2,50.0,6,10,60.0,5,6,83.3,6,5,11,2,2,1,0,0,1,2
../kbl_data/2022-2023,S41G01N175,안양 KGC,Home,정준원,0,0,0,0.0,0,0,0.0,0,0,0.0,0,0,0.0,0,0,0,1,0,0,0,0,0,0
../kbl_data/2022-2023,S41G01N175,안양 KGC,Home,배병준,11,1,5,20.0,3,7,42.9,4,12,33.3,0,0,0.0,0,2,2,0,1,0,0,0,2,2
../kbl_data/2022-2023,S41G01N175,안양 KGC,Home,문성곤,6,0,1,0.0,1,4,25.0,1,5,20.0,3,4,75.0,1,2,3,2,2,0,0,0,1,4
../kbl_data/2022-2023,S41G01N175,안양 KGC,Home,박지훈,20,4,4,100.0,2,12,16.7,6,16,37.5,6,8,75.0,0,6,6,4,2,0,0,0,4,10
../kbl_data/2022-2023,S41G01N175,안양 KGC,Home,대릴 먼로,14,6,13,46.2,0,2,0.0,6,15,40.0,2,2,100.0,6,3,9,1,0,0,0,0,2,3
../kbl_data/2022-2023,S41G01N175,안양 KGC,Home,변준형,26,3,8,37.5,4,6,66.7,7,14,50.0,8,9,88.9,2,3,5,5,1,0,0,0,3,4
../kbl_data/2022-2023,S41G01N175,안양 KGC,Home,한승희,0,0,4,0.0,0,1,0.0,0,5,0.0,0,0,0.0,3,1,4,2,2,0,0,0,0,0
../kbl_data/2022-2023,S41G01N175,안양 KGC,Home,오마리 스펠맨,2,1,3,33.3,0,4,0.0,1,7,14.3,0,0,0.0,1,6,7,1,1,0,0,0,3,0
../kbl_data/2022-2023,S41G01N175,안양 KGC,Home,조은후,0,0,1,0.0,0,0,0.0,0,1,0.0,0,0,0.0,0,0,0,0,0,0,0,0,0,0
../kbl_data/2022-2023,S41G01N175,안양 KGC,Home,고찬혁,0,0,0,0.0,0,0,0.0,0,0,0.0,0,0,0.0,0,0,0,0,0,0,0,0,0,0
../kbl_data/2022-2023,S41G01N175,대구 한국가스공사,Away,차바위,1,0,0,0.0,0,1,0.0,0,1,0.0,1,2,50.0,2,2,4,1,0,0,0,0,0,0
../kbl_data/2022-2023,S41G01N175,대구 한국가스공사,Away,박지훈,20,4,4,100.0,2,12,16.7,6,16,37.5,6,8,75.0,0,6,6,4,2,0,0,0,4,10
../kbl_data/2022-2023,S41G01N175,대구 한국가스공사,Away,이원대,0,0,1,0.0,0,0,0.0,0,1,0.0,0,0,0.0,0,1,1,1,1,0,0,0,0,3
../kbl_data/2022-2023,S41G01N175,대구 한국가스공사,Away,이대헌,10,1,3,33.3,2,2,100.0,3,5,60.0,2,4,50.0,0,1,1,0,1,0,0,0,1,2
../kbl_data/2022-2023,S41G01N175,대구 한국가스공사,Away,이대성,29,5,7,71.4,3,6,50.0,8,13,61.5,10,10,100.0,1,3,4,6,2,2,0,0,4,3
../kbl_data/2022-2023,S41G01N175,대구 한국가스공사,Away,정효근,14,4,7,57.1,1,1,100.0,5,8,62.5,3,3,100.0,1,7,8,1,3,0,0,0,3,4
../kbl_data/2022-2023,S41G01N175,대구 한국가스공사,Away,박봉진,0,0,0,0.0,0,0,0.0,0,0,0.0,0,0,0.0,0,0,0,0,0,0,0,0,0,0
../kbl_data/2022-2023,S41G01N175,대구 한국가스공사,Away,우동현,0,0,0,0.0,0,2,0.0,0,2,0.0,0,0,0.0,0,0,0,1,0,0,0,0,0,1
../kbl_data/2022-2023,S41G01N175,대구 한국가스공사,Away,전현우,4,0,3,0.0,1,3,33.3,1,6,16.7,1,1,100.0,0,0,0,1,1,0,0,0,0,0
../kbl_data/2022-2023,S41G01N175,대구 한국가스공사,Away,데본 스캇,15,5,12,41.7,1,4,25.0,6,16,37.5,2,3,66.7,2,14,16,7,1,1,0,0,6,4
../kbl_data/2022-2023,S41G01N175,대구 한국가스공사,Away,신승민,3,1,3,33.3,0,3,0.0,1,6,16.7,1,2,50.0,2,4,6,0,0,0,1,0,0,3
../kbl_data/2022-2023,S41G01N175,대구 한국가스공사,Away,샘조세프 벨란겔,9,3,4,75.0,1,2,50.0,4,6,66.7,0,0,0.0,0,0,0,0,2,0,1,0,1,3
../kbl_data/2022-2023,S41G01N176,울산 현대모비스,Home,함지훈,8,1,4,25.0,0,0,0.0,1,4,25.0,6,6,100.0,2,1,3,6,1,0,0,0,1,2
../kbl_data/2022-2023,S41G01N176,울산 현대모비스,Home,김현민,0,0,0,0.0,0,0,0.0,0,0,0.0,0,0,0.0,0,0,0,0,0,0,0,0,1,1
../kbl_data/2022-2023,S41G01N176,울산 현대모비스,Home,최진수,0,0,0,0.0,0,0,0.0,0,0,0.0,0,0,0.0,0,0,0,0,0,0,0,0,0,0
../kbl_data/2022-2023,S41G01N176,울산 현대모비스,Home,장재석,2,1,6,16.7,0,0,0.0,1,6,16.7,0,0,0.0,0,2,2,1,1,1,0,0,1,2
../kbl_data/2022-2023,S41G01N176,울산 현대모비스,Home,김영현,0,0,1,0.0,0,4,0.0,0,5,0.0,0,0,0.0,0,0,0,0,0,0,0,0,0,1
../kbl_data/2022-2023,S41G01N176,울산 현대모비스,Home,서명진,10,2,4,50.0,2,2,100.0,4,6,66.7,0,0,0.0,1,1,2,1,0,0,0,0,1,3
../kbl_data/2022-2023,S41G01N176,울산 현대모비스,Home,헨리 심스,5,1,2,50.0,1,1,100.0,2,3,66.7,0,0,0.0,1,3,4,0,0,0,0,0,0,0
../kbl_data/2022-2023,S41G01N176,울산 현대모비스,Home,이우석,11,4,7,57.1,1,4,25.0,5,11,45.5,0,0,0.0,0,4,4,3,1,0,0,0,0,4
../kbl_data/2022-2023,S41G01N176,울산 현대모비스,Home,신민석,6,0,0,0.0,2,5,40.0,2,5,40.0,0,0,0.0,1,2,3,1,0,0,0,0,1,2
../kbl_data/2022-2023,S41G01N176,울산 현대모비스,Home,론제이 아바리엔토스,20,3,4,75.0,4,11,36.4,7,15,46.7,2,2,100.0,1,4,5,5,1,1,0,0,2,1
../kbl_data/2022-2023,S41G01N176,울산 현대모비스,Home,게이지 프림,17,7,14,50.0,0,1,0.0,7,15,46.7,3,4,75.0,3,10,13,0,0,2,0,0,0,3
../kbl_data/2022-2023,S41G01N176,울산 현대모비스,Home,김태완,0,0,1,0.0,0,0,0.0,0,1,0.0,0,0,0.0,0,0,0,0,0,0,0,0,0,1
../kbl_data/2022-2023,S41G01N176,서울 SK,Away,양우섭,4,2,2,100.0,0,2,0.0,2,4,50.0,0,0,0.0,1,1,2,0,1,0,0,0,1,0
../kbl_data/2022-2023,S41G01N176,서울 SK,Away,허일영,3,0,1,0.0,0,0,0.0,0,1,0.0,3,4,75.0,1,4,5,0,0,0,0,0,1,2
../kbl_data/2022-2023,S41G01N176,서울 SK,Away,김선형,6,3,8,37.5,0,2,0.0,3,10,30.0,0,0,0.0,1,1,2,6,0,2,0,0,2,1
../kbl_data/2022-2023,S41G01N176,서울 SK,Away,홍경기,0,0,0,0.0,0,0,0.0,0,0,0.0,0,0,0.0,0,0,0,0,0,0,0,0,0,1
../kbl_data/2022-2023,S41G01N176,서울 SK,Away,최부경,16,7,13,53.8,0,0,0.0,7,13,53.8,2,2,100.0,4,4,8,2,0,1,0,0,1,4
../kbl_data/2022-2023,S41G01N176,서울 SK,Away,리온 윌리엄스,5,2,3,66.7,0,1,0.0,2,4,50.0,1,1,100.0,1,0,1,0,2,0,0,0,0,0
../kbl_data/2022-2023,S41G01N176,서울 SK,Away,최원혁,2,0,1,0.0,0,0,0.0,0,1,0.0,2,2,100.0,3,1,4,0,0,0,0,0,0,1
../kbl_data/2022-2023,S41G01N176,서울 SK,Away,최준용,0,0,0,0.0,0,0,0.0,0,0,0.0,0,0,0.0,0,0,0,0,0,0,0,0,0,0
../kbl_data/2022-2023,S41G01N176,서울 SK,Away,최성원,8,0,1,0.0,2,5,40.0,2,6,33.3,2,2,100.0,0,0,0,2,0,0,0,0,2,2
../kbl_data/2022-2023,S41G01N176,서울 SK,Away,자밀 워니,15,6,19,31.6,0,3,0.0,6,22,27.3,3,4,75.0,3,15,18,3,0,1,0,0,2,0
../kbl_data/2022-2023,S41G01N176,서울 SK,Away,김형빈,2,1,2,50.0,0,2,0.0,1,4,25.0,0,0,0.0,0,1,1,0,0,2,0,0,0,5
../kbl_data/2022-2023,S41G01N176,서울 SK,Away,오재현,4,2,5,40.0,0,1,0.0,2,6,33.3,0,0,0.0,0,1,1,1,1,0,0,0,2,0
../kbl_data/2022-2023,S41G01N177,고양 캐롯,Home,김강선,3,0,1,0.0,1,7,14.3,1,8,12.5,0,0,0.0,1,0,1,0,1,0,1,0,0,4
../kbl_data/2022-2023,S41G01N177,고양 캐롯,Home,최현민,4,0,0,0.0,1,1,100.0,1,1,100.0,1,2,50.0,1,2,3,0,0,1,0,0,0,1
../kbl_data/2022-2023,S41G01N177,고양 캐롯,Home,임종일,0,0,0,0.0,0,0,0.0,0,0,0.0,0,0,0.0,0,0,0,0,0,0,0,0,0,0
../kbl_data/2022-2023,S41G01N177,고양 캐롯,Home,전성현,9,3,8,37.5,0,7,0.0,3,15,20.0,3,3,100.0,0,3,3,6,3,0,0,0,3,1
../kbl_data/2022-2023,S41G01N177,고양 캐롯,Home,이종현,0,0,1,0.0,0,1,0.0,0,2,0.0,0,0,0.0,0,1,1,0,0,0,0,0,0,0
../kbl_data/2022-2023,S41G01N177,고양 캐롯,Home,김진유,0,0,0,0.0,0,2,0.0,0,2,0.0,0,0,0.0,0,3,3,0,0,0,0,0,1,1
../kbl_data/2022-2023,S41G01N177,고양 캐롯,Home,조한진,12,3,4,75.0,2,9,22.2,5,13,38.5,0,0,0.0,0,2,2,1,1,0,0,0,0,1
../kbl_data/2022-2023,S41G01N177,고양 캐롯,Home,디드릭 로슨,29,12,18,66.7,0,2,0.0,12,20,60.0,5,6,83.3,7,12,19,2,3,2,0,2,1,3
../kbl_data/2022-2023,S41G01N177,고양 캐롯,Home,박진철,0,0,0,0.0,0,0,0.0,0,0,0.0,0,0,0.0,0,0,0,0,0,0,0,0,0,0
../kbl_data/2022-2023,S41G01N177,고양 캐롯,Home,이정현,20,6,16,37.5,0,16,0.0,6,32,18.8,8,12,66.7,0,10,10,16,4,0,0,0,6,10
../kbl_data/2022-2023,S41G01N177,고양 캐롯,Home,모리구치 히사시,5,0,1,0.0,1,1,100.0,1,2,50.0,2,2,100.0,1,2,3,0,1,0,0,0,1,3
../kbl_data/2022-2023,S41G01N177,고양 캐롯,Home,조나단 알렛지,2,0,1,0.0,0,0,0.0,0,1,0.0,2,2,100.0,1,0,1,0,0,0,0,0,0,0
../kbl_data/2022-2023,S41G01N177,서울 삼성,Away,이정현,20,6,16,37.5,0,16,0.0,6,32,18.8,8,12,66.7,0,10,10,16,4,0,0,0,6,10
../kbl_data/2022-2023,S41G01N177,서울 삼성,Away,장민국,5,2,3,66.7,0,0,0.0,2,3,66.7,1,2,50.0,3,4,7,0,0,0,0,0,0,4
../kbl_data/2022-2023,S41G01N177,서울 삼성,Away,김시래,3,0,2,0.0,0,2,0.0,0,4,0.0,3,4,75.0,0,2,2,3,1,0,0,0,1,4
../kbl_data/2022-2023,S41G01N177,서울 삼성,Away,이동엽,10,2,3,66.7,2,3,66.7,4,6,66.7,0,0,0.0,0,0,0,1,0,0,0,0,0,2
../kbl_data/2022-2023,S41G01N177,서울 삼성,Away,이호현,10,3,4,75.0,1,3,33.3,4,7,57.1,1,2,50.0,0,5,5,3,3,0,0,0,3,1
../kbl_data/2022-2023,S41G01N177,서울 삼성,Away,강바일,0,0,0,0.0,0,0,0.0,0,0,0.0,0,0,0.0,0,0,0,0,0,0,0,0,0,0
../kbl_data/2022-2023,S41G01N177,서울 삼성,Away,김한솔,2,1,1,100.0,0,0,0.0,1,1,100.0,0,0,0.0,0,1,1,0,0,0,0,0,1,1
../kbl_data/2022-2023,S41G01N177,서울 삼성,Away,김진영,0,0,0,0.0,0,0,0.0,0,0,0.0,0,0,0.0,0,0,0,0,0,0,0,0,0,0
../kbl_data/2022-2023,S41G01N177,서울 삼성,Away,차민석,2,1,2,50.0,0,0,0.0,1,2,50.0,0,0,0.0,1,0,1,2,0,0,0,0,1,5
../kbl_data/2022-2023,S41G01N177,서울 삼성,Away,신동혁,7,1,2,50.0,1,3,33.3,2,5,40.0,2,2,100.0,2,4,6,0,0,0,0,0,0,3
../kbl_data/2022-2023,S41G01N177,서울 삼성,Away,다랄 윌리스,15,4,10,40.0,0,5,0.0,4,15,26.7,7,9,77.8,0,11,11,0,0,3,0,1,5,3
../kbl_data/2022-2023,S41G01N177,서울 삼성,Away,앤서니 모스,5,2,5,40.0,0,0,0.0,2,5,40.0,1,2,50.0,4,3,7,0,0,1,0,0,2,1
../kbl_data/2022-2023,S41G01N178,수원 KT,Home,김동욱,5,1,2,50.0,1,2,50.0,2,4,50.0,0,0,0.0,0,1,1,1,0,0,0,0,0,2
../kbl_data/2022-2023,S41G01N178,수원 KT,Home,김영환,0,0,0,0.0,0,0,0.0,0,0,0.0,0,0,0.0,0,0,0,0,0,0,0,0,0,0
../kbl_data/2022-2023,S41G01N178,수원 KT,Home,한희원,2,0,0,0.0,0,2,0.0,0,2,0.0,2,2,100.0,0,1,1,2,0,0,0,0,0,1
../kbl_data/2022-2023,S41G01N178,수원 KT,Home,정성우,22,4,4,100.0,3,7,42.9,7,11,63.6,5,7,71.4,0,2,2,5,2,0,0,0,2,4
../kbl_data/2022-2023,S41G01N178,수원 KT,Home,최성모,0,0,0,0.0,0,0,0.0,0,0,0.0,0,0,0.0,0,1,1,0,0,0,0,0,2,1
../kbl_data/2022-2023,S41G01N178,수원 KT,Home,양홍석,10,3,6,50.0,0,5,0.0,3,11,27.3,4,5,80.0,0,5,5,2,2,0,0,0,2,2
../kbl_data/2022-2023,S41G01N178,수원 KT,Home,박지원,0,0,0,0.0,0,0,0.0,0,0,0.0,0,0,0.0,0,0,0,0,0,0,0,0,0,0
../kbl_data/2022-2023,S41G01N178,수원 KT,Home,하윤기,16,7,10,70.0,0,0,0.0,7,10,70.0,2,2,100.0,3,3,6,3,0,0,0,0,2,2
../kbl_data/2022-2023,S41G01N178,수원 KT,Home,이두원,0,0,0,0.0,0,0,0.0,0,0,0.0,0,0,0.0,0,0,0,1,0,0,0,0,0,1
../kbl_data/2022-2023,S41G01N178,수원 KT,Home,레스터 프로스퍼,0,0,0,0.0,0,0,0.0,0,0,0.0,0,0,0.0,0,0,0,0,0,0,0,0,0,1
../kbl_data/2022-2023,S41G01N178,수원 KT,Home,재로드 존스,23,6,8,75.0,3,5,60.0,9,13,69.2,2,2,100.0,2,7,9,1,0,2,0,1,1,2
../kbl_data/2022-2023,S41G01N178,수원 KT,Home,데이브 일데폰소,10,2,4,50.0,2,3,66.7,4,7,57.1,0,0,0.0,1,1,2,2,0,0,0,0,2,3
../kbl_data/2022-2023,S41G01N178,대구 한국가스공사,Away,차바위,0,0,0,0.0,0,1,0.0,0,1,0.0,0,0,0.0,1,1,2,1,1,0,0,0,0,3
../kbl_data/2022-2023,S41G01N178,대구 한국가스공사,Away,박지훈,0,0,0,0.0,0,0,0.0,0,0,0.0,0,0,0.0,0,0,0,0,0,0,0,0,0,1
../kbl_data/2022-2023,S41G01N178,대구 한국가스공사,Away,이원대,0,0,1,0.0,0,0,0.0,0,1,0.0,0,0,0.0,0,0,0,0,0,0,0,0,0,0
../kbl_data/2022-2023,S41G01N178,대구 한국가스공사,Away,이대성,22,5,10,50.0,2,8,25.0,7,18,38.9,6,6,100.0,1,3,4,4,1,0,0,0,1,4
../kbl_data/2022-2023,S41G01N178,대구 한국가스공사,Away,정효근,13,3,6,50.0,2,9,22.2,5,15,33.3,1,2,50.0,1,4,5,1,0,0,0,0,1,4
../kbl_data/2022-2023,S41G01N178,대구 한국가스공사,Away,박봉진,0,0,0,0.0,0,0,0.0,0,0,0.0,0,0,0.0,0,0,0,0,0,0,0,0,0,0
../kbl_data/2022-2023,S41G01N178,대구 한국가스공사,Away,머피 할로웨이,21,10,11,90.9,0,0,0.0,10,11,90.9,1,3,33.3,6,7,13,4,3,1,0,0,4,3
../kbl_data/2022-2023,S41G01N178,대구 한국가스공사,Away,우동현,0,0,0,0.0,0,2,0.0,0,2,0.0,0,0,0.0,0,0,0,1,0,0,0,0,0,0
../kbl_data/2022-2023,S41G01N178,대구 한국가스공사,Away,전현우,5,1,1,100.0,1,3,33.3,2,4,50.0,0,0,0.0,0,1,1,2,1,0,0,0,0,1
../kbl_data/2022-2023,S41G01N178,대구 한국가스공사,Away,데본 스캇,3,1,3,33.3,0,0,0.0,1,3,33.3,1,2,50.0,1,0,1,2,1,0,0,0,0,0
../kbl_data/2022-2023,S41G01N178,대구 한국가스공사,Away,신승민,12,3,4,75.0,2,3,66.7,5,7,71.4,0,0,0.0,2,1,3,2,1,0,1,0,0,5
../kbl_data/2022-2023,S41G01N178,대구 한국가스공사,Away,샘조세프 벨란겔,8,4,5,80.0,0,2,0.0,4,7,57.1,0,0,0.0,1,1,2,0,0,0,1,0,1,0
../kbl_data/2022-2023,S41G01N179,전주 KCC,Home,정창영,12,4,5,80.0,1,3,33.3,5,8,62.5,1,2,50.0,5,7,12,4,4,0,0,0,1,2
../kbl_data/2022-2023,S41G01N179,전주 KCC,Home,라건아,6,2,7,28.6,0,0,0.0,2,7,28.6,2,2,100.0,2,1,3,1,0,0,0,0,1,0
../kbl_data/2022-2023,S41G01N179,전주 KCC,Home,박경상,0,0,0,0.0,0,1,0.0,0,1,0.0,0,0,0.0,0,0,0,0,0,0,0,0,0,1
../kbl_data/2022-2023,S41G01N179,전주 KCC,Home,김지완,6,0,0,0.0,2,4,50.0,2,4,50.0,0,0,0.0,1,2,3,5,0,0,0,0,1,4
../kbl_data/2022-2023,S41G01N179,전주 KCC,Home,김상규,5,1,2,50.0,1,2,50.0,2,4,50.0,0,0,0.0,1,0,1,0,0,1,1,0,0,2
../kbl_data/2022-2023,S41G01N179,전주 KCC,Home,전준범,3,1,1,100.0,0,2,0.0,1,3,33.3,1,1,100.0,0,0,0,1,0,0,0,0,0,1
../kbl_data/2022-2023,S41G01N179,전주 KCC,Home,허웅,11,3,7,42.9,1,5,20.0,4,12,33.3,2,2,100.0,0,5,5,5,0,0,0,0,1,4
../kbl_data/2022-2023,S41G01N179,전주 KCC,Home,이진욱,0,0,0,0.0,0,0,0.0,0,0,0.0,0,0,0.0,0,0,0,0,0,0,0,0,0,0
../kbl_data/2022-2023,S41G01N179,전주 KCC,Home,이근휘,0,0,0,0.0,0,1,0.0,0,1,0.0,0,0,0.0,0,1,1,0,0,0,0,0,0,0
../kbl_data/2022-2023,S41G01N179,전주 KCC,Home,서정현,0,0,0,0.0,0,0,0.0,0,0,0.0,0,0,0.0,0,0,0,0,0,0,0,0,0,0
../kbl_data/2022-2023,S41G01N179,전주 KCC,Home,론데 홀리스 제퍼슨,37,14,23,60.9,1,2,50.0,15,25,60.0,6,9,66.7,1,10,11,1,2,1,0,0,2,0
../kbl_data/2022-2023,S41G01N179,전주 KCC,Home,칼빈 제프리 에피스톨라,1,0,0,0.0,0,0,0.0,0,0,0.0,1,2,50.0,0,1,1,0,0,0,0,0,1,3
../kbl_data/2022-2023,S41G01N179,안양 KGC,Away,양희종,0,0,0,0.0,0,1,0.0,0,1,0.0,0,0,0.0,0,1,1,0,0,0,0,0,0,1
../kbl_data/2022-2023,S41G01N179,안양 KGC,Away,오세근,8,2,9,22.2,1,1,100.0,3,10,30.0,1,2,50.0,4,6,10,2,2,1,0,0,1,2
../kbl_data/2022-2023,S41G01N179,안양 KGC,Away,정준원,0,0,1,0.0,0,0,0.0,0,1,0.0,0,0,0.0,0,0,0,0,0,0,0,0,0,0
../kbl_data/2022-2023,S41G01N179,안양 KGC,Away,배병준,10,1,2,50.0,2,5,40.0,3,7,42.9,2,2,100.0,0,1,1,2,1,0,0,0,0,1
../kbl_data/2022-2023,S41G01N179,안양 KGC,Away,문성곤,12,3,3,100.0,2,6,33.3,5,9,55.6,0,0,0.0,0,0,0,2,0,0,0,0,4,3
../kbl_data/2022-2023,S41G01N179,안양 KGC,Away,박지훈,0,0,2,0.0,0,1,0.0,0,3,0.0,0,0,0.0,0,1,1,1,0,0,0,0,0,2
../kbl_data/2022-2023,S41G01N179,안양 KGC,Away,대릴 먼로,0,0,0,0.0,0,0,0.0,0,0,0.0,0,0,0.0,0,0,0,0,0,0,1,0,0,1
../kbl_data/2022-2023,S41G01N179,안양 KGC,Away,변준형,11,3,8,37.5,1,5,20.0,4,13,30.8,2,3,66.7,2,3,5,8,1,0,0,0,0,2
../kbl_data/2022-2023,S41G01N179,안양 KGC,Away,한승희,5,2,2,100.0,0,0,0.0,2,2,100.0,1,2,50.0,2,1,3,0,0,0,0,0,1,5
../kbl_data/2022-2023,S41G01N179,안양 KGC,Away,오마리 스펠맨,34,8,12,66.7,6,8,75.0,14,20,70.0,0,0,0.0,2,9,11,5,0,2,0,1,1,2
../kbl_data/2022-2023,S41G01N179,안양 KGC,Away,조은후,0,0,0,0.0,0,0,0.0,0,0,0.0,0,0,0.0,0,0,0,0,0,0,0,0,0,0
../kbl_data/2022-2023,S41G01N179,안양 KGC,Away,고찬혁,3,0,0,0.0,1,2,50.0,1,2,50.0,0,0,0.0,0,1,1,0,0,0,0,0,0,0
../kbl_data/2022-2023,S41G01N180,서울 SK,Home,양우섭,2,1,3,33.3,0,1,0.0,1,4,25.0,0,0,0.0,0,1,1,0,0,0,1,0,0,3
../kbl_data/2022-2023,S41G01N180,서울 SK,Home,허일영,5,0,3,0.0,1,2,50.0,1,5,20.0,2,2,100.0,1,3,4,0,0,1,0,0,1,2
../kbl_data/2022-2023,S41G01N180,서울 SK,Home,김선형,20,4,10,40.0,2,6,33.3,6,16,37.5,6,6,100.0,0,3,3,3,2,0,1,0,8,3
../kbl_data/2022-2023,S41G01N180,서울 SK,Home,홍경기,0,0,0,0.0,0,0,0.0,0,0,0.0,0,0,0.0,0,0,0,0,0,0,0,0,0,1
../kbl_data/2022-2023,S41G01N180,서울 SK,Home,최부경,0,0,0,0.0,0,0,0.0,0,0,0.0,0,0,0.0,1,0,1,0,1,0,0,0,0,1
../kbl_data/2022-2023,S41G01N180,서울 SK,Home,리온 윌리엄스,0,0,1,0.0,0,0,0.0,0,1,0.0,0,0,0.0,1,0,1,0,0,0,0,0,0,1
../kbl_data/2022-2023,S41G01N180,서울 SK,Home,최원혁,0,0,0,0.0,0,0,0.0,0,0,0.0,0,0,0.0,0,1,1,0,0,0,0,0,0,2
../kbl_data/2022-2023,S41G01N180,서울 SK,Home,최준용,8,1,3,33.3,2,5,40.0,3,8,37.5,0,0,0.0,0,4,4,5,0,1,0,0,1,2
../kbl_data/2022-2023,S41G01N180,서울 SK,Home,최성원,3,0,1,0.0,1,2,50.0,1,3,33.3,0,0,0.0,0,1,1,3,1,0,0,0,0,1
../kbl_data/2022-2023,S41G01N180,서울 SK,Home,자밀 워니,26,10,15,66.7,1,3,33.3,11,18,61.1,3,4,75.0,2,11,13,3,1,1,0,0,2,1
../kbl_data/2022-2023,S41G01N180,서울 SK,Home,김형빈,0,0,0,0.0,0,0,0.0,0,0,0.0,0,0,0.0,0,0,0,0,0,0,0,0,0,0
../kbl_data/2022-2023,S41G01N180,서울 SK,Home,오재현,8,2,4,50.0,1,3,33.3,3,7,42.9,1,2,50.0,1,6,7,1,0,1,0,0,0,3
../kbl_data/2022-2023,S41G01N180,창원 LG,Away,이관희,20,2,7,28.6,5,11,45.5,7,18,38.9,1,2,50.0,2,1,3,1,0,1,0,0,0,4
../kbl_data/2022-2023,S41G01N180,창원 LG,Away,정희재,8,1,2,50.0,2,5,40.0,3,7,42.9,0,0,0.0,2,2,4,4,4,0,0,0,0,3
../kbl_data/2022-2023,S41G01N180,창원 LG,Away,임동섭,11,0,1,0.0,3,7,42.9,3,8,37.5,2,2,100.0,0,2,2,1,1,0,0,0,0,2
../kbl_data/2022-2023,S41G01N180,창원 LG,Away,서민수,0,0,0,0.0,0,0,0.0,0,0,0.0,0,0,0.0,0,0,0,0,0,0,0,0,0,0
../kbl_data/2022-2023,S41G01N180,창원 LG,Away,이재도,4,2,9,22.2,0,1,0.0,2,10,20.0,0,0,0.0,0,2,2,1,2,0,1,0,2,4
../kbl_data/2022-2023,S41G01N180,창원 LG,Away,김준일,4,2,4,50.0,0,0,0.0,2,4,50.0,0,0,0.0,1,3,4,2,0,0,0,0,1,0
../kbl_data/2022-2023,S41G01N180,창원 LG,Away,정인덕,0,0,1,0.0,0,3,0.0,0,4,0.0,0,0,0.0,2,1,3,1,0,0,0,0,1,0
../kbl_data/2022-2023,S41G01N180,창원 LG,Away,윤원상,4,1,1,100.0,0,1,0.0,1,2,50.0,2,2,100.0,0,0,0,1,0,0,0,0,0,2
../kbl_data/2022-2023,S41G01N180,창원 LG,Away,아셈 마레이,19,9,17,52.9,0,0,0.0,9,17,52.9,1,2,50.0,9,13,22,5,2,1,0,0,3,2
../kbl_data/2022-2023,S41G01N180,창원 LG,Away,저스틴 구탕,1,0,0,0.0,0,0,0.0,0,0,0.0,1,2,50.0,0,0,0,0,0,0,0,0,1,0
../kbl_data/2022-2023,S41G01N180,창원 LG,Away,양준석,0,0,1,0.0,0,1,0.0,0,2,0.0,0,0,0.0,0,0,0,1,0,0,0,0,0,0
../kbl_data/2022-2023,S41G01N180,창원 LG,Away,단테 커닝햄,4,1,4,25.0,0,0,0.0,1,4,25.0,2,2,100.0,0,0,0,0,1,0,0,1,1,3
../kbl_data/2022-2023,S41G01N181,고양 캐롯,Home,김강선,9,0,1,0.0,3,5,60.0,3,6,50.0,0,0,0.0,2,1,3,0,1,1,0,0,2,1
../kbl_data/2022-2023,S41G01N181,고양 캐롯,Home,임종일,0,0,0,0.0,0,1,0.0,0,1,0.0,0,0,0.0,0,0,0,0,0,0,0,0,0,0
../kbl_data/2022-2023,S41G01N181,고양 캐롯,Home,전성현,5,1,6,16.7,1,8,12.5,2,14,14.3,0,0,0.0,0,1,1,3,0,0,0,0,2,0
../kbl_data/2022-2023,S41G01N181,고양 캐롯,Home,김진유,10,0,0,0.0,3,11,27.3,3,11,27.3,1,1,100.0,5,6,11,4,0,0,0,0,0,5
../kbl_data/2022-2023,S41G01N181,고양 캐롯,Home,조한진,5,1,1,100.0,1,5,20.0,2,6,33.3,0,0,0.0,3,2,5,1,1,0,0,0,1,3
../kbl_data/2022-2023,S41G01N181,고양 캐롯,Home,김세창,0,0,0,0.0,0,1,0.0,0,1,0.0,0,0,0.0,0,0,0,3,0,0,0,0,0,0
../kbl_data/2022-2023,S41G01N181,고양 캐롯,Home,디드릭 로슨,10,5,7,71.4,0,5,0.0,5,12,41.7,0,0,0.0,3,6,9,5,2,0,0,0,5,2
../kbl_data/2022-2023,S41G01N181,고양 캐롯,Home,박진철,0,0,0,0.0,0,0,0.0,0,0,0.0,0,0,0.0,0,0,0,0,0,0,0,0,0,0
../kbl_data/2022-2023,S41G01N181,고양 캐롯,Home,이정현,9,3,5,60.0,1,10,10.0,4,15,26.7,0,0,0.0,3,1,4,2,1,0,0,0,2,0
../kbl_data/2022-2023,S41G01N181,고양 캐롯,Home,모리구치 히사시,0,0,0,0.0,0,0,0.0,0,0,0.0,0,0,0.0,0,0,0,0,0,0,0,0,0,0
../kbl_data/2022-2023,S41G01N181,고양 캐롯,Home,안정욱,3,0,0,0.0,1,4,25.0,1,4,25.0,0,0,0.0,0,1,1,1,1,0,0,0,0,1
../kbl_data/2022-2023,S41G01N181,고양 캐롯,Home,조나단 알렛지,14,2,4,50.0,3,5,60.0,5,9,55.6,1,2,50.0,3,1,4,0,0,0,0,0,2,3
../kbl_data/2022-2023,S41G01N181,안양 KGC,Away,양희종,5,1,5,20.0,0,1,0.0,1,6,16.7,3,3,100.0,0,9,9,2,0,0,0,0,1,4
../kbl_data/2022-2023,S41G01N181,안양 KGC,Away,오세근,0,0,0,0.0,0,0,0.0,0,0,0.0,0,0,0.0,0,0,0,0,0,0,0,0,0,0
../kbl_data/2022-2023,S41G01N181,안양 KGC,Away,정준원,2,1,1,100.0,0,0,0.0,1,1,100.0,0,0,0.0,0,1,1,0,0,0,0,0,0,0
../kbl_data/2022-2023,S41G01N181,안양 KGC,Away,배병준,4,2,3,66.7,0,5,0.0,2,8,25.0,0,0,0.0,0,1,1,1,2,0,0,0,1,2
../kbl_data/2022-2023,S41G01N181,안양 KGC,Away,문성곤,13,4,7,57.1,1,4,25.0,5,11,45.5,2,2,100.0,5,4,9,1,3,1,0,0,2,1
../kbl_data/2022-2023,S41G01N181,안양 KGC,Away,박지훈,0,0,2,0.0,0,2,0.0,0,4,0.0,0,0,0.0,1,2,3,1,0,0,0,0,1,2
../kbl_data/2022-2023,S41G01N181,안양 KGC,Away,대릴 먼로,2,1,4,25.0,0,1,0.0,1,5,20.0,0,0,0.0,1,3,4,3,0,0,0,0,1,1
../kbl_data/2022-2023,S41G01N181,안양 KGC,Away,변준형,26,9,10,90.0,2,3,66.7,11,13,84.6,2,2,100.0,0,3,3,6,4,1,0,0,2,2
../kbl_data/2022-2023,S41G01N181,안양 KGC,Away,한승희,6,3,3,100.0,0,0,0.0,3,3,100.0,0,0,0.0,1,0,1,1,0,0,0,0,0,3
../kbl_data/2022-2023,S41G01N181,안양 KGC,Away,오마리 스펠맨,22,9,13,69.2,1,6,16.7,10,19,52.6,1,1,100.0,3,8,11,2,0,1,0,3,2,2
../kbl_data/2022-2023,S41G01N181,안양 KGC,Away,조은후,0,0,0,0.0,0,0,0.0,0,0,0.0,0,0,0.0,0,0,0,0,0,0,0,0,0,0
../kbl_data/2022-2023,S41G01N181,안양 KGC,Away,고찬혁,2,0,0,0.0,0,0,0.0,0,0,0.0,2,2,100.0,0,0,0,0,0,0,0,0,1,0
../kbl_data/2022-2023,S41G01N182,서울 삼성,Home,이정현,16,3,6,50.0,1,7,14.3,4,13,30.8,7,8,87.5,0,1,1,2,0,0,0,0,0,2
../kbl_data/2022-2023,S41G01N182,서울 삼성,Home,장민국,9,3,3,100.0,1,3,33.3,4,6,66.7,0,1,0.0,0,4,4,2,1,0,1,0,3,4
../kbl_data/2022-2023,S41G01N182,서울 삼성,Home,김승원,1,0,1,0.0,0,0,0.0,0,1,0.0,1,2,50.0,4,0,4,2,1,0,0,0,0,4
../kbl_data/2022-2023,S41G01N182,서울 삼성,Home,김시래,11,1,3,33.3,1,7,14.3,2,10,20.0,6,6,100.0,2,3,5,4,3,0,0,0,0,3
../kbl_data/2022-2023,S41G01N182,서울 삼성,Home,이동엽,5,1,3,33.3,0,2,0.0,1,5,20.0,3,4,75.0,0,2,2,3,0,0,0,0,0,1
../kbl_data/2022-2023,S41G01N182,서울 삼성,Home,이호현,2,0,1,0.0,0,1,0.0,0,2,0.0,2,2,100.0,0,0,0,1,0,0,0,0,1,0
../kbl_data/2022-2023,S41G01N182,서울 삼성,Home,강바일,3,0,0,0.0,1,2,50.0,1,2,50.0,0,0,0.0,0,1,1,0,0,1,0,0,0,0
../kbl_data/2022-2023,S41G01N182,서울 삼성,Home,김한솔,2,1,2,50.0,0,0,0.0,1,2,50.0,0,0,0.0,0,2,2,0,0,0,0,0,0,0
../kbl_data/2022-2023,S41G01N182,서울 삼성,Home,김진영,0,0,0,0.0,0,0,0.0,0,0,0.0,0,0,0.0,0,0,0,0,0,0,0,0,0,0
../kbl_data/2022-2023,S41G01N182,서울 삼성,Home,김무성,0,0,0,0.0,0,0,0.0,0,0,0.0,0,0,0.0,0,0,0,0,0,0,0,0,0,0
../kbl_data/2022-2023,S41G01N182,서울 삼성,Home,신동혁,3,0,1,0.0,1,3,33.3,1,4,25.0,0,0,0.0,1,1,2,1,0,0,0,0,2,3
../kbl_data/2022-2023,S41G01N182,서울 삼성,Home,앤서니 모스,21,9,14,64.3,0,0,0.0,9,14,64.3,3,5,60.0,4,8,12,0,1,2,0,1,1,3
../kbl_data/2022-2023,S41G01N182,수원 KT,Away,김동욱,6,0,1,0.0,2,3,66.7,2,4,50.0,0,0,0.0,0,1,1,4,0,0,0,0,3,3
../kbl_data/2022-2023,S41G01N182,수원 KT,Away,김영환,1,0,1,0.0,0,0,0.0,0,1,0.0,1,2,50.0,0,1,1,0,1,0,0,0,0,1
../kbl_data/2022-2023,S41G01N182,수원 KT,Away,한희원,0,0,1,0.0,0,1,0.0,0,2,0.0,0,0,0.0,1,0,1,1,1,0,0,0,0,0
../kbl_data/2022-2023,S41G01N182,수원 KT,Away,정성우,9,2,6,33.3,1,3,33.3,3,9,33.3,2,2,100.0,0,1,1,2,0,0,0,0,2,2
../kbl_data/2022-2023,S41G01N182,수원 KT,Away,최성모,0,0,0,0.0,0,0,0.0,0,0,0.0,0,0,0.0,0,0,0,0,1,0,0,0,0,1
../kbl_data/2022-2023,S41G01N182,수원 KT,Away,양홍석,19,6,9,66.7,2,4,50.0,8,13,61.5,1,2,50.0,2,4,6,2,0,1,0,0,1,2
../kbl_data/2022-2023,S41G01N182,수원 KT,Away,박지원,1,0,1,0.0,0,0,0.0,0,1,0.0,1,2,50.0,0,1,1,1,0,0,0,0,0,3
../kbl_data/2022-2023,S41G01N182,수원 KT,Away,하윤기,15,4,9,44.4,0,0,0.0,4,9,44.4,7,8,87.5,4,1,5,3,0,0,0,0,1,2
../kbl_data/2022-2023,S41G01N182,수원 KT,Away,이두원,2,1,3,33.3,0,0,0.0,1,3,33.3,0,0,0.0,0,1,1,0,0,0,0,0,0,0
../kbl_data/2022-2023,S41G01N182,수원 KT,Away,레스터 프로스퍼,10,2,4,50.0,1,2,50.0,3,6,50.0,3,4,75.0,2,8,10,3,0,2,0,2,0,3
../kbl_data/2022-2023,S41G01N182,수원 KT,Away,재로드 존스,3,1,2,50.0,0,4,0.0,1,6,16.7,1,2,50.0,0,2,2,2,0,1,0,0,2,5
../kbl_data/2022-2023,S41G01N182,수원 KT,Away,데이브 일데폰소,4,2,2,100.0,0,1,0.0,2,3,66.7,0,0,0.0,0,1,1,1,0,0,0,0,0,2
../kbl_data/2022-2023,S41G01N183,창원 LG,Home,이관희,2,1,4,25.0,0,3,0.0,1,7,14.3,0,0,0.0,0,0,0,1,0,0,0,0,0,2
../kbl_data/2022-2023,S41G01N183,창원 LG,Home,정희재,0,0,0,0.0,0,2,0.0,0,2,0.0,0,0,0.0,1,0,1,0,0,0,0,0,1,3
../kbl_data/2022-2023,S41G01N183,창원 LG,Home,임동섭,2,1,1,100.0,0,3,0.0,1,4,25.0,0,0,0.0,0,1,1,0,0,0,0,0,0,0
../kbl_data/2022-2023,S41G01N183,창원 LG,Home,서민수,0,0,0,0.0,0,0,0.0,0,0,0.0,0,0,0.0,0,0,0,0,0,0,0,0,0,0
../kbl_data/2022-2023,S41G01N183,창원 LG,Home,이재도,10,5,6,83.3,0,5,0.0,5,11,45.5,0,0,0.0,0,4,4,7,2,0,0,0,5,1
../kbl_data/2022-2023,S41G01N183,창원 LG,Home,김준일,17,5,14,35.7,0,0,0.0,5,14,35.7,7,9,77.8,2,3,5,1,0,1,0,0,0,1
../kbl_data/2022-2023,S41G01N183,창원 LG,Home,정인덕,5,2,2,100.0,0,2,0.0,2,4,50.0,1,1,100.0,1,1,2,3,1,0,0,0,0,4
../kbl_data/2022-2023,S41G01N183,창원 LG,Home,윤원상,18,1,2,50.0,5,10,50.0,6,12,50.0,1,1,100.0,0,2,2,0,1,0,0,0,3,3
../kbl_data/2022-2023,S41G01N183,창원 LG,Home,아셈 마레이,15,6,8,75.0,0,0,0.0,6,8,75.0,3,6,50.0,4,13,17,0,0,1,0,0,1,1
../kbl_data/2022-2023,S41G01N183,창원 LG,Home,저스틴 구탕,0,0,1,0.0,0,0,0.0,0,1,0.0,0,0,0.0,0,1,1,0,0,0,0,0,1,1
../kbl_data/2022-2023,S41G01N183,창원 LG,Home,양준석,0,0,0,0.0,0,0,0.0,0,0,0.0,0,0,0.0,0,0,0,1,0,0,0,0,0,1
../kbl_data/2022-2023,S41G01N183,창원 LG,Home,단테 커닝햄,7,3,6,50.0,0,0,0.0,3,6,50.0,1,2,50.0,3,2,5,0,0,1,0,0,1,0
../kbl_data/2022-2023,S41G01N183,원주 DB,Away,박찬희,2,1,4,25.0,0,0,0.0,1,4,25.0,0,0,0.0,0,1,1,5,1,0,0,0,1,3
../kbl_data/2022-2023,S41G01N183,원주 DB,Away,김현호,4,2,3,66.7,0,1,0.0,2,4,50.0,0,0,0.0,0,2,2,3,1,0,0,0,0,4
../kbl_data/2022-2023,S41G01N183,원주 DB,Away,말콤 토마스,7,3,4,75.0,0,0,0.0,3,4,75.0,1,4,25.0,1,5,6,1,0,0,0,2,0,1
../kbl_data/2022-2023,S41G01N183,원주 DB,Away,김종규,6,3,5,60.0,0,0,0.0,3,5,60.0,0,0,0.0,2,2,4,1,0,0,0,0,2,5
../kbl_data/2022-2023,S41G01N183,원주 DB,Away,최승욱,8,4,5,80.0,0,3,0.0,4,8,50.0,0,0,0.0,1,4,5,0,0,0,0,0,1,1
../kbl_data/2022-2023,S41G01N183,원주 DB,Away,강상재,17,6,15,40.0,1,4,25.0,7,19,36.8,2,2,100.0,0,3,3,3,3,1,0,0,1,3
../kbl_data/2022-2023,S41G01N183,원주 DB,Away,윤성원,0,0,0,0.0,0,0,0.0,0,0,0.0,0,0,0.0,0,0,0,0,0,0,0,0,0,0
../kbl_data/2022-2023,S41G01N183,원주 DB,Away,원종훈,0,0,0,0.0,0,0,0.0,0,0,0.0,0,0,0.0,0,0,0,0,0,0,0,0,0,0
../kbl_data/2022-2023,S41G01N183,원주 DB,Away,레나드 프리먼,7,2,5,40.0,0,0,0.0,2,5,40.0,3,4,75.0,2,7,9,2,4,0,0,0,1,3
../kbl_data/2022-2023,S41G01N183,원주 DB,Away,정호영,4,2,4,50.0,0,0,0.0,2,4,50.0,0,0,0.0,0,0,0,0,1,0,0,0,1,1
../kbl_data/2022-2023,S41G01N183,원주 DB,Away,이민석,0,0,2,0.0,0,1,0.0,0,3,0.0,0,0,0.0,0,0,0,0,0,0,0,0,0,0
../kbl_data/2022-2023,S41G01N183,원주 DB,Away,이선 알바노,19,4,10,40.0,2,4,50.0,6,14,42.9,5,5,100.0,1,3,4,5,0,0,0,0,1,2
../kbl_data/2022-2023,S41G01N184,안양 KGC,Home,양희종,0,0,1,0.0,0,0,0.0,0,1,0.0,0,0,0.0,0,0,0,0,1,0,0,0,0,0
../kbl_data/2022-2023,S41G01N184,안양 KGC,Home,오세근,4,1,6,16.7,0,1,0.0,1,7,14.3,2,4,50.0,3,7,10,3,0,2,0,0,3,2
../kbl_data/2022-2023,S41G01N184,안양 KGC,Home,정준원,3,0,1,0.0,1,1,100.0,1,2,50.0,0,0,0.0,0,0,0,0,0,0,0,0,0,0
../kbl_data/2022-2023,S41G01N184,안양 KGC,Home,배병준,3,0,3,0.0,1,3,33.3,1,6,16.7,0,0,0.0,0,0,0,1,2,1,0,0,0,1
../kbl_data/2022-2023,S41G01N184,안양 KGC,Home,문성곤,5,1,4,25.0,1,2,50.0,2,6,33.3,0,0,0.0,0,3,3,1,1,0,0,0,1,3
../kbl_data/2022-2023,S41G01N184,안양 KGC,Home,박지훈,5,2,4,50.0,0,1,0.0,2,5,40.0,1,1,100.0,0,2,2,4,1,2,0,0,1,1
../kbl_data/2022-2023,S41G01N184,안양 KGC,Home,대릴 먼로,5,2,2,100.0,0,0,0.0,2,2,100.0,1,2,50.0,1,1,2,1,1,0,0,1,0,1
../kbl_data/2022-2023,S41G01N184,안양 KGC,Home,변준형,19,7,10,70.0,1,5,20.0,8,15,53.3,2,2,100.0,0,1,1,3,0,1,0,0,3,3
../kbl_data/2022-2023,S41G01N184,안양 KGC,Home,한승희,0,0,0,0.0,0,0,0.0,0,0,0.0,0,0,0.0,0,0,0,0,1,0,0,0,0,2
../kbl_data/2022-2023,S41G01N184,안양 KGC,Home,오마리 스펠맨,20,5,7,71.4,2,7,28.6,7,14,50.0,4,4,100.0,0,8,8,0,0,1,0,0,0,2
../kbl_data/2022-2023,S41G01N184,안양 KGC,Home,조은후,0,0,0,0.0,0,0,0.0,0,0,0.0,0,0,0.0,0,0,0,0,0,0,0,0,0,0
../kbl_data/2022-2023,S41G01N184,안양 KGC,Home,고찬혁,0,0,0,0.0,0,0,0.0,0,0,0.0,0,0,0.0,0,0,0,0,0,0,0,0,0,0
../kbl_data/2022-2023,S41G01N184,서울 삼성,Away,이정현,22,1,3,33.3,5,10,50.0,6,13,46.2,5,5,100.0,0,2,2,1,3,0,0,0,2,2
../kbl_data/2022-2023,S41G01N184,서울 삼성,Away,장민국,8,4,7,57.1,0,3,0.0,4,10,40.0,0,0,0.0,3,3,6,0,0,0,0,0,1,1
../kbl_data/2022-2023,S41G01N184,서울 삼성,Away,김승원,0,0,1,0.0,0,0,0.0,0,1,0.0,0,0,0.0,5,5,10,0,1,0,0,0,1,1
../kbl_data/2022-2023,S41G01N184,서울 삼성,Away,김시래,7,2,6,33.3,1,4,25.0,3,10,30.0,0,0,0.0,2,2,4,5,1,0,1,0,0,3
../kbl_data/2022-2023,S41G01N184,서울 삼성,Away,이동엽,4,0,5,0.0,1,4,25.0,1,9,11.1,1,2,50.0,0,2,2,2,0,0,0,0,0,4
../kbl_data/2022-2023,S41G01N184,서울 삼성,Away,이호현,2,1,4,25.0,0,2,0.0,1,6,16.7,0,0,0.0,0,3,3,1,0,0,0,0,1,0
../kbl_data/2022-2023,S41G01N184,서울 삼성,Away,강바일,0,0,0,0.0,0,1,0.0,0,1,0.0,0,0,0.0,0,0,0,0,0,0,0,0,0,0
../kbl_data/2022-2023,S41G01N184,서울 삼성,Away,김한솔,0,0,0,0.0,0,0,0.0,0,0,0.0,0,0,0.0,0,0,0,0,0,0,0,0,0,1
../kbl_data/2022-2023,S41G01N184,서울 삼성,Away,김진영,2,1,2,50.0,0,2,0.0,1,4,25.0,0,0,0.0,2,1,3,0,0,0,0,0,0,0
../kbl_data/2022-2023,S41G01N184,서울 삼성,Away,김무성,0,0,0,0.0,0,0,0.0,0,0,0.0,0,0,0.0,0,0,0,0,0,0,0,0,0,0
../kbl_data/2022-2023,S41G01N184,서울 삼성,Away,신동혁,2,1,2,50.0,0,2,0.0,1,4,25.0,0,0,0.0,0,1,1,0,0,0,0,0,2,1
../kbl_data/2022-2023,S41G01N184,서울 삼성,Away,앤서니 모스,14,6,13,46.2,0,0,0.0,6,13,46.2,2,4,50.0,6,10,16,1,1,1,0,0,1,4
../kbl_data/2022-2023,S41G01N185,울산 현대모비스,Home,함지훈,4,2,7,28.6,0,0,0.0,2,7,28.6,0,0,0.0,7,1,8,2,0,0,0,0,0,1
../kbl_data/2022-2023,S41G01N185,울산 현대모비스,Home,김현민,0,0,0,0.0,0,0,0.0,0,0,0.0,0,0,0.0,0,0,0,0,0,0,0,0,0,0
../kbl_data/2022-2023,S41G01N185,울산 현대모비스,Home,최진수,0,0,0,0.0,0,0,0.0,0,0,0.0,0,0,0.0,0,0,0,1,0,0,0,0,1,2
../kbl_data/2022-2023,S41G01N185,울산 현대모비스,Home,장재석,11,4,4,100.0,0,0,0.0,4,4,100.0,3,5,60.0,2,3,5,3,1,1,0,0,3,2
../kbl_data/2022-2023,S41G01N185,울산 현대모비스,Home,김영현,0,0,1,0.0,0,2,0.0,0,3,0.0,0,0,0.0,2,0,2,0,0,0,0,0,2,2
../kbl_data/2022-2023,S41G01N185,울산 현대모비스,Home,서명진,12,3,4,75.0,2,4,50.0,5,8,62.5,0,0,0.0,0,3,3,4,1,0,0,0,0,2
../kbl_data/2022-2023,S41G01N185,울산 현대모비스,Home,헨리 심스,6,2,4,50.0,0,1,0.0,2,5,40.0,2,2,100.0,2,7,9,0,0,1,0,0,1,3
../kbl_data/2022-2023,S41G01N185,울산 현대모비스,Home,이우석,15,2,2,100.0,3,5,60.0,5,7,71.4,2,2,100.0,0,2,2,3,1,0,0,0,1,0
../kbl_data/2022-2023,S41G01N185,울산 현대모비스,Home,신민석,2,1,1,100.0,0,2,0.0,1,3,33.3,0,0,0.0,0,1,1,0,0,0,0,0,0,0
../kbl_data/2022-2023,S41G01N185,울산 현대모비스,Home,론제이 아바리엔토스,5,1,3,33.3,1,5,20.0,2,8,25.0,0,0,0.0,0,2,2,3,0,0,0,0,2,3
../kbl_data/2022-2023,S41G01N185,울산 현대모비스,Home,게이지 프림,21,9,15,60.0,0,0,0.0,9,15,60.0,3,4,75.0,3,4,7,3,0,0,0,0,4,5
../kbl_data/2022-2023,S41G01N185,울산 현대모비스,Home,김태완,6,2,2,100.0,0,6,0.0,2,8,25.0,2,2,100.0,2,2,4,2,1,0,2,0,1,2
../kbl_data/2022-2023,S41G01N185,고양 캐롯,Away,김강선,12,1,1,100.0,3,7,42.9,4,8,50.0,1,1,100.0,2,1,3,0,1,1,0,0,0,4
../kbl_data/2022-2023,S41G01N185,고양 캐롯,Away,임종일,0,0,0,0.0,0,0,0.0,0,0,0.0,0,0,0.0,0,0,0,0,0,0,0,0,0,0
../kbl_data/2022-2023,S41G01N185,고양 캐롯,Away,전성현,20,3,8,37.5,4,10,40.0,7,18,38.9,2,3,66.7,1,1,2,2,1,0,0,0,2,0
../kbl_data/2022-2023,S41G01N185,고양 캐롯,Away,김진유,1,0,1,0.0,0,2,0.0,0,3,0.0,1,2,50.0,1,3,4,2,1,0,1,0,0,1
../kbl_data/2022-2023,S41G01N185,고양 캐롯,Away,정해원,0,0,0,0.0,0,0,0.0,0,0,0.0,0,0,0.0,0,0,0,0,0,0,0,0,0,0
../kbl_data/2022-2023,S41G01N185,고양 캐롯,Away,조한진,0,0,0,0.0,0,2,0.0,0,2,0.0,0,0,0.0,1,1,2,0,2,0,0,0,0,0
../kbl_data/2022-2023,S41G01N185,고양 캐롯,Away,디드릭 로슨,30,9,13,69.2,2,6,33.3,11,19,57.9,6,6,100.0,4,4,8,2,1,2,0,0,1,1
../kbl_data/2022-2023,S41G01N185,고양 캐롯,Away,박진철,0,0,0,0.0,0,0,0.0,0,0,0.0,0,0,0.0,0,0,0,0,0,0,0,0,0,5
../kbl_data/2022-2023,S41G01N185,고양 캐롯,Away,이정현,15,2,2,100.0,2,4,50.0,4,6,66.7,5,6,83.3,1,3,4,6,2,0,0,0,3,2
../kbl_data/2022-2023,S41G01N185,고양 캐롯,Away,모리구치 히사시,0,0,0,0.0,0,0,0.0,0,0,0.0,0,0,0.0,0,0,0,0,0,0,0,0,0,0
../kbl_data/2022-2023,S41G01N185,고양 캐롯,Away,안정욱,6,0,1,0.0,2,7,28.6,2,8,25.0,0,0,0.0,0,1,1,1,0,0,1,0,1,5
../kbl_data/2022-2023,S41G01N185,고양 캐롯,Away,조나단 알렛지,0,0,1,0.0,0,3,0.0,0,4,0.0,0,0,0.0,0,0,0,0,0,0,0,0,0,0
../kbl_data/2022-2023,S41G01N186,대구 한국가스공사,Home,차바위,0,0,0,0.0,0,1,0.0,0,1,0.0,0,0,0.0,0,0,0,1,0,0,0,0,0,2
../kbl_data/2022-2023,S41G01N186,대구 한국가스공사,Home,박지훈,0,0,0,0.0,0,0,0.0,0,0,0.0,0,0,0.0,0,0,0,1,0,0,0,0,0,0
../kbl_data/2022-2023,S41G01N186,대구 한국가스공사,Home,이원대,0,0,0,0.0,0,0,0.0,0,0,0.0,0,0,0.0,0,0,0,0,0,0,0,0,0,1
../kbl_data/2022-2023,S41G01N186,대구 한국가스공사,Home,이대헌,15,7,8,87.5,0,1,0.0,7,9,77.8,1,1,100.0,3,2,5,2,0,0,0,0,0,1
../kbl_data/2022-2023,S41G01N186,대구 한국가스공사,Home,이대성,23,6,12,50.0,1,4,25.0,7,16,43.8,8,10,80.0,0,4,4,7,3,0,0,0,2,3
../kbl_data/2022-2023,S41G01N186,대구 한국가스공사,Home,정효근,16,2,6,33.3,4,8,50.0,6,14,42.9,0,0,0.0,0,2,2,0,1,0,0,0,0,3
../kbl_data/2022-2023,S41G01N186,대구 한국가스공사,Home,머피 할로웨이,8,4,4,100.0,0,0,0.0,4,4,100.0,0,3,0.0,1,5,6,1,1,0,0,0,5,2
../kbl_data/2022-2023,S41G01N186,대구 한국가스공사,Home,우동현,0,0,0,0.0,0,0,0.0,0,0,0.0,0,0,0.0,1,1,2,0,0,0,0,0,1,2
../kbl_data/2022-2023,S41G01N186,대구 한국가스공사,Home,전현우,0,0,0,0.0,0,2,0.0,0,2,0.0,0,0,0.0,1,0,1,0,2,0,0,0,1,0
../kbl_data/2022-2023,S41G01N186,대구 한국가스공사,Home,데본 스캇,6,3,5,60.0,0,1,0.0,3,6,50.0,0,0,0.0,1,2,3,0,0,0,0,0,2,1
../kbl_data/2022-2023,S41G01N186,대구 한국가스공사,Home,신승민,3,0,0,0.0,1,1,100.0,1,1,100.0,0,2,0.0,1,0,1,1,0,0,0,0,0,1
../kbl_data/2022-2023,S41G01N186,대구 한국가스공사,Home,샘조세프 벨란겔,2,1,3,33.3,0,3,0.0,1,6,16.7,0,0,0.0,0,1,1,1,0,0,1,0,1,2
../kbl_data/2022-2023,S41G01N186,수원 KT,Away,김동욱,0,0,0,0.0,0,0,0.0,0,0,0.0,0,0,0.0,0,0,0,0,0,0,0,0,0,0
../kbl_data/2022-2023,S41G01N186,수원 KT,Away,김영환,1,0,0,0.0,0,0,0.0,0,0,0.0,1,2,50.0,1,0,1,2,0,0,0,0,0,0
../kbl_data/2022-2023,S41G01N186,수원 KT,Away,한희원,0,0,0,0.0,0,2,0.0,0,2,0.0,0,0,0.0,0,1,1,2,0,0,0,0,1,3
../kbl_data/2022-2023,S41G01N186,수원 KT,Away,정성우,4,2,3,66.7,0,4,0.0,2,7,28.6,0,0,0.0,0,0,0,2,2,0,0,0,4,4
../kbl_data/2022-2023,S41G01N186,수원 KT,Away,최성모,2,1,1,100.0,0,2,0.0,1,3,33.3,0,0,0.0,0,1,1,1,1,0,1,0,0,2
../kbl_data/2022-2023,S41G01N186,수원 KT,Away,양홍석,22,2,3,66.7,5,8,62.5,7,11,63.6,3,4,75.0,0,3,3,3,1,1,0,0,3,2
../kbl_data/2022-2023,S41G01N186,수원 KT,Away,박지원,7,1,4,25.0,1,3,33.3,2,7,28.6,2,2,100.0,2,0,2,1,1,0,1,0,1,2
../kbl_data/2022-2023,S41G01N186,수원 KT,Away,하윤기,17,8,11,72.7,0,0,0.0,8,11,72.7,1,2,50.0,3,7,10,3,0,1,0,0,1,1
../kbl_data/2022-2023,S41G01N186,수원 KT,Away,이두원,2,1,2,50.0,0,0,0.0,1,2,50.0,0,0,0.0,0,2,2,0,0,0,0,0,0,3
../kbl_data/2022-2023,S41G01N186,수원 KT,Away,레스터 프로스퍼,2,1,1,100.0,0,2,0.0,1,3,33.3,0,0,0.0,0,2,2,0,0,0,0,0,2,0
../kbl_data/2022-2023,S41G01N186,수원 KT,Away,재로드 존스,19,2,5,40.0,5,9,55.6,7,14,50.0,0,0,0.0,1,6,7,6,3,0,0,0,1,1
../kbl_data/2022-2023,S41G01N186,수원 KT,Away,데이브 일데폰소,0,0,0,0.0,0,0,0.0,0,0,0.0,0,0,0.0,1,0,1,1,0,0,0,0,0,1
../kbl_data/2022-2023,S41G01N187,울산 현대모비스,Home,함지훈,4,2,3,66.7,0,0,0.0,2,3,66.7,0,0,0.0,2,2,4,3,0,0,0,0,1,2
../kbl_data/2022-2023,S41G01N187,울산 현대모비스,Home,김현민,0,0,0,0.0,0,0,0.0,0,0,0.0,0,0,0.0,0,0,0,0,0,0,0,0,0,0
../kbl_data/2022-2023,S41G01N187,울산 현대모비스,Home,최진수,0,0,1,0.0,0,2,0.0,0,3,0.0,0,0,0.0,0,1,1,0,0,0,0,0,0,1
../kbl_data/2022-2023,S41G01N187,울산 현대모비스,Home,장재석,2,1,4,25.0,0,0,0.0,1,4,25.0,0,0,0.0,2,3,5,0,0,1,0,0,1,3
../kbl_data/2022-2023,S41G01N187,울산 현대모비스,Home,김영현,5,1,1,100.0,1,2,50.0,2,3,66.7,0,0,0.0,1,0,1,0,0,0,0,0,0,1
../kbl_data/2022-2023,S41G01N187,울산 현대모비스,Home,서명진,10,3,7,42.9,1,3,33.3,4,10,40.0,1,2,50.0,1,3,4,4,1,0,0,0,1,2
../kbl_data/2022-2023,S41G01N187,울산 현대모비스,Home,헨리 심스,6,3,7,42.9,0,0,0.0,3,7,42.9,0,0,0.0,3,5,8,0,0,1,0,1,1,1
../kbl_data/2022-2023,S41G01N187,울산 현대모비스,Home,이우석,11,1,4,25.0,3,7,42.9,4,11,36.4,0,0,0.0,3,3,6,2,1,0,0,0,1,0
../kbl_data/2022-2023,S41G01N187,울산 현대모비스,Home,신민석,0,0,0,0.0,0,0,0.0,0,0,0.0,0,0,0.0,0,1,1,0,0,0,0,0,0,1
../kbl_data/2022-2023,S41G01N187,울산 현대모비스,Home,론제이 아바리엔토스,23,1,3,33.3,7,15,46.7,8,18,44.4,0,0,0.0,2,0,2,3,0,0,0,0,1,3
../kbl_data/2022-2023,S41G01N187,울산 현대모비스,Home,게이지 프림,19,8,19,42.1,0,0,0.0,8,19,42.1,3,3,100.0,7,7,14,1,1,1,0,0,3,2
../kbl_data/2022-2023,S41G01N187,울산 현대모비스,Home,김태완,0,0,0,0.0,0,0,0.0,0,0,0.0,0,0,0.0,0,0,0,1,0,0,1,0,0,0
../kbl_data/2022-2023,S41G01N187,원주 DB,Away,박찬희,2,0,4,0.0,0,2,0.0,0,6,0.0,2,2,100.0,0,1,1,2,0,0,0,0,0,1
../kbl_data/2022-2023,S41G01N187,원주 DB,Away,김현호,10,5,6,83.3,0,5,0.0,5,11,45.5,0,0,0.0,0,1,1,3,1,0,0,0,1,1
../kbl_data/2022-2023,S41G01N187,원주 DB,Away,말콤 토마스,4,2,3,66.7,0,2,0.0,2,5,40.0,0,0,0.0,1,5,6,2,1,1,0,0,0,3
../kbl_data/2022-2023,S41G01N187,원주 DB,Away,김종규,5,2,5,40.0,0,1,0.0,2,6,33.3,1,2,50.0,2,5,7,0,0,3,0,0,1,1
../kbl_data/2022-2023,S41G01N187,원주 DB,Away,최승욱,0,0,1,0.0,0,0,0.0,0,1,0.0,0,0,0.0,1,2,3,1,0,1,0,0,1,0
../kbl_data/2022-2023,S41G01N187,원주 DB,Away,강상재,16,4,9,44.4,1,4,25.0,5,13,38.5,5,5,100.0,3,6,9,2,1,0,1,0,0,2
../kbl_data/2022-2023,S41G01N187,원주 DB,Away,윤성원,0,0,0,0.0,0,0,0.0,0,0,0.0,0,0,0.0,0,0,0,0,0,0,0,0,0,0
../kbl_data/2022-2023,S41G01N187,원주 DB,Away,원종훈,0,0,1,0.0,0,0,0.0,0,1,0.0,0,0,0.0,0,0,0,0,0,0,0,0,0,2
../kbl_data/2022-2023,S41G01N187,원주 DB,Away,레나드 프리먼,18,7,10,70.0,0,0,0.0,7,10,70.0,4,4,100.0,6,1,7,1,0,0,0,0,1,2
../kbl_data/2022-2023,S41G01N187,원주 DB,Away,정호영,0,0,2,0.0,0,2,0.0,0,4,0.0,0,0,0.0,0,0,0,0,0,0,0,0,0,1
../kbl_data/2022-2023,S41G01N187,원주 DB,Away,이민석,2,1,1,100.0,0,1,0.0,1,2,50.0,0,0,0.0,1,0,1,0,0,0,0,0,0,0
../kbl_data/2022-2023,S41G01N187,원주 DB,Away,이선 알바노,14,3,8,37.5,2,4,50.0,5,12,41.7,2,2,100.0,0,1,1,0,1,0,0,0,2,3
../kbl_data/2022-2023,S41G01N188,전주 KCC,Home,정창영,12,3,3,100.0,2,3,66.7,5,6,83.3,0,0,0.0,1,4,5,1,0,1,1,0,2,2
../kbl_data/2022-2023,S41G01N188,전주 KCC,Home,라건아,32,7,14,50.0,5,6,83.3,12,20,60.0,3,3,100.0,1,12,13,3,0,2,0,1,1,3
../kbl_data/2022-2023,S41G01N188,전주 KCC,Home,박경상,6,0,0,0.0,2,5,40.0,2,5,40.0,0,0,0.0,0,3,3,1,2,0,0,0,1,2
../kbl_data/2022-2023,S41G01N188,전주 KCC,Home,김지완,5,1,1,100.0,1,2,50.0,2,3,66.7,0,0,0.0,0,2,2,2,0,0,0,0,3,2
../kbl_data/2022-2023,S41G01N188,전주 KCC,Home,김상규,10,3,3,100.0,1,2,50.0,4,5,80.0,1,2,50.0,1,0,1,2,1,0,0,0,0,2
../kbl_data/2022-2023,S41G01N188,전주 KCC,Home,전준범,0,0,0,0.0,0,0,0.0,0,0,0.0,0,0,0.0,0,1,1,0,0,0,0,0,0,1
../kbl_data/2022-2023,S41G01N188,전주 KCC,Home,허웅,16,4,10,40.0,1,6,16.7,5,16,31.2,5,5,100.0,0,6,6,6,1,0,0,0,2,1
../kbl_data/2022-2023,S41G01N188,전주 KCC,Home,이종현,4,2,3,66.7,0,0,0.0,2,3,66.7,0,0,0.0,1,2,3,0,0,0,0,0,0,1
../kbl_data/2022-2023,S41G01N188,전주 KCC,Home,이진욱,0,0,0,0.0,0,0,0.0,0,0,0.0,0,0,0.0,0,0,0,1,0,0,0,0,0,0
../kbl_data/2022-2023,S41G01N188,전주 KCC,Home,이근휘,0,0,0,0.0,0,1,0.0,0,1,0.0,0,0,0.0,0,1,1,0,0,0,0,0,0,0
../kbl_data/2022-2023,S41G01N188,전주 KCC,Home,론데 홀리스 제퍼슨,0,0,0,0.0,0,0,0.0,0,0,0.0,0,0,0.0,2,1,3,1,2,0,0,0,1,1
../kbl_data/2022-2023,S41G01N188,전주 KCC,Home,칼빈 제프리 에피스톨라,2,0,1,0.0,0,3,0.0,0,4,0.0,2,2,100.0,0,2,2,2,0,0,0,0,2,5
../kbl_data/2022-2023,S41G01N188,창원 LG,Away,이관희,6,1,4,25.0,1,5,20.0,2,9,22.2,1,1,100.0,1,2,3,0,0,0,0,0,2,2
../kbl_data/2022-2023,S41G01N188,창원 LG,Away,정희재,0,0,1,0.0,0,0,0.0,0,1,0.0,0,0,0.0,1,1,2,0,0,0,0,0,0,2
../kbl_data/2022-2023,S41G01N188,창원 LG,Away,임동섭,2,1,1,100.0,0,2,0.0,1,3,33.3,0,0,0.0,0,0,0,0,0,0,0,0,0,1
../kbl_data/2022-2023,S41G01N188,창원 LG,Away,서민수,0,0,1,0.0,0,0,0.0,0,1,0.0,0,0,0.0,1,0,1,1,1,0,0,0,0,0
../kbl_data/2022-2023,S41G01N188,창원 LG,Away,이재도,2,1,3,33.3,0,1,0.0,1,4,25.0,0,0,0.0,0,0,0,1,0,0,0,0,0,0
../kbl_data/2022-2023,S41G01N188,창원 LG,Away,김준일,11,3,9,33.3,0,0,0.0,3,9,33.3,5,5,100.0,1,3,4,1,0,0,0,0,4,2
../kbl_data/2022-2023,S41G01N188,창원 LG,Away,정인덕,0,0,0,0.0,0,1,0.0,0,1,0.0,0,0,0.0,0,0,0,0,0,0,0,0,1,0
../kbl_data/2022-2023,S41G01N188,창원 LG,Away,윤원상,3,1,4,25.0,0,5,0.0,1,9,11.1,1,2,50.0,0,0,0,2,1,0,0,0,1,4
../kbl_data/2022-2023,S41G01N188,창원 LG,Away,아셈 마레이,11,5,9,55.6,0,0,0.0,5,9,55.6,1,1,100.0,4,3,7,1,1,0,0,0,0,2
../kbl_data/2022-2023,S41G01N188,창원 LG,Away,저스틴 구탕,3,1,4,25.0,0,0,0.0,1,4,25.0,1,2,50.0,1,5,6,5,2,1,0,1,1,3
../kbl_data/2022-2023,S41G01N188,창원 LG,Away,양준석,2,1,4,25.0,0,4,0.0,1,8,12.5,0,0,0.0,0,1,1,2,3,0,0,0,1,0
../kbl_data/2022-2023,S41G01N188,창원 LG,Away,단테 커닝햄,24,11,15,73.3,0,1,0.0,11,16,68.8,2,3,66.7,3,7,10,0,0,1,0,0,0,1
../kbl_data/2022-2023,S41G01N189,서울 SK,Home,양우섭,2,1,1,100.0,0,0,0.0,1,1,100.0,0,0,0.0,0,0,0,0,0,0,0,0,0,0
../kbl_data/2022-2023,S41G01N189,서울 SK,Home,허일영,8,1,4,25.0,2,3,66.7,3,7,42.9,0,0,0.0,0,2,2,0,1,0,0,0,0,3
../kbl_data/2022-2023,S41G01N189,서울 SK,Home,김선형,19,6,8,75.0,2,5,40.0,8,13,61.5,1,2,50.0,0,3,3,12,4,0,0,0,2,2
../kbl_data/2022-2023,S41G01N189,서울 SK,Home,홍경기,0,0,0,0.0,0,0,0.0,0,0,0.0,0,0,0.0,0,0,0,0,0,0,0,0,0,0
../kbl_data/2022-2023,S41G01N189,서울 SK,Home,최부경,17,8,11,72.7,0,0,0.0,8,11,72.7,1,2,50.0,3,4,7,2,1,1,0,0,2,4
../kbl_data/2022-2023,S41G01N189,서울 SK,Home,리온 윌리엄스,0,0,0,0.0,0,0,0.0,0,0,0.0,0,0,0.0,1,3,4,0,0,0,0,0,0,0
../kbl_data/2022-2023,S41G01N189,서울 SK,Home,최원혁,0,0,0,0.0,0,0,0.0,0,0,0.0,0,0,0.0,0,0,0,0,0,0,0,0,0,0
../kbl_data/2022-2023,S41G01N189,서울 SK,Home,최준용,6,2,7,28.6,0,3,0.0,2,10,20.0,2,4,50.0,0,4,4,5,1,0,0,0,0,3
../kbl_data/2022-2023,S41G01N189,서울 SK,Home,최성원,5,1,1,100.0,1,3,33.3,2,4,50.0,0,0,0.0,1,0,1,0,0,0,0,0,0,0
../kbl_data/2022-2023,S41G01N189,서울 SK,Home,자밀 워니,29,13,15,86.7,0,0,0.0,13,15,86.7,3,4,75.0,2,6,8,6,2,0,0,3,1,1
../kbl_data/2022-2023,S41G01N189,서울 SK,Home,김형빈,0,0,0,0.0,0,0,0.0,0,0,0.0,0,0,0.0,0,0,0,0,0,0,0,0,0,0
../kbl_data/2022-2023,S41G01N189,서울 SK,Home,오재현,10,2,5,40.0,1,3,33.3,3,8,37.5,3,4,75.0,3,4,7,2,0,0,0,0,1,2
../kbl_data/2022-2023,S41G01N189,고양 캐롯,Away,김강선,3,0,0,0.0,1,2,50.0,1,2,50.0,0,0,0.0,0,0,0,1,0,0,0,0,0,2
../kbl_data/2022-2023,S41G01N189,고양 캐롯,Away,임종일,0,0,0,0.0,0,0,0.0,0,0,0.0,0,0,0.0,0,0,0,0,0,0,0,0,0,0
../kbl_data/2022-2023,S41G01N189,고양 캐롯,Away,전성현,22,4,6,66.7,4,12,33.3,8,18,44.4,2,2,100.0,0,1,1,2,1,1,0,0,2,0
../kbl_data/2022-2023,S41G01N189,고양 캐롯,Away,김진유,0,0,0,0.0,0,3,0.0,0,3,0.0,0,0,0.0,1,1,2,0,1,0,0,0,0,1
../kbl_data/2022-2023,S41G01N189,고양 캐롯,Away,정해원,0,0,0,0.0,0,0,0.0,0,0,0.0,0,0,0.0,0,0,0,0,0,0,0,0,0,0
../kbl_data/2022-2023,S41G01N189,고양 캐롯,Away,조한진,11,1,3,33.3,3,7,42.9,4,10,40.0,0,0,0.0,0,2,2,0,1,0,0,0,0,3
../kbl_data/2022-2023,S41G01N189,고양 캐롯,Away,디드릭 로슨,35,8,9,88.9,4,7,57.1,12,16,75.0,7,7,100.0,4,12,16,3,0,0,0,0,2,1
../kbl_data/2022-2023,S41G01N189,고양 캐롯,Away,박진철,0,0,0,0.0,0,0,0.0,0,0,0.0,0,0,0.0,0,0,0,0,0,0,0,0,1,1
../kbl_data/2022-2023,S41G01N189,고양 캐롯,Away,이정현,2,1,1,100.0,0,2,0.0,1,3,33.3,0,0,0.0,0,1,1,4,0,0,0,0,1,3
../kbl_data/2022-2023,S41G01N189,고양 캐롯,Away,모리구치 히사시,0,0,0,0.0,0,1,0.0,0,1,0.0,0,0,0.0,0,0,0,0,0,0,0,0,0,0
../kbl_data/2022-2023,S41G01N189,고양 캐롯,Away,안정욱,7,2,3,66.7,1,5,20.0,3,8,37.5,0,0,0.0,0,2,2,0,1,0,0,0,1,3
../kbl_data/2022-2023,S41G01N189,고양 캐롯,Away,조나단 알렛지,3,1,3,33.3,0,0,0.0,1,3,33.3,1,2,50.0,1,1,2,1,1,0,0,0,3,1
../kbl_data/2022-2023,S41G01N190,수원 KT,Home,김동욱,0,0,0,0.0,0,0,0.0,0,0,0.0,0,0,0.0,0,0,0,0,1,0,0,0,1,1
../kbl_data/2022-2023,S41G01N190,수원 KT,Home,김영환,0,0,0,0.0,0,0,0.0,0,0,0.0,0,0,0.0,0,0,0,0,0,0,0,0,0,0
../kbl_data/2022-2023,S41G01N190,수원 KT,Home,한희원,0,0,1,0.0,0,2,0.0,0,3,0.0,0,0,0.0,1,5,6,2,1,0,1,0,0,4
../kbl_data/2022-2023,S41G01N190,수원 KT,Home,정성우,8,1,3,33.3,2,7,28.6,3,10,30.0,0,0,0.0,1,2,3,5,0,0,0,0,2,4
../kbl_data/2022-2023,S41G01N190,수원 KT,Home,최성모,3,0,2,0.0,1,2,50.0,1,4,25.0,0,0,0.0,1,0,1,5,2,0,0,0,0,4
../kbl_data/2022-2023,S41G01N190,수원 KT,Home,양홍석,24,7,13,53.8,3,8,37.5,10,21,47.6,1,1,100.0,3,3,6,3,1,0,0,0,0,2
../kbl_data/2022-2023,S41G01N190,수원 KT,Home,박지원,0,0,0,0.0,0,0,0.0,0,0,0.0,0,0,0.0,0,0,0,0,0,0,0,0,0,0
../kbl_data/2022-2023,S41G01N190,수원 KT,Home,하윤기,20,7,9,77.8,0,0,0.0,7,9,77.8,6,8,75.0,3,1,4,2,0,0,0,0,2,2
../kbl_data/2022-2023,S41G01N190,수원 KT,Home,이두원,0,0,0,0.0,0,0,0.0,0,0,0.0,0,0,0.0,0,0,0,0,0,0,0,0,0,0
../kbl_data/2022-2023,S41G01N190,수원 KT,Home,레스터 프로스퍼,5,1,1,100.0,1,3,33.3,2,4,50.0,0,0,0.0,1,0,1,1,0,0,0,0,1,1
../kbl_data/2022-2023,S41G01N190,수원 KT,Home,재로드 존스,23,4,11,36.4,5,11,45.5,9,22,40.9,0,0,0.0,4,4,8,3,2,1,0,0,2,1
../kbl_data/2022-2023,S41G01N190,수원 KT,Home,데이브 일데폰소,1,0,1,0.0,0,0,0.0,0,1,0.0,1,2,50.0,0,3,3,1,0,0,0,0,0,0
../kbl_data/2022-2023,S41G01N190,안양 KGC,Away,양희종,11,4,5,80.0,1,3,33.3,5,8,62.5,0,0,0.0,0,2,2,5,1,1,0,0,2,2
../kbl_data/2022-2023,S41G01N190,안양 KGC,Away,오세근,10,2,5,40.0,2,3,66.7,4,8,50.0,0,0,0.0,2,7,9,3,0,0,0,0,2,4
../kbl_data/2022-2023,S41G01N190,안양 KGC,Away,정준원,0,0,0,0.0,0,0,0.0,0,0,0.0,0,0,0.0,0,0,0,0,0,0,0,0,0,0
../kbl_data/2022-2023,S41G01N190,안양 KGC,Away,배병준,6,3,3,100.0,0,2,0.0,3,5,60.0,0,0,0.0,1,1,2,3,1,0,0,0,1,0
../kbl_data/2022-2023,S41G01N190,안양 KGC,Away,문성곤,5,1,1,100.0,1,4,25.0,2,5,40.0,0,0,0.0,2,4,6,0,1,1,1,0,2,4
../kbl_data/2022-2023,S41G01N190,안양 KGC,Away,박지훈,4,1,1,100.0,0,1,0.0,1,2,50.0,2,2,100.0,1,1,2,1,0,0,0,0,0,0
../kbl_data/2022-2023,S41G01N190,안양 KGC,Away,대릴 먼로,0,0,0,0.0,0,0,0.0,0,0,0.0,0,0,0.0,0,0,0,0,0,0,0,0,0,0
../kbl_data/2022-2023,S41G01N190,안양 KGC,Away,변준형,9,3,7,42.9,1,2,50.0,4,9,44.4,0,0,0.0,0,1,1,8,1,0,0,0,3,3
../kbl_data/2022-2023,S41G01N190,안양 KGC,Away,한승희,2,1,2,50.0,0,0,0.0,1,2,50.0,0,0,0.0,0,0,0,0,1,0,0,0,0,0
../kbl_data/2022-2023,S41G01N190,안양 KGC,Away,오마리 스펠맨,40,7,11,63.6,7,12,58.3,14,23,60.9,5,10,50.0,1,6,7,1,0,0,0,5,0,2
../kbl_data/2022-2023,S41G01N190,안양 KGC,Away,조은후,0,0,0,0.0,0,0,0.0,0,0,0.0,0,0,0.0,0,0,0,0,0,0,0,0,0,0
../kbl_data/2022-2023,S41G01N190,안양 KGC,Away,렌즈 아반도,0,0,3,0.0,0,0,0.0,0,3,0.0,0,0,0.0,0,0,0,0,0,0,0,0,0,0
../kbl_data/2022-2023,S41G01N191,서울 SK,Home,양우섭,0,0,0,0.0,0,0,0.0,0,0,0.0,0,0,0.0,0,0,0,1,0,0,0,0,1,1
../kbl_data/2022-2023,S41G01N191,서울 SK,Home,허일영,1,0,2,0.0,0,0,0.0,0,2,0.0,1,1,100.0,1,1,2,0,0,0,0,0,0,2
../kbl_data/2022-2023,S41G01N191,서울 SK,Home,김선형,13,3,4,75.0,1,6,16.7,4,10,40.0,4,7,57.1,1,3,4,6,0,0,0,0,0,0
../kbl_data/2022-2023,S41G01N191,서울 SK,Home,홍경기,0,0,0,0.0,0,0,0.0,0,0,0.0,0,0,0.0,0,0,0,0,0,0,0,0,0,0
../kbl_data/2022-2023,S41G01N191,서울 SK,Home,최부경,6,3,4,75.0,0,0,0.0,3,4,75.0,0,0,0.0,0,2,2,0,1,1,0,0,0,0
../kbl_data/2022-2023,S41G01N191,서울 SK,Home,리온 윌리엄스,2,1,4,25.0,0,1,0.0,1,5,20.0,0,0,0.0,2,1,3,0,2,0,0,0,0,1
../kbl_data/2022-2023,S41G01N191,서울 SK,Home,최원혁,3,0,0,0.0,1,2,50.0,1,2,50.0,0,0,0.0,3,1,4,2,1,0,0,0,0,3
../kbl_data/2022-2023,S41G01N191,서울 SK,Home,최준용,10,3,7,42.9,1,6,16.7,4,13,30.8,1,2,50.0,0,5,5,2,1,3,0,0,3,3
../kbl_data/2022-2023,S41G01N191,서울 SK,Home,최성원,15,3,4,75.0,3,4,75.0,6,8,75.0,0,0,0.0,1,2,3,1,0,0,0,0,1,3
../kbl_data/2022-2023,S41G01N191,서울 SK,Home,자밀 워니,19,9,14,64.3,0,0,0.0,9,14,64.3,1,2,50.0,1,12,13,3,2,2,0,0,2,3
../kbl_data/2022-2023,S41G01N191,서울 SK,Home,김형빈,0,0,0,0.0,0,0,0.0,0,0,0.0,0,0,0.0,0,0,0,0,0,0,0,0,0,0
../kbl_data/2022-2023,S41G01N191,서울 SK,Home,오재현,4,2,4,50.0,0,4,0.0,2,8,25.0,0,0,0.0,0,1,1,3,1,1,0,0,0,0
../kbl_data/2022-2023,S41G01N191,울산 현대모비스,Away,함지훈,5,1,4,25.0,1,1,100.0,2,5,40.0,0,2,0.0,0,2,2,7,0,0,0,0,0,1
../kbl_data/2022-2023,S41G01N191,울산 현대모비스,Away,김현민,0,0,0,0.0,0,0,0.0,0,0,0.0,0,0,0.0,0,0,0,0,0,0,0,0,0,0
../kbl_data/2022-2023,S41G01N191,울산 현대모비스,Away,최진수,0,0,0,0.0,0,0,0.0,0,0,0.0,0,0,0.0,0,0,0,0,0,0,0,0,0,0
../kbl_data/2022-2023,S41G01N191,울산 현대모비스,Away,장재석,4,2,5,40.0,0,0,0.0,2,5,40.0,0,0,0.0,3,1,4,1,1,1,0,0,1,1
../kbl_data/2022-2023,S41G01N191,울산 현대모비스,Away,김영현,2,1,1,100.0,0,0,0.0,1,1,100.0,0,0,0.0,0,0,0,0,1,0,0,0,0,3
../kbl_data/2022-2023,S41G01N191,울산 현대모비스,Away,서명진,18,4,7,57.1,3,5,60.0,7,12,58.3,1,2,50.0,0,2,2,1,1,0,0,0,2,2
../kbl_data/2022-2023,S41G01N191,울산 현대모비스,Away,헨리 심스,4,2,4,50.0,0,0,0.0,2,4,50.0,0,0,0.0,1,8,9,1,0,0,0,0,1,1
../kbl_data/2022-2023,S41G01N191,울산 현대모비스,Away,이우석,13,5,8,62.5,1,6,16.7,6,14,42.9,0,0,0.0,1,3,4,3,0,0,0,0,1,2
../kbl_data/2022-2023,S41G01N191,울산 현대모비스,Away,신민석,0,0,0,0.0,0,1,0.0,0,1,0.0,0,0,0.0,0,0,0,0,0,0,0,0,0,1
../kbl_data/2022-2023,S41G01N191,울산 현대모비스,Away,론제이 아바리엔토스,8,1,5,20.0,2,7,28.6,3,12,25.0,0,0,0.0,0,4,4,3,2,1,0,0,2,1
../kbl_data/2022-2023,S41G01N191,울산 현대모비스,Away,게이지 프림,14,7,19,36.8,0,0,0.0,7,19,36.8,0,0,0.0,8,2,10,3,2,0,0,0,2,4
../kbl_data/2022-2023,S41G01N191,울산 현대모비스,Away,김태완,0,0,0,0.0,0,1,0.0,0,1,0.0,0,0,0.0,1,1,2,0,0,0,0,0,1,1
../kbl_data/2022-2023,S41G01N192,대구 한국가스공사,Home,차바위,6,0,0,0.0,2,2,100.0,2,2,100.0,0,0,0.0,0,2,2,1,0,0,1,0,1,2
../kbl_data/2022-2023,S41G01N192,대구 한국가스공사,Home,박지훈,0,0,1,0.0,0,0,0.0,0,1,0.0,0,0,0.0,0,0,0,0,0,0,0,0,1,3
../kbl_data/2022-2023,S41G01N192,대구 한국가스공사,Home,이원대,3,0,2,0.0,1,1,100.0,1,3,33.3,0,0,0.0,0,0,0,1,0,0,0,0,2,1
../kbl_data/2022-2023,S41G01N192,대구 한국가스공사,Home,이대헌,12,3,6,50.0,2,3,66.7,5,9,55.6,0,0,0.0,1,4,5,1,1,0,0,0,1,2
../kbl_data/2022-2023,S41G01N192,대구 한국가스공사,Home,이대성,19,7,9,77.8,0,1,0.0,7,10,70.0,5,5,100.0,0,1,1,7,2,0,0,0,5,2
../kbl_data/2022-2023,S41G01N192,대구 한국가스공사,Home,정효근,16,3,4,75.0,2,4,50.0,5,8,62.5,4,5,80.0,0,4,4,1,1,0,0,0,0,5
../kbl_data/2022-2023,S41G01N192,대구 한국가스공사,Home,머피 할로웨이,21,9,12,75.0,0,0,0.0,9,12,75.0,3,3,100.0,2,7,9,1,2,0,0,0,2,2
../kbl_data/2022-2023,S41G01N192,대구 한국가스공사,Home,우동현,7,1,2,50.0,1,3,33.3,2,5,40.0,2,4,50.0,0,1,1,2,2,0,0,0,0,1
../kbl_data/2022-2023,S41G01N192,대구 한국가스공사,Home,전현우,0,0,0,0.0,0,1,0.0,0,1,0.0,0,0,0.0,0,0,0,0,0,0,0,0,0,0
../kbl_data/2022-2023,S41G01N192,대구 한국가스공사,Home,데본 스캇,13,3,4,75.0,1,3,33.3,4,7,57.1,4,4,100.0,1,3,4,3,0,0,0,1,1,2
../kbl_data/2022-2023,S41G01N192,대구 한국가스공사,Home,신승민,0,0,0,0.0,0,0,0.0,0,0,0.0,0,0,0.0,0,0,0,0,0,0,0,0,0,0
../kbl_data/2022-2023,S41G01N192,대구 한국가스공사,Home,샘조세프 벨란겔,5,1,1,100.0,1,3,33.3,2,4,50.0,0,0,0.0,0,0,0,3,1,0,0,0,1,3
../kbl_data/2022-2023,S41G01N192,창원 LG,Away,이관희,11,2,2,100.0,2,6,33.3,4,8,50.0,1,2,50.0,1,4,5,3,3,0,0,0,3,2
../kbl_data/2022-2023,S41G01N192,창원 LG,Away,정희재,13,2,3,66.7,3,7,42.9,5,10,50.0,0,0,0.0,1,2,3,2,1,0,0,0,1,3
../kbl_data/2022-2023,S41G01N192,창원 LG,Away,임동섭,0,0,1,0.0,0,2,0.0,0,3,0.0,0,0,0.0,0,1,1,0,0,0,0,0,0,2
../kbl_data/2022-2023,S41G01N192,창원 LG,Away,서민수,0,0,0,0.0,0,0,0.0,0,0,0.0,0,0,0.0,0,0,0,0,0,0,0,0,0,0
../kbl_data/2022-2023,S41G01N192,창원 LG,Away,이재도,14,3,6,50.0,2,3,66.7,5,9,55.6,2,2,100.0,0,1,1,7,0,0,0,0,2,2
../kbl_data/2022-2023,S41G01N192,창원 LG,Away,김준일,7,1,1,100.0,0,0,0.0,1,1,100.0,5,6,83.3,0,0,0,1,0,1,0,0,1,2
../kbl_data/2022-2023,S41G01N192,창원 LG,Away,정인덕,14,1,3,33.3,4,7,57.1,5,10,50.0,0,0,0.0,1,1,2,0,0,0,0,0,1,2
../kbl_data/2022-2023,S41G01N192,창원 LG,Away,윤원상,11,0,1,0.0,2,3,66.7,2,4,50.0,5,6,83.3,0,0,0,1,0,0,0,0,0,3
../kbl_data/2022-2023,S41G01N192,창원 LG,Away,아셈 마레이,27,11,16,68.8,0,0,0.0,11,16,68.8,5,6,83.3,5,5,10,4,3,0,0,1,2,4
../kbl_data/2022-2023,S41G01N192,창원 LG,Away,저스틴 구탕,6,3,4,75.0,0,0,0.0,3,4,75.0,0,0,0.0,0,2,2,1,1,0,0,0,2,0
../kbl_data/2022-2023,S41G01N192,창원 LG,Away,양준석,0,0,0,0.0,0,0,0.0,0,0,0.0,0,0,0.0,0,0,0,0,0,0,0,0,0,0
../kbl_data/2022-2023,S41G01N192,창원 LG,Away,단테 커닝햄,5,2,4,50.0,0,0,0.0,2,4,50.0,1,1,100.0,1,5,6,3,1,0,0,0,0,1
../kbl_data/2022-2023,S41G01N193,안양 KGC,Home,양희종,0,0,0,0.0,0,2,0.0,0,2,0.0,0,2,0.0,0,1,1,1,0,1,0,0,0,3
../kbl_data/2022-2023,S41G01N193,안양 KGC,Home,오세근,15,4,7,57.1,2,3,66.7,6,10,60.0,1,2,50.0,3,5,8,2,1,2,0,0,1,3
../kbl_data/2022-2023,S41G01N193,안양 KGC,Home,정준원,0,0,0,0.0,0,0,0.0,0,0,0.0,0,0,0.0,0,0,0,0,0,0,0,0,0,0
../kbl_data/2022-2023,S41G01N193,안양 KGC,Home,배병준,4,2,3,66.7,0,1,0.0,2,4,50.0,0,2,0.0,1,1,2,1,0,0,0,0,0,1
../kbl_data/2022-2023,S41G01N193,안양 KGC,Home,문성곤,4,2,2,100.0,0,4,0.0,2,6,33.3,0,0,0.0,4,2,6,1,3,1,0,0,1,3
../kbl_data/2022-2023,S41G01N193,안양 KGC,Home,박지훈,5,1,4,25.0,1,4,25.0,2,8,25.0,0,0,0.0,2,2,4,1,2,0,0,0,1,2
../kbl_data/2022-2023,S41G01N193,안양 KGC,Home,이우정,0,0,0,0.0,0,0,0.0,0,0,0.0,0,0,0.0,0,0,0,0,0,0,0,0,0,0
../kbl_data/2022-2023,S41G01N193,안양 KGC,Home,대릴 먼로,2,1,1,100.0,0,0,0.0,1,1,100.0,0,0,0.0,0,1,1,0,1,0,0,1,0,0
../kbl_data/2022-2023,S41G01N193,안양 KGC,Home,변준형,21,5,8,62.5,3,7,42.9,8,15,53.3,2,3,66.7,0,5,5,7,0,0,0,0,1,3
../kbl_data/2022-2023,S41G01N193,안양 KGC,Home,한승희,0,0,1,0.0,0,0,0.0,0,1,0.0,0,0,0.0,0,0,0,0,1,0,1,0,0,0
../kbl_data/2022-2023,S41G01N193,안양 KGC,Home,오마리 스펠맨,26,9,17,52.9,2,5,40.0,11,22,50.0,2,4,50.0,3,8,11,4,1,2,0,2,3,1
../kbl_data/2022-2023,S41G01N193,안양 KGC,Home,렌즈 아반도,3,0,1,0.0,1,3,33.3,1,4,25.0,0,0,0.0,1,1,2,0,0,1,1,0,2,1
../kbl_data/2022-2023,S41G01N193,원주 DB,Away,박찬희,2,1,2,50.0,0,0,0.0,1,2,50.0,0,0,0.0,0,0,0,0,0,0,0,0,2,1
../kbl_data/2022-2023,S41G01N193,원주 DB,Away,김현호,23,1,4,25.0,5,10,50.0,6,14,42.9,6,6,100.0,0,3,3,0,2,0,0,0,2,3
../kbl_data/2022-2023,S41G01N193,원주 DB,Away,말콤 토마스,4,1,4,25.0,0,1,0.0,1,5,20.0,2,3,66.7,1,9,10,3,1,1,0,0,1,3
../kbl_data/2022-2023,S41G01N193,원주 DB,Away,김종규,14,5,7,71.4,0,0,0.0,5,7,71.4,4,4,100.0,1,6,7,0,0,1,0,2,2,2
../kbl_data/2022-2023,S41G01N193,원주 DB,Away,최승욱,4,0,5,0.0,1,3,33.3,1,8,12.5,1,2,50.0,1,3,4,0,0,0,0,0,0,0
../kbl_data/2022-2023,S41G01N193,원주 DB,Away,강상재,11,4,10,40.0,1,2,50.0,5,12,41.7,0,0,0.0,2,0,2,6,1,0,0,0,2,3
../kbl_data/2022-2023,S41G01N193,원주 DB,Away,윤성원,0,0,0,0.0,0,0,0.0,0,0,0.0,0,0,0.0,0,0,0,0,0,0,0,0,0,0
../kbl_data/2022-2023,S41G01N193,원주 DB,Away,이준희,0,0,0,0.0,0,0,0.0,0,0,0.0,0,0,0.0,0,0,0,0,0,0,0,0,0,0
../kbl_data/2022-2023,S41G01N193,원주 DB,Away,레나드 프리먼,4,2,5,40.0,0,0,0.0,2,5,40.0,0,0,0.0,3,4,7,0,1,0,0,0,0,1
../kbl_data/2022-2023,S41G01N193,원주 DB,Away,정호영,0,0,0,0.0,0,0,0.0,0,0,0.0,0,0,0.0,0,0,0,0,0,0,0,0,0,0
../kbl_data/2022-2023,S41G01N193,원주 DB,Away,이민석,0,0,0,0.0,0,0,0.0,0,0,0.0,0,0,0.0,2,0,2,0,0,0,0,0,0,2
../kbl_data/2022-2023,S41G01N193,원주 DB,Away,이선 알바노,8,4,10,40.0,0,3,0.0,4,13,30.8,0,0,0.0,2,2,4,3,2,0,0,0,3,4
../kbl_data/2022-2023,S41G01N194,전주 KCC,Home,정창영,8,1,5,20.0,1,5,20.0,2,10,20.0,3,4,75.0,0,3,3,4,1,0,0,0,3,3
../kbl_data/2022-2023,S41G01N194,전주 KCC,Home,라건아,25,10,13,76.9,1,6,16.7,11,19,57.9,2,2,100.0,4,8,12,2,1,1,0,0,2,1
../kbl_data/2022-2023,S41G01N194,전주 KCC,Home,박경상,1,0,0,0.0,0,3,0.0,0,3,0.0,1,2,50.0,0,0,0,3,1,0,1,0,1,0
../kbl_data/2022-2023,S41G01N194,전주 KCC,Home,김지완,9,3,5,60.0,1,4,25.0,4,9,44.4,0,0,0.0,0,3,3,1,1,0,0,0,3,4
../kbl_data/2022-2023,S41G01N194,전주 KCC,Home,김상규,2,1,1,100.0,0,1,0.0,1,2,50.0,0,0,0.0,2,0,2,1,0,0,0,0,0,2
../kbl_data/2022-2023,S41G01N194,전주 KCC,Home,전준범,6,1,2,50.0,0,1,0.0,1,3,33.3,4,4,100.0,1,2,3,1,0,0,0,0,0,3
../kbl_data/2022-2023,S41G01N194,전주 KCC,Home,허웅,3,1,4,25.0,0,0,0.0,1,4,25.0,1,2,50.0,0,0,0,0,2,0,0,0,0,1
../kbl_data/2022-2023,S41G01N194,전주 KCC,Home,이종현,13,5,6,83.3,0,0,0.0,5,6,83.3,3,3,100.0,3,6,9,2,0,0,0,0,1,3
../kbl_data/2022-2023,S41G01N194,전주 KCC,Home,이진욱,0,0,0,0.0,0,0,0.0,0,0,0.0,0,0,0.0,0,0,0,1,0,0,0,0,0,0
../kbl_data/2022-2023,S41G01N194,전주 KCC,Home,이근휘,0,0,0,0.0,0,0,0.0,0,0,0.0,0,0,0.0,0,0,0,0,0,0,0,0,1,1
../kbl_data/2022-2023,S41G01N194,전주 KCC,Home,론데 홀리스 제퍼슨,0,0,0,0.0,0,0,0.0,0,0,0.0,0,0,0.0,0,0,0,0,0,0,0,0,0,0
../kbl_data/2022-2023,S41G01N194,전주 KCC,Home,칼빈 제프리 에피스톨라,3,1,3,33.3,0,1,0.0,1,4,25.0,1,2,50.0,2,1,3,0,1,0,0,0,0,1
../kbl_data/2022-2023,S41G01N194,울산 현대모비스,Away,함지훈,4,1,1,100.0,0,1,0.0,1,2,50.0,2,2,100.0,0,2,2,2,1,0,0,0,0,2
../kbl_data/2022-2023,S41G01N194,울산 현대모비스,Away,김현민,0,0,0,0.0,0,0,0.0,0,0,0.0,0,0,0.0,0,0,0,0,0,0,0,0,0,0
../kbl_data/2022-2023,S41G01N194,울산 현대모비스,Away,최진수,0,0,0,0.0,0,0,0.0,0,0,0.0,0,0,0.0,0,0,0,0,0,0,0,0,0,0
../kbl_data/2022-2023,S41G01N194,울산 현대모비스,Away,장재석,19,9,9,100.0,0,0,0.0,9,9,100.0,1,2,50.0,5,4,9,1,4,0,0,1,1,3
../kbl_data/2022-2023,S41G01N194,울산 현대모비스,Away,김영현,0,0,0,0.0,0,0,0.0,0,0,0.0,0,0,0.0,0,1,1,0,0,0,0,0,0,1
../kbl_data/2022-2023,S41G01N194,울산 현대모비스,Away,서명진,14,2,5,40.0,3,8,37.5,5,13,38.5,1,2,50.0,1,1,2,4,0,0,0,0,3,0
../kbl_data/2022-2023,S41G01N194,울산 현대모비스,Away,헨리 심스,2,1,6,16.7,0,0,0.0,1,6,16.7,0,0,0.0,1,3,4,0,0,1,0,0,0,2
../kbl_data/2022-2023,S41G01N194,울산 현대모비스,Away,이우석,10,3,4,75.0,0,2,0.0,3,6,50.0,4,4,100.0,0,1,1,2,0,0,0,0,1,2
../kbl_data/2022-2023,S41G01N194,울산 현대모비스,Away,신민석,2,1,3,33.3,0,1,0.0,1,4,25.0,0,0,0.0,2,0,2,0,0,0,0,0,0,3
../kbl_data/2022-2023,S41G01N194,울산 현대모비스,Away,론제이 아바리엔토스,9,0,2,0.0,3,9,33.3,3,11,27.3,0,0,0.0,0,3,3,5,1,0,0,0,1,3
../kbl_data/2022-2023,S41G01N194,울산 현대모비스,Away,게이지 프림,13,6,11,54.5,0,0,0.0,6,11,54.5,1,2,50.0,2,6,8,0,1,0,0,0,2,3
../kbl_data/2022-2023,S41G01N194,울산 현대모비스,Away,김태완,3,0,1,0.0,1,2,50.0,1,3,33.3,0,0,0.0,0,0,0,0,0,0,1,0,0,1
../kbl_data/2022-2023,S41G01N195,창원 LG,Home,이관희,15,6,10,60.0,0,5,0.0,6,15,40.0,3,4,75.0,1,3,4,1,2,0,0,0,1,2
../kbl_data/2022-2023,S41G01N195,창원 LG,Home,정희재,0,0,1,0.0,0,2,0.0,0,3,0.0,0,0,0.0,0,0,0,5,0,0,0,0,0,2
../kbl_data/2022-2023,S41G01N195,창원 LG,Home,임동섭,15,2,2,100.0,3,3,100.0,5,5,100.0,2,2,100.0,1,3,4,1,3,0,0,0,2,3
../kbl_data/2022-2023,S41G01N195,창원 LG,Home,서민수,2,1,2,50.0,0,0,0.0,1,2,50.0,0,0,0.0,0,0,0,0,0,0,0,0,0,0
../kbl_data/2022-2023,S41G01N195,창원 LG,Home,이재도,7,2,7,28.6,1,2,50.0,3,9,33.3,0,0,0.0,1,1,2,0,1,0,0,0,3,2
../kbl_data/2022-2023,S41G01N195,창원 LG,Home,김준일,12,5,9,55.6,0,0,0.0,5,9,55.6,2,4,50.0,0,1,1,4,1,0,0,0,3,2
../kbl_data/2022-2023,S41G01N195,창원 LG,Home,정인덕,0,0,0,0.0,0,2,0.0,0,2,0.0,0,0,0.0,0,0,0,0,0,0,0,0,0,0
../kbl_data/2022-2023,S41G01N195,창원 LG,Home,윤원상,8,1,1,100.0,2,3,66.7,3,4,75.0,0,0,0.0,2,0,2,3,0,0,0,0,1,4
../kbl_data/2022-2023,S41G01N195,창원 LG,Home,아셈 마레이,14,6,8,75.0,0,0,0.0,6,8,75.0,2,4,50.0,4,6,10,0,2,0,0,0,1,1
../kbl_data/2022-2023,S41G01N195,창원 LG,Home,저스틴 구탕,10,4,4,100.0,0,0,0.0,4,4,100.0,2,2,100.0,0,1,1,3,2,0,0,0,1,4
../kbl_data/2022-2023,S41G01N195,창원 LG,Home,양준석,3,0,0,0.0,1,1,100.0,1,1,100.0,0,0,0.0,0,0,0,0,0,0,0,0,0,0
../kbl_data/2022-2023,S41G01N195,창원 LG,Home,단테 커닝햄,10,4,6,66.7,0,0,0.0,4,6,66.7,2,5,40.0,2,11,13,2,0,2,0,0,1,2
../kbl_data/2022-2023,S41G01N195,서울 삼성,Away,이정현,12,3,9,33.3,0,5,0.0,3,14,21.4,6,7,85.7,1,3,4,4,1,0,0,0,2,0
../kbl_data/2022-2023,S41G01N195,서울 삼성,Away,장민국,11,1,1,100.0,3,5,60.0,4,6,66.7,0,0,0.0,2,6,8,3,0,0,0,0,1,5
../kbl_data/2022-2023,S41G01N195,서울 삼성,Away,김승원,4,1,4,25.0,0,0,0.0,1,4,25.0,2,2,100.0,2,3,5,0,0,0,0,0,2,1
../kbl_data/2022-2023,S41G01N195,서울 삼성,Away,김시래,5,1,5,20.0,0,2,0.0,1,7,14.3,3,4,75.0,0,2,2,5,2,0,0,0,3,2
../kbl_data/2022-2023,S41G01N195,서울 삼성,Away,이동엽,2,0,1,0.0,0,2,0.0,0,3,0.0,2,2,100.0,2,1,3,2,1,0,0,0,2,1
../kbl_data/2022-2023,S41G01N195,서울 삼성,Away,이호현,15,7,10,70.0,0,1,0.0,7,11,63.6,1,1,100.0,0,3,3,4,2,0,1,0,1,2
../kbl_data/2022-2023,S41G01N195,서울 삼성,Away,강바일,0,0,0,0.0,0,0,0.0,0,0,0.0,0,0,0.0,0,0,0,0,0,0,0,0,0,0
../kbl_data/2022-2023,S41G01N195,서울 삼성,Away,김한솔,0,0,0,0.0,0,0,0.0,0,0,0.0,0,0,0.0,0,0,0,0,0,0,0,0,1,1
../kbl_data/2022-2023,S41G01N195,서울 삼성,Away,김진영,4,1,2,50.0,0,3,0.0,1,5,20.0,2,2,100.0,0,1,1,0,0,0,0,0,1,3
../kbl_data/2022-2023,S41G01N195,서울 삼성,Away,차민석,2,1,2,50.0,0,0,0.0,1,2,50.0,0,0,0.0,1,0,1,0,0,0,0,0,0,2
../kbl_data/2022-2023,S41G01N195,서울 삼성,Away,신동혁,0,0,1,0.0,0,0,0.0,0,1,0.0,0,0,0.0,0,0,0,0,0,0,0,0,1,1
../kbl_data/2022-2023,S41G01N195,서울 삼성,Away,앤서니 모스,23,9,13,69.2,0,0,0.0,9,13,69.2,5,7,71.4,4,5,9,0,1,0,0,4,0,4
../kbl_data/2022-2023,S41G01N196,고양 캐롯,Home,김강선,8,1,1,100.0,2,8,25.0,3,9,33.3,0,0,0.0,0,1,1,0,0,0,0,0,0,3
../kbl_data/2022-2023,S41G01N196,고양 캐롯,Home,임종일,0,0,0,0.0,0,0,0.0,0,0,0.0,0,0,0.0,0,0,0,0,0,0,0,0,0,0
../kbl_data/2022-2023,S41G01N196,고양 캐롯,Home,전성현,10,1,5,20.0,2,7,28.6,3,12,25.0,2,2,100.0,0,0,0,5,2,0,0,0,1,2
../kbl_data/2022-2023,S41G01N196,고양 캐롯,Home,김진유,0,0,0,0.0,0,0,0.0,0,0,0.0,0,0,0.0,1,1,2,2,3,0,0,0,0,1
../kbl_data/2022-2023,S41G01N196,고양 캐롯,Home,김진용,0,0,0,0.0,0,0,0.0,0,0,0.0,0,0,0.0,0,0,0,0,0,0,0,0,0,0
../kbl_data/2022-2023,S41G01N196,고양 캐롯,Home,조한진,6,0,1,0.0,2,3,66.7,2,4,50.0,0,0,0.0,2,1,3,1,0,1,1,0,1,5
../kbl_data/2022-2023,S41G01N196,고양 캐롯,Home,김세창,0,0,0,0.0,0,0,0.0,0,0,0.0,0,0,0.0,0,0,0,0,0,0,0,0,0,0
../kbl_data/2022-2023,S41G01N196,고양 캐롯,Home,디드릭 로슨,22,9,13,69.2,0,6,0.0,9,19,47.4,4,5,80.0,3,6,9,5,3,2,0,1,2,1
../kbl_data/2022-2023,S41G01N196,고양 캐롯,Home,박진철,6,3,5,60.0,0,0,0.0,3,5,60.0,0,0,0.0,1,8,9,2,1,0,0,1,0,2
../kbl_data/2022-2023,S41G01N196,고양 캐롯,Home,이정현,16,1,1,100.0,4,8,50.0,5,9,55.6,2,2,100.0,0,3,3,5,3,0,0,0,0,4
../kbl_data/2022-2023,S41G01N196,고양 캐롯,Home,모리구치 히사시,2,1,2,50.0,0,0,0.0,1,2,50.0,0,0,0.0,1,2,3,0,1,0,0,0,0,0
../kbl_data/2022-2023,S41G01N196,고양 캐롯,Home,조나단 알렛지,13,3,4,75.0,2,2,100.0,5,6,83.3,1,1,100.0,0,1,1,0,0,0,0,0,1,2
../kbl_data/2022-2023,S41G01N196,수원 KT,Away,김동욱,3,0,1,0.0,1,2,50.0,1,3,33.3,0,0,0.0,0,1,1,0,0,0,0,0,0,0
../kbl_data/2022-2023,S41G01N196,수원 KT,Away,김영환,3,0,1,0.0,1,2,50.0,1,3,33.3,0,0,0.0,1,0,1,1,0,0,0,0,0,0
../kbl_data/2022-2023,S41G01N196,수원 KT,Away,한희원,3,0,1,0.0,1,4,25.0,1,5,20.0,0,0,0.0,0,3,3,0,0,1,0,0,2,2
../kbl_data/2022-2023,S41G01N196,수원 KT,Away,정성우,7,1,5,20.0,1,1,100.0,2,6,33.3,2,2,100.0,0,0,0,7,0,0,0,0,1,1
../kbl_data/2022-2023,S41G01N196,수원 KT,Away,최성모,3,1,1,100.0,0,2,0.0,1,3,33.3,1,1,100.0,0,2,2,2,1,0,0,0,3,3
../kbl_data/2022-2023,S41G01N196,수원 KT,Away,양홍석,14,4,7,57.1,2,5,40.0,6,12,50.0,0,0,0.0,4,5,9,0,0,0,0,0,2,2
../kbl_data/2022-2023,S41G01N196,수원 KT,Away,박지원,4,0,0,0.0,1,4,25.0,1,4,25.0,1,2,50.0,0,3,3,0,0,0,0,0,1,4
../kbl_data/2022-2023,S41G01N196,수원 KT,Away,하윤기,19,9,15,60.0,0,0,0.0,9,15,60.0,1,3,33.3,3,8,11,1,0,0,0,1,2,1
../kbl_data/2022-2023,S41G01N196,수원 KT,Away,이두원,0,0,0,0.0,0,0,0.0,0,0,0.0,0,0,0.0,0,0,0,0,0,0,0,0,0,1
../kbl_data/2022-2023,S41G01N196,수원 KT,Away,레스터 프로스퍼,2,1,4,25.0,0,0,0.0,1,4,25.0,0,0,0.0,3,2,5,0,0,0,0,0,0,1
../kbl_data/2022-2023,S41G01N196,수원 KT,Away,재로드 존스,9,2,3,66.7,1,6,16.7,3,9,33.3,2,2,100.0,0,3,3,4,2,0,1,0,4,2
../kbl_data/2022-2023,S41G01N196,수원 KT,Away,데이브 일데폰소,0,0,0,0.0,0,0,0.0,0,0,0.0,0,0,0.0,0,0,0,0,0,0,0,0,0,0
../kbl_data/2022-2023,S41G01N197,서울 SK,Home,양우섭,0,0,0,0.0,0,0,0.0,0,0,0.0,0,0,0.0,0,0,0,0,0,0,0,0,0,0
../kbl_data/2022-2023,S41G01N197,서울 SK,Home,허일영,11,1,2,50.0,3,6,50.0,4,8,50.0,0,0,0.0,0,1,1,0,0,0,0,0,1,3
../kbl_data/2022-2023,S41G01N197,서울 SK,Home,송창용,0,0,0,0.0,0,0,0.0,0,0,0.0,0,0,0.0,0,0,0,0,0,0,0,0,0,0
../kbl_data/2022-2023,S41G01N197,서울 SK,Home,김선형,9,3,7,42.9,0,3,0.0,3,10,30.0,3,4,75.0,0,4,4,4,1,0,0,0,4,2
../kbl_data/2022-2023,S41G01N197,서울 SK,Home,최부경,5,1,4,25.0,0,0,0.0,1,4,25.0,3,4,75.0,2,4,6,1,2,0,0,0,0,0
../kbl_data/2022-2023,S41G01N197,서울 SK,Home,리온 윌리엄스,3,0,2,0.0,1,1,100.0,1,3,33.3,0,0,0.0,0,2,2,0,1,0,0,0,0,1
../kbl_data/2022-2023,S41G01N197,서울 SK,Home,최원혁,10,2,2,100.0,2,5,40.0,4,7,57.1,0,0,0.0,1,1,2,3,3,0,0,0,1,4
../kbl_data/2022-2023,S41G01N197,서울 SK,Home,최준용,13,3,5,60.0,2,4,50.0,5,9,55.6,1,2,50.0,0,5,5,6,1,1,0,0,2,3
../kbl_data/2022-2023,S41G01N197,서울 SK,Home,최성원,5,1,1,100.0,1,1,100.0,2,2,100.0,0,0,0.0,0,0,0,1,0,0,0,0,0,3
../kbl_data/2022-2023,S41G01N197,서울 SK,Home,자밀 워니,28,11,19,57.9,1,1,100.0,12,20,60.0,3,4,75.0,4,6,10,6,1,1,0,0,4,3
../kbl_data/2022-2023,S41G01N197,서울 SK,Home,오재현,5,1,1,100.0,1,2,50.0,2,3,66.7,0,0,0.0,0,0,0,0,1,0,0,0,0,4
../kbl_data/2022-2023,S41G01N197,서울 SK,Home,선상혁,0,0,0,0.0,0,0,0.0,0,0,0.0,0,0,0.0,0,0,0,0,0,0,0,0,0,0
../kbl_data/2022-2023,S41G01N197,대구 한국가스공사,Away,차바위,3,0,2,0.0,1,2,50.0,1,4,25.0,0,0,0.0,0,2,2,0,0,0,2,0,0,5
../kbl_data/2022-2023,S41G01N197,대구 한국가스공사,Away,박지훈,0,0,0,0.0,0,0,0.0,0,0,0.0,0,0,0.0,0,0,0,0,0,0,0,0,0,0
../kbl_data/2022-2023,S41G01N197,대구 한국가스공사,Away,이원대,0,0,0,0.0,0,1,0.0,0,1,0.0,0,0,0.0,0,1,1,0,0,0,0,0,1,0
../kbl_data/2022-2023,S41G01N197,대구 한국가스공사,Away,이대헌,13,3,6,50.0,2,6,33.3,5,12,41.7,1,3,33.3,2,2,4,1,1,0,0,0,2,2
../kbl_data/2022-2023,S41G01N197,대구 한국가스공사,Away,이대성,12,3,11,27.3,0,1,0.0,3,12,25.0,6,6,100.0,1,1,2,5,2,0,0,0,3,0
../kbl_data/2022-2023,S41G01N197,대구 한국가스공사,Away,정효근,20,4,4,100.0,4,7,57.1,8,11,72.7,0,1,0.0,0,3,3,3,0,0,0,0,1,5
../kbl_data/2022-2023,S41G01N197,대구 한국가스공사,Away,머피 할로웨이,20,9,12,75.0,0,0,0.0,9,12,75.0,2,2,100.0,1,8,9,3,3,1,0,3,5,1
../kbl_data/2022-2023,S41G01N197,대구 한국가스공사,Away,우동현,0,0,0,0.0,0,0,0.0,0,0,0.0,0,0,0.0,0,0,0,0,0,0,0,0,0,0
../kbl_data/2022-2023,S41G01N197,대구 한국가스공사,Away,전현우,0,0,0,0.0,0,0,0.0,0,0,0.0,0,0,0.0,0,0,0,0,0,0,0,0,0,0
../kbl_data/2022-2023,S41G01N197,대구 한국가스공사,Away,데본 스캇,7,3,4,75.0,0,0,0.0,3,4,75.0,1,2,50.0,1,3,4,1,0,0,0,0,0,1
../kbl_data/2022-2023,S41G01N197,대구 한국가스공사,Away,신승민,0,0,0,0.0,0,1,0.0,0,1,0.0,0,0,0.0,0,0,0,0,0,0,0,0,1,0
../kbl_data/2022-2023,S41G01N197,대구 한국가스공사,Away,샘조세프 벨란겔,10,2,4,50.0,2,2,100.0,4,6,66.7,0,2,0.0,0,3,3,4,2,0,0,0,0,4
../kbl_data/2022-2023,S41G01N198,안양 KGC,Home,양희종,5,1,2,50.0,1,2,50.0,2,4,50.0,0,0,0.0,0,3,3,0,0,1,1,0,0,2
../kbl_data/2022-2023,S41G01N198,안양 KGC,Home,오세근,17,5,8,62.5,2,4,50.0,7,12,58.3,1,2,50.0,0,4,4,1,0,0,0,0,0,1
../kbl_data/2022-2023,S41G01N198,안양 KGC,Home,정준원,3,1,1,100.0,0,0,0.0,1,1,100.0,1,1,100.0,1,0,1,0,0,0,0,0,0,0
../kbl_data/2022-2023,S41G01N198,안양 KGC,Home,배병준,5,1,3,33.3,1,1,100.0,2,4,50.0,0,0,0.0,0,1,1,2,0,0,0,0,0,0
../kbl_data/2022-2023,S41G01N198,안양 KGC,Home,문성곤,2,0,0,0.0,0,2,0.0,0,2,0.0,2,2,100.0,4,3,7,1,2,0,0,0,2,2
../kbl_data/2022-2023,S41G01N198,안양 KGC,Home,박지훈,7,2,3,66.7,1,2,50.0,3,5,60.0,0,0,0.0,0,2,2,4,0,1,0,0,1,3
../kbl_data/2022-2023,S41G01N198,안양 KGC,Home,이우정,0,0,0,0.0,0,0,0.0,0,0,0.0,0,0,0.0,0,0,0,0,0,0,0,0,0,0
../kbl_data/2022-2023,S41G01N198,안양 KGC,Home,대릴 먼로,0,0,2,0.0,0,0,0.0,0,2,0.0,0,0,0.0,0,0,0,0,0,0,0,0,0,0
../kbl_data/2022-2023,S41G01N198,안양 KGC,Home,변준형,18,6,10,60.0,1,4,25.0,7,14,50.0,3,4,75.0,0,1,1,9,1,0,1,0,2,1
../kbl_data/2022-2023,S41G01N198,안양 KGC,Home,김경원,5,1,1,100.0,1,1,100.0,2,2,100.0,0,0,0.0,1,0,1,0,0,0,0,0,1,2
../kbl_data/2022-2023,S41G01N198,안양 KGC,Home,오마리 스펠맨,27,4,8,50.0,5,9,55.6,9,17,52.9,4,4,100.0,0,14,14,2,1,1,0,0,2,1
../kbl_data/2022-2023,S41G01N198,안양 KGC,Home,렌즈 아반도,6,2,4,50.0,0,1,0.0,2,5,40.0,2,3,66.7,0,0,0,0,1,0,0,1,1,2
../kbl_data/2022-2023,S41G01N198,울산 현대모비스,Away,함지훈,3,1,3,33.3,0,1,0.0,1,4,25.0,1,1,100.0,0,1,1,0,0,0,0,0,1,0
../kbl_data/2022-2023,S41G01N198,울산 현대모비스,Away,김현민,0,0,0,0.0,0,0,0.0,0,0,0.0,0,0,0.0,0,0,0,0,0,0,0,0,0,0
../kbl_data/2022-2023,S41G01N198,울산 현대모비스,Away,최진수,4,2,4,50.0,0,2,0.0,2,6,33.3,0,0,0.0,1,3,4,0,1,0,0,0,2,2
../kbl_data/2022-2023,S41G01N198,울산 현대모비스,Away,장재석,8,3,4,75.0,0,0,0.0,3,4,75.0,2,3,66.7,0,0,0,0,0,0,0,0,0,0
../kbl_data/2022-2023,S41G01N198,울산 현대모비스,Away,김국찬,2,1,1,100.0,0,1,0.0,1,2,50.0,0,0,0.0,0,0,0,0,0,0,1,0,0,1
../kbl_data/2022-2023,S41G01N198,울산 현대모비스,Away,서명진,6,3,5,60.0,0,2,0.0,3,7,42.9,0,0,0.0,0,1,1,2,0,0,0,0,3,4
../kbl_data/2022-2023,S41G01N198,울산 현대모비스,Away,헨리 심스,0,0,1,0.0,0,1,0.0,0,2,0.0,0,0,0.0,0,0,0,0,0,0,0,0,0,0
../kbl_data/2022-2023,S41G01N198,울산 현대모비스,Away,이우석,14,4,8,50.0,2,6,33.3,6,14,42.9,0,0,0.0,2,4,6,3,0,0,0,0,2,1
../kbl_data/2022-2023,S41G01N198,울산 현대모비스,Away,신민석,0,0,0,0.0,0,0,0.0,0,0,0.0,0,0,0.0,1,1,2,1,0,0,0,0,0,3
../kbl_data/2022-2023,S41G01N198,울산 현대모비스,Away,론제이 아바리엔토스,10,1,3,33.3,2,7,28.6,3,10,30.0,2,2,100.0,0,2,2,5,2,0,0,0,1,3
../kbl_data/2022-2023,S41G01N198,울산 현대모비스,Away,게이지 프림,24,9,14,64.3,1,1,100.0,10,15,66.7,3,4,75.0,5,12,17,2,1,0,0,0,2,2
../kbl_data/2022-2023,S41G01N198,울산 현대모비스,Away,김태완,12,3,4,75.0,2,4,50.0,5,8,62.5,0,0,0.0,0,5,5,3,4,0,0,0,0,4
../kbl_data/2022-2023,S41G01N199,서울 SK,Home,양우섭,0,0,0,0.0,0,0,0.0,0,0,0.0,0,0,0.0,0,0,0,0,0,0,0,0,0,0
../kbl_data/2022-2023,S41G01N199,서울 SK,Home,허일영,9,2,2,100.0,1,2,50.0,3,4,75.0,2,2,100.0,0,3,3,0,0,0,0,0,1,2
../kbl_data/2022-2023,S41G01N199,서울 SK,Home,송창용,0,0,0,0.0,0,0,0.0,0,0,0.0,0,0,0.0,0,0,0,0,0,0,0,0,0,0
../kbl_data/2022-2023,S41G01N199,서울 SK,Home,김선형,17,5,10,50.0,2,6,33.3,7,16,43.8,1,1,100.0,0,1,1,8,1,0,0,0,2,3
../kbl_data/2022-2023,S41G01N199,서울 SK,Home,최부경,12,5,8,62.5,0,0,0.0,5,8,62.5,2,2,100.0,1,2,3,2,0,0,0,0,0,2
../kbl_data/2022-2023,S41G01N199,서울 SK,Home,리온 윌리엄스,0,0,0,0.0,0,0,0.0,0,0,0.0,0,0,0.0,0,0,0,0,0,0,0,0,0,0
../kbl_data/2022-2023,S41G01N199,서울 SK,Home,최원혁,2,1,1,100.0,0,0,0.0,1,1,100.0,0,0,0.0,1,0,1,1,0,0,1,0,1,5
../kbl_data/2022-2023,S41G01N199,서울 SK,Home,최준용,0,0,0,0.0,0,0,0.0,0,0,0.0,0,0,0.0,0,0,0,0,0,0,0,0,0,0
../kbl_data/2022-2023,S41G01N199,서울 SK,Home,최성원,5,1,2,50.0,0,4,0.0,1,6,16.7,3,3,100.0,0,0,0,3,0,0,0,0,0,3
../kbl_data/2022-2023,S41G01N199,서울 SK,Home,자밀 워니,37,13,24,54.2,2,5,40.0,15,29,51.7,5,5,100.0,1,13,14,3,1,2,0,1,4,3
../kbl_data/2022-2023,S41G01N199,서울 SK,Home,오재현,2,1,1,100.0,0,1,0.0,1,2,50.0,0,0,0.0,1,0,1,0,0,0,0,0,1,2
../kbl_data/2022-2023,S41G01N199,서울 SK,Home,선상혁,0,0,0,0.0,0,0,0.0,0,0,0.0,0,0,0.0,1,2,3,0,0,0,0,0,0,1
../kbl_data/2022-2023,S41G01N199,창원 LG,Away,이관희,20,7,12,58.3,1,3,33.3,8,15,53.3,3,3,100.0,0,3,3,4,2,0,0,0,0,1
../kbl_data/2022-2023,S41G01N199,창원 LG,Away,정희재,12,2,2,100.0,2,3,66.7,4,5,80.0,2,2,100.0,2,0,2,4,1,0,0,0,1,4
../kbl_data/2022-2023,S41G01N199,창원 LG,Away,임동섭,5,1,1,100.0,1,2,50.0,2,3,66.7,0,0,0.0,0,1,1,0,0,0,0,0,1,5
../kbl_data/2022-2023,S41G01N199,창원 LG,Away,서민수,0,0,0,0.0,0,0,0.0,0,0,0.0,0,0,0.0,0,0,0,0,0,0,0,0,0,0
../kbl_data/2022-2023,S41G01N199,창원 LG,Away,이재도,16,7,7,100.0,0,2,0.0,7,9,77.8,2,3,66.7,0,2,2,6,1,0,0,0,2,3
../kbl_data/2022-2023,S41G01N199,창원 LG,Away,김준일,5,2,3,66.7,0,0,0.0,2,3,66.7,1,2,50.0,0,3,3,1,0,1,0,0,0,0
../kbl_data/2022-2023,S41G01N199,창원 LG,Away,정인덕,0,0,0,0.0,0,1,0.0,0,1,0.0,0,0,0.0,0,0,0,0,0,1,0,0,0,1
../kbl_data/2022-2023,S41G01N199,창원 LG,Away,윤원상,6,0,1,0.0,2,2,100.0,2,3,66.7,0,0,0.0,0,0,0,0,0,0,0,0,1,4
../kbl_data/2022-2023,S41G01N199,창원 LG,Away,아셈 마레이,24,8,18,44.4,0,0,0.0,8,18,44.4,8,12,66.7,7,13,20,7,2,0,0,1,0,3
../kbl_data/2022-2023,S41G01N199,창원 LG,Away,저스틴 구탕,4,2,3,66.7,0,0,0.0,2,3,66.7,0,0,0.0,0,0,0,1,1,0,0,0,0,1
../kbl_data/2022-2023,S41G01N199,창원 LG,Away,양준석,0,0,0,0.0,0,0,0.0,0,0,0.0,0,0,0.0,0,0,0,0,1,0,0,0,0,1
../kbl_data/2022-2023,S41G01N199,창원 LG,Away,단테 커닝햄,2,0,2,0.0,0,0,0.0,0,2,0.0,2,2,100.0,1,0,1,2,0,0,0,0,0,0
../kbl_data/2022-2023,S41G01N200,수원 KT,Home,김동욱,0,0,0,0.0,0,0,0.0,0,0,0.0,0,0,0.0,0,0,0,0,0,0,0,0,0,0
../kbl_data/2022-2023,S41G01N200,수원 KT,Home,김영환,2,1,2,50.0,0,0,0.0,1,2,50.0,0,0,0.0,0,0,0,1,1,0,0,0,1,3
../kbl_data/2022-2023,S41G01N200,수원 KT,Home,한희원,0,0,0,0.0,0,0,0.0,0,0,0.0,0,0,0.0,0,0,0,0,0,0,0,0,0,0
../kbl_data/2022-2023,S41G01N200,수원 KT,Home,정성우,18,1,2,50.0,5,10,50.0,6,12,50.0,1,2,50.0,0,2,2,1,1,0,0,0,1,1
../kbl_data/2022-2023,S41G01N200,수원 KT,Home,최성모,2,0,0,0.0,0,1,0.0,0,1,0.0,2,2,100.0,0,1,1,2,1,0,0,0,0,4
../kbl_data/2022-2023,S41G01N200,수원 KT,Home,양홍석,20,3,8,37.5,4,8,50.0,7,16,43.8,2,2,100.0,4,6,10,7,1,0,0,0,0,3
../kbl_data/2022-2023,S41G01N200,수원 KT,Home,박지원,2,1,1,100.0,0,0,0.0,1,1,100.0,0,0,0.0,0,0,0,0,0,0,0,0,0,1
../kbl_data/2022-2023,S41G01N200,수원 KT,Home,하윤기,20,9,13,69.2,0,0,0.0,9,13,69.2,2,2,100.0,2,3,5,1,0,1,0,1,1,1
../kbl_data/2022-2023,S41G01N200,수원 KT,Home,이두원,2,1,2,50.0,0,0,0.0,1,2,50.0,0,0,0.0,2,0,2,1,0,0,0,0,0,2
../kbl_data/2022-2023,S41G01N200,수원 KT,Home,레스터 프로스퍼,8,1,2,50.0,2,5,40.0,3,7,42.9,0,0,0.0,3,4,7,0,1,0,0,0,0,3
../kbl_data/2022-2023,S41G01N200,수원 KT,Home,재로드 존스,11,3,4,75.0,1,10,10.0,4,14,28.6,2,2,100.0,1,9,10,2,1,0,0,0,1,1
../kbl_data/2022-2023,S41G01N200,수원 KT,Home,데이브 일데폰소,1,0,1,0.0,0,0,0.0,0,1,0.0,1,2,50.0,1,0,1,1,0,0,0,0,0,2
../kbl_data/2022-2023,S41G01N200,전주 KCC,Away,정창영,4,0,1,0.0,1,5,20.0,1,6,16.7,1,4,25.0,2,2,4,2,1,0,0,0,1,2
../kbl_data/2022-2023,S41G01N200,전주 KCC,Away,라건아,28,10,21,47.6,2,4,50.0,12,25,48.0,2,5,40.0,7,9,16,2,0,0,0,0,1,1
../kbl_data/2022-2023,S41G01N200,전주 KCC,Away,김지완,9,1,3,33.3,2,4,50.0,3,7,42.9,1,3,33.3,0,2,2,3,0,0,0,0,2,1
../kbl_data/2022-2023,S41G01N200,전주 KCC,Away,김상규,6,0,1,0.0,2,4,50.0,2,5,40.0,0,0,0.0,2,2,4,1,0,1,0,0,1,2
../kbl_data/2022-2023,S41G01N200,전주 KCC,Away,유병훈,3,0,0,0.0,1,2,50.0,1,2,50.0,0,0,0.0,1,0,1,0,0,0,0,0,0,1
../kbl_data/2022-2023,S41G01N200,전주 KCC,Away,전준범,0,0,1,0.0,0,0,0.0,0,1,0.0,0,0,0.0,0,1,1,0,0,0,0,0,1,0
../kbl_data/2022-2023,S41G01N200,전주 KCC,Away,이종현,9,3,6,50.0,0,0,0.0,3,6,50.0,3,4,75.0,2,0,2,1,0,0,0,0,0,0
../kbl_data/2022-2023,S41G01N200,전주 KCC,Away,박세진,0,0,0,0.0,0,0,0.0,0,0,0.0,0,0,0.0,0,0,0,0,0,0,0,0,0,0
../kbl_data/2022-2023,S41G01N200,전주 KCC,Away,이근휘,0,0,1,0.0,0,2,0.0,0,3,0.0,0,0,0.0,0,0,0,1,0,0,0,0,0,1
../kbl_data/2022-2023,S41G01N200,전주 KCC,Away,김동현,0,0,0,0.0,0,0,0.0,0,0,0.0,0,0,0.0,0,0,0,0,0,0,0,0,0,0
../kbl_data/2022-2023,S41G01N200,전주 KCC,Away,송동훈,5,0,2,0.0,1,1,100.0,1,3,33.3,2,2,100.0,1,3,4,0,0,0,0,0,0,3
../kbl_data/2022-2023,S41G01N200,전주 KCC,Away,칼빈 제프리 에피스톨라,9,3,4,75.0,0,4,0.0,3,8,37.5,3,4,75.0,1,1,2,3,2,0,0,0,1,1
../kbl_data/2022-2023,S41G01N201,대구 한국가스공사,Home,차바위,4,2,2,100.0,0,3,0.0,2,5,40.0,0,0,0.0,2,2,4,0,0,0,0,0,2,3
../kbl_data/2022-2023,S41G01N201,대구 한국가스공사,Home,박지훈,4,2,2,100.0,0,2,0.0,2,4,50.0,0,0,0.0,0,2,2,2,2,0,0,0,2,6
../kbl_data/2022-2023,S41G01N201,대구 한국가스공사,Home,이원대,2,1,1,100.0,0,2,0.0,1,3,33.3,0,0,0.0,0,2,2,2,1,0,0,0,1,2
../kbl_data/2022-2023,S41G01N201,대구 한국가스공사,Home,이대헌,12,4,5,80.0,1,5,20.0,5,10,50.0,1,2,50.0,2,4,6,1,3,0,0,0,0,3
../kbl_data/2022-2023,S41G01N201,대구 한국가스공사,Home,이대성,15,7,9,77.8,0,1,0.0,7,10,70.0,1,1,100.0,0,3,3,4,1,0,0,0,6,5
../kbl_data/2022-2023,S41G01N201,대구 한국가스공사,Home,정효근,5,2,5,40.0,0,4,0.0,2,9,22.2,1,1,100.0,0,4,4,0,0,1,0,0,1,1
../kbl_data/2022-2023,S41G01N201,대구 한국가스공사,Home,머피 할로웨이,3,1,4,25.0,0,0,0.0,1,4,25.0,1,2,50.0,1,4,5,0,1,0,0,0,3,2
../kbl_data/2022-2023,S41G01N201,대구 한국가스공사,Home,우동현,0,0,0,0.0,0,0,0.0,0,0,0.0,0,0,0.0,0,0,0,0,0,0,0,0,0,0
../kbl_data/2022-2023,S41G01N201,대구 한국가스공사,Home,전현우,0,0,0,0.0,0,3,0.0,0,3,0.0,0,0,0.0,0,0,0,1,1,0,0,0,0,0
../kbl_data/2022-2023,S41G01N201,대구 한국가스공사,Home,데본 스캇,15,7,9,77.8,0,1,0.0,7,10,70.0,1,1,100.0,3,7,10,3,1,0,0,1,1,3
../kbl_data/2022-2023,S41G01N201,대구 한국가스공사,Home,신승민,0,0,0,0.0,0,0,0.0,0,0,0.0,0,0,0.0,0,0,0,0,0,0,0,0,0,0
../kbl_data/2022-2023,S41G01N201,대구 한국가스공사,Home,샘조세프 벨란겔,8,1,4,25.0,2,5,40.0,3,9,33.3,0,0,0.0,0,2,2,1,0,0,0,0,0,3
../kbl_data/2022-2023,S41G01N201,안양 KGC,Away,양희종,0,0,0,0.0,0,2,0.0,0,2,0.0,0,0,0.0,0,0,0,0,0,0,0,0,1,0
../kbl_data/2022-2023,S41G01N201,안양 KGC,Away,오세근,11,4,12,33.3,0,1,0.0,4,13,30.8,3,4,75.0,2,3,5,2,1,0,0,0,2,1
../kbl_data/2022-2023,S41G01N201,안양 KGC,Away,정준원,0,0,0,0.0,0,0,0.0,0,0,0.0,0,0,0.0,0,0,0,0,1,0,0,0,0,0
../kbl_data/2022-2023,S41G01N201,안양 KGC,Away,배병준,12,3,3,100.0,2,3,66.7,5,6,83.3,0,0,0.0,0,3,3,0,0,0,0,0,0,0
../kbl_data/2022-2023,S41G01N201,안양 KGC,Away,문성곤,5,0,3,0.0,1,3,33.3,1,6,16.7,2,2,100.0,6,4,10,4,3,0,1,0,1,4
../kbl_data/2022-2023,S41G01N201,안양 KGC,Away,박지훈,4,2,2,100.0,0,2,0.0,2,4,50.0,0,0,0.0,0,2,2,2,2,0,0,0,2,6
../kbl_data/2022-2023,S41G01N201,안양 KGC,Away,대릴 먼로,6,3,3,100.0,0,0,0.0,3,3,100.0,0,0,0.0,1,2,3,0,0,0,0,0,1,3
../kbl_data/2022-2023,S41G01N201,안양 KGC,Away,변준형,4,2,4,50.0,0,5,0.0,2,9,22.2,0,2,0.0,1,0,1,3,1,0,0,0,2,0
../kbl_data/2022-2023,S41G01N201,안양 KGC,Away,한승희,2,1,3,33.3,0,0,0.0,1,3,33.3,0,0,0.0,0,1,1,0,0,0,1,0,0,1
../kbl_data/2022-2023,S41G01N201,안양 KGC,Away,오마리 스펠맨,25,5,8,62.5,4,11,36.4,9,19,47.4,3,5,60.0,2,6,8,3,0,4,0,0,0,0
../kbl_data/2022-2023,S41G01N201,안양 KGC,Away,조은후,0,0,0,0.0,0,0,0.0,0,0,0.0,0,0,0.0,0,0,0,0,0,0,0,0,0,0
../kbl_data/2022-2023,S41G01N201,안양 KGC,Away,렌즈 아반도,3,0,2,0.0,1,2,50.0,1,4,25.0,0,0,0.0,1,3,4,1,2,0,0,0,3,1
../kbl_data/2022-2023,S41G01N202,서울 삼성,Home,이정현,15,3,6,50.0,2,6,33.3,5,12,41.7,3,3,100.0,0,2,2,5,0,0,0,0,2,2
../kbl_data/2022-2023,S41G01N202,서울 삼성,Home,장민국,5,1,3,33.3,1,3,33.3,2,6,33.3,0,0,0.0,1,1,2,0,1,0,0,0,0,3
../kbl_data/2022-2023,S41G01N202,서울 삼성,Home,김승원,6,3,6,50.0,0,1,0.0,3,7,42.9,0,0,0.0,6,5,11,0,0,0,0,0,0,1
../kbl_data/2022-2023,S41G01N202,서울 삼성,Home,김시래,3,0,2,0.0,0,3,0.0,0,5,0.0,3,4,75.0,0,0,0,3,1,0,0,0,4,2
../kbl_data/2022-2023,S41G01N202,서울 삼성,Home,이동엽,0,0,5,0.0,0,1,0.0,0,6,0.0,0,0,0.0,4,0,4,3,1,0,0,0,1,1
../kbl_data/2022-2023,S41G01N202,서울 삼성,Home,이호현,10,4,11,36.4,0,2,0.0,4,13,30.8,2,2,100.0,0,4,4,7,1,0,0,0,2,1
../kbl_data/2022-2023,S41G01N202,서울 삼성,Home,강바일,0,0,0,0.0,0,0,0.0,0,0,0.0,0,0,0.0,0,0,0,0,0,0,0,0,0,0
../kbl_data/2022-2023,S41G01N202,서울 삼성,Home,김진영,0,0,0,0.0,0,0,0.0,0,0,0.0,0,2,0.0,0,1,1,0,0,0,0,0,1,0
../kbl_data/2022-2023,S41G01N202,서울 삼성,Home,차민석,0,0,0,0.0,0,0,0.0,0,0,0.0,0,0,0.0,0,0,0,0,0,0,0,0,0,0
../kbl_data/2022-2023,S41G01N202,서울 삼성,Home,신동혁,13,1,2,50.0,3,5,60.0,4,7,57.1,2,2,100.0,0,2,2,1,2,0,0,0,1,2
../kbl_data/2022-2023,S41G01N202,서울 삼성,Home,다랄 윌리스,18,4,12,33.3,2,3,66.7,6,15,40.0,4,4,100.0,2,6,8,0,1,0,0,0,1,2
../kbl_data/2022-2023,S41G01N202,서울 삼성,Home,앤서니 모스,13,4,8,50.0,0,0,0.0,4,8,50.0,5,7,71.4,8,10,18,1,1,2,0,1,0,5
../kbl_data/2022-2023,S41G01N202,원주 DB,Away,윤호영,0,0,0,0.0,0,0,0.0,0,0,0.0,0,0,0.0,0,2,2,0,0,0,0,0,1,1
../kbl_data/2022-2023,S41G01N202,원주 DB,Away,박찬희,0,0,0,0.0,0,0,0.0,0,0,0.0,0,0,0.0,0,0,0,0,0,0,0,0,0,0
../kbl_data/2022-2023,S41G01N202,원주 DB,Away,김현호,6,3,5,60.0,0,5,0.0,3,10,30.0,0,1,0.0,0,1,1,4,0,0,0,0,2,2
../kbl_data/2022-2023,S41G01N202,원주 DB,Away,말콤 토마스,6,2,3,66.7,0,0,0.0,2,3,66.7,2,2,100.0,1,1,2,2,0,1,0,1,1,4
../kbl_data/2022-2023,S41G01N202,원주 DB,Away,김종규,24,7,14,50.0,1,3,33.3,8,17,47.1,7,10,70.0,3,4,7,1,1,0,0,2,3,1
../kbl_data/2022-2023,S41G01N202,원주 DB,Away,최승욱,15,6,9,66.7,1,3,33.3,7,12,58.3,0,0,0.0,1,6,7,0,0,1,0,0,0,2
../kbl_data/2022-2023,S41G01N202,원주 DB,Away,윤성원,0,0,1,0.0,0,1,0.0,0,2,0.0,0,0,0.0,0,0,0,0,0,0,0,0,0,0
../kbl_data/2022-2023,S41G01N202,원주 DB,Away,이준희,0,0,0,0.0,0,0,0.0,0,0,0.0,0,0,0.0,0,0,0,2,0,0,0,0,0,3
../kbl_data/2022-2023,S41G01N202,원주 DB,Away,레나드 프리먼,7,3,5,60.0,0,0,0.0,3,5,60.0,1,1,100.0,2,9,11,2,2,1,0,1,2,3
../kbl_data/2022-2023,S41G01N202,원주 DB,Away,정호영,13,5,8,62.5,1,2,50.0,6,10,60.0,0,0,0.0,0,0,0,4,1,0,0,0,2,4
../kbl_data/2022-2023,S41G01N202,원주 DB,Away,이민석,0,0,0,0.0,0,0,0.0,0,0,0.0,0,0,0.0,0,0,0,0,0,0,0,0,0,0
../kbl_data/2022-2023,S41G01N202,원주 DB,Away,이선 알바노,6,2,6,33.3,0,5,0.0,2,11,18.2,2,3,66.7,1,4,5,5,0,0,0,0,0,2
../kbl_data/2022-2023,S41G01N203,서울 SK,Home,양우섭,0,0,0,0.0,0,0,0.0,0,0,0.0,0,0,0.0,0,0,0,0,0,0,0,0,0,0
../kbl_data/2022-2023,S41G01N203,서울 SK,Home,허일영,16,3,7,42.9,3,7,42.9,6,14,42.9,1,1,100.0,3,2,5,0,0,0,0,0,1,3
../kbl_data/2022-2023,S41G01N203,서울 SK,Home,송창용,0,0,0,0.0,0,0,0.0,0,0,0.0,0,0,0.0,0,0,0,0,0,0,0,0,0,1
../kbl_data/2022-2023,S41G01N203,서울 SK,Home,김선형,16,7,10,70.0,0,2,0.0,7,12,58.3,2,3,66.7,0,2,2,6,3,0,0,0,0,1
../kbl_data/2022-2023,S41G01N203,서울 SK,Home,홍경기,0,0,0,0.0,0,0,0.0,0,0,0.0,0,0,0.0,0,0,0,0,0,0,0,0,0,0
../kbl_data/2022-2023,S41G01N203,서울 SK,Home,최부경,9,4,5,80.0,0,0,0.0,4,5,80.0,1,1,100.0,6,6,12,0,1,0,0,0,1,1
../kbl_data/2022-2023,S41G01N203,서울 SK,Home,리온 윌리엄스,2,0,1,0.0,0,1,0.0,0,2,0.0,2,2,100.0,1,1,2,3,0,0,0,0,1,2
../kbl_data/2022-2023,S41G01N203,서울 SK,Home,최원혁,3,0,1,0.0,1,1,100.0,1,2,50.0,0,0,0.0,1,1,2,2,0,0,0,0,1,0
../kbl_data/2022-2023,S41G01N203,서울 SK,Home,최성원,4,0,0,0.0,1,4,25.0,1,4,25.0,1,1,100.0,1,1,2,4,0,0,0,0,3,2
../kbl_data/2022-2023,S41G01N203,서울 SK,Home,자밀 워니,19,7,15,46.7,1,2,50.0,8,17,47.1,2,2,100.0,4,9,13,5,2,0,0,0,2,2
../kbl_data/2022-2023,S41G01N203,서울 SK,Home,오재현,22,4,6,66.7,4,7,57.1,8,13,61.5,2,2,100.0,0,1,1,0,1,0,0,0,2,4
../kbl_data/2022-2023,S41G01N203,서울 SK,Home,선상혁,0,0,3,0.0,0,0,0.0,0,3,0.0,0,0,0.0,0,0,0,0,0,0,0,0,0,3
../kbl_data/2022-2023,S41G01N203,수원 KT,Away,김동욱,6,0,1,0.0,1,1,100.0,1,2,50.0,3,3,100.0,0,0,0,0,1,0,0,0,2,1
../kbl_data/2022-2023,S41G01N203,수원 KT,Away,김영환,2,0,2,0.0,0,1,0.0,0,3,0.0,2,2,100.0,0,0,0,0,0,0,0,0,0,0
../kbl_data/2022-2023,S41G01N203,수원 KT,Away,한희원,4,2,3,66.7,0,2,0.0,2,5,40.0,0,0,0.0,0,2,2,0,1,0,0,0,1,1
../kbl_data/2022-2023,S41G01N203,수원 KT,Away,정성우,2,1,3,33.3,0,1,0.0,1,4,25.0,0,0,0.0,1,2,3,3,2,0,0,0,0,1
../kbl_data/2022-2023,S41G01N203,수원 KT,Away,최성모,5,1,1,100.0,1,4,25.0,2,5,40.0,0,0,0.0,1,1,2,2,0,0,0,0,2,4
../kbl_data/2022-2023,S41G01N203,수원 KT,Away,양홍석,4,2,3,66.7,0,3,0.0,2,6,33.3,0,0,0.0,0,5,5,2,0,0,0,0,0,2
../kbl_data/2022-2023,S41G01N203,수원 KT,Away,박지원,5,0,2,0.0,1,2,50.0,1,4,25.0,2,2,100.0,0,2,2,4,0,0,0,0,1,3
../kbl_data/2022-2023,S41G01N203,수원 KT,Away,하윤기,18,7,8,87.5,0,0,0.0,7,8,87.5,4,4,100.0,4,3,7,3,0,0,0,0,1,1
../kbl_data/2022-2023,S41G01N203,수원 KT,Away,이두원,10,3,3,100.0,0,0,0.0,3,3,100.0,4,4,100.0,2,0,2,1,2,0,0,0,0,1
../kbl_data/2022-2023,S41G01N203,수원 KT,Away,레스터 프로스퍼,7,1,3,33.3,1,4,25.0,2,7,28.6,2,2,100.0,0,4,4,0,1,1,0,0,0,2
../kbl_data/2022-2023,S41G01N203,수원 KT,Away,재로드 존스,15,4,6,66.7,2,8,25.0,6,14,42.9,1,1,100.0,1,2,3,1,0,0,0,0,2,1
../kbl_data/2022-2023,S41G01N203,수원 KT,Away,데이브 일데폰소,4,2,3,66.7,0,1,0.0,2,4,50.0,0,0,0.0,0,1,1,0,1,0,0,0,0,0
../kbl_data/2022-2023,S41G01N204,안양 KGC,Home,양희종,5,1,2,50.0,1,2,50.0,2,4,50.0,0,0,0.0,1,1,2,2,1,0,0,0,0,2
../kbl_data/2022-2023,S41G01N204,안양 KGC,Home,오세근,26,6,10,60.0,4,7,57.1,10,17,58.8,2,2,100.0,3,7,10,1,0,1,0,0,0,1
../kbl_data/2022-2023,S41G01N204,안양 KGC,Home,정준원,2,1,1,100.0,0,0,0.0,1,1,100.0,0,0,0.0,0,0,0,0,0,0,0,0,0,0
../kbl_data/2022-2023,S41G01N204,안양 KGC,Home,배병준,7,2,4,50.0,1,3,33.3,3,7,42.9,0,0,0.0,1,1,2,0,0,0,0,0,1,2
../kbl_data/2022-2023,S41G01N204,안양 KGC,Home,문성곤,8,2,2,100.0,1,4,25.0,3,6,50.0,1,1,100.0,2,5,7,4,1,0,0,0,1,4
../kbl_data/2022-2023,S41G01N204,안양 KGC,Home,박지훈,8,3,8,37.5,0,0,0.0,3,8,37.5,2,2,100.0,0,1,1,1,2,0,0,0,3,2
../kbl_data/2022-2023,S41G01N204,안양 KGC,Home,이우정,0,0,0,0.0,0,0,0.0,0,0,0.0,0,0,0.0,0,3,3,0,0,0,0,0,1,0
../kbl_data/2022-2023,S41G01N204,안양 KGC,Home,대릴 먼로,6,1,4,25.0,0,0,0.0,1,4,25.0,4,4,100.0,1,2,3,2,0,0,0,0,0,2
../kbl_data/2022-2023,S41G01N204,안양 KGC,Home,변준형,5,1,3,33.3,0,2,0.0,1,5,20.0,3,3,100.0,1,1,2,6,0,0,0,0,1,5
../kbl_data/2022-2023,S41G01N204,안양 KGC,Home,한승희,0,0,0,0.0,0,0,0.0,0,0,0.0,0,0,0.0,0,0,0,0,0,0,0,0,0,0
../kbl_data/2022-2023,S41G01N204,안양 KGC,Home,오마리 스펠맨,13,4,8,50.0,1,4,25.0,5,12,41.7,2,2,100.0,1,12,13,5,0,2,0,0,1,4
../kbl_data/2022-2023,S41G01N204,안양 KGC,Home,렌즈 아반도,9,1,2,50.0,0,0,0.0,1,2,50.0,7,7,100.0,2,2,4,2,1,0,0,0,1,1
../kbl_data/2022-2023,S41G01N204,창원 LG,Away,이관희,10,0,6,0.0,3,5,60.0,3,11,27.3,1,2,50.0,1,2,3,0,2,0,0,0,0,3
../kbl_data/2022-2023,S41G01N204,창원 LG,Away,정희재,0,0,1,0.0,0,0,0.0,0,1,0.0,0,0,0.0,0,3,3,1,1,0,0,0,0,2
../kbl_data/2022-2023,S41G01N204,창원 LG,Away,임동섭,1,0,1,0.0,0,1,0.0,0,2,0.0,1,2,50.0,1,0,1,0,0,0,0,0,0,1
../kbl_data/2022-2023,S41G01N204,창원 LG,Away,서민수,0,0,0,0.0,0,0,0.0,0,0,0.0,0,0,0.0,0,1,1,0,0,0,0,0,0,0
../kbl_data/2022-2023,S41G01N204,창원 LG,Away,이재도,3,0,2,0.0,1,3,33.3,1,5,20.0,0,0,0.0,0,0,0,2,0,0,0,0,2,1
../kbl_data/2022-2023,S41G01N204,창원 LG,Away,김준일,10,1,3,33.3,0,0,0.0,1,3,33.3,8,8,100.0,0,3,3,0,0,1,0,0,2,1
../kbl_data/2022-2023,S41G01N204,창원 LG,Away,정인덕,3,0,0,0.0,1,2,50.0,1,2,50.0,0,0,0.0,0,0,0,0,0,0,0,0,0,0
../kbl_data/2022-2023,S41G01N204,창원 LG,Away,윤원상,3,0,1,0.0,1,4,25.0,1,5,20.0,0,0,0.0,0,0,0,2,0,0,0,0,0,2
../kbl_data/2022-2023,S41G01N204,창원 LG,Away,아셈 마레이,12,4,10,40.0,0,0,0.0,4,10,40.0,4,8,50.0,4,2,6,2,0,0,0,0,1,2
../kbl_data/2022-2023,S41G01N204,창원 LG,Away,저스틴 구탕,6,3,7,42.9,0,1,0.0,3,8,37.5,0,0,0.0,0,8,8,0,0,0,1,0,0,3
../kbl_data/2022-2023,S41G01N204,창원 LG,Away,양준석,9,2,3,66.7,1,4,25.0,3,7,42.9,2,3,66.7,1,0,1,2,0,0,1,0,1,2
../kbl_data/2022-2023,S41G01N204,창원 LG,Away,단테 커닝햄,10,5,9,55.6,0,0,0.0,5,9,55.6,0,0,0.0,1,3,4,1,3,1,0,2,1,2
../kbl_data/2022-2023,S41G01N205,대구 한국가스공사,Home,차바위,6,3,3,100.0,0,0,0.0,3,3,100.0,0,0,0.0,1,3,4,0,1,0,1,0,1,1
../kbl_data/2022-2023,S41G01N205,대구 한국가스공사,Home,박지훈,2,0,1,0.0,0,1,0.0,0,2,0.0,2,2,100.0,1,0,1,0,0,0,0,0,0,3
../kbl_data/2022-2023,S41G01N205,대구 한국가스공사,Home,조상열,2,0,0,0.0,0,2,0.0,0,2,0.0,2,2,100.0,1,2,3,3,1,0,1,0,2,1
../kbl_data/2022-2023,S41G01N205,대구 한국가스공사,Home,이원대,0,0,0,0.0,0,2,0.0,0,2,0.0,0,0,0.0,1,0,1,1,0,0,0,0,2,1
../kbl_data/2022-2023,S41G01N205,대구 한국가스공사,Home,이대헌,2,0,1,0.0,0,2,0.0,0,3,0.0,2,2,100.0,3,0,3,1,1,0,0,0,1,2
../kbl_data/2022-2023,S41G01N205,대구 한국가스공사,Home,이대성,18,3,7,42.9,3,7,42.9,6,14,42.9,3,3,100.0,2,4,6,5,1,0,0,0,3,2
../kbl_data/2022-2023,S41G01N205,대구 한국가스공사,Home,머피 할로웨이,19,8,13,61.5,0,1,0.0,8,14,57.1,3,4,75.0,1,4,5,0,2,0,0,3,6,3
../kbl_data/2022-2023,S41G01N205,대구 한국가스공사,Home,우동현,5,1,2,50.0,1,4,25.0,2,6,33.3,0,0,0.0,0,1,1,3,0,0,2,0,1,2
../kbl_data/2022-2023,S41G01N205,대구 한국가스공사,Home,전현우,0,0,0,0.0,0,0,0.0,0,0,0.0,0,0,0.0,0,0,0,0,0,0,0,0,0,0
../kbl_data/2022-2023,S41G01N205,대구 한국가스공사,Home,데본 스캇,10,5,8,62.5,0,0,0.0,5,8,62.5,0,0,0.0,2,3,5,2,0,1,0,1,3,1
../kbl_data/2022-2023,S41G01N205,대구 한국가스공사,Home,신승민,11,0,1,0.0,3,5,60.0,3,6,50.0,2,3,66.7,1,3,4,0,0,0,2,0,1,3
../kbl_data/2022-2023,S41G01N205,대구 한국가스공사,Home,샘조세프 벨란겔,2,1,1,100.0,0,3,0.0,1,4,25.0,0,0,0.0,1,2,3,2,1,0,0,0,0,2
../kbl_data/2022-2023,S41G01N205,울산 현대모비스,Away,함지훈,2,0,4,0.0,0,0,0.0,0,4,0.0,2,2,100.0,3,1,4,6,2,1,0,0,1,0
../kbl_data/2022-2023,S41G01N205,울산 현대모비스,Away,김현민,0,0,0,0.0,0,0,0.0,0,0,0.0,0,0,0.0,0,0,0,0,0,0,0,0,0,0
../kbl_data/2022-2023,S41G01N205,울산 현대모비스,Away,최진수,0,0,0,0.0,0,0,0.0,0,0,0.0,0,0,0.0,0,0,0,0,0,0,0,0,0,0
../kbl_data/2022-2023,S41G01N205,울산 현대모비스,Away,장재석,10,5,8,62.5,0,0,0.0,5,8,62.5,0,0,0.0,1,5,6,0,3,1,0,1,5,5
../kbl_data/2022-2023,S41G01N205,울산 현대모비스,Away,김국찬,0,0,2,0.0,0,0,0.0,0,2,0.0,0,0,0.0,0,2,2,0,0,0,0,0,0,0
../kbl_data/2022-2023,S41G01N205,울산 현대모비스,Away,서명진,11,2,5,40.0,2,9,22.2,4,14,28.6,1,1,100.0,0,2,2,3,3,0,0,0,4,4
../kbl_data/2022-2023,S41G01N205,울산 현대모비스,Away,헨리 심스,4,2,2,100.0,0,1,0.0,2,3,66.7,0,0,0.0,1,2,3,0,0,0,0,0,0,3
../kbl_data/2022-2023,S41G01N205,울산 현대모비스,Away,이우석,5,1,2,50.0,1,2,50.0,2,4,50.0,0,0,0.0,0,1,1,1,0,0,0,0,0,1
../kbl_data/2022-2023,S41G01N205,울산 현대모비스,Away,신민석,10,3,4,75.0,1,2,50.0,4,6,66.7,1,3,33.3,2,0,2,1,0,0,0,0,1,5
../kbl_data/2022-2023,S41G01N205,울산 현대모비스,Away,론제이 아바리엔토스,9,0,2,0.0,2,3,66.7,2,5,40.0,3,3,100.0,0,0,0,2,2,0,0,0,2,0
../kbl_data/2022-2023,S41G01N205,울산 현대모비스,Away,게이지 프림,25,11,15,73.3,0,3,0.0,11,18,61.1,3,5,60.0,6,7,13,4,5,0,1,2,0,2
../kbl_data/2022-2023,S41G01N205,울산 현대모비스,Away,김태완,8,0,1,0.0,2,3,66.7,2,4,50.0,2,2,100.0,0,1,1,0,0,0,0,0,2,3
../kbl_data/2022-2023,S41G01N206,서울 삼성,Home,이정현,9,0,4,0.0,2,9,22.2,2,13,15.4,3,3,100.0,1,1,2,7,0,0,0,0,3,3
../kbl_data/2022-2023,S41G01N206,서울 삼성,Home,장민국,17,4,4,100.0,3,5,60.0,7,9,77.8,0,0,0.0,1,0,1,1,0,1,0,0,1,5
../kbl_data/2022-2023,S41G01N206,서울 삼성,Home,김승원,6,2,4,50.0,0,0,0.0,2,4,50.0,2,2,100.0,3,3,6,4,0,0,0,0,0,5
../kbl_data/2022-2023,S41G01N206,서울 삼성,Home,김시래,23,4,6,66.7,4,5,80.0,8,11,72.7,3,5,60.0,2,0,2,5,1,0,0,0,3,3
../kbl_data/2022-2023,S41G01N206,서울 삼성,Home,김현수,0,0,0,0.0,0,0,0.0,0,0,0.0,0,0,0.0,0,0,0,0,0,0,0,0,0,0
../kbl_data/2022-2023,S41G01N206,서울 삼성,Home,이동엽,5,1,1,100.0,1,2,50.0,2,3,66.7,0,0,0.0,1,2,3,0,1,0,0,0,2,1
../kbl_data/2022-2023,S41G01N206,서울 삼성,Home,이호현,15,6,9,66.7,1,2,50.0,7,11,63.6,0,0,0.0,2,1,3,2,3,1,0,0,0,3
../kbl_data/2022-2023,S41G01N206,서울 삼성,Home,강바일,0,0,0,0.0,0,0,0.0,0,0,0.0,0,0,0.0,0,0,0,0,0,0,0,0,0,0
../kbl_data/2022-2023,S41G01N206,서울 삼성,Home,차민석,4,1,1,100.0,0,0,0.0,1,1,100.0,2,2,100.0,0,0,0,0,0,0,0,0,0,0
../kbl_data/2022-2023,S41G01N206,서울 삼성,Home,신동혁,7,2,3,66.7,1,1,100.0,3,4,75.0,0,0,0.0,0,1,1,0,0,0,0,0,0,2
../kbl_data/2022-2023,S41G01N206,서울 삼성,Home,다랄 윌리스,15,6,11,54.5,1,7,14.3,7,18,38.9,0,0,0.0,5,8,13,5,0,0,0,0,4,5
../kbl_data/2022-2023,S41G01N206,서울 삼성,Home,앤서니 모스,12,5,8,62.5,0,0,0.0,5,8,62.5,2,4,50.0,3,3,6,0,0,0,0,1,1,5
../kbl_data/2022-2023,S41G01N206,서울 SK,Away,양우섭,0,0,0,0.0,0,0,0.0,0,0,0.0,0,0,0.0,0,0,0,0,0,0,0,0,0,0
../kbl_data/2022-2023,S41G01N206,서울 SK,Away,허일영,13,4,7,57.1,1,3,33.3,5,10,50.0,2,2,100.0,2,4,6,2,0,1,0,0,3,3
../kbl_data/2022-2023,S41G01N206,서울 SK,Away,송창용,0,0,0,0.0,0,1,0.0,0,1,0.0,0,0,0.0,1,1,2,0,0,0,0,0,0,2
../kbl_data/2022-2023,S41G01N206,서울 SK,Away,김선형,29,8,12,66.7,2,4,50.0,10,16,62.5,7,8,87.5,0,2,2,13,1,0,0,0,1,0
../kbl_data/2022-2023,S41G01N206,서울 SK,Away,홍경기,0,0,0,0.0,0,0,0.0,0,0,0.0,0,0,0.0,0,0,0,0,0,0,0,0,0,0
../kbl_data/2022-2023,S41G01N206,서울 SK,Away,최부경,17,7,8,87.5,0,0,0.0,7,8,87.5,3,8,37.5,3,2,5,2,3,0,2,0,1,5
../kbl_data/2022-2023,S41G01N206,서울 SK,Away,리온 윌리엄스,2,1,3,33.3,0,0,0.0,1,3,33.3,0,1,0.0,1,0,1,0,0,0,0,0,0,2
../kbl_data/2022-2023,S41G01N206,서울 SK,Away,최원혁,0,0,0,0.0,0,0,0.0,0,0,0.0,0,0,0.0,0,1,1,2,1,0,0,0,0,2
../kbl_data/2022-2023,S41G01N206,서울 SK,Away,최성원,9,0,1,0.0,2,3,66.7,2,4,50.0,3,3,100.0,0,3,3,1,0,0,0,0,0,2
../kbl_data/2022-2023,S41G01N206,서울 SK,Away,자밀 워니,43,14,21,66.7,1,1,100.0,15,22,68.2,12,17,70.6,3,5,8,5,1,0,0,1,0,3
../kbl_data/2022-2023,S41G01N206,서울 SK,Away,오재현,2,0,0,0.0,0,1,0.0,0,1,0.0,2,2,100.0,0,0,0,2,0,0,0,0,0,1
../kbl_data/2022-2023,S41G01N206,서울 SK,Away,선상혁,0,0,0,0.0,0,0,0.0,0,0,0.0,0,0,0.0,0,0,0,0,0,0,0,0,0,0
../kbl_data/2022-2023,S41G01N207,창원 LG,Home,이관희,3,1,2,50.0,0,5,0.0,1,7,14.3,1,2,50.0,0,0,0,0,0,0,0,0,2,2
../kbl_data/2022-2023,S41G01N207,창원 LG,Home,정희재,5,0,0,0.0,1,1,100.0,1,1,100.0,2,2,100.0,2,3,5,1,0,0,1,0,2,2
../kbl_data/2022-2023,S41G01N207,창원 LG,Home,임동섭,0,0,0,0.0,0,0,0.0,0,0,0.0,0,0,0.0,0,0,0,0,0,0,0,0,0,2
../kbl_data/2022-2023,S41G01N207,창원 LG,Home,서민수,0,0,0,0.0,0,0,0.0,0,0,0.0,0,0,0.0,0,0,0,0,0,0,0,0,0,0
../kbl_data/2022-2023,S41G01N207,창원 LG,Home,이재도,13,6,8,75.0,0,2,0.0,6,10,60.0,1,3,33.3,0,2,2,2,1,0,0,0,3,1
../kbl_data/2022-2023,S41G01N207,창원 LG,Home,김준일,13,6,9,66.7,0,0,0.0,6,9,66.7,1,4,25.0,2,4,6,3,1,0,0,0,0,5
../kbl_data/2022-2023,S41G01N207,창원 LG,Home,정인덕,8,2,2,100.0,1,3,33.3,3,5,60.0,1,3,33.3,3,1,4,1,0,0,0,0,0,2
../kbl_data/2022-2023,S41G01N207,창원 LG,Home,윤원상,11,2,4,50.0,2,7,28.6,4,11,36.4,1,2,50.0,3,1,4,3,0,0,1,0,1,2
../kbl_data/2022-2023,S41G01N207,창원 LG,Home,아셈 마레이,4,1,6,16.7,0,0,0.0,1,6,16.7,2,8,25.0,5,7,12,3,2,1,0,0,1,2
../kbl_data/2022-2023,S41G01N207,창원 LG,Home,저스틴 구탕,2,0,0,0.0,0,0,0.0,0,0,0.0,2,2,100.0,0,0,0,1,0,1,0,0,0,0
../kbl_data/2022-2023,S41G01N207,창원 LG,Home,양준석,10,4,4,100.0,0,1,0.0,4,5,80.0,2,3,66.7,0,3,3,4,1,0,0,0,0,0
../kbl_data/2022-2023,S41G01N207,창원 LG,Home,단테 커닝햄,16,8,13,61.5,0,0,0.0,8,13,61.5,0,0,0.0,4,7,11,1,1,0,0,0,0,1
../kbl_data/2022-2023,S41G01N207,고양 캐롯,Away,김강선,0,0,0,0.0,0,1,0.0,0,1,0.0,0,0,0.0,1,0,1,1,2,0,0,0,0,1
../kbl_data/2022-2023,S41G01N207,고양 캐롯,Away,임종일,0,0,0,0.0,0,0,0.0,0,0,0.0,0,0,0.0,0,0,0,0,0,0,0,0,0,0
../kbl_data/2022-2023,S41G01N207,고양 캐롯,Away,한호빈,3,0,0,0.0,0,2,0.0,0,2,0.0,3,4,75.0,1,0,1,3,0,0,0,0,1,3
../kbl_data/2022-2023,S41G01N207,고양 캐롯,Away,전성현,19,4,10,40.0,3,11,27.3,7,21,33.3,2,4,50.0,1,1,2,0,1,0,0,0,0,3
../kbl_data/2022-2023,S41G01N207,고양 캐롯,Away,김진유,1,0,0,0.0,0,2,0.0,0,2,0.0,1,2,50.0,2,1,3,0,0,0,0,0,0,1
../kbl_data/2022-2023,S41G01N207,고양 캐롯,Away,김진용,14,5,6,83.3,0,0,0.0,5,6,83.3,4,5,80.0,0,2,2,1,0,0,0,0,0,5
../kbl_data/2022-2023,S41G01N207,고양 캐롯,Away,조한진,5,1,1,100.0,1,5,20.0,2,6,33.3,0,0,0.0,0,3,3,0,0,0,0,0,1,3
../kbl_data/2022-2023,S41G01N207,고양 캐롯,Away,디드릭 로슨,5,1,4,25.0,1,1,100.0,2,5,40.0,0,0,0.0,0,7,7,5,0,2,0,0,2,4
../kbl_data/2022-2023,S41G01N207,고양 캐롯,Away,박진철,4,2,3,66.7,0,0,0.0,2,3,66.7,0,0,0.0,2,1,3,0,2,0,0,1,1,2
../kbl_data/2022-2023,S41G01N207,고양 캐롯,Away,이정현,9,4,4,100.0,0,2,0.0,4,6,66.7,1,1,100.0,1,1,2,3,1,0,0,0,3,2
../kbl_data/2022-2023,S41G01N207,고양 캐롯,Away,모리구치 히사시,0,0,0,0.0,0,0,0.0,0,0,0.0,0,0,0.0,1,0,1,0,0,0,0,0,0,0
../kbl_data/2022-2023,S41G01N207,고양 캐롯,Away,조나단 알렛지,8,3,10,30.0,0,1,0.0,3,11,27.3,2,3,66.7,0,2,2,3,0,1,0,0,1,2
../kbl_data/2022-2023,S41G01N208,안양 KGC,Home,양희종,0,0,0,0.0,0,0,0.0,0,0,0.0,0,0,0.0,0,0,0,0,0,1,0,0,0,1
../kbl_data/2022-2023,S41G01N208,안양 KGC,Home,오세근,15,6,10,60.0,1,6,16.7,7,16,43.8,0,0,0.0,2,6,8,2,1,1,0,0,0,4
../kbl_data/2022-2023,S41G01N208,안양 KGC,Home,정준원,0,0,2,0.0,0,0,0.0,0,2,0.0,0,0,0.0,1,0,1,0,0,0,0,0,1,1
../kbl_data/2022-2023,S41G01N208,안양 KGC,Home,배병준,0,0,1,0.0,0,2,0.0,0,3,0.0,0,0,0.0,0,2,2,1,0,0,0,0,1,0
../kbl_data/2022-2023,S41G01N208,안양 KGC,Home,문성곤,5,1,2,50.0,1,7,14.3,2,9,22.2,0,0,0.0,5,3,8,4,0,0,0,0,1,4
../kbl_data/2022-2023,S41G01N208,안양 KGC,Home,박지훈,20,8,8,100.0,1,1,100.0,9,9,100.0,1,3,33.3,2,3,5,1,0,0,0,0,0,3
../kbl_data/2022-2023,S41G01N208,안양 KGC,Home,대릴 먼로,4,2,2,100.0,0,0,0.0,2,2,100.0,0,0,0.0,0,2,2,1,0,0,0,0,1,1
../kbl_data/2022-2023,S41G01N208,안양 KGC,Home,변준형,26,4,10,40.0,5,9,55.6,9,19,47.4,3,4,75.0,1,4,5,8,1,0,0,0,1,2
../kbl_data/2022-2023,S41G01N208,안양 KGC,Home,한승희,0,0,1,0.0,0,0,0.0,0,1,0.0,0,0,0.0,1,0,1,0,0,0,0,0,0,0
../kbl_data/2022-2023,S41G01N208,안양 KGC,Home,오마리 스펠맨,15,3,8,37.5,3,5,60.0,6,13,46.2,0,2,0.0,1,9,10,1,0,0,0,1,0,4
../kbl_data/2022-2023,S41G01N208,안양 KGC,Home,조은후,0,0,0,0.0,0,0,0.0,0,0,0.0,0,0,0.0,0,0,0,0,0,0,0,0,0,0
../kbl_data/2022-2023,S41G01N208,안양 KGC,Home,렌즈 아반도,3,0,1,0.0,1,1,100.0,1,2,50.0,0,0,0.0,0,2,2,0,0,0,0,0,0,0
../kbl_data/2022-2023,S41G01N208,전주 KCC,Away,정창영,6,0,4,0.0,1,4,25.0,1,8,12.5,3,4,75.0,1,2,3,5,1,0,0,0,1,3
../kbl_data/2022-2023,S41G01N208,전주 KCC,Away,라건아,29,8,16,50.0,2,5,40.0,10,21,47.6,7,8,87.5,2,9,11,4,0,3,0,0,0,1
../kbl_data/2022-2023,S41G01N208,전주 KCC,Away,박경상,14,2,4,50.0,2,4,50.0,4,8,50.0,4,6,66.7,0,2,2,3,0,0,0,0,0,2
../kbl_data/2022-2023,S41G01N208,전주 KCC,Away,김지완,0,0,1,0.0,0,0,0.0,0,1,0.0,0,0,0.0,0,1,1,1,0,0,0,0,1,1
../kbl_data/2022-2023,S41G01N208,전주 KCC,Away,김상규,1,0,0,0.0,0,1,0.0,0,1,0.0,1,4,25.0,0,0,0,1,0,0,0,0,0,1
../kbl_data/2022-2023,S41G01N208,전주 KCC,Away,유병훈,0,0,0,0.0,0,0,0.0,0,0,0.0,0,2,0.0,0,1,1,0,0,0,0,0,0,0
../kbl_data/2022-2023,S41G01N208,전주 KCC,Away,전준범,3,0,0,0.0,1,2,50.0,1,2,50.0,0,0,0.0,0,1,1,0,1,0,0,0,0,2
../kbl_data/2022-2023,S41G01N208,전주 KCC,Away,이승현,11,3,6,50.0,1,2,50.0,4,8,50.0,2,2,100.0,0,5,5,1,0,0,0,0,0,2
../kbl_data/2022-2023,S41G01N208,전주 KCC,Away,이종현,0,0,0,0.0,0,0,0.0,0,0,0.0,0,0,0.0,0,0,0,0,0,0,0,0,0,0
../kbl_data/2022-2023,S41G01N208,전주 KCC,Away,이근휘,5,1,1,100.0,1,3,33.3,2,4,50.0,0,0,0.0,1,1,2,2,1,0,0,0,0,2
../kbl_data/2022-2023,S41G01N208,전주 KCC,Away,송동훈,10,3,4,75.0,1,2,50.0,4,6,66.7,1,2,50.0,0,2,2,1,0,0,0,0,0,3
../kbl_data/2022-2023,S41G01N208,전주 KCC,Away,칼빈 제프리 에피스톨라,0,0,0,0.0,0,0,0.0,0,0,0.0,0,0,0.0,0,0,0,0,0,0,0,0,0,0
../kbl_data/2022-2023,S41G01N209,원주 DB,Home,윤호영,0,0,3,0.0,0,0,0.0,0,3,0.0,0,0,0.0,0,1,1,1,0,1,1,0,1,4
../kbl_data/2022-2023,S41G01N209,원주 DB,Home,박찬희,4,0,0,0.0,1,1,100.0,1,1,100.0,1,2,50.0,0,1,1,0,0,0,0,0,1,1
../kbl_data/2022-2023,S41G01N209,원주 DB,Home,김현호,16,4,10,40.0,2,2,100.0,6,12,50.0,2,2,100.0,1,5,6,3,1,0,0,0,2,3
../kbl_data/2022-2023,S41G01N209,원주 DB,Home,말콤 토마스,0,0,1,0.0,0,0,0.0,0,1,0.0,0,0,0.0,0,0,0,0,0,0,0,0,0,0
../kbl_data/2022-2023,S41G01N209,원주 DB,Home,김종규,12,6,9,66.7,0,1,0.0,6,10,60.0,0,0,0.0,1,3,4,1,0,0,0,0,2,5
../kbl_data/2022-2023,S41G01N209,원주 DB,Home,최승욱,6,3,6,50.0,0,3,0.0,3,9,33.3,0,1,0.0,1,3,4,3,1,0,0,0,1,0
../kbl_data/2022-2023,S41G01N209,원주 DB,Home,윤성원,3,0,0,0.0,1,2,50.0,1,2,50.0,0,0,0.0,2,2,4,0,0,0,0,0,2,3
../kbl_data/2022-2023,S41G01N209,원주 DB,Home,레나드 프리먼,10,5,13,38.5,0,0,0.0,5,13,38.5,0,2,0.0,9,5,14,0,0,0,0,0,3,4
../kbl_data/2022-2023,S41G01N209,원주 DB,Home,정호영,2,1,2,50.0,0,0,0.0,1,2,50.0,0,0,0.0,0,1,1,2,0,0,0,0,0,1
../kbl_data/2022-2023,S41G01N209,원주 DB,Home,이민석,2,1,1,100.0,0,1,0.0,1,2,50.0,0,0,0.0,1,0,1,0,0,0,0,0,0,0
../kbl_data/2022-2023,S41G01N209,원주 DB,Home,이선 알바노,14,4,11,36.4,2,4,50.0,6,15,40.0,0,0,0.0,0,2,2,7,2,0,0,0,4,2
../kbl_data/2022-2023,S41G01N209,원주 DB,Home,인승찬,4,2,2,100.0,0,0,0.0,2,2,100.0,0,0,0.0,0,0,0,3,0,0,0,0,0,4
../kbl_data/2022-2023,S41G01N209,서울 SK,Away,양우섭,3,0,0,0.0,1,1,100.0,1,1,100.0,0,0,0.0,0,1,1,0,0,0,0,0,0,1
../kbl_data/2022-2023,S41G01N209,서울 SK,Away,허일영,9,0,3,0.0,1,2,50.0,1,5,20.0,6,6,100.0,1,2,3,0,1,0,0,0,0,1
../kbl_data/2022-2023,S41G01N209,서울 SK,Away,송창용,5,0,0,0.0,1,2,50.0,1,2,50.0,2,2,100.0,1,1,2,0,0,0,0,0,0,0
../kbl_data/2022-2023,S41G01N209,서울 SK,Away,김선형,9,3,6,50.0,1,4,25.0,4,10,40.0,0,0,0.0,0,2,2,8,4,1,0,0,0,1
../kbl_data/2022-2023,S41G01N209,서울 SK,Away,홍경기,0,0,0,0.0,0,1,0.0,0,1,0.0,0,0,0.0,0,1,1,1,0,0,0,0,1,0
../kbl_data/2022-2023,S41G01N209,서울 SK,Away,최부경,8,1,3,33.3,0,0,0.0,1,3,33.3,6,6,100.0,4,4,8,1,2,0,0,0,0,0
../kbl_data/2022-2023,S41G01N209,서울 SK,Away,리온 윌리엄스,10,2,3,66.7,0,1,0.0,2,4,50.0,6,8,75.0,2,2,4,1,1,1,0,0,1,2
../kbl_data/2022-2023,S41G01N209,서울 SK,Away,최원혁,0,0,0,0.0,0,0,0.0,0,0,0.0,0,0,0.0,0,3,3,1,1,0,0,0,0,0
../kbl_data/2022-2023,S41G01N209,서울 SK,Away,최성원,14,1,3,33.3,4,8,50.0,5,11,45.5,0,1,0.0,0,1,1,1,2,1,0,0,1,3
../kbl_data/2022-2023,S41G01N209,서울 SK,Away,자밀 워니,19,7,14,50.0,0,2,0.0,7,16,43.8,5,5,100.0,1,8,9,4,1,1,0,0,3,1
../kbl_data/2022-2023,S41G01N209,서울 SK,Away,오재현,15,2,2,100.0,3,7,42.9,5,9,55.6,2,2,100.0,0,0,0,3,2,1,0,0,0,2
../kbl_data/2022-2023,S41G01N209,서울 SK,Away,선상혁,0,0,0,0.0,0,0,0.0,0,0,0.0,0,0,0.0,0,0,0,0,0,0,0,0,0,2
../kbl_data/2022-2023,S41G01N210,서울 삼성,Home,이정현,8,2,6,33.3,1,3,33.3,3,9,33.3,1,1,100.0,0,1,1,2,1,0,0,0,4,4
../kbl_data/2022-2023,S41G01N210,서울 삼성,Home,장민국,7,2,2,100.0,1,3,33.3,3,5,60.0,0,0,0.0,0,1,1,0,0,0,0,0,0,5
../kbl_data/2022-2023,S41G01N210,서울 삼성,Home,김승원,0,0,1,0.0,0,0,0.0,0,1,0.0,0,0,0.0,0,2,2,1,1,0,0,0,0,0
../kbl_data/2022-2023,S41G01N210,서울 삼성,Home,김시래,11,1,3,33.3,2,5,40.0,3,8,37.5,3,4,75.0,3,2,5,6,0,0,0,0,0,2
../kbl_data/2022-2023,S41G01N210,서울 삼성,Home,김현수,0,0,0,0.0,0,0,0.0,0,0,0.0,0,0,0.0,0,0,0,0,0,0,0,0,0,0
../kbl_data/2022-2023,S41G01N210,서울 삼성,Home,이동엽,7,3,7,42.9,0,4,0.0,3,11,27.3,1,2,50.0,1,0,1,0,2,1,0,0,0,3
../kbl_data/2022-2023,S41G01N210,서울 삼성,Home,이호현,4,2,6,33.3,0,2,0.0,2,8,25.0,0,0,0.0,1,0,1,5,1,0,0,0,0,0
../kbl_data/2022-2023,S41G01N210,서울 삼성,Home,차민석,2,1,2,50.0,0,0,0.0,1,2,50.0,0,0,0.0,0,0,0,0,0,0,0,0,0,2
../kbl_data/2022-2023,S41G01N210,서울 삼성,Home,이원석,4,2,2,100.0,0,0,0.0,2,2,100.0,0,0,0.0,0,1,1,1,0,0,0,0,0,4
../kbl_data/2022-2023,S41G01N210,서울 삼성,Home,신동혁,2,1,2,50.0,0,5,0.0,1,7,14.3,0,0,0.0,0,1,1,1,0,0,0,0,3,2
../kbl_data/2022-2023,S41G01N210,서울 삼성,Home,다랄 윌리스,10,5,8,62.5,0,1,0.0,5,9,55.6,0,0,0.0,1,6,7,0,0,0,0,0,1,2
../kbl_data/2022-2023,S41G01N210,서울 삼성,Home,앤서니 모스,11,5,7,71.4,0,0,0.0,5,7,71.4,1,1,100.0,2,6,8,2,1,0,0,1,1,3
../kbl_data/2022-2023,S41G01N210,대구 한국가스공사,Away,차바위,0,0,0,0.0,0,0,0.0,0,0,0.0,0,0,0.0,1,4,5,2,1,1,0,0,2,2
../kbl_data/2022-2023,S41G01N210,대구 한국가스공사,Away,박지훈,0,0,0,0.0,0,0,0.0,0,0,0.0,0,0,0.0,0,0,0,0,0,0,0,0,0,0
../kbl_data/2022-2023,S41G01N210,대구 한국가스공사,Away,조상열,6,0,1,0.0,2,2,100.0,2,3,66.7,0,0,0.0,0,2,2,0,0,0,0,0,0,2
../kbl_data/2022-2023,S41G01N210,대구 한국가스공사,Away,이대헌,14,4,7,57.1,1,2,50.0,5,9,55.6,3,5,60.0,1,2,3,2,2,0,0,1,0,4
../kbl_data/2022-2023,S41G01N210,대구 한국가스공사,Away,이대성,22,5,7,71.4,2,6,33.3,7,13,53.8,6,7,85.7,0,2,2,2,1,1,0,0,2,0
../kbl_data/2022-2023,S41G01N210,대구 한국가스공사,Away,정효근,11,4,6,66.7,1,3,33.3,5,9,55.6,0,1,0.0,3,0,3,3,0,0,0,0,0,1
../kbl_data/2022-2023,S41G01N210,대구 한국가스공사,Away,머피 할로웨이,13,6,13,46.2,0,0,0.0,6,13,46.2,1,4,25.0,2,10,12,2,1,1,0,0,2,2
../kbl_data/2022-2023,S41G01N210,대구 한국가스공사,Away,우동현,1,0,1,0.0,0,0,0.0,0,1,0.0,1,4,25.0,1,3,4,2,0,0,0,0,1,2
../kbl_data/2022-2023,S41G01N210,대구 한국가스공사,Away,전현우,5,1,2,50.0,1,2,50.0,2,4,50.0,0,0,0.0,0,0,0,0,0,0,0,0,0,1
../kbl_data/2022-2023,S41G01N210,대구 한국가스공사,Away,데본 스캇,17,6,6,100.0,0,2,0.0,6,8,75.0,5,6,83.3,4,5,9,0,1,0,0,0,2,2
../kbl_data/2022-2023,S41G01N210,대구 한국가스공사,Away,신승민,0,0,1,0.0,0,0,0.0,0,1,0.0,0,0,0.0,0,0,0,0,0,0,0,0,0,0
../kbl_data/2022-2023,S41G01N210,대구 한국가스공사,Away,샘조세프 벨란겔,0,0,0,0.0,0,4,0.0,0,4,0.0,0,0,0.0,0,1,1,4,0,0,0,0,0,3
../kbl_data/2022-2023,S41G01N211,울산 현대모비스,Home,함지훈,7,2,8,25.0,0,3,0.0,2,11,18.2,3,3,100.0,2,2,4,2,1,0,0,0,1,2
../kbl_data/2022-2023,S41G01N211,울산 현대모비스,Home,김현민,0,0,0,0.0,0,0,0.0,0,0,0.0,0,0,0.0,0,0,0,0,0,0,0,0,1,0
../kbl_data/2022-2023,S41G01N211,울산 현대모비스,Home,최진수,3,0,1,0.0,1,2,50.0,1,3,33.3,0,0,0.0,0,1,1,0,0,1,0,0,0,3
../kbl_data/2022-2023,S41G01N211,울산 현대모비스,Home,장재석,2,1,2,50.0,0,0,0.0,1,2,50.0,0,0,0.0,0,0,0,1,2,0,0,0,1,0
../kbl_data/2022-2023,S41G01N211,울산 현대모비스,Home,김국찬,0,0,0,0.0,0,0,0.0,0,0,0.0,0,0,0.0,0,0,0,0,0,0,0,0,0,0
../kbl_data/2022-2023,S41G01N211,울산 현대모비스,Home,서명진,15,3,4,75.0,3,8,37.5,6,12,50.0,0,0,0.0,0,1,1,3,3,0,0,0,2,1
../kbl_data/2022-2023,S41G01N211,울산 현대모비스,Home,헨리 심스,0,0,1,0.0,0,0,0.0,0,1,0.0,0,0,0.0,1,1,2,0,1,1,0,0,1,0
../kbl_data/2022-2023,S41G01N211,울산 현대모비스,Home,신민석,5,1,1,100.0,1,3,33.3,2,4,50.0,0,0,0.0,1,3,4,0,0,0,0,0,2,3
../kbl_data/2022-2023,S41G01N211,울산 현대모비스,Home,김동준,0,0,0,0.0,0,0,0.0,0,0,0.0,0,0,0.0,0,0,0,0,0,0,0,0,0,0
../kbl_data/2022-2023,S41G01N211,울산 현대모비스,Home,론제이 아바리엔토스,14,4,6,66.7,2,13,15.4,6,19,31.6,0,0,0.0,1,4,5,3,0,0,0,0,2,3
../kbl_data/2022-2023,S41G01N211,울산 현대모비스,Home,게이지 프림,20,7,11,63.6,0,0,0.0,7,11,63.6,6,6,100.0,6,8,14,2,3,1,0,1,4,4
../kbl_data/2022-2023,S41G01N211,울산 현대모비스,Home,김태완,3,0,1,0.0,1,2,50.0,1,3,33.3,0,0,0.0,1,2,3,3,0,0,0,0,1,1
../kbl_data/2022-2023,S41G01N211,수원 KT,Away,김동욱,0,0,0,0.0,0,0,0.0,0,0,0.0,0,0,0.0,0,0,0,0,0,0,0,0,0,0
../kbl_data/2022-2023,S41G01N211,수원 KT,Away,김영환,0,0,1,0.0,0,0,0.0,0,1,0.0,0,0,0.0,1,0,1,0,1,0,0,0,0,1
../kbl_data/2022-2023,S41G01N211,수원 KT,Away,한희원,6,3,3,100.0,0,1,0.0,3,4,75.0,0,0,0.0,0,2,2,0,1,0,0,0,1,2
../kbl_data/2022-2023,S41G01N211,수원 KT,Away,최창진,1,0,0,0.0,0,0,0.0,0,0,0.0,1,2,50.0,0,0,0,1,0,0,0,0,0,0
../kbl_data/2022-2023,S41G01N211,수원 KT,Away,최성모,1,0,1,0.0,0,1,0.0,0,2,0.0,1,2,50.0,0,0,0,0,2,0,0,0,1,2
../kbl_data/2022-2023,S41G01N211,수원 KT,Away,양홍석,4,2,8,25.0,0,4,0.0,2,12,16.7,0,0,0.0,1,3,4,2,1,0,0,0,1,0
../kbl_data/2022-2023,S41G01N211,수원 KT,Away,박지원,3,0,2,0.0,1,2,50.0,1,4,25.0,0,0,0.0,0,1,1,2,0,0,0,0,2,1
../kbl_data/2022-2023,S41G01N211,수원 KT,Away,하윤기,11,5,15,33.3,0,0,0.0,5,15,33.3,1,3,33.3,5,1,6,1,0,0,0,1,2,1
../kbl_data/2022-2023,S41G01N211,수원 KT,Away,이두원,6,3,5,60.0,0,0,0.0,3,5,60.0,0,0,0.0,0,0,0,1,1,0,0,1,0,0
../kbl_data/2022-2023,S41G01N211,수원 KT,Away,레스터 프로스퍼,3,1,3,33.3,0,0,0.0,1,3,33.3,1,2,50.0,0,6,6,2,1,1,0,0,3,2
../kbl_data/2022-2023,S41G01N211,수원 KT,Away,재로드 존스,16,6,7,85.7,0,3,0.0,6,10,60.0,4,4,100.0,3,7,10,1,0,2,0,0,2,3
../kbl_data/2022-2023,S41G01N211,수원 KT,Away,데이브 일데폰소,8,2,6,33.3,0,2,0.0,2,8,25.0,4,4,100.0,1,4,5,2,5,0,0,0,2,2
../kbl_data/2022-2023,S41G01N212,고양 캐롯,Home,김강선,10,1,1,100.0,1,2,50.0,2,3,66.7,5,5,100.0,0,1,1,0,1,0,0,0,0,3
../kbl_data/2022-2023,S41G01N212,고양 캐롯,Home,임종일,0,0,0,0.0,0,0,0.0,0,0,0.0,0,0,0.0,0,0,0,0,0,0,0,0,0,0
../kbl_data/2022-2023,S41G01N212,고양 캐롯,Home,한호빈,3,0,1,0.0,1,2,50.0,1,3,33.3,0,0,0.0,1,2,3,2,0,0,0,0,0,2
../kbl_data/2022-2023,S41G01N212,고양 캐롯,Home,전성현,19,5,8,62.5,3,9,33.3,8,17,47.1,0,1,0.0,0,3,3,2,0,0,0,0,0,3
../kbl_data/2022-2023,S41G01N212,고양 캐롯,Home,김진유,0,0,0,0.0,0,0,0.0,0,0,0.0,0,0,0.0,0,0,0,0,0,0,0,0,0,0
../kbl_data/2022-2023,S41G01N212,고양 캐롯,Home,김진용,4,2,3,66.7,0,0,0.0,2,3,66.7,0,1,0.0,3,5,8,0,0,1,0,0,0,2
../kbl_data/2022-2023,S41G01N212,고양 캐롯,Home,조한진,0,0,0,0.0,0,0,0.0,0,0,0.0,0,0,0.0,0,0,0,0,0,0,0,0,0,0
../kbl_data/2022-2023,S41G01N212,고양 캐롯,Home,디드릭 로슨,34,12,17,70.6,0,4,0.0,12,21,57.1,10,13,76.9,4,10,14,6,0,2,0,1,0,4
../kbl_data/2022-2023,S41G01N212,고양 캐롯,Home,이정현,20,2,12,16.7,4,12,33.3,6,24,25.0,4,4,100.0,0,6,6,10,0,0,0,0,4,6
../kbl_data/2022-2023,S41G01N212,고양 캐롯,Home,모리구치 히사시,3,0,0,0.0,1,2,50.0,1,2,50.0,0,0,0.0,1,1,2,0,0,0,0,0,0,0
../kbl_data/2022-2023,S41G01N212,고양 캐롯,Home,안정욱,0,0,0,0.0,0,0,0.0,0,0,0.0,0,0,0.0,0,0,0,0,1,0,0,0,0,1
../kbl_data/2022-2023,S41G01N212,고양 캐롯,Home,조나단 알렛지,9,1,5,20.0,1,1,100.0,2,6,33.3,4,4,100.0,1,0,1,1,1,0,0,0,0,1
../kbl_data/2022-2023,S41G01N212,서울 삼성,Away,이정현,20,2,12,16.7,4,12,33.3,6,24,25.0,4,4,100.0,0,6,6,10,0,0,0,0,4,6
../kbl_data/2022-2023,S41G01N212,서울 삼성,Away,장민국,5,1,1,100.0,1,3,33.3,2,4,50.0,0,0,0.0,2,3,5,2,0,0,0,0,0,2
../kbl_data/2022-2023,S41G01N212,서울 삼성,Away,김승원,0,0,0,0.0,0,0,0.0,0,0,0.0,0,0,0.0,1,1,2,0,0,0,0,0,0,3
../kbl_data/2022-2023,S41G01N212,서울 삼성,Away,김시래,5,1,3,33.3,1,3,33.3,2,6,33.3,0,0,0.0,1,2,3,4,0,1,0,0,1,0
../kbl_data/2022-2023,S41G01N212,서울 삼성,Away,김현수,0,0,0,0.0,0,0,0.0,0,0,0.0,0,0,0.0,0,0,0,0,0,0,0,0,0,0
../kbl_data/2022-2023,S41G01N212,서울 삼성,Away,이동엽,12,2,2,100.0,2,6,33.3,4,8,50.0,2,3,66.7,0,2,2,3,0,0,0,0,0,3
../kbl_data/2022-2023,S41G01N212,서울 삼성,Away,이호현,13,5,9,55.6,1,2,50.0,6,11,54.5,0,0,0.0,1,3,4,4,0,0,0,0,0,3
../kbl_data/2022-2023,S41G01N212,서울 삼성,Away,차민석,0,0,1,0.0,0,0,0.0,0,1,0.0,0,0,0.0,0,2,2,0,0,0,0,0,0,1
../kbl_data/2022-2023,S41G01N212,서울 삼성,Away,신동혁,16,2,5,40.0,4,4,100.0,6,9,66.7,0,0,0.0,2,2,4,2,0,0,0,0,0,3
../kbl_data/2022-2023,S41G01N212,서울 삼성,Away,박민채,0,0,0,0.0,0,0,0.0,0,0,0.0,0,0,0.0,0,0,0,0,0,0,0,0,0,0
../kbl_data/2022-2023,S41G01N212,서울 삼성,Away,다랄 윌리스,30,12,20,60.0,0,4,0.0,12,24,50.0,6,6,100.0,3,4,7,0,1,1,0,1,2,4
../kbl_data/2022-2023,S41G01N212,서울 삼성,Away,앤서니 모스,5,2,2,100.0,0,0,0.0,2,2,100.0,1,4,25.0,0,3,3,1,0,0,0,0,0,2
../kbl_data/2022-2023,S41G01N213,대구 한국가스공사,Home,차바위,6,0,0,0.0,2,2,100.0,2,2,100.0,0,0,0.0,2,5,7,2,2,0,0,0,0,3
../kbl_data/2022-2023,S41G01N213,대구 한국가스공사,Home,박지훈,0,0,0,0.0,0,0,0.0,0,0,0.0,0,0,0.0,0,0,0,0,0,0,0,0,0,0
../kbl_data/2022-2023,S41G01N213,대구 한국가스공사,Home,조상열,8,1,2,50.0,2,3,66.7,3,5,60.0,0,0,0.0,2,1,3,1,2,0,0,0,2,4
../kbl_data/2022-2023,S41G01N213,대구 한국가스공사,Home,이대헌,15,6,7,85.7,1,3,33.3,7,10,70.0,0,0,0.0,1,0,1,1,0,0,0,0,1,2
../kbl_data/2022-2023,S41G01N213,대구 한국가스공사,Home,이대성,19,8,13,61.5,1,5,20.0,9,18,50.0,0,0,0.0,1,0,1,5,1,0,0,0,6,3
../kbl_data/2022-2023,S41G01N213,대구 한국가스공사,Home,정효근,8,2,2,100.0,1,3,33.3,3,5,60.0,1,2,50.0,0,1,1,3,1,0,0,0,1,1
../kbl_data/2022-2023,S41G01N213,대구 한국가스공사,Home,머피 할로웨이,13,6,9,66.7,0,0,0.0,6,9,66.7,1,4,25.0,2,8,10,5,0,1,0,1,2,4
../kbl_data/2022-2023,S41G01N213,대구 한국가스공사,Home,우동현,6,2,2,100.0,0,2,0.0,2,4,50.0,2,2,100.0,0,0,0,2,2,0,0,0,0,2
../kbl_data/2022-2023,S41G01N213,대구 한국가스공사,Home,전현우,0,0,0,0.0,0,0,0.0,0,0,0.0,0,0,0.0,0,0,0,0,0,0,0,0,0,0
../kbl_data/2022-2023,S41G01N213,대구 한국가스공사,Home,데본 스캇,3,0,2,0.0,1,1,100.0,1,3,33.3,0,0,0.0,1,0,1,1,0,1,0,0,2,4
../kbl_data/2022-2023,S41G01N213,대구 한국가스공사,Home,신승민,3,0,0,0.0,1,1,100.0,1,1,100.0,0,0,0.0,0,0,0,0,0,0,1,0,0,0
../kbl_data/2022-2023,S41G01N213,대구 한국가스공사,Home,샘조세프 벨란겔,0,0,2,0.0,0,1,0.0,0,3,0.0,0,0,0.0,0,0,0,3,2,0,0,0,1,3
../kbl_data/2022-2023,S41G01N213,전주 KCC,Away,정창영,4,1,3,33.3,0,1,0.0,1,4,25.0,2,2,100.0,1,0,1,1,1,0,1,0,1,1
../kbl_data/2022-2023,S41G01N213,전주 KCC,Away,라건아,25,8,13,61.5,1,2,50.0,9,15,60.0,6,6,100.0,3,8,11,2,0,0,0,0,3,1
../kbl_data/2022-2023,S41G01N213,전주 KCC,Away,박경상,10,3,4,75.0,0,3,0.0,3,7,42.9,4,4,100.0,0,1,1,2,0,0,0,0,0,0
../kbl_data/2022-2023,S41G01N213,전주 KCC,Away,김상규,0,0,0,0.0,0,0,0.0,0,0,0.0,0,0,0.0,0,0,0,0,0,0,0,0,0,0
../kbl_data/2022-2023,S41G01N213,전주 KCC,Away,유병훈,0,0,0,0.0,0,1,0.0,0,1,0.0,0,0,0.0,1,0,1,0,0,0,0,0,1,1
../kbl_data/2022-2023,S41G01N213,전주 KCC,Away,전준범,11,0,1,0.0,2,3,66.7,2,4,50.0,5,6,83.3,0,0,0,1,0,0,0,0,2,2
../kbl_data/2022-2023,S41G01N213,전주 KCC,Away,이승현,7,3,10,30.0,0,2,0.0,3,12,25.0,1,2,50.0,1,2,3,3,1,0,0,0,1,3
../kbl_data/2022-2023,S41G01N213,전주 KCC,Away,이종현,4,1,1,100.0,0,0,0.0,1,1,100.0,2,4,50.0,0,0,0,1,1,0,0,0,1,1
../kbl_data/2022-2023,S41G01N213,전주 KCC,Away,이근휘,13,2,3,66.7,2,4,50.0,4,7,57.1,3,3,100.0,1,3,4,1,3,0,1,0,1,2
../kbl_data/2022-2023,S41G01N213,전주 KCC,Away,송동훈,5,1,2,50.0,1,1,100.0,2,3,66.7,0,0,0.0,0,1,1,1,1,0,1,0,2,2
../kbl_data/2022-2023,S41G01N213,전주 KCC,Away,여준형,0,0,0,0.0,0,0,0.0,0,0,0.0,0,0,0.0,0,0,0,0,0,0,0,0,0,0
../kbl_data/2022-2023,S41G01N213,전주 KCC,Away,칼빈 제프리 에피스톨라,0,0,0,0.0,0,0,0.0,0,0,0.0,0,0,0.0,0,1,1,0,0,0,0,0,1,1
../kbl_data/2022-2023,S41G01N214,서울 SK,Home,양우섭,0,0,0,0.0,0,0,0.0,0,0,0.0,0,0,0.0,0,0,0,0,0,0,0,0,0,0
../kbl_data/2022-2023,S41G01N214,서울 SK,Home,허일영,11,2,3,66.7,2,3,66.7,4,6,66.7,1,1,100.0,1,1,2,0,2,0,0,0,0,2
../kbl_data/2022-2023,S41G01N214,서울 SK,Home,송창용,0,0,0,0.0,0,0,0.0,0,0,0.0,0,0,0.0,0,0,0,0,0,0,0,0,0,0
../kbl_data/2022-2023,S41G01N214,서울 SK,Home,김선형,20,8,13,61.5,1,3,33.3,9,16,56.2,1,1,100.0,2,0,2,10,2,0,0,0,3,2
../kbl_data/2022-2023,S41G01N214,서울 SK,Home,홍경기,0,0,0,0.0,0,0,0.0,0,0,0.0,0,0,0.0,0,0,0,0,0,0,0,0,0,0
../kbl_data/2022-2023,S41G01N214,서울 SK,Home,최부경,12,6,11,54.5,0,0,0.0,6,11,54.5,0,0,0.0,4,8,12,1,1,0,0,0,0,2
../kbl_data/2022-2023,S41G01N214,서울 SK,Home,리온 윌리엄스,0,0,0,0.0,0,0,0.0,0,0,0.0,0,0,0.0,0,0,0,0,0,0,0,0,0,0
../kbl_data/2022-2023,S41G01N214,서울 SK,Home,최원혁,4,2,3,66.7,0,1,0.0,2,4,50.0,0,0,0.0,0,3,3,1,2,1,0,0,0,1
../kbl_data/2022-2023,S41G01N214,서울 SK,Home,최성원,10,2,3,66.7,2,6,33.3,4,9,44.4,0,0,0.0,1,1,2,0,0,0,0,0,2,5
../kbl_data/2022-2023,S41G01N214,서울 SK,Home,자밀 워니,25,9,17,52.9,2,3,66.7,11,20,55.0,1,2,50.0,1,12,13,1,2,1,0,0,2,0
../kbl_data/2022-2023,S41G01N214,서울 SK,Home,오재현,3,0,1,0.0,1,3,33.3,1,4,25.0,0,0,0.0,0,1,1,1,0,0,0,0,1,5
../kbl_data/2022-2023,S41G01N214,서울 SK,Home,선상혁,0,0,0,0.0,0,0,0.0,0,0,0.0,0,0,0.0,0,0,0,0,0,0,0,0,0,0
../kbl_data/2022-2023,S41G01N214,안양 KGC,Away,양희종,0,0,0,0.0,0,0,0.0,0,0,0.0,0,0,0.0,0,0,0,0,0,0,0,0,0,0
../kbl_data/2022-2023,S41G01N214,안양 KGC,Away,오세근,17,8,12,66.7,0,1,0.0,8,13,61.5,1,2,50.0,0,8,8,2,0,2,0,0,1,1
../kbl_data/2022-2023,S41G01N214,안양 KGC,Away,정준원,0,0,0,0.0,0,0,0.0,0,0,0.0,0,0,0.0,0,0,0,0,0,0,0,0,0,0
../kbl_data/2022-2023,S41G01N214,안양 KGC,Away,배병준,0,0,0,0.0,0,0,0.0,0,0,0.0,0,0,0.0,0,0,0,0,0,0,0,0,0,0
../kbl_data/2022-2023,S41G01N214,안양 KGC,Away,문성곤,9,0,2,0.0,2,3,66.7,2,5,40.0,3,4,75.0,2,4,6,3,1,0,0,0,1,3
../kbl_data/2022-2023,S41G01N214,안양 KGC,Away,박지훈,2,1,2,50.0,0,0,0.0,1,2,50.0,0,0,0.0,1,1,2,4,0,0,0,0,0,3
../kbl_data/2022-2023,S41G01N214,안양 KGC,Away,이우정,0,0,0,0.0,0,0,0.0,0,0,0.0,0,0,0.0,0,0,0,0,0,0,0,0,0,0
../kbl_data/2022-2023,S41G01N214,안양 KGC,Away,대릴 먼로,0,0,0,0.0,0,0,0.0,0,0,0.0,0,0,0.0,0,0,0,0,0,0,0,0,0,2
../kbl_data/2022-2023,S41G01N214,안양 KGC,Away,변준형,12,2,5,40.0,2,4,50.0,4,9,44.4,2,2,100.0,1,1,2,6,1,0,1,0,2,1
../kbl_data/2022-2023,S41G01N214,안양 KGC,Away,한승희,0,0,1,0.0,0,0,0.0,0,1,0.0,0,0,0.0,1,1,2,0,0,1,0,0,1,0
../kbl_data/2022-2023,S41G01N214,안양 KGC,Away,오마리 스펠맨,20,7,12,58.3,2,10,20.0,9,22,40.9,0,0,0.0,1,6,7,2,1,0,0,2,3,1
../kbl_data/2022-2023,S41G01N214,안양 KGC,Away,렌즈 아반도,19,8,9,88.9,0,1,0.0,8,10,80.0,3,4,75.0,0,2,2,2,2,1,0,2,1,0
../kbl_data/2022-2023,S41G01N215,전주 KCC,Home,정창영,18,9,11,81.8,0,2,0.0,9,13,69.2,0,0,0.0,1,5,6,2,3,0,0,0,1,2
../kbl_data/2022-2023,S41G01N215,전주 KCC,Home,라건아,22,4,10,40.0,3,4,75.0,7,14,50.0,5,6,83.3,4,11,15,1,1,1,0,0,2,1
../kbl_data/2022-2023,S41G01N215,전주 KCC,Home,박경상,7,1,2,50.0,1,3,33.3,2,5,40.0,2,4,50.0,0,2,2,5,0,0,0,0,3,4
../kbl_data/2022-2023,S41G01N215,전주 KCC,Home,김상규,0,0,0,0.0,0,0,0.0,0,0,0.0,0,0,0.0,0,0,0,0,0,0,0,0,0,0
../kbl_data/2022-2023,S41G01N215,전주 KCC,Home,유병훈,0,0,0,0.0,0,0,0.0,0,0,0.0,0,0,0.0,0,0,0,0,0,0,0,0,0,0
../kbl_data/2022-2023,S41G01N215,전주 KCC,Home,전준범,4,2,3,66.7,0,0,0.0,2,3,66.7,0,0,0.0,0,1,1,0,0,0,0,0,1,1
../kbl_data/2022-2023,S41G01N215,전주 KCC,Home,이승현,16,6,9,66.7,0,0,0.0,6,9,66.7,4,4,100.0,0,2,2,5,0,1,0,0,2,3
../kbl_data/2022-2023,S41G01N215,전주 KCC,Home,이종현,0,0,0,0.0,0,0,0.0,0,0,0.0,0,0,0.0,0,0,0,0,0,0,0,0,0,1
../kbl_data/2022-2023,S41G01N215,전주 KCC,Home,이근휘,0,0,0,0.0,0,4,0.0,0,4,0.0,0,0,0.0,0,5,5,1,1,0,0,0,0,3
../kbl_data/2022-2023,S41G01N215,전주 KCC,Home,송동훈,4,1,1,100.0,0,1,0.0,1,2,50.0,2,2,100.0,0,1,1,1,0,0,1,0,1,1
../kbl_data/2022-2023,S41G01N215,전주 KCC,Home,칼빈 제프리 에피스톨라,0,0,1,0.0,0,1,0.0,0,2,0.0,0,0,0.0,1,0,1,0,0,0,0,0,1,0
../kbl_data/2022-2023,S41G01N215,전주 KCC,Home,디온 탐슨,2,0,0,0.0,0,0,0.0,0,0,0.0,2,2,100.0,0,0,0,0,0,0,0,0,0,0
../kbl_data/2022-2023,S41G01N215,서울 SK,Away,양우섭,0,0,0,0.0,0,0,0.0,0,0,0.0,0,0,0.0,0,0,0,0,0,0,0,0,0,0
../kbl_data/2022-2023,S41G01N215,서울 SK,Away,허일영,6,3,4,75.0,0,3,0.0,3,7,42.9,0,0,0.0,1,2,3,3,2,0,0,0,2,2
../kbl_data/2022-2023,S41G01N215,서울 SK,Away,송창용,0,0,0,0.0,0,0,0.0,0,0,0.0,0,0,0.0,0,0,0,0,0,0,0,0,0,0
../kbl_data/2022-2023,S41G01N215,서울 SK,Away,김선형,20,6,10,60.0,2,6,33.3,8,16,50.0,2,2,100.0,0,2,2,8,0,0,0,0,3,2
../kbl_data/2022-2023,S41G01N215,서울 SK,Away,홍경기,0,0,0,0.0,0,0,0.0,0,0,0.0,0,0,0.0,0,0,0,0,0,0,0,0,0,0
../kbl_data/2022-2023,S41G01N215,서울 SK,Away,최부경,12,6,9,66.7,0,0,0.0,6,9,66.7,0,0,0.0,1,1,2,0,0,1,1,0,0,5
../kbl_data/2022-2023,S41G01N215,서울 SK,Away,리온 윌리엄스,4,0,1,0.0,0,2,0.0,0,3,0.0,4,4,100.0,1,2,3,1,1,0,0,0,0,3
../kbl_data/2022-2023,S41G01N215,서울 SK,Away,최원혁,0,0,0,0.0,0,0,0.0,0,0,0.0,0,0,0.0,2,0,2,0,0,1,0,0,0,1
../kbl_data/2022-2023,S41G01N215,서울 SK,Away,최성원,5,0,1,0.0,1,7,14.3,1,8,12.5,2,2,100.0,2,2,4,5,2,0,0,0,0,0
../kbl_data/2022-2023,S41G01N215,서울 SK,Away,자밀 워니,14,4,12,33.3,2,5,40.0,6,17,35.3,0,2,0.0,1,7,8,1,1,0,0,0,1,1
../kbl_data/2022-2023,S41G01N215,서울 SK,Away,오재현,5,1,1,100.0,1,4,25.0,2,5,40.0,0,0,0.0,1,0,1,0,0,1,0,0,0,3
../kbl_data/2022-2023,S41G01N215,서울 SK,Away,선상혁,2,1,1,100.0,0,0,0.0,1,1,100.0,0,0,0.0,0,1,1,0,0,0,0,0,1,2
../kbl_data/2022-2023,S41G01N216,원주 DB,Home,윤호영,0,0,0,0.0,0,2,0.0,0,2,0.0,0,0,0.0,0,0,0,0,0,0,0,0,0,0
../kbl_data/2022-2023,S41G01N216,원주 DB,Home,박찬희,0,0,0,0.0,0,0,0.0,0,0,0.0,0,0,0.0,0,0,0,0,0,0,0,0,0,0
../kbl_data/2022-2023,S41G01N216,원주 DB,Home,김현호,5,1,4,25.0,1,3,33.3,2,7,28.6,0,0,0.0,1,4,5,4,3,1,0,0,3,4
../kbl_data/2022-2023,S41G01N216,원주 DB,Home,말콤 토마스,0,0,1,0.0,0,0,0.0,0,1,0.0,0,0,0.0,0,1,1,0,0,0,0,0,0,1
../kbl_data/2022-2023,S41G01N216,원주 DB,Home,두경민,14,1,6,16.7,3,10,30.0,4,16,25.0,3,3,100.0,0,1,1,5,2,0,0,0,2,1
../kbl_data/2022-2023,S41G01N216,원주 DB,Home,김종규,22,10,14,71.4,0,1,0.0,10,15,66.7,2,2,100.0,3,5,8,2,0,1,0,2,0,4
../kbl_data/2022-2023,S41G01N216,원주 DB,Home,최승욱,7,2,5,40.0,1,4,25.0,3,9,33.3,0,0,0.0,2,1,3,2,0,0,0,0,0,3
../kbl_data/2022-2023,S41G01N216,원주 DB,Home,강상재,4,2,4,50.0,0,2,0.0,2,6,33.3,0,0,0.0,1,0,1,2,0,0,0,0,1,1
../kbl_data/2022-2023,S41G01N216,원주 DB,Home,레나드 프리먼,8,4,6,66.7,0,0,0.0,4,6,66.7,0,0,0.0,7,6,13,2,1,0,0,0,3,2
../kbl_data/2022-2023,S41G01N216,원주 DB,Home,정호영,0,0,0,0.0,0,0,0.0,0,0,0.0,0,0,0.0,0,0,0,0,0,0,0,0,0,0
../kbl_data/2022-2023,S41G01N216,원주 DB,Home,이민석,0,0,1,0.0,0,0,0.0,0,1,0.0,0,0,0.0,0,0,0,0,0,0,0,0,0,0
../kbl_data/2022-2023,S41G01N216,원주 DB,Home,이선 알바노,11,4,7,57.1,1,3,33.3,5,10,50.0,0,0,0.0,0,1,1,5,2,0,0,0,1,3
../kbl_data/2022-2023,S41G01N216,전주 KCC,Away,정창영,8,4,8,50.0,0,4,0.0,4,12,33.3,0,0,0.0,2,1,3,1,2,0,0,0,2,3
../kbl_data/2022-2023,S41G01N216,전주 KCC,Away,라건아,18,6,7,85.7,2,4,50.0,8,11,72.7,0,1,0.0,4,9,13,5,2,1,0,0,0,0
../kbl_data/2022-2023,S41G01N216,전주 KCC,Away,박경상,0,0,0,0.0,0,4,0.0,0,4,0.0,0,0,0.0,0,2,2,4,1,0,0,0,1,1
../kbl_data/2022-2023,S41G01N216,전주 KCC,Away,김상규,0,0,0,0.0,0,0,0.0,0,0,0.0,0,0,0.0,0,0,0,0,0,0,0,0,0,0
../kbl_data/2022-2023,S41G01N216,전주 KCC,Away,전준범,10,1,1,100.0,2,3,66.7,3,4,75.0,2,2,100.0,1,6,7,2,0,1,0,0,0,3
../kbl_data/2022-2023,S41G01N216,전주 KCC,Away,이승현,21,7,12,58.3,1,4,25.0,8,16,50.0,4,6,66.7,1,6,7,2,1,0,0,0,3,3
../kbl_data/2022-2023,S41G01N216,전주 KCC,Away,이종현,0,0,2,0.0,0,0,0.0,0,2,0.0,0,0,0.0,1,0,1,0,0,0,0,0,0,0
../kbl_data/2022-2023,S41G01N216,전주 KCC,Away,이진욱,3,0,0,0.0,1,1,100.0,1,1,100.0,0,0,0.0,0,0,0,0,1,0,1,0,0,0
../kbl_data/2022-2023,S41G01N216,전주 KCC,Away,이근휘,2,1,3,33.3,0,2,0.0,1,5,20.0,0,0,0.0,1,0,1,0,0,0,0,0,0,0
../kbl_data/2022-2023,S41G01N216,전주 KCC,Away,송동훈,8,1,3,33.3,2,4,50.0,3,7,42.9,0,0,0.0,1,2,3,1,0,0,0,0,1,4
../kbl_data/2022-2023,S41G01N216,전주 KCC,Away,칼빈 제프리 에피스톨라,0,0,0,0.0,0,0,0.0,0,0,0.0,0,0,0.0,0,0,0,1,0,0,0,0,2,0
../kbl_data/2022-2023,S41G01N216,전주 KCC,Away,디온 탐슨,5,1,1,100.0,1,2,50.0,2,3,66.7,0,0,0.0,1,0,1,2,1,1,0,0,2,0
../kbl_data/2022-2023,S41G01N217,안양 KGC,Home,양희종,0,0,0,0.0,0,1,0.0,0,1,0.0,0,0,0.0,0,1,1,0,0,0,0,0,1,0
../kbl_data/2022-2023,S41G01N217,안양 KGC,Home,오세근,18,6,13,46.2,1,2,50.0,7,15,46.7,3,4,75.0,0,7,7,2,0,0,0,0,0,4
../kbl_data/2022-2023,S41G01N217,안양 KGC,Home,정준원,4,2,2,100.0,0,1,0.0,2,3,66.7,0,0,0.0,1,2,3,1,1,0,0,0,1,2
../kbl_data/2022-2023,S41G01N217,안양 KGC,Home,배병준,2,1,3,33.3,0,0,0.0,1,3,33.3,0,0,0.0,0,1,1,0,0,0,0,0,0,2
../kbl_data/2022-2023,S41G01N217,안양 KGC,Home,문성곤,5,1,3,33.3,1,4,25.0,2,7,28.6,0,0,0.0,2,8,10,5,4,0,0,0,1,3
../kbl_data/2022-2023,S41G01N217,안양 KGC,Home,박지훈,0,0,2,0.0,0,0,0.0,0,2,0.0,0,0,0.0,2,0,2,0,0,0,0,0,6,2
../kbl_data/2022-2023,S41G01N217,안양 KGC,Home,이우정,0,0,1,0.0,0,0,0.0,0,1,0.0,0,0,0.0,0,0,0,0,0,0,0,0,0,0
../kbl_data/2022-2023,S41G01N217,안양 KGC,Home,대릴 먼로,0,0,1,0.0,0,0,0.0,0,1,0.0,0,0,0.0,1,1,2,0,0,0,0,0,0,1
../kbl_data/2022-2023,S41G01N217,안양 KGC,Home,변준형,18,6,9,66.7,2,6,33.3,8,15,53.3,0,0,0.0,0,3,3,7,0,0,1,0,3,2
../kbl_data/2022-2023,S41G01N217,안양 KGC,Home,한승희,2,1,1,100.0,0,0,0.0,1,1,100.0,0,0,0.0,0,0,0,0,0,0,0,0,1,3
../kbl_data/2022-2023,S41G01N217,안양 KGC,Home,오마리 스펠맨,20,4,8,50.0,3,8,37.5,7,16,43.8,3,3,100.0,0,10,10,1,2,1,0,2,1,1
../kbl_data/2022-2023,S41G01N217,안양 KGC,Home,렌즈 아반도,4,1,3,33.3,0,1,0.0,1,4,25.0,2,2,100.0,1,1,2,1,1,0,0,0,1,2
../kbl_data/2022-2023,S41G01N217,대구 한국가스공사,Away,차바위,3,0,0,0.0,1,3,33.3,1,3,33.3,0,0,0.0,0,4,4,1,0,1,0,0,0,0
../kbl_data/2022-2023,S41G01N217,대구 한국가스공사,Away,박지훈,0,0,2,0.0,0,0,0.0,0,2,0.0,0,0,0.0,2,0,2,0,0,0,0,0,6,2
../kbl_data/2022-2023,S41G01N217,대구 한국가스공사,Away,조상열,8,0,1,0.0,2,7,28.6,2,8,25.0,2,2,100.0,1,1,2,1,3,0,1,0,0,1
../kbl_data/2022-2023,S41G01N217,대구 한국가스공사,Away,이대헌,22,7,9,77.8,2,3,66.7,9,12,75.0,2,3,66.7,0,4,4,2,0,0,0,0,0,0
../kbl_data/2022-2023,S41G01N217,대구 한국가스공사,Away,이대성,10,4,11,36.4,0,7,0.0,4,18,22.2,2,2,100.0,1,2,3,4,1,0,0,0,2,2
../kbl_data/2022-2023,S41G01N217,대구 한국가스공사,Away,정효근,5,0,1,0.0,1,3,33.3,1,4,25.0,2,4,50.0,0,5,5,2,0,1,0,0,4,3
../kbl_data/2022-2023,S41G01N217,대구 한국가스공사,Away,머피 할로웨이,2,1,1,100.0,0,0,0.0,1,1,100.0,0,0,0.0,1,5,6,1,1,0,0,0,0,1
../kbl_data/2022-2023,S41G01N217,대구 한국가스공사,Away,우동현,0,0,0,0.0,0,0,0.0,0,0,0.0,0,0,0.0,0,0,0,0,0,0,0,0,2,1
../kbl_data/2022-2023,S41G01N217,대구 한국가스공사,Away,전현우,0,0,0,0.0,0,0,0.0,0,0,0.0,0,0,0.0,0,0,0,0,0,0,0,0,0,0
../kbl_data/2022-2023,S41G01N217,대구 한국가스공사,Away,데본 스캇,8,3,8,37.5,0,2,0.0,3,10,30.0,2,2,100.0,1,7,8,3,1,0,0,0,1,2
../kbl_data/2022-2023,S41G01N217,대구 한국가스공사,Away,신승민,0,0,0,0.0,0,0,0.0,0,0,0.0,0,0,0.0,0,0,0,0,0,0,0,0,0,0
../kbl_data/2022-2023,S41G01N217,대구 한국가스공사,Away,샘조세프 벨란겔,6,2,4,50.0,0,2,0.0,2,6,33.3,2,4,50.0,0,2,2,3,3,0,0,0,1,1
../kbl_data/2022-2023,S41G01N218,전주 KCC,Home,정창영,11,0,1,0.0,2,5,40.0,2,6,33.3,5,6,83.3,0,2,2,7,0,0,0,0,1,3
../kbl_data/2022-2023,S41G01N218,전주 KCC,Home,라건아,22,6,9,66.7,2,4,50.0,8,13,61.5,4,6,66.7,5,7,12,2,0,1,0,0,2,2
../kbl_data/2022-2023,S41G01N218,전주 KCC,Home,박경상,0,0,0,0.0,0,2,0.0,0,2,0.0,0,0,0.0,0,0,0,1,0,1,0,0,0,1
../kbl_data/2022-2023,S41G01N218,전주 KCC,Home,김상규,0,0,0,0.0,0,0,0.0,0,0,0.0,0,0,0.0,0,0,0,0,0,0,0,0,0,0
../kbl_data/2022-2023,S41G01N218,전주 KCC,Home,전준범,7,3,4,75.0,0,1,0.0,3,5,60.0,1,1,100.0,0,1,1,1,0,0,0,0,1,2
../kbl_data/2022-2023,S41G01N218,전주 KCC,Home,이승현,21,9,18,50.0,0,2,0.0,9,20,45.0,3,4,75.0,1,6,7,6,0,0,0,0,2,1
../kbl_data/2022-2023,S41G01N218,전주 KCC,Home,이종현,0,0,1,0.0,0,0,0.0,0,1,0.0,0,0,0.0,0,1,1,0,0,0,0,0,1,1
../kbl_data/2022-2023,S41G01N218,전주 KCC,Home,이진욱,4,1,2,50.0,0,0,0.0,1,2,50.0,2,2,100.0,1,0,1,1,1,0,0,0,0,4
../kbl_data/2022-2023,S41G01N218,전주 KCC,Home,이근휘,9,0,0,0.0,3,6,50.0,3,6,50.0,0,0,0.0,2,3,5,1,0,0,1,0,2,2
../kbl_data/2022-2023,S41G01N218,전주 KCC,Home,송동훈,0,0,2,0.0,0,1,0.0,0,3,0.0,0,0,0.0,1,1,2,2,1,0,0,0,0,4
../kbl_data/2022-2023,S41G01N218,전주 KCC,Home,칼빈 제프리 에피스톨라,0,0,0,0.0,0,0,0.0,0,0,0.0,0,0,0.0,0,0,0,0,0,0,0,0,0,0
../kbl_data/2022-2023,S41G01N218,전주 KCC,Home,디온 탐슨,5,1,3,33.3,1,1,100.0,2,4,50.0,0,0,0.0,2,4,6,0,0,0,0,0,0,0
../kbl_data/2022-2023,S41G01N218,서울 삼성,Away,이정현,13,4,9,44.4,1,7,14.3,5,16,31.2,2,4,50.0,1,1,2,3,2,0,0,0,1,3
../kbl_data/2022-2023,S41G01N218,서울 삼성,Away,장민국,0,0,1,0.0,0,0,0.0,0,1,0.0,0,0,0.0,2,2,4,3,0,0,0,0,0,3
../kbl_data/2022-2023,S41G01N218,서울 삼성,Away,김승원,0,0,0,0.0,0,0,0.0,0,0,0.0,0,0,0.0,0,1,1,0,0,0,0,0,0,1
../kbl_data/2022-2023,S41G01N218,서울 삼성,Away,김시래,2,1,3,33.3,0,1,0.0,1,4,25.0,0,0,0.0,1,0,1,2,0,0,0,0,0,1
../kbl_data/2022-2023,S41G01N218,서울 삼성,Away,이동엽,0,0,3,0.0,0,1,0.0,0,4,0.0,0,0,0.0,0,3,3,1,0,0,0,0,0,0
../kbl_data/2022-2023,S41G01N218,서울 삼성,Away,이호현,16,4,9,44.4,2,3,66.7,6,12,50.0,2,2,100.0,0,1,1,0,0,0,0,0,1,2
../kbl_data/2022-2023,S41G01N218,서울 삼성,Away,김무성,0,0,0,0.0,0,0,0.0,0,0,0.0,0,0,0.0,0,0,0,0,0,0,0,0,0,0
../kbl_data/2022-2023,S41G01N218,서울 삼성,Away,차민석,0,0,0,0.0,0,0,0.0,0,0,0.0,0,0,0.0,0,0,0,0,0,0,0,0,0,0
../kbl_data/2022-2023,S41G01N218,서울 삼성,Away,이원석,10,0,6,0.0,2,3,66.7,2,9,22.2,4,4,100.0,5,5,10,0,2,1,0,0,0,4
../kbl_data/2022-2023,S41G01N218,서울 삼성,Away,신동혁,5,1,2,50.0,1,3,33.3,2,5,40.0,0,0,0.0,0,1,1,2,1,0,0,0,0,1
../kbl_data/2022-2023,S41G01N218,서울 삼성,Away,다랄 윌리스,11,5,9,55.6,0,1,0.0,5,10,50.0,1,2,50.0,2,1,3,0,1,1,0,0,1,4
../kbl_data/2022-2023,S41G01N218,서울 삼성,Away,앤서니 모스,16,6,13,46.2,0,0,0.0,6,13,46.2,4,4,100.0,8,7,15,0,0,2,0,2,2,2
../kbl_data/2022-2023,S41G01N219,대구 한국가스공사,Home,차바위,7,1,2,50.0,1,1,100.0,2,3,66.7,2,2,100.0,2,5,7,3,0,0,0,0,2,1
../kbl_data/2022-2023,S41G01N219,대구 한국가스공사,Home,박지훈,0,0,0,0.0,0,0,0.0,0,0,0.0,0,0,0.0,0,0,0,0,0,0,0,0,0,0
../kbl_data/2022-2023,S41G01N219,대구 한국가스공사,Home,조상열,11,1,1,100.0,3,6,50.0,4,7,57.1,0,0,0.0,0,0,0,1,0,0,0,0,0,2
../kbl_data/2022-2023,S41G01N219,대구 한국가스공사,Home,이원대,0,0,0,0.0,0,0,0.0,0,0,0.0,0,0,0.0,0,0,0,0,0,0,0,0,0,0
../kbl_data/2022-2023,S41G01N219,대구 한국가스공사,Home,이대헌,13,4,7,57.1,1,5,20.0,5,12,41.7,2,2,100.0,1,1,2,5,1,0,0,0,2,3
../kbl_data/2022-2023,S41G01N219,대구 한국가스공사,Home,이대성,12,4,9,44.4,0,2,0.0,4,11,36.4,4,4,100.0,0,4,4,7,0,0,1,0,1,2
../kbl_data/2022-2023,S41G01N219,대구 한국가스공사,Home,정효근,19,7,12,58.3,1,1,100.0,8,13,61.5,2,3,66.7,1,4,5,1,0,1,1,1,0,5
../kbl_data/2022-2023,S41G01N219,대구 한국가스공사,Home,전현우,0,0,0,0.0,0,0,0.0,0,0,0.0,0,0,0.0,0,0,0,0,0,0,0,0,0,0
../kbl_data/2022-2023,S41G01N219,대구 한국가스공사,Home,데본 스캇,19,7,11,63.6,0,0,0.0,7,11,63.6,5,6,83.3,6,8,14,2,1,0,0,1,3,2
../kbl_data/2022-2023,S41G01N219,대구 한국가스공사,Home,신승민,0,0,1,0.0,0,2,0.0,0,3,0.0,0,0,0.0,0,0,0,0,1,0,0,0,1,2
../kbl_data/2022-2023,S41G01N219,대구 한국가스공사,Home,샘조세프 벨란겔,2,1,4,25.0,0,0,0.0,1,4,25.0,0,0,0.0,1,3,4,3,1,0,0,0,0,0
../kbl_data/2022-2023,S41G01N219,대구 한국가스공사,Home,염유성,0,0,0,0.0,0,0,0.0,0,0,0.0,0,0,0.0,0,0,0,0,0,0,0,0,0,0
../kbl_data/2022-2023,S41G01N219,고양 캐롯,Away,김강선,17,1,1,100.0,5,12,41.7,6,13,46.2,0,0,0.0,0,0,0,1,0,0,0,0,1,4
../kbl_data/2022-2023,S41G01N219,고양 캐롯,Away,최현민,7,2,3,66.7,1,6,16.7,3,9,33.3,0,0,0.0,2,3,5,1,1,1,0,0,0,1
../kbl_data/2022-2023,S41G01N219,고양 캐롯,Away,한호빈,0,0,0,0.0,0,1,0.0,0,1,0.0,0,0,0.0,0,0,0,1,0,0,0,0,0,0
../kbl_data/2022-2023,S41G01N219,고양 캐롯,Away,전성현,3,0,2,0.0,1,9,11.1,1,11,9.1,0,0,0.0,1,1,2,1,0,0,0,0,1,1
../kbl_data/2022-2023,S41G01N219,고양 캐롯,Away,김진유,0,0,0,0.0,0,2,0.0,0,2,0.0,0,0,0.0,1,0,1,0,0,0,0,0,0,0
../kbl_data/2022-2023,S41G01N219,고양 캐롯,Away,김진용,0,0,0,0.0,0,0,0.0,0,0,0.0,0,0,0.0,0,0,0,0,0,0,0,0,0,0
../kbl_data/2022-2023,S41G01N219,고양 캐롯,Away,조한진,6,0,0,0.0,2,5,40.0,2,5,40.0,0,0,0.0,0,1,1,0,1,0,0,0,1,3
../kbl_data/2022-2023,S41G01N219,고양 캐롯,Away,디드릭 로슨,21,5,7,71.4,1,5,20.0,6,12,50.0,8,10,80.0,2,12,14,4,2,3,0,0,3,4
../kbl_data/2022-2023,S41G01N219,고양 캐롯,Away,박진철,4,2,2,100.0,0,0,0.0,2,2,100.0,0,0,0.0,1,0,1,1,0,0,0,1,0,2
../kbl_data/2022-2023,S41G01N219,고양 캐롯,Away,이정현,14,2,4,50.0,2,5,40.0,4,9,44.4,4,4,100.0,1,1,2,5,0,0,0,0,0,1
../kbl_data/2022-2023,S41G01N219,고양 캐롯,Away,모리구치 히사시,0,0,0,0.0,0,0,0.0,0,0,0.0,0,0,0.0,0,0,0,0,0,0,0,0,0,0
../kbl_data/2022-2023,S41G01N219,고양 캐롯,Away,조나단 알렛지,4,2,3,66.7,0,1,0.0,2,4,50.0,0,0,0.0,2,4,6,1,0,0,0,0,1,3
../kbl_data/2022-2023,S41G01N220,수원 KT,Home,김동욱,0,0,0,0.0,0,0,0.0,0,0,0.0,0,0,0.0,0,0,0,0,0,0,0,0,0,0
../kbl_data/2022-2023,S41G01N220,수원 KT,Home,김영환,2,1,1,100.0,0,2,0.0,1,3,33.3,0,0,0.0,0,1,1,1,0,0,0,0,0,4
../kbl_data/2022-2023,S41G01N220,수원 KT,Home,한희원,5,1,4,25.0,1,1,100.0,2,5,40.0,0,0,0.0,3,3,6,3,0,0,0,0,2,4
../kbl_data/2022-2023,S41G01N220,수원 KT,Home,최창진,0,0,0,0.0,0,0,0.0,0,0,0.0,0,0,0.0,0,0,0,0,0,0,0,0,0,0
../kbl_data/2022-2023,S41G01N220,수원 KT,Home,최성모,0,0,0,0.0,0,0,0.0,0,0,0.0,0,0,0.0,0,0,0,0,0,0,0,0,0,0
../kbl_data/2022-2023,S41G01N220,수원 KT,Home,양홍석,8,4,6,66.7,0,3,0.0,4,9,44.4,0,0,0.0,1,7,8,2,2,1,0,0,5,0
../kbl_data/2022-2023,S41G01N220,수원 KT,Home,박지원,5,1,1,100.0,1,2,50.0,2,3,66.7,0,0,0.0,0,3,3,2,0,0,0,0,2,2
../kbl_data/2022-2023,S41G01N220,수원 KT,Home,하윤기,18,8,13,61.5,0,0,0.0,8,13,61.5,2,2,100.0,5,7,12,3,1,1,0,0,2,2
../kbl_data/2022-2023,S41G01N220,수원 KT,Home,이두원,4,1,1,100.0,0,0,0.0,1,1,100.0,2,4,50.0,0,0,0,0,0,0,0,0,0,0
../kbl_data/2022-2023,S41G01N220,수원 KT,Home,레스터 프로스퍼,0,0,0,0.0,0,1,0.0,0,1,0.0,0,0,0.0,0,2,2,2,0,0,0,0,2,0
../kbl_data/2022-2023,S41G01N220,수원 KT,Home,재로드 존스,21,7,11,63.6,1,4,25.0,8,15,53.3,4,4,100.0,1,7,8,1,4,5,0,2,3,1
../kbl_data/2022-2023,S41G01N220,수원 KT,Home,데이브 일데폰소,14,3,6,50.0,2,6,33.3,5,12,41.7,2,2,100.0,1,0,1,4,2,0,0,0,1,3
../kbl_data/2022-2023,S41G01N220,원주 DB,Away,박찬희,0,0,0,0.0,0,0,0.0,0,0,0.0,0,0,0.0,0,0,0,0,0,0,0,0,0,0
../kbl_data/2022-2023,S41G01N220,원주 DB,Away,김현호,14,4,8,50.0,2,4,50.0,6,12,50.0,0,0,0.0,0,3,3,2,1,1,0,0,1,3
../kbl_data/2022-2023,S41G01N220,원주 DB,Away,두경민,8,1,2,50.0,2,7,28.6,3,9,33.3,0,0,0.0,0,0,0,2,2,0,0,0,1,2
../kbl_data/2022-2023,S41G01N220,원주 DB,Away,김종규,6,3,7,42.9,0,0,0.0,3,7,42.9,0,0,0.0,0,4,4,5,2,0,2,0,1,5
../kbl_data/2022-2023,S41G01N220,원주 DB,Away,최승욱,0,0,0,0.0,0,0,0.0,0,0,0.0,0,0,0.0,1,0,1,1,0,1,0,0,0,0
../kbl_data/2022-2023,S41G01N220,원주 DB,Away,강상재,2,1,5,20.0,0,2,0.0,1,7,14.3,0,0,0.0,2,1,3,3,1,1,0,0,1,1
../kbl_data/2022-2023,S41G01N220,원주 DB,Away,윤성원,0,0,0,0.0,0,0,0.0,0,0,0.0,0,0,0.0,0,0,0,0,0,0,0,0,1,0
../kbl_data/2022-2023,S41G01N220,원주 DB,Away,레나드 프리먼,8,4,8,50.0,0,0,0.0,4,8,50.0,0,0,0.0,0,2,2,1,0,0,0,0,2,0
../kbl_data/2022-2023,S41G01N220,원주 DB,Away,정호영,0,0,0,0.0,0,0,0.0,0,0,0.0,0,0,0.0,0,0,0,0,0,0,0,0,0,0
../kbl_data/2022-2023,S41G01N220,원주 DB,Away,이민석,0,0,0,0.0,0,0,0.0,0,0,0.0,0,0,0.0,0,0,0,0,0,0,0,0,0,0
../kbl_data/2022-2023,S41G01N220,원주 DB,Away,이선 알바노,14,4,9,44.4,2,5,40.0,6,14,42.9,0,2,0.0,2,2,4,3,3,0,0,0,2,1
../kbl_data/2022-2023,S41G01N220,원주 DB,Away,디존 데이비스,13,4,6,66.7,1,5,20.0,5,11,45.5,2,4,50.0,4,7,11,0,1,0,0,0,3,3
../kbl_data/2022-2023,S41G01N221,울산 현대모비스,Home,김현민,1,0,0,0.0,0,1,0.0,0,1,0.0,1,2,50.0,1,0,1,1,0,1,0,0,0,2
../kbl_data/2022-2023,S41G01N221,울산 현대모비스,Home,최진수,7,2,6,33.3,1,2,50.0,3,8,37.5,0,0,0.0,0,5,5,3,2,2,0,0,0,4
../kbl_data/2022-2023,S41G01N221,울산 현대모비스,Home,김영현,0,0,1,0.0,0,1,0.0,0,2,0.0,0,0,0.0,2,0,2,0,0,1,0,0,1,4
../kbl_data/2022-2023,S41G01N221,울산 현대모비스,Home,김국찬,3,0,1,0.0,1,1,100.0,1,2,50.0,0,0,0.0,0,1,1,0,0,0,1,0,0,1
../kbl_data/2022-2023,S41G01N221,울산 현대모비스,Home,서명진,12,3,7,42.9,2,6,33.3,5,13,38.5,0,0,0.0,1,2,3,6,0,0,0,0,3,2
../kbl_data/2022-2023,S41G01N221,울산 현대모비스,Home,저스틴 녹스,15,5,9,55.6,0,2,0.0,5,11,45.5,5,6,83.3,4,3,7,2,0,0,0,1,2,3
../kbl_data/2022-2023,S41G01N221,울산 현대모비스,Home,신민석,6,3,3,100.0,0,4,0.0,3,7,42.9,0,0,0.0,1,3,4,1,0,0,0,0,1,1
../kbl_data/2022-2023,S41G01N221,울산 현대모비스,Home,김동준,0,0,1,0.0,0,0,0.0,0,1,0.0,0,0,0.0,0,0,0,0,0,0,0,0,0,0
../kbl_data/2022-2023,S41G01N221,울산 현대모비스,Home,정종현,0,0,0,0.0,0,0,0.0,0,0,0.0,0,0,0.0,1,1,2,0,0,0,0,0,0,0
../kbl_data/2022-2023,S41G01N221,울산 현대모비스,Home,론제이 아바리엔토스,12,3,5,60.0,2,8,25.0,5,13,38.5,0,0,0.0,0,0,0,2,0,0,0,0,2,0
../kbl_data/2022-2023,S41G01N221,울산 현대모비스,Home,게이지 프림,17,8,11,72.7,0,0,0.0,8,11,72.7,1,2,50.0,1,4,5,0,2,0,0,0,0,2
../kbl_data/2022-2023,S41G01N221,울산 현대모비스,Home,김태완,7,2,4,50.0,1,6,16.7,3,10,30.0,0,0,0.0,2,2,4,7,2,0,0,0,3,2
../kbl_data/2022-2023,S41G01N221,창원 LG,Away,이관희,11,4,7,57.1,1,2,50.0,5,9,55.6,0,0,0.0,1,3,4,1,0,1,0,0,1,1
../kbl_data/2022-2023,S41G01N221,창원 LG,Away,정희재,4,2,2,100.0,0,0,0.0,2,2,100.0,0,0,0.0,1,0,1,0,0,0,0,0,0,1
../kbl_data/2022-2023,S41G01N221,창원 LG,Away,임동섭,0,0,0,0.0,0,0,0.0,0,0,0.0,0,0,0.0,0,0,0,0,0,0,0,0,0,0
../kbl_data/2022-2023,S41G01N221,창원 LG,Away,서민수,0,0,0,0.0,0,0,0.0,0,0,0.0,0,0,0.0,0,1,1,1,0,0,0,0,0,0
../kbl_data/2022-2023,S41G01N221,창원 LG,Away,이재도,21,3,7,42.9,3,8,37.5,6,15,40.0,6,7,85.7,1,2,3,8,1,0,0,0,3,4
../kbl_data/2022-2023,S41G01N221,창원 LG,Away,김준일,20,8,10,80.0,0,0,0.0,8,10,80.0,4,4,100.0,1,8,9,4,0,1,0,0,2,3
../kbl_data/2022-2023,S41G01N221,창원 LG,Away,정인덕,0,0,1,0.0,0,2,0.0,0,3,0.0,0,0,0.0,1,1,2,1,1,0,0,0,0,0
../kbl_data/2022-2023,S41G01N221,창원 LG,Away,윤원상,0,0,3,0.0,0,1,0.0,0,4,0.0,0,0,0.0,1,2,3,4,1,0,0,0,0,4
../kbl_data/2022-2023,S41G01N221,창원 LG,Away,아셈 마레이,16,7,9,77.8,0,0,0.0,7,9,77.8,2,3,66.7,1,0,1,2,2,0,0,3,0,3
../kbl_data/2022-2023,S41G01N221,창원 LG,Away,저스틴 구탕,8,4,5,80.0,0,0,0.0,4,5,80.0,0,0,0.0,1,6,7,4,2,0,0,2,2,0
../kbl_data/2022-2023,S41G01N221,창원 LG,Away,양준석,0,0,0,0.0,0,0,0.0,0,0,0.0,0,0,0.0,0,0,0,1,0,0,0,0,1,0
../kbl_data/2022-2023,S41G01N221,창원 LG,Away,단테 커닝햄,14,6,9,66.7,0,0,0.0,6,9,66.7,2,6,33.3,0,4,4,1,2,0,0,4,1,1
../kbl_data/2022-2023,S41G01N222,원주 DB,Home,박찬희,0,0,0,0.0,0,0,0.0,0,0,0.0,0,0,0.0,0,0,0,0,0,0,0,0,0,0
../kbl_data/2022-2023,S41G01N222,원주 DB,Home,김현호,0,0,0,0.0,0,2,0.0,0,2,0.0,0,0,0.0,0,0,0,3,1,0,1,0,4,1
../kbl_data/2022-2023,S41G01N222,원주 DB,Home,두경민,13,0,0,0.0,4,6,66.7,4,6,66.7,1,2,50.0,0,0,0,1,1,0,0,0,0,4
../kbl_data/2022-2023,S41G01N222,원주 DB,Home,김종규,16,7,10,70.0,0,2,0.0,7,12,58.3,2,4,50.0,0,10,10,2,0,3,1,2,0,3
../kbl_data/2022-2023,S41G01N222,원주 DB,Home,최승욱,2,0,2,0.0,0,1,0.0,0,3,0.0,2,2,100.0,1,0,1,0,1,0,0,0,0,1
../kbl_data/2022-2023,S41G01N222,원주 DB,Home,강상재,15,3,8,37.5,3,7,42.9,6,15,40.0,0,0,0.0,1,1,2,4,0,1,0,0,2,3
../kbl_data/2022-2023,S41G01N222,원주 DB,Home,윤성원,5,1,1,100.0,1,2,50.0,2,3,66.7,0,1,0.0,0,0,0,0,0,0,0,0,0,2
../kbl_data/2022-2023,S41G01N222,원주 DB,Home,레나드 프리먼,13,6,11,54.5,0,0,0.0,6,11,54.5,1,3,33.3,3,7,10,4,2,1,0,0,1,1
../kbl_data/2022-2023,S41G01N222,원주 DB,Home,정호영,2,1,3,33.3,0,3,0.0,1,6,16.7,0,0,0.0,0,0,0,2,1,0,0,0,2,2
../kbl_data/2022-2023,S41G01N222,원주 DB,Home,이선 알바노,13,1,4,25.0,3,4,75.0,4,8,50.0,2,4,50.0,1,6,7,9,2,0,2,0,1,4
../kbl_data/2022-2023,S41G01N222,원주 DB,Home,인승찬,0,0,0,0.0,0,0,0.0,0,0,0.0,0,0,0.0,0,0,0,0,0,0,0,0,0,0
../kbl_data/2022-2023,S41G01N222,원주 DB,Home,디존 데이비스,2,1,2,50.0,0,0,0.0,1,2,50.0,0,0,0.0,1,1,2,0,0,0,0,0,1,0
../kbl_data/2022-2023,S41G01N222,대구 한국가스공사,Away,차바위,4,0,0,0.0,1,4,25.0,1,4,25.0,1,2,50.0,1,4,5,1,0,0,0,0,3,3
../kbl_data/2022-2023,S41G01N222,대구 한국가스공사,Away,박지훈,0,0,0,0.0,0,0,0.0,0,0,0.0,0,0,0.0,0,0,0,0,0,0,0,0,0,0
../kbl_data/2022-2023,S41G01N222,대구 한국가스공사,Away,조상열,3,0,3,0.0,1,3,33.3,1,6,16.7,0,0,0.0,0,0,0,2,1,0,0,0,1,3
../kbl_data/2022-2023,S41G01N222,대구 한국가스공사,Away,이원대,0,0,0,0.0,0,0,0.0,0,0,0.0,0,0,0.0,0,0,0,0,0,0,0,0,0,0
../kbl_data/2022-2023,S41G01N222,대구 한국가스공사,Away,이대헌,15,4,9,44.4,1,1,100.0,5,10,50.0,4,4,100.0,3,3,6,2,0,0,0,0,1,3
../kbl_data/2022-2023,S41G01N222,대구 한국가스공사,Away,이대성,21,8,20,40.0,1,2,50.0,9,22,40.9,2,2,100.0,4,3,7,5,2,2,0,0,4,4
../kbl_data/2022-2023,S41G01N222,대구 한국가스공사,Away,정효근,5,1,2,50.0,0,2,0.0,1,4,25.0,3,4,75.0,2,1,3,0,0,0,0,0,3,3
../kbl_data/2022-2023,S41G01N222,대구 한국가스공사,Away,전현우,0,0,0,0.0,0,0,0.0,0,0,0.0,0,0,0.0,0,0,0,0,0,0,0,0,0,0
../kbl_data/2022-2023,S41G01N222,대구 한국가스공사,Away,박찬호,0,0,0,0.0,0,0,0.0,0,0,0.0,0,0,0.0,0,0,0,0,0,0,0,0,0,0
../kbl_data/2022-2023,S41G01N222,대구 한국가스공사,Away,데본 스캇,13,6,14,42.9,0,2,0.0,6,16,37.5,1,2,50.0,5,18,23,4,3,2,0,0,2,3
../kbl_data/2022-2023,S41G01N222,대구 한국가스공사,Away,신승민,12,3,3,100.0,2,4,50.0,5,7,71.4,0,0,0.0,0,4,4,0,1,0,0,0,1,2
../kbl_data/2022-2023,S41G01N222,대구 한국가스공사,Away,샘조세프 벨란겔,5,1,4,25.0,1,4,25.0,2,8,25.0,0,0,0.0,3,1,4,3,1,0,0,0,1,2
../kbl_data/2022-2023,S41G01N223,고양 캐롯,Home,김강선,6,1,1,100.0,1,2,50.0,2,3,66.7,1,1,100.0,0,2,2,0,3,0,0,0,1,1
../kbl_data/2022-2023,S41G01N223,고양 캐롯,Home,최현민,5,0,1,0.0,1,3,33.3,1,4,25.0,2,2,100.0,0,2,2,1,1,0,0,0,0,4
../kbl_data/2022-2023,S41G01N223,고양 캐롯,Home,한호빈,8,1,2,50.0,2,5,40.0,3,7,42.9,0,0,0.0,0,3,3,3,1,1,0,0,0,1
../kbl_data/2022-2023,S41G01N223,고양 캐롯,Home,전성현,10,3,6,50.0,1,8,12.5,4,14,28.6,1,2,50.0,0,2,2,0,2,0,0,0,0,2
../kbl_data/2022-2023,S41G01N223,고양 캐롯,Home,김진유,2,1,1,100.0,0,0,0.0,1,1,100.0,0,0,0.0,3,0,3,0,1,0,0,0,0,2
../kbl_data/2022-2023,S41G01N223,고양 캐롯,Home,김진용,0,0,0,0.0,0,0,0.0,0,0,0.0,0,0,0.0,0,0,0,0,0,0,0,0,0,0
../kbl_data/2022-2023,S41G01N223,고양 캐롯,Home,조한진,6,0,0,0.0,2,5,40.0,2,5,40.0,0,0,0.0,0,0,0,0,1,0,0,0,0,1
../kbl_data/2022-2023,S41G01N223,고양 캐롯,Home,디드릭 로슨,18,8,11,72.7,0,2,0.0,8,13,61.5,2,2,100.0,1,3,4,3,0,2,0,0,0,1
../kbl_data/2022-2023,S41G01N223,고양 캐롯,Home,박진철,2,1,2,50.0,0,0,0.0,1,2,50.0,0,0,0.0,0,7,7,0,1,0,0,0,1,2
../kbl_data/2022-2023,S41G01N223,고양 캐롯,Home,이정현,18,4,6,66.7,3,7,42.9,7,13,53.8,1,1,100.0,1,2,3,4,1,0,1,0,0,2
../kbl_data/2022-2023,S41G01N223,고양 캐롯,Home,모리구치 히사시,0,0,0,0.0,0,0,0.0,0,0,0.0,0,0,0.0,0,0,0,0,0,0,0,0,0,1
../kbl_data/2022-2023,S41G01N223,고양 캐롯,Home,조나단 알렛지,5,1,2,50.0,1,7,14.3,2,9,22.2,0,0,0.0,2,3,5,2,1,1,0,0,0,1
../kbl_data/2022-2023,S41G01N223,전주 KCC,Away,정창영,9,3,7,42.9,1,3,33.3,4,10,40.0,0,0,0.0,2,2,4,2,1,0,0,0,3,1
../kbl_data/2022-2023,S41G01N223,전주 KCC,Away,라건아,17,6,8,75.0,0,0,0.0,6,8,75.0,5,5,100.0,2,6,8,1,0,0,0,0,3,1
../kbl_data/2022-2023,S41G01N223,전주 KCC,Away,박경상,0,0,1,0.0,0,2,0.0,0,3,0.0,0,0,0.0,0,0,0,2,0,0,0,0,0,0
../kbl_data/2022-2023,S41G01N223,전주 KCC,Away,김상규,3,1,2,50.0,0,2,0.0,1,4,25.0,1,2,50.0,2,2,4,0,0,0,0,0,1,3
../kbl_data/2022-2023,S41G01N223,전주 KCC,Away,전준범,10,3,6,50.0,1,7,14.3,4,13,30.8,1,1,100.0,1,4,5,1,0,0,0,0,3,4
../kbl_data/2022-2023,S41G01N223,전주 KCC,Away,이승현,2,1,4,25.0,0,0,0.0,1,4,25.0,0,0,0.0,2,3,5,1,0,2,0,0,2,2
../kbl_data/2022-2023,S41G01N223,전주 KCC,Away,이종현,0,0,0,0.0,0,0,0.0,0,0,0.0,0,0,0.0,0,0,0,0,0,0,0,0,0,0
../kbl_data/2022-2023,S41G01N223,전주 KCC,Away,이진욱,4,2,2,100.0,0,2,0.0,2,4,50.0,0,0,0.0,2,1,3,1,0,0,0,0,1,1
../kbl_data/2022-2023,S41G01N223,전주 KCC,Away,이근휘,0,0,0,0.0,0,3,0.0,0,3,0.0,0,0,0.0,0,2,2,2,0,0,0,0,0,2
../kbl_data/2022-2023,S41G01N223,전주 KCC,Away,송동훈,6,2,3,66.7,0,1,0.0,2,4,50.0,2,2,100.0,1,1,2,2,0,0,0,0,0,1
../kbl_data/2022-2023,S41G01N223,전주 KCC,Away,칼빈 제프리 에피스톨라,0,0,0,0.0,0,0,0.0,0,0,0.0,0,0,0.0,0,0,0,0,0,0,0,0,1,0
../kbl_data/2022-2023,S41G01N223,전주 KCC,Away,디온 탐슨,9,2,7,28.6,1,2,50.0,3,9,33.3,2,3,66.7,1,7,8,0,0,2,0,0,0,1
../kbl_data/2022-2023,S41G01N224,서울 삼성,Home,이정현,18,2,4,50.0,3,5,60.0,5,9,55.6,5,6,83.3,1,4,5,8,0,0,0,0,4,2
../kbl_data/2022-2023,S41G01N224,서울 삼성,Home,장민국,2,1,2,50.0,0,0,0.0,1,2,50.0,0,0,0.0,0,4,4,1,0,0,0,0,0,4
../kbl_data/2022-2023,S41G01N224,서울 삼성,Home,김승원,0,0,0,0.0,0,0,0.0,0,0,0.0,0,0,0.0,0,0,0,0,0,0,0,0,0,0
../kbl_data/2022-2023,S41G01N224,서울 삼성,Home,김시래,4,1,3,33.3,0,0,0.0,1,3,33.3,2,2,100.0,0,0,0,2,0,0,0,0,1,1
../kbl_data/2022-2023,S41G01N224,서울 삼성,Home,이동엽,4,2,3,66.7,0,3,0.0,2,6,33.3,0,0,0.0,2,1,3,2,0,0,0,0,1,4
../kbl_data/2022-2023,S41G01N224,서울 삼성,Home,이호현,21,5,8,62.5,3,5,60.0,8,13,61.5,2,4,50.0,0,1,1,3,2,0,0,0,1,0
../kbl_data/2022-2023,S41G01N224,서울 삼성,Home,김무성,0,0,0,0.0,0,1,0.0,0,1,0.0,0,0,0.0,0,0,0,0,0,0,0,0,0,1
../kbl_data/2022-2023,S41G01N224,서울 삼성,Home,차민석,0,0,0,0.0,0,0,0.0,0,0,0.0,0,0,0.0,0,0,0,0,0,0,0,0,0,0
../kbl_data/2022-2023,S41G01N224,서울 삼성,Home,이원석,12,3,7,42.9,1,1,100.0,4,8,50.0,3,4,75.0,3,6,9,0,2,0,0,0,4,2
../kbl_data/2022-2023,S41G01N224,서울 삼성,Home,신동혁,0,0,1,0.0,0,2,0.0,0,3,0.0,0,0,0.0,0,1,1,0,1,0,0,0,1,4
../kbl_data/2022-2023,S41G01N224,서울 삼성,Home,다랄 윌리스,1,0,1,0.0,0,0,0.0,0,1,0.0,1,2,50.0,0,0,0,0,0,0,0,0,2,1
../kbl_data/2022-2023,S41G01N224,서울 삼성,Home,앤서니 모스,26,12,15,80.0,0,0,0.0,12,15,80.0,2,5,40.0,1,8,9,0,1,1,1,4,1,2
../kbl_data/2022-2023,S41G01N224,울산 현대모비스,Away,김현민,0,0,0,0.0,0,0,0.0,0,0,0.0,0,0,0.0,0,1,1,0,0,0,0,0,0,0
../kbl_data/2022-2023,S41G01N224,울산 현대모비스,Away,최진수,14,5,6,83.3,1,4,25.0,6,10,60.0,1,2,50.0,0,6,6,3,0,1,0,0,0,3
../kbl_data/2022-2023,S41G01N224,울산 현대모비스,Away,김영현,0,0,0,0.0,0,3,0.0,0,3,0.0,0,0,0.0,1,0,1,0,0,0,0,0,0,1
../kbl_data/2022-2023,S41G01N224,울산 현대모비스,Away,김국찬,0,0,0,0.0,0,0,0.0,0,0,0.0,0,0,0.0,0,0,0,0,0,0,0,0,0,0
../kbl_data/2022-2023,S41G01N224,울산 현대모비스,Away,서명진,19,3,7,42.9,3,7,42.9,6,14,42.9,4,4,100.0,2,2,4,4,0,0,0,0,0,1
../kbl_data/2022-2023,S41G01N224,울산 현대모비스,Away,저스틴 녹스,5,2,4,50.0,0,0,0.0,2,4,50.0,1,1,100.0,0,6,6,1,1,0,0,0,6,5
../kbl_data/2022-2023,S41G01N224,울산 현대모비스,Away,신민석,4,2,2,100.0,0,1,0.0,2,3,66.7,0,0,0.0,4,1,5,1,0,0,0,0,1,4
../kbl_data/2022-2023,S41G01N224,울산 현대모비스,Away,김동준,0,0,0,0.0,0,0,0.0,0,0,0.0,0,0,0.0,0,0,0,0,0,0,0,0,0,0
../kbl_data/2022-2023,S41G01N224,울산 현대모비스,Away,정종현,0,0,0,0.0,0,0,0.0,0,0,0.0,0,0,0.0,0,0,0,0,0,0,0,0,0,0
../kbl_data/2022-2023,S41G01N224,울산 현대모비스,Away,론제이 아바리엔토스,23,2,5,40.0,6,13,46.2,8,18,44.4,1,3,33.3,0,2,2,5,2,1,1,0,3,1
../kbl_data/2022-2023,S41G01N224,울산 현대모비스,Away,게이지 프림,22,9,17,52.9,0,0,0.0,9,17,52.9,4,6,66.7,4,5,9,5,3,1,0,0,2,5
../kbl_data/2022-2023,S41G01N224,울산 현대모비스,Away,김태완,5,1,1,100.0,1,3,33.3,2,4,50.0,0,0,0.0,1,0,1,1,2,0,0,0,0,2
../kbl_data/2022-2023,S41G01N225,창원 LG,Home,이관희,12,3,5,60.0,2,6,33.3,5,11,45.5,0,0,0.0,0,2,2,3,0,1,0,0,1,2
../kbl_data/2022-2023,S41G01N225,창원 LG,Home,정희재,17,1,4,25.0,5,8,62.5,6,12,50.0,0,0,0.0,0,2,2,0,0,0,0,0,1,2
../kbl_data/2022-2023,S41G01N225,창원 LG,Home,임동섭,0,0,1,0.0,0,0,0.0,0,1,0.0,0,0,0.0,0,1,1,0,0,0,0,0,0,1
../kbl_data/2022-2023,S41G01N225,창원 LG,Home,서민수,0,0,0,0.0,0,0,0.0,0,0,0.0,0,0,0.0,0,0,0,0,0,0,0,0,0,0
../kbl_data/2022-2023,S41G01N225,창원 LG,Home,이재도,17,2,8,25.0,3,4,75.0,5,12,41.7,4,4,100.0,1,6,7,6,0,0,0,0,0,2
../kbl_data/2022-2023,S41G01N225,창원 LG,Home,김준일,4,1,4,25.0,0,0,0.0,1,4,25.0,2,2,100.0,1,3,4,1,0,0,0,0,1,5
../kbl_data/2022-2023,S41G01N225,창원 LG,Home,정인덕,4,2,3,66.7,0,0,0.0,2,3,66.7,0,0,0.0,1,1,2,2,0,0,0,0,0,2
../kbl_data/2022-2023,S41G01N225,창원 LG,Home,윤원상,3,0,1,0.0,1,2,50.0,1,3,33.3,0,0,0.0,0,1,1,1,0,0,0,0,0,3
../kbl_data/2022-2023,S41G01N225,창원 LG,Home,아셈 마레이,13,5,10,50.0,0,0,0.0,5,10,50.0,3,5,60.0,5,11,16,3,2,0,0,0,0,0
../kbl_data/2022-2023,S41G01N225,창원 LG,Home,저스틴 구탕,2,1,5,20.0,0,0,0.0,1,5,20.0,0,0,0.0,0,2,2,1,1,0,0,0,2,1
../kbl_data/2022-2023,S41G01N225,창원 LG,Home,양준석,0,0,0,0.0,0,0,0.0,0,0,0.0,0,0,0.0,0,0,0,0,0,0,0,0,0,0
../kbl_data/2022-2023,S41G01N225,창원 LG,Home,단테 커닝햄,12,5,8,62.5,0,0,0.0,5,8,62.5,2,2,100.0,1,4,5,2,2,0,0,3,1,2
../kbl_data/2022-2023,S41G01N225,수원 KT,Away,김영환,6,1,4,25.0,1,2,50.0,2,6,33.3,1,1,100.0,0,1,1,2,0,0,0,0,1,3
../kbl_data/2022-2023,S41G01N225,수원 KT,Away,한희원,5,1,5,20.0,1,4,25.0,2,9,22.2,0,0,0.0,0,4,4,1,0,0,0,0,0,3
../kbl_data/2022-2023,S41G01N225,수원 KT,Away,최창진,0,0,0,0.0,0,0,0.0,0,0,0.0,0,0,0.0,0,0,0,0,0,0,0,0,0,0
../kbl_data/2022-2023,S41G01N225,수원 KT,Away,이현석,0,0,0,0.0,0,0,0.0,0,0,0.0,0,0,0.0,0,0,0,0,0,0,0,0,0,0
../kbl_data/2022-2023,S41G01N225,수원 KT,Away,최성모,3,0,0,0.0,1,2,50.0,1,2,50.0,0,0,0.0,0,0,0,0,0,0,0,0,0,2
../kbl_data/2022-2023,S41G01N225,수원 KT,Away,양홍석,4,1,7,14.3,0,2,0.0,1,9,11.1,2,2,100.0,0,5,5,2,2,1,0,0,1,0
../kbl_data/2022-2023,S41G01N225,수원 KT,Away,박지원,3,0,2,0.0,1,3,33.3,1,5,20.0,0,0,0.0,2,2,4,2,1,1,0,0,0,3
../kbl_data/2022-2023,S41G01N225,수원 KT,Away,하윤기,6,3,9,33.3,0,0,0.0,3,9,33.3,0,0,0.0,2,2,4,1,0,0,0,0,0,1
../kbl_data/2022-2023,S41G01N225,수원 KT,Away,이두원,6,2,5,40.0,0,0,0.0,2,5,40.0,2,4,50.0,2,2,4,0,0,1,0,0,0,0
../kbl_data/2022-2023,S41G01N225,수원 KT,Away,레스터 프로스퍼,7,2,3,66.7,1,3,33.3,3,6,50.0,0,0,0.0,2,3,5,1,0,0,0,0,2,2
../kbl_data/2022-2023,S41G01N225,수원 KT,Away,재로드 존스,20,4,8,50.0,3,6,50.0,7,14,50.0,3,5,60.0,2,5,7,3,2,1,0,0,0,2
../kbl_data/2022-2023,S41G01N225,수원 KT,Away,데이브 일데폰소,7,2,5,40.0,1,5,20.0,3,10,30.0,0,2,0.0,2,3,5,1,0,0,0,0,3,1
../kbl_data/2022-2023,S41G01N226,원주 DB,Home,박찬희,0,0,0,0.0,0,0,0.0,0,0,0.0,0,0,0.0,0,0,0,0,0,0,0,0,0,0
../kbl_data/2022-2023,S41G01N226,원주 DB,Home,김현호,4,1,3,33.3,0,1,0.0,1,4,25.0,2,2,100.0,1,0,1,1,0,0,0,0,4,5
../kbl_data/2022-2023,S41G01N226,원주 DB,Home,두경민,3,0,0,0.0,1,3,33.3,1,3,33.3,0,0,0.0,1,0,1,0,0,0,0,0,2,1
../kbl_data/2022-2023,S41G01N226,원주 DB,Home,김종규,21,7,14,50.0,1,1,100.0,8,15,53.3,4,6,66.7,4,5,9,2,0,0,0,3,0,5
../kbl_data/2022-2023,S41G01N226,원주 DB,Home,최승욱,4,0,3,0.0,1,2,50.0,1,5,20.0,1,2,50.0,1,3,4,1,1,1,0,0,1,3
../kbl_data/2022-2023,S41G01N226,원주 DB,Home,강상재,17,5,5,100.0,2,5,40.0,7,10,70.0,1,1,100.0,0,3,3,5,0,0,0,0,3,2
../kbl_data/2022-2023,S41G01N226,원주 DB,Home,윤성원,0,0,0,0.0,0,0,0.0,0,0,0.0,0,0,0.0,0,0,0,0,0,0,0,0,0,0
../kbl_data/2022-2023,S41G01N226,원주 DB,Home,레나드 프리먼,15,7,8,87.5,0,0,0.0,7,8,87.5,1,4,25.0,5,7,12,2,0,1,0,2,3,3
../kbl_data/2022-2023,S41G01N226,원주 DB,Home,정호영,5,1,2,50.0,1,1,100.0,2,3,66.7,0,0,0.0,2,1,3,4,2,0,0,0,0,2
../kbl_data/2022-2023,S41G01N226,원주 DB,Home,이민석,0,0,0,0.0,0,0,0.0,0,0,0.0,0,0,0.0,0,0,0,0,0,0,0,0,0,0
../kbl_data/2022-2023,S41G01N226,원주 DB,Home,이선 알바노,20,4,7,57.1,3,8,37.5,7,15,46.7,3,3,100.0,0,1,1,10,2,0,0,0,2,3
../kbl_data/2022-2023,S41G01N226,원주 DB,Home,디존 데이비스,2,1,1,100.0,0,0,0.0,1,1,100.0,0,0,0.0,0,1,1,1,0,0,0,0,2,1
../kbl_data/2022-2023,S41G01N226,고양 캐롯,Away,김강선,0,0,1,0.0,0,0,0.0,0,1,0.0,0,0,0.0,0,0,0,0,0,0,1,0,0,5
../kbl_data/2022-2023,S41G01N226,고양 캐롯,Away,최현민,8,1,3,33.3,2,7,28.6,3,10,30.0,0,0,0.0,1,1,2,2,2,0,1,0,0,2
../kbl_data/2022-2023,S41G01N226,고양 캐롯,Away,한호빈,8,1,1,100.0,1,1,100.0,2,2,100.0,3,3,100.0,0,0,0,0,1,0,0,0,2,2
../kbl_data/2022-2023,S41G01N226,고양 캐롯,Away,전성현,4,2,2,100.0,0,2,0.0,2,4,50.0,0,0,0.0,0,0,0,0,0,0,0,0,1,0
../kbl_data/2022-2023,S41G01N226,고양 캐롯,Away,김진유,0,0,1,0.0,0,0,0.0,0,1,0.0,0,0,0.0,0,0,0,1,2,0,0,0,0,3
../kbl_data/2022-2023,S41G01N226,고양 캐롯,Away,김진용,0,0,0,0.0,0,0,0.0,0,0,0.0,0,0,0.0,0,0,0,0,0,0,0,0,0,0
../kbl_data/2022-2023,S41G01N226,고양 캐롯,Away,조한진,14,3,3,100.0,2,5,40.0,5,8,62.5,2,2,100.0,0,3,3,1,1,0,0,0,0,3
../kbl_data/2022-2023,S41G01N226,고양 캐롯,Away,디드릭 로슨,38,13,18,72.2,3,5,60.0,16,23,69.6,3,4,75.0,6,8,14,3,0,0,0,0,2,0
../kbl_data/2022-2023,S41G01N226,고양 캐롯,Away,박진철,0,0,0,0.0,0,0,0.0,0,0,0.0,0,0,0.0,0,0,0,0,0,0,0,0,0,0
../kbl_data/2022-2023,S41G01N226,고양 캐롯,Away,이정현,17,4,6,66.7,1,5,20.0,5,11,45.5,6,7,85.7,1,1,2,6,4,0,1,0,2,3
../kbl_data/2022-2023,S41G01N226,고양 캐롯,Away,모리구치 히사시,0,0,0,0.0,0,0,0.0,0,0,0.0,0,0,0.0,0,0,0,0,0,0,0,0,0,0
../kbl_data/2022-2023,S41G01N226,고양 캐롯,Away,조나단 알렛지,7,0,3,0.0,1,2,50.0,1,5,20.0,4,6,66.7,1,1,2,0,0,0,0,0,1,2
../kbl_data/2022-2023,S41G01N227,서울 SK,Home,양우섭,3,0,0,0.0,1,1,100.0,1,1,100.0,0,0,0.0,0,2,2,1,1,0,0,0,0,0
../kbl_data/2022-2023,S41G01N227,서울 SK,Home,허일영,15,2,2,100.0,3,6,50.0,5,8,62.5,2,3,66.7,0,2,2,1,3,0,0,0,0,1
../kbl_data/2022-2023,S41G01N227,서울 SK,Home,송창용,0,0,0,0.0,0,0,0.0,0,0,0.0,0,0,0.0,0,0,0,0,1,0,0,0,0,0
../kbl_data/2022-2023,S41G01N227,서울 SK,Home,김선형,33,6,11,54.5,5,8,62.5,11,19,57.9,6,8,75.0,2,2,4,4,0,0,0,0,4,2
../kbl_data/2022-2023,S41G01N227,서울 SK,Home,홍경기,0,0,0,0.0,0,1,0.0,0,1,0.0,0,0,0.0,1,0,1,1,0,0,0,0,0,4
../kbl_data/2022-2023,S41G01N227,서울 SK,Home,최부경,10,5,7,71.4,0,0,0.0,5,7,71.4,0,0,0.0,1,3,4,0,1,0,0,1,1,3
../kbl_data/2022-2023,S41G01N227,서울 SK,Home,리온 윌리엄스,0,0,0,0.0,0,0,0.0,0,0,0.0,0,0,0.0,0,0,0,0,0,0,0,0,0,0
../kbl_data/2022-2023,S41G01N227,서울 SK,Home,최원혁,0,0,0,0.0,0,0,0.0,0,0,0.0,0,0,0.0,0,0,0,0,0,0,0,0,0,0
../kbl_data/2022-2023,S41G01N227,서울 SK,Home,자밀 워니,29,12,19,63.2,1,5,20.0,13,24,54.2,2,2,100.0,4,6,10,8,1,0,0,1,3,4
../kbl_data/2022-2023,S41G01N227,서울 SK,Home,오재현,4,1,3,33.3,0,1,0.0,1,4,25.0,2,2,100.0,2,4,6,4,2,0,0,0,1,3
../kbl_data/2022-2023,S41G01N227,서울 SK,Home,선상혁,0,0,1,0.0,0,0,0.0,0,1,0.0,0,0,0.0,0,1,1,0,0,0,0,0,0,1
../kbl_data/2022-2023,S41G01N227,서울 SK,Home,김수환,0,0,0,0.0,0,0,0.0,0,0,0.0,0,0,0.0,0,0,0,0,0,0,0,0,0,0
../kbl_data/2022-2023,S41G01N227,수원 KT,Away,김영환,0,0,0,0.0,0,0,0.0,0,0,0.0,0,0,0.0,0,0,0,1,0,0,0,0,2,0
../kbl_data/2022-2023,S41G01N227,수원 KT,Away,한희원,0,0,1,0.0,0,1,0.0,0,2,0.0,0,0,0.0,0,5,5,1,0,0,0,0,0,3
../kbl_data/2022-2023,S41G01N227,수원 KT,Away,이현석,0,0,0,0.0,0,0,0.0,0,0,0.0,0,0,0.0,0,0,0,0,0,0,0,0,0,0
../kbl_data/2022-2023,S41G01N227,수원 KT,Away,정성우,0,0,2,0.0,0,0,0.0,0,2,0.0,0,0,0.0,0,0,0,3,0,0,0,0,1,0
../kbl_data/2022-2023,S41G01N227,수원 KT,Away,최성모,3,1,3,33.3,0,1,0.0,1,4,25.0,1,2,50.0,0,3,3,3,1,0,1,0,0,2
../kbl_data/2022-2023,S41G01N227,수원 KT,Away,양홍석,18,3,6,50.0,4,9,44.4,7,15,46.7,0,0,0.0,2,5,7,2,0,1,0,0,1,4
../kbl_data/2022-2023,S41G01N227,수원 KT,Away,박지원,0,0,0,0.0,0,0,0.0,0,0,0.0,0,0,0.0,0,0,0,0,0,0,0,0,1,1
../kbl_data/2022-2023,S41G01N227,수원 KT,Away,하윤기,22,9,12,75.0,0,0,0.0,9,12,75.0,4,5,80.0,5,2,7,3,1,0,0,0,2,1
../kbl_data/2022-2023,S41G01N227,수원 KT,Away,이두원,0,0,0,0.0,0,0,0.0,0,0,0.0,0,0,0.0,0,0,0,0,0,0,0,0,0,1
../kbl_data/2022-2023,S41G01N227,수원 KT,Away,레스터 프로스퍼,2,1,3,33.3,0,0,0.0,1,3,33.3,0,0,0.0,0,1,1,0,0,1,0,0,0,1
../kbl_data/2022-2023,S41G01N227,수원 KT,Away,재로드 존스,29,7,11,63.6,4,5,80.0,11,16,68.8,3,3,100.0,2,4,6,6,1,1,0,0,4,1
../kbl_data/2022-2023,S41G01N227,수원 KT,Away,데이브 일데폰소,17,3,4,75.0,3,6,50.0,6,10,60.0,2,4,50.0,1,0,1,3,2,0,0,0,1,3
../kbl_data/2022-2023,S41G01N228,전주 KCC,Home,정창영,11,4,7,57.1,0,0,0.0,4,7,57.1,3,4,75.0,1,1,2,2,1,0,0,0,0,1
../kbl_data/2022-2023,S41G01N228,전주 KCC,Home,라건아,4,2,5,40.0,0,1,0.0,2,6,33.3,0,0,0.0,2,8,10,0,0,0,0,0,0,1
../kbl_data/2022-2023,S41G01N228,전주 KCC,Home,김상규,0,0,0,0.0,0,0,0.0,0,0,0.0,0,0,0.0,0,0,0,0,0,0,0,0,0,0
../kbl_data/2022-2023,S41G01N228,전주 KCC,Home,전준범,7,1,4,25.0,0,1,0.0,1,5,20.0,5,5,100.0,0,0,0,2,0,0,0,0,1,1
../kbl_data/2022-2023,S41G01N228,전주 KCC,Home,이승현,7,3,8,37.5,0,0,0.0,3,8,37.5,1,2,50.0,0,0,0,0,1,0,0,0,1,0
../kbl_data/2022-2023,S41G01N228,전주 KCC,Home,이종현,8,4,5,80.0,0,0,0.0,4,5,80.0,0,0,0.0,1,3,4,1,0,0,0,0,1,1
../kbl_data/2022-2023,S41G01N228,전주 KCC,Home,이진욱,0,0,1,0.0,0,0,0.0,0,1,0.0,0,2,0.0,0,0,0,0,0,0,1,0,0,0
../kbl_data/2022-2023,S41G01N228,전주 KCC,Home,이근휘,5,1,2,50.0,0,1,0.0,1,3,33.3,3,3,100.0,1,0,1,1,0,0,0,0,1,1
../kbl_data/2022-2023,S41G01N228,전주 KCC,Home,김동현,2,1,2,50.0,0,2,0.0,1,4,25.0,0,0,0.0,0,0,0,1,3,0,0,0,4,1
../kbl_data/2022-2023,S41G01N228,전주 KCC,Home,송동훈,4,2,4,50.0,0,0,0.0,2,4,50.0,0,2,0.0,1,0,1,1,1,0,0,0,1,5
../kbl_data/2022-2023,S41G01N228,전주 KCC,Home,칼빈 제프리 에피스톨라,2,0,3,0.0,0,3,0.0,0,6,0.0,2,2,100.0,0,3,3,0,0,0,0,0,3,2
../kbl_data/2022-2023,S41G01N228,전주 KCC,Home,디온 탐슨,7,3,6,50.0,0,2,0.0,3,8,37.5,1,2,50.0,0,5,5,2,0,0,0,1,2,5
../kbl_data/2022-2023,S41G01N228,창원 LG,Away,이관희,5,1,3,33.3,1,5,20.0,2,8,25.0,0,0,0.0,0,2,2,1,2,0,0,0,0,2
../kbl_data/2022-2023,S41G01N228,창원 LG,Away,정희재,8,1,1,100.0,2,2,100.0,3,3,100.0,0,0,0.0,0,1,1,0,0,0,0,0,0,3
../kbl_data/2022-2023,S41G01N228,창원 LG,Away,임동섭,2,1,1,100.0,0,0,0.0,1,1,100.0,0,0,0.0,0,0,0,0,1,0,0,0,2,2
../kbl_data/2022-2023,S41G01N228,창원 LG,Away,서민수,0,0,1,0.0,0,0,0.0,0,1,0.0,0,0,0.0,0,1,1,0,0,0,0,0,0,0
../kbl_data/2022-2023,S41G01N228,창원 LG,Away,이재도,13,3,8,37.5,2,8,25.0,5,16,31.2,1,1,100.0,2,2,4,5,1,0,0,0,2,2
../kbl_data/2022-2023,S41G01N228,창원 LG,Away,김준일,13,6,8,75.0,0,0,0.0,6,8,75.0,1,1,100.0,2,2,4,5,1,0,0,0,4,1
../kbl_data/2022-2023,S41G01N228,창원 LG,Away,정인덕,0,0,0,0.0,0,1,0.0,0,1,0.0,0,0,0.0,0,2,2,1,0,0,0,0,0,3
../kbl_data/2022-2023,S41G01N228,창원 LG,Away,윤원상,9,4,5,80.0,0,2,0.0,4,7,57.1,1,2,50.0,0,2,2,1,0,0,0,0,0,3
../kbl_data/2022-2023,S41G01N228,창원 LG,Away,아셈 마레이,20,9,12,75.0,0,1,0.0,9,13,69.2,2,5,40.0,5,8,13,2,5,0,0,0,0,2
../kbl_data/2022-2023,S41G01N228,창원 LG,Away,저스틴 구탕,5,2,3,66.7,0,1,0.0,2,4,50.0,1,2,50.0,1,5,6,1,1,0,0,1,2,0
../kbl_data/2022-2023,S41G01N228,창원 LG,Away,양준석,6,2,3,66.7,0,0,0.0,2,3,66.7,2,2,100.0,0,2,2,2,0,0,0,0,0,2
../kbl_data/2022-2023,S41G01N228,창원 LG,Away,단테 커닝햄,6,2,4,50.0,0,0,0.0,2,4,50.0,2,2,100.0,1,3,4,2,1,1,0,0,1,2
../kbl_data/2022-2023,S41G01N229,대구 한국가스공사,Home,차바위,7,0,0,0.0,2,6,33.3,2,6,33.3,1,2,50.0,0,3,3,3,2,0,0,0,2,2
../kbl_data/2022-2023,S41G01N229,대구 한국가스공사,Home,박지훈,0,0,0,0.0,0,0,0.0,0,0,0.0,0,0,0.0,0,0,0,0,0,0,0,0,0,0
../kbl_data/2022-2023,S41G01N229,대구 한국가스공사,Home,조상열,8,1,2,50.0,2,5,40.0,3,7,42.9,0,0,0.0,1,0,1,2,2,0,0,0,1,4
../kbl_data/2022-2023,S41G01N229,대구 한국가스공사,Home,이원대,0,0,0,0.0,0,0,0.0,0,0,0.0,0,0,0.0,0,0,0,0,0,0,0,0,0,0
../kbl_data/2022-2023,S41G01N229,대구 한국가스공사,Home,이대헌,15,3,4,75.0,2,4,50.0,5,8,62.5,3,5,60.0,3,3,6,2,1,0,0,0,1,2
../kbl_data/2022-2023,S41G01N229,대구 한국가스공사,Home,이대성,21,5,13,38.5,1,2,50.0,6,15,40.0,8,8,100.0,0,3,3,3,1,2,0,0,2,4
../kbl_data/2022-2023,S41G01N229,대구 한국가스공사,Home,머피 할로웨이,12,6,7,85.7,0,0,0.0,6,7,85.7,0,0,0.0,3,6,9,3,1,1,0,0,0,1
../kbl_data/2022-2023,S41G01N229,대구 한국가스공사,Home,전현우,5,1,2,50.0,1,5,20.0,2,7,28.6,0,0,0.0,3,0,3,0,0,0,0,0,0,1
../kbl_data/2022-2023,S41G01N229,대구 한국가스공사,Home,데본 스캇,12,5,8,62.5,0,0,0.0,5,8,62.5,2,2,100.0,5,7,12,0,0,1,0,2,2,3
../kbl_data/2022-2023,S41G01N229,대구 한국가스공사,Home,신승민,4,1,3,33.3,0,2,0.0,1,5,20.0,2,2,100.0,0,0,0,2,1,0,0,0,1,5
../kbl_data/2022-2023,S41G01N229,대구 한국가스공사,Home,샘조세프 벨란겔,2,1,1,100.0,0,2,0.0,1,3,33.3,0,0,0.0,0,0,0,1,0,0,0,0,2,1
../kbl_data/2022-2023,S41G01N229,대구 한국가스공사,Home,염유성,0,0,0,0.0,0,0,0.0,0,0,0.0,0,0,0.0,0,0,0,0,0,0,0,0,0,0
../kbl_data/2022-2023,S41G01N229,고양 캐롯,Away,김강선,4,1,3,33.3,0,3,0.0,1,6,16.7,2,2,100.0,3,2,5,1,4,0,2,0,1,3
../kbl_data/2022-2023,S41G01N229,고양 캐롯,Away,최현민,8,1,1,100.0,2,6,33.3,3,7,42.9,0,0,0.0,1,4,5,1,0,0,0,0,0,4
../kbl_data/2022-2023,S41G01N229,고양 캐롯,Away,한호빈,8,1,2,50.0,2,6,33.3,3,8,37.5,0,0,0.0,1,0,1,1,2,0,0,0,2,2
../kbl_data/2022-2023,S41G01N229,고양 캐롯,Away,전성현,5,1,3,33.3,1,6,16.7,2,9,22.2,0,0,0.0,0,0,0,3,0,0,0,0,3,2
../kbl_data/2022-2023,S41G01N229,고양 캐롯,Away,김진유,0,0,0,0.0,0,1,0.0,0,1,0.0,0,0,0.0,0,1,1,0,0,0,0,0,0,0
../kbl_data/2022-2023,S41G01N229,고양 캐롯,Away,김진용,2,1,2,50.0,0,0,0.0,1,2,50.0,0,0,0.0,3,0,3,0,0,0,0,0,2,1
../kbl_data/2022-2023,S41G01N229,고양 캐롯,Away,조한진,0,0,0,0.0,0,0,0.0,0,0,0.0,0,2,0.0,0,0,0,0,0,0,0,0,0,1
../kbl_data/2022-2023,S41G01N229,고양 캐롯,Away,디드릭 로슨,31,12,17,70.6,1,2,50.0,13,19,68.4,4,6,66.7,7,9,16,4,1,2,0,0,0,1
../kbl_data/2022-2023,S41G01N229,고양 캐롯,Away,박진철,0,0,0,0.0,0,0,0.0,0,0,0.0,0,0,0.0,1,0,1,1,0,0,0,0,0,2
../kbl_data/2022-2023,S41G01N229,고양 캐롯,Away,이정현,20,3,8,37.5,3,8,37.5,6,16,37.5,5,5,100.0,2,0,2,3,0,0,1,0,4,2
../kbl_data/2022-2023,S41G01N229,고양 캐롯,Away,모리구치 히사시,0,0,0,0.0,0,0,0.0,0,0,0.0,0,0,0.0,0,0,0,0,0,0,0,0,0,0
../kbl_data/2022-2023,S41G01N229,고양 캐롯,Away,조나단 알렛지,2,0,0,0.0,0,1,0.0,0,1,0.0,2,2,100.0,0,3,3,0,0,0,0,0,0,2
../kbl_data/2022-2023,S41G01N230,울산 현대모비스,Home,함지훈,14,3,6,50.0,1,1,100.0,4,7,57.1,5,6,83.3,0,3,3,1,1,0,0,0,0,1
../kbl_data/2022-2023,S41G01N230,울산 현대모비스,Home,김현민,0,0,0,0.0,0,1,0.0,0,1,0.0,0,0,0.0,0,0,0,0,0,0,0,0,0,0
../kbl_data/2022-2023,S41G01N230,울산 현대모비스,Home,최진수,6,3,4,75.0,0,3,0.0,3,7,42.9,0,0,0.0,0,7,7,2,1,0,0,0,1,2
../kbl_data/2022-2023,S41G01N230,울산 현대모비스,Home,김영현,4,0,1,0.0,1,3,33.3,1,4,25.0,1,2,50.0,0,0,0,1,0,0,0,0,0,2
../kbl_data/2022-2023,S41G01N230,울산 현대모비스,Home,김국찬,0,0,0,0.0,0,0,0.0,0,0,0.0,0,0,0.0,0,0,0,0,0,0,0,0,0,0
../kbl_data/2022-2023,S41G01N230,울산 현대모비스,Home,서명진,15,2,4,50.0,3,7,42.9,5,11,45.5,2,2,100.0,1,0,1,2,0,0,0,0,1,2
../kbl_data/2022-2023,S41G01N230,울산 현대모비스,Home,저스틴 녹스,4,2,3,66.7,0,0,0.0,2,3,66.7,0,0,0.0,1,4,5,0,0,0,0,0,1,0
../kbl_data/2022-2023,S41G01N230,울산 현대모비스,Home,신민석,2,1,2,50.0,0,4,0.0,1,6,16.7,0,0,0.0,1,1,2,0,2,0,0,0,0,1
../kbl_data/2022-2023,S41G01N230,울산 현대모비스,Home,김동준,0,0,1,0.0,0,0,0.0,0,1,0.0,0,0,0.0,0,0,0,0,0,0,0,0,1,1
../kbl_data/2022-2023,S41G01N230,울산 현대모비스,Home,론제이 아바리엔토스,13,2,3,66.7,3,9,33.3,5,12,41.7,0,0,0.0,0,3,3,5,1,0,0,0,0,2
../kbl_data/2022-2023,S41G01N230,울산 현대모비스,Home,게이지 프림,17,8,13,61.5,0,0,0.0,8,13,61.5,1,2,50.0,2,3,5,7,0,0,0,0,2,4
../kbl_data/2022-2023,S41G01N230,울산 현대모비스,Home,김태완,0,0,3,0.0,0,0,0.0,0,3,0.0,0,0,0.0,2,0,2,1,1,0,0,0,0,3
../kbl_data/2022-2023,S41G01N230,서울 SK,Away,양우섭,3,1,1,100.0,0,1,0.0,1,2,50.0,1,2,50.0,1,1,2,0,0,0,0,0,0,2
../kbl_data/2022-2023,S41G01N230,서울 SK,Away,허일영,11,2,3,66.7,2,3,66.7,4,6,66.7,1,2,50.0,1,4,5,0,0,0,0,0,1,1
../kbl_data/2022-2023,S41G01N230,서울 SK,Away,송창용,0,0,0,0.0,0,0,0.0,0,0,0.0,0,0,0.0,0,0,0,0,0,0,0,0,0,2
../kbl_data/2022-2023,S41G01N230,서울 SK,Away,김선형,22,7,11,63.6,0,2,0.0,7,13,53.8,8,9,88.9,0,2,2,12,0,3,0,0,3,3
../kbl_data/2022-2023,S41G01N230,서울 SK,Away,홍경기,0,0,0,0.0,0,1,0.0,0,1,0.0,0,0,0.0,0,0,0,0,0,0,0,0,0,1
../kbl_data/2022-2023,S41G01N230,서울 SK,Away,최부경,17,8,11,72.7,0,0,0.0,8,11,72.7,1,3,33.3,3,5,8,0,1,0,0,0,3,2
../kbl_data/2022-2023,S41G01N230,서울 SK,Away,리온 윌리엄스,0,0,1,0.0,0,0,0.0,0,1,0.0,0,0,0.0,0,3,3,0,0,0,0,0,0,2
../kbl_data/2022-2023,S41G01N230,서울 SK,Away,최원혁,0,0,0,0.0,0,2,0.0,0,2,0.0,0,0,0.0,0,0,0,1,0,0,0,0,0,3
../kbl_data/2022-2023,S41G01N230,서울 SK,Away,자밀 워니,25,11,18,61.1,0,0,0.0,11,18,61.1,3,4,75.0,0,13,13,4,1,1,0,1,2,2
../kbl_data/2022-2023,S41G01N230,서울 SK,Away,오재현,7,2,3,66.7,1,3,33.3,3,6,50.0,0,0,0.0,1,2,3,1,1,0,0,0,1,1
../kbl_data/2022-2023,S41G01N230,서울 SK,Away,선상혁,0,0,0,0.0,0,0,0.0,0,0,0.0,0,0,0.0,0,0,0,0,0,0,0,0,0,0
../kbl_data/2022-2023,S41G01N230,서울 SK,Away,김수환,0,0,0,0.0,0,0,0.0,0,0,0.0,0,0,0.0,0,0,0,0,0,0,0,0,0,0
../kbl_data/2022-2023,S41G01N231,서울 삼성,Home,이정현,14,3,6,50.0,1,5,20.0,4,11,36.4,5,6,83.3,0,1,1,5,1,0,0,0,4,3
../kbl_data/2022-2023,S41G01N231,서울 삼성,Home,장민국,10,2,5,40.0,2,2,100.0,4,7,57.1,0,0,0.0,1,4,5,2,1,0,0,0,2,1
../kbl_data/2022-2023,S41G01N231,서울 삼성,Home,김승원,3,1,2,50.0,0,0,0.0,1,2,50.0,1,2,50.0,0,4,4,0,0,0,0,0,0,2
../kbl_data/2022-2023,S41G01N231,서울 삼성,Home,김시래,13,2,4,50.0,2,5,40.0,4,9,44.4,3,4,75.0,1,1,2,5,2,0,1,0,0,3
../kbl_data/2022-2023,S41G01N231,서울 삼성,Home,이동엽,8,4,5,80.0,0,3,0.0,4,8,50.0,0,0,0.0,3,2,5,1,0,0,0,0,0,2
../kbl_data/2022-2023,S41G01N231,서울 삼성,Home,이호현,2,1,1,100.0,0,3,0.0,1,4,25.0,0,0,0.0,1,0,1,2,0,0,0,0,2,0
../kbl_data/2022-2023,S41G01N231,서울 삼성,Home,김광철,0,0,0,0.0,0,0,0.0,0,0,0.0,0,0,0.0,0,0,0,0,0,0,0,0,0,0
../kbl_data/2022-2023,S41G01N231,서울 삼성,Home,김무성,0,0,0,0.0,0,0,0.0,0,0,0.0,0,0,0.0,0,0,0,0,0,0,0,0,0,0
../kbl_data/2022-2023,S41G01N231,서울 삼성,Home,차민석,0,0,0,0.0,0,0,0.0,0,0,0.0,0,0,0.0,0,0,0,0,0,0,0,0,0,0
../kbl_data/2022-2023,S41G01N231,서울 삼성,Home,이원석,4,2,5,40.0,0,0,0.0,2,5,40.0,0,0,0.0,1,6,7,2,1,2,0,0,1,3
../kbl_data/2022-2023,S41G01N231,서울 삼성,Home,신동혁,5,1,1,100.0,1,2,50.0,2,3,66.7,0,0,0.0,0,1,1,1,1,0,0,0,1,3
../kbl_data/2022-2023,S41G01N231,서울 삼성,Home,앤서니 모스,23,7,15,46.7,0,0,0.0,7,15,46.7,9,10,90.0,4,8,12,1,0,1,0,0,4,3
../kbl_data/2022-2023,S41G01N231,안양 KGC,Away,양희종,0,0,0,0.0,0,0,0.0,0,0,0.0,0,0,0.0,0,0,0,0,0,0,0,0,0,2
../kbl_data/2022-2023,S41G01N231,안양 KGC,Away,오세근,6,2,6,33.3,0,1,0.0,2,7,28.6,2,2,100.0,0,1,1,2,0,0,0,0,2,4
../kbl_data/2022-2023,S41G01N231,안양 KGC,Away,정준원,0,0,0,0.0,0,0,0.0,0,0,0.0,0,0,0.0,0,0,0,0,0,0,0,0,0,0
../kbl_data/2022-2023,S41G01N231,안양 KGC,Away,배병준,0,0,1,0.0,0,0,0.0,0,1,0.0,0,0,0.0,0,0,0,0,0,0,0,0,0,1
../kbl_data/2022-2023,S41G01N231,안양 KGC,Away,문성곤,8,3,7,42.9,0,2,0.0,3,9,33.3,2,3,66.7,8,3,11,5,2,0,0,0,2,5
../kbl_data/2022-2023,S41G01N231,안양 KGC,Away,박지훈,2,0,2,0.0,0,0,0.0,0,2,0.0,2,3,66.7,0,2,2,0,0,0,0,0,0,1
../kbl_data/2022-2023,S41G01N231,안양 KGC,Away,이우정,0,0,0,0.0,0,0,0.0,0,0,0.0,0,0,0.0,0,0,0,0,0,0,0,0,0,0
../kbl_data/2022-2023,S41G01N231,안양 KGC,Away,대릴 먼로,20,9,20,45.0,0,2,0.0,9,22,40.9,2,3,66.7,5,6,11,6,4,1,0,1,0,1
../kbl_data/2022-2023,S41G01N231,안양 KGC,Away,변준형,13,5,8,62.5,1,5,20.0,6,13,46.2,0,1,0.0,2,2,4,2,1,1,3,0,3,2
../kbl_data/2022-2023,S41G01N231,안양 KGC,Away,김경원,0,0,0,0.0,0,0,0.0,0,0,0.0,0,0,0.0,0,0,0,0,0,0,0,0,0,0
../kbl_data/2022-2023,S41G01N231,안양 KGC,Away,한승희,2,1,5,20.0,0,0,0.0,1,5,20.0,0,0,0.0,3,0,3,0,0,1,0,0,1,3
../kbl_data/2022-2023,S41G01N231,안양 KGC,Away,렌즈 아반도,28,13,17,76.5,0,1,0.0,13,18,72.2,2,4,50.0,0,2,2,0,1,2,0,3,3,1
../kbl_data/2022-2023,S41G01N232,고양 캐롯,Home,김강선,8,1,1,100.0,2,3,66.7,3,4,75.0,0,0,0.0,0,1,1,1,0,0,0,0,0,1
../kbl_data/2022-2023,S41G01N232,고양 캐롯,Home,최현민,0,0,0,0.0,0,2,0.0,0,2,0.0,0,2,0.0,0,1,1,0,0,0,0,0,0,1
../kbl_data/2022-2023,S41G01N232,고양 캐롯,Home,한호빈,6,0,0,0.0,2,6,33.3,2,6,33.3,0,0,0.0,0,0,0,3,1,0,0,0,0,2
../kbl_data/2022-2023,S41G01N232,고양 캐롯,Home,전성현,18,5,7,71.4,2,5,40.0,7,12,58.3,2,2,100.0,0,1,1,1,2,0,0,0,1,1
../kbl_data/2022-2023,S41G01N232,고양 캐롯,Home,김진유,0,0,0,0.0,0,0,0.0,0,0,0.0,0,0,0.0,0,1,1,0,0,0,0,0,0,1
../kbl_data/2022-2023,S41G01N232,고양 캐롯,Home,김진용,8,4,5,80.0,0,0,0.0,4,5,80.0,0,0,0.0,1,5,6,1,0,1,0,0,0,2
../kbl_data/2022-2023,S41G01N232,고양 캐롯,Home,조한진,0,0,0,0.0,0,0,0.0,0,0,0.0,0,0,0.0,0,0,0,0,0,0,0,0,0,0
../kbl_data/2022-2023,S41G01N232,고양 캐롯,Home,디드릭 로슨,6,2,5,40.0,0,2,0.0,2,7,28.6,2,2,100.0,2,2,4,2,0,0,0,0,2,0
../kbl_data/2022-2023,S41G01N232,고양 캐롯,Home,박진철,6,3,3,100.0,0,0,0.0,3,3,100.0,0,1,0.0,2,4,6,0,0,0,0,0,0,3
../kbl_data/2022-2023,S41G01N232,고양 캐롯,Home,이정현,30,11,15,73.3,1,6,16.7,12,21,57.1,5,5,100.0,0,6,6,9,3,0,2,0,1,3
../kbl_data/2022-2023,S41G01N232,고양 캐롯,Home,모리구치 히사시,0,0,1,0.0,0,0,0.0,0,1,0.0,0,0,0.0,0,0,0,0,0,0,0,0,0,0
../kbl_data/2022-2023,S41G01N232,고양 캐롯,Home,조나단 알렛지,10,1,1,100.0,2,3,66.7,3,4,75.0,2,3,66.7,1,1,2,2,0,1,0,0,1,4
../kbl_data/2022-2023,S41G01N232,창원 LG,Away,이관희,20,4,9,44.4,4,11,36.4,8,20,40.0,0,0,0.0,0,1,1,3,0,0,0,0,1,1
../kbl_data/2022-2023,S41G01N232,창원 LG,Away,정희재,4,0,0,0.0,1,2,50.0,1,2,50.0,1,2,50.0,1,1,2,2,0,0,1,0,1,4
../kbl_data/2022-2023,S41G01N232,창원 LG,Away,임동섭,4,2,2,100.0,0,0,0.0,2,2,100.0,0,0,0.0,1,0,1,0,1,0,0,0,0,0
../kbl_data/2022-2023,S41G01N232,창원 LG,Away,서민수,0,0,0,0.0,0,0,0.0,0,0,0.0,0,0,0.0,0,0,0,0,0,0,0,0,0,0
../kbl_data/2022-2023,S41G01N232,창원 LG,Away,이재도,20,6,9,66.7,2,4,50.0,8,13,61.5,2,2,100.0,1,2,3,5,0,0,0,0,0,2
../kbl_data/2022-2023,S41G01N232,창원 LG,Away,김준일,8,2,5,40.0,0,0,0.0,2,5,40.0,4,4,100.0,0,4,4,0,0,0,0,0,1,2
../kbl_data/2022-2023,S41G01N232,창원 LG,Away,정인덕,0,0,0,0.0,0,0,0.0,0,0,0.0,0,0,0.0,0,0,0,0,0,0,0,0,0,1
../kbl_data/2022-2023,S41G01N232,창원 LG,Away,윤원상,5,0,0,0.0,1,5,20.0,1,5,20.0,2,2,100.0,0,1,1,0,0,0,0,0,0,1
../kbl_data/2022-2023,S41G01N232,창원 LG,Away,아셈 마레이,16,7,8,87.5,0,0,0.0,7,8,87.5,2,2,100.0,2,11,13,1,1,0,0,0,3,5
../kbl_data/2022-2023,S41G01N232,창원 LG,Away,저스틴 구탕,0,0,2,0.0,0,0,0.0,0,2,0.0,0,0,0.0,0,1,1,1,0,0,0,0,3,1
../kbl_data/2022-2023,S41G01N232,창원 LG,Away,양준석,0,0,1,0.0,0,1,0.0,0,2,0.0,0,0,0.0,1,0,1,1,0,0,0,0,1,0
../kbl_data/2022-2023,S41G01N232,창원 LG,Away,단테 커닝햄,6,2,3,66.7,0,1,0.0,2,4,50.0,2,2,100.0,3,3,6,2,1,0,0,0,2,2
../kbl_data/2022-2023,S41G01N233,전주 KCC,Home,정창영,13,4,8,50.0,0,0,0.0,4,8,50.0,5,5,100.0,0,3,3,8,2,1,0,0,0,3
../kbl_data/2022-2023,S41G01N233,전주 KCC,Home,라건아,21,6,13,46.2,1,2,50.0,7,15,46.7,6,8,75.0,6,8,14,2,0,1,0,0,0,0
../kbl_data/2022-2023,S41G01N233,전주 KCC,Home,박경상,5,1,3,33.3,1,3,33.3,2,6,33.3,0,0,0.0,0,2,2,2,1,0,1,0,0,0
../kbl_data/2022-2023,S41G01N233,전주 KCC,Home,김상규,6,1,2,50.0,1,2,50.0,2,4,50.0,1,2,50.0,1,1,2,0,0,0,0,0,1,3
../kbl_data/2022-2023,S41G01N233,전주 KCC,Home,전준범,12,3,4,75.0,2,4,50.0,5,8,62.5,0,0,0.0,0,5,5,1,0,1,0,0,2,4
../kbl_data/2022-2023,S41G01N233,전주 KCC,Home,이승현,2,1,7,14.3,0,0,0.0,1,7,14.3,0,0,0.0,3,4,7,4,0,0,0,0,1,1
../kbl_data/2022-2023,S41G01N233,전주 KCC,Home,이종현,0,0,1,0.0,0,0,0.0,0,1,0.0,0,0,0.0,0,2,2,0,0,1,0,0,0,0
../kbl_data/2022-2023,S41G01N233,전주 KCC,Home,이진욱,0,0,0,0.0,0,0,0.0,0,0,0.0,0,0,0.0,1,0,1,4,1,0,0,0,1,3
../kbl_data/2022-2023,S41G01N233,전주 KCC,Home,이근휘,12,0,0,0.0,4,7,57.1,4,7,57.1,0,0,0.0,0,0,0,1,1,1,0,0,1,2
../kbl_data/2022-2023,S41G01N233,전주 KCC,Home,김동현,0,0,0,0.0,0,0,0.0,0,0,0.0,0,0,0.0,0,1,1,0,0,0,0,0,0,0
../kbl_data/2022-2023,S41G01N233,전주 KCC,Home,송동훈,0,0,0,0.0,0,1,0.0,0,1,0.0,0,0,0.0,0,0,0,0,0,0,0,0,0,0
../kbl_data/2022-2023,S41G01N233,전주 KCC,Home,디온 탐슨,13,5,6,83.3,0,2,0.0,5,8,62.5,3,4,75.0,1,0,1,2,2,0,0,1,1,0
../kbl_data/2022-2023,S41G01N233,원주 DB,Away,박찬희,0,0,0,0.0,0,0,0.0,0,0,0.0,0,0,0.0,0,0,0,0,0,0,0,0,0,0
../kbl_data/2022-2023,S41G01N233,원주 DB,Away,김현호,3,0,2,0.0,1,5,20.0,1,7,14.3,0,0,0.0,0,3,3,4,1,0,0,0,2,3
../kbl_data/2022-2023,S41G01N233,원주 DB,Away,김종규,8,4,6,66.7,0,0,0.0,4,6,66.7,0,0,0.0,2,3,5,2,0,0,0,1,1,3
../kbl_data/2022-2023,S41G01N233,원주 DB,Away,최승욱,7,2,5,40.0,1,2,50.0,3,7,42.9,0,0,0.0,0,1,1,0,0,0,0,0,1,1
../kbl_data/2022-2023,S41G01N233,원주 DB,Away,강상재,0,0,3,0.0,0,4,0.0,0,7,0.0,0,0,0.0,1,6,7,1,1,1,0,0,0,1
../kbl_data/2022-2023,S41G01N233,원주 DB,Away,윤성원,0,0,0,0.0,0,1,0.0,0,1,0.0,0,0,0.0,0,0,0,0,0,0,0,0,0,0
../kbl_data/2022-2023,S41G01N233,원주 DB,Away,이윤수,2,1,1,100.0,0,0,0.0,1,1,100.0,0,0,0.0,1,1,2,0,0,0,0,0,0,2
../kbl_data/2022-2023,S41G01N233,원주 DB,Away,레나드 프리먼,11,5,10,50.0,0,0,0.0,5,10,50.0,1,2,50.0,5,7,12,1,1,0,0,1,1,3
../kbl_data/2022-2023,S41G01N233,원주 DB,Away,정호영,4,1,2,50.0,0,3,0.0,1,5,20.0,2,2,100.0,2,0,2,0,1,0,0,0,4,1
../kbl_data/2022-2023,S41G01N233,원주 DB,Away,이민석,0,0,0,0.0,0,0,0.0,0,0,0.0,0,0,0.0,0,0,0,0,0,0,0,0,0,0
../kbl_data/2022-2023,S41G01N233,원주 DB,Away,이선 알바노,13,2,5,40.0,3,6,50.0,5,11,45.5,0,0,0.0,0,1,1,7,0,0,0,0,0,4
../kbl_data/2022-2023,S41G01N233,원주 DB,Away,디존 데이비스,16,8,9,88.9,0,4,0.0,8,13,61.5,0,0,0.0,0,3,3,0,0,0,0,1,1,3
../kbl_data/2022-2023,S41G01N234,대구 한국가스공사,Home,차바위,3,0,0,0.0,1,1,100.0,1,1,100.0,0,0,0.0,0,4,4,1,1,0,0,0,1,1
../kbl_data/2022-2023,S41G01N234,대구 한국가스공사,Home,박지훈,0,0,1,0.0,0,1,0.0,0,2,0.0,0,0,0.0,0,0,0,0,0,0,0,0,0,1
../kbl_data/2022-2023,S41G01N234,대구 한국가스공사,Home,조상열,5,1,2,50.0,1,3,33.3,2,5,40.0,0,0,0.0,1,0,1,1,0,0,0,0,0,3
../kbl_data/2022-2023,S41G01N234,대구 한국가스공사,Home,이대헌,14,5,8,62.5,1,3,33.3,6,11,54.5,1,2,50.0,0,3,3,1,2,0,0,0,1,1
../kbl_data/2022-2023,S41G01N234,대구 한국가스공사,Home,이대성,15,5,11,45.5,0,4,0.0,5,15,33.3,5,6,83.3,1,2,3,8,1,0,0,0,2,2
../kbl_data/2022-2023,S41G01N234,대구 한국가스공사,Home,머피 할로웨이,3,1,4,25.0,0,0,0.0,1,4,25.0,1,2,50.0,5,5,10,2,1,0,0,0,0,2
../kbl_data/2022-2023,S41G01N234,대구 한국가스공사,Home,전현우,0,0,0,0.0,0,0,0.0,0,0,0.0,0,0,0.0,0,0,0,0,0,0,0,0,0,0
../kbl_data/2022-2023,S41G01N234,대구 한국가스공사,Home,박찬호,0,0,0,0.0,0,0,0.0,0,0,0.0,0,0,0.0,0,0,0,0,0,0,0,0,0,0
../kbl_data/2022-2023,S41G01N234,대구 한국가스공사,Home,데본 스캇,20,7,9,77.8,1,2,50.0,8,11,72.7,3,4,75.0,3,4,7,4,2,0,0,1,2,3
../kbl_data/2022-2023,S41G01N234,대구 한국가스공사,Home,신승민,15,1,1,100.0,4,10,40.0,5,11,45.5,1,2,50.0,0,1,1,2,0,0,0,0,1,2
../kbl_data/2022-2023,S41G01N234,대구 한국가스공사,Home,샘조세프 벨란겔,5,1,2,50.0,1,4,25.0,2,6,33.3,0,0,0.0,0,1,1,1,1,0,0,0,0,2
../kbl_data/2022-2023,S41G01N234,대구 한국가스공사,Home,염유성,3,0,0,0.0,1,5,20.0,1,5,20.0,0,0,0.0,1,1,2,4,2,0,0,0,0,4
../kbl_data/2022-2023,S41G01N234,수원 KT,Away,김영환,0,0,0,0.0,0,0,0.0,0,0,0.0,0,0,0.0,1,0,1,2,0,0,0,0,0,0
../kbl_data/2022-2023,S41G01N234,수원 KT,Away,한희원,0,0,0,0.0,0,1,0.0,0,1,0.0,0,0,0.0,1,1,2,0,0,0,0,0,1,1
../kbl_data/2022-2023,S41G01N234,수원 KT,Away,이현석,0,0,0,0.0,0,0,0.0,0,0,0.0,0,0,0.0,0,0,0,0,0,0,0,0,0,0
../kbl_data/2022-2023,S41G01N234,수원 KT,Away,정성우,5,1,2,50.0,1,2,50.0,2,4,50.0,0,0,0.0,0,0,0,4,1,0,0,0,1,2
../kbl_data/2022-2023,S41G01N234,수원 KT,Away,최성모,3,0,1,0.0,1,1,100.0,1,2,50.0,0,0,0.0,1,1,2,1,0,0,0,0,2,4
../kbl_data/2022-2023,S41G01N234,수원 KT,Away,양홍석,12,2,4,50.0,2,6,33.3,4,10,40.0,2,2,100.0,1,4,5,2,1,0,0,0,2,3
../kbl_data/2022-2023,S41G01N234,수원 KT,Away,박지원,0,0,0,0.0,0,0,0.0,0,0,0.0,0,0,0.0,0,0,0,0,0,0,0,0,0,0
../kbl_data/2022-2023,S41G01N234,수원 KT,Away,하윤기,24,10,12,83.3,0,0,0.0,10,12,83.3,4,6,66.7,1,8,9,2,0,0,0,1,3,3
../kbl_data/2022-2023,S41G01N234,수원 KT,Away,이두원,0,0,1,0.0,0,0,0.0,0,1,0.0,0,0,0.0,0,1,1,0,0,0,0,0,0,1
../kbl_data/2022-2023,S41G01N234,수원 KT,Away,레스터 프로스퍼,0,0,0,0.0,0,0,0.0,0,0,0.0,0,0,0.0,0,0,0,0,1,1,0,0,0,2
../kbl_data/2022-2023,S41G01N234,수원 KT,Away,재로드 존스,29,8,13,61.5,3,5,60.0,11,18,61.1,4,4,100.0,2,8,10,4,1,0,0,0,3,0
../kbl_data/2022-2023,S41G01N234,수원 KT,Away,데이브 일데폰소,13,2,5,40.0,3,6,50.0,5,11,45.5,0,1,0.0,1,1,2,4,0,0,0,0,3,1
../kbl_data/2022-2023,S41G01N235,전주 KCC,Home,정창영,4,1,3,33.3,0,3,0.0,1,6,16.7,2,2,100.0,2,3,5,6,1,1,0,0,0,3
../kbl_data/2022-2023,S41G01N235,전주 KCC,Home,라건아,22,8,15,53.3,1,4,25.0,9,19,47.4,3,3,100.0,2,6,8,1,0,1,0,0,2,2
../kbl_data/2022-2023,S41G01N235,전주 KCC,Home,박경상,0,0,0,0.0,0,1,0.0,0,1,0.0,0,0,0.0,0,1,1,0,0,0,0,0,1,1
../kbl_data/2022-2023,S41G01N235,전주 KCC,Home,김상규,0,0,0,0.0,0,0,0.0,0,0,0.0,0,0,0.0,0,0,0,0,0,0,0,0,0,0
../kbl_data/2022-2023,S41G01N235,전주 KCC,Home,이승현,18,6,11,54.5,1,2,50.0,7,13,53.8,3,6,50.0,1,5,6,4,2,1,0,0,2,1
../kbl_data/2022-2023,S41G01N235,전주 KCC,Home,이종현,2,1,3,33.3,0,0,0.0,1,3,33.3,0,0,0.0,0,1,1,1,0,0,0,0,0,1
../kbl_data/2022-2023,S41G01N235,전주 KCC,Home,이진욱,7,1,2,50.0,1,1,100.0,2,3,66.7,2,2,100.0,2,0,2,2,2,0,0,0,1,2
../kbl_data/2022-2023,S41G01N235,전주 KCC,Home,이근휘,6,0,3,0.0,2,2,100.0,2,5,40.0,0,0,0.0,0,0,0,0,0,0,0,0,0,2
../kbl_data/2022-2023,S41G01N235,전주 KCC,Home,김동현,13,2,3,66.7,1,2,50.0,3,5,60.0,6,6,100.0,0,2,2,1,5,0,1,0,0,4
../kbl_data/2022-2023,S41G01N235,전주 KCC,Home,송동훈,0,0,0,0.0,0,1,0.0,0,1,0.0,0,0,0.0,0,0,0,0,0,0,0,0,0,0
../kbl_data/2022-2023,S41G01N235,전주 KCC,Home,칼빈 제프리 에피스톨라,0,0,0,0.0,0,0,0.0,0,0,0.0,0,0,0.0,0,0,0,0,0,0,0,0,0,0
../kbl_data/2022-2023,S41G01N235,전주 KCC,Home,디온 탐슨,6,2,5,40.0,0,1,0.0,2,6,33.3,2,4,50.0,1,3,4,0,0,0,0,0,0,1
../kbl_data/2022-2023,S41G01N235,서울 삼성,Away,이정현,0,0,1,0.0,0,3,0.0,0,4,0.0,0,0,0.0,0,1,1,4,0,0,0,0,2,4
../kbl_data/2022-2023,S41G01N235,서울 삼성,Away,장민국,0,0,0,0.0,0,1,0.0,0,1,0.0,0,0,0.0,0,1,1,0,0,0,0,0,0,1
../kbl_data/2022-2023,S41G01N235,서울 삼성,Away,김승원,0,0,0,0.0,0,0,0.0,0,0,0.0,0,0,0.0,1,2,3,0,1,0,0,0,1,3
../kbl_data/2022-2023,S41G01N235,서울 삼성,Away,김시래,3,0,3,0.0,1,3,33.3,1,6,16.7,0,0,0.0,0,2,2,4,0,0,0,0,3,3
../kbl_data/2022-2023,S41G01N235,서울 삼성,Away,이동엽,22,3,6,50.0,5,6,83.3,8,12,66.7,1,1,100.0,0,4,4,3,1,1,0,0,2,1
../kbl_data/2022-2023,S41G01N235,서울 삼성,Away,이호현,11,2,5,40.0,1,3,33.3,3,8,37.5,4,4,100.0,1,3,4,2,0,0,0,0,2,2
../kbl_data/2022-2023,S41G01N235,서울 삼성,Away,최승욱,2,1,1,100.0,0,1,0.0,1,2,50.0,0,0,0.0,0,0,0,1,0,0,0,0,0,1
../kbl_data/2022-2023,S41G01N235,서울 삼성,Away,김무성,0,0,0,0.0,0,0,0.0,0,0,0.0,0,0,0.0,0,0,0,0,0,0,0,0,0,0
../kbl_data/2022-2023,S41G01N235,서울 삼성,Away,차민석,0,0,0,0.0,0,0,0.0,0,0,0.0,0,0,0.0,0,0,0,0,0,0,0,0,0,0
../kbl_data/2022-2023,S41G01N235,서울 삼성,Away,이원석,9,3,5,60.0,1,3,33.3,4,8,50.0,0,0,0.0,3,4,7,0,1,0,0,0,2,4
../kbl_data/2022-2023,S41G01N235,서울 삼성,Away,신동혁,8,1,5,20.0,2,3,66.7,3,8,37.5,0,0,0.0,0,2,2,0,0,0,0,0,0,2
../kbl_data/2022-2023,S41G01N235,서울 삼성,Away,앤서니 모스,20,8,14,57.1,0,0,0.0,8,14,57.1,4,4,100.0,6,9,15,1,1,1,0,0,3,2
../kbl_data/2022-2023,S41G01N236,서울 SK,Home,양우섭,2,1,2,50.0,0,1,0.0,1,3,33.3,0,0,0.0,1,1,2,0,0,0,0,0,0,0
../kbl_data/2022-2023,S41G01N236,서울 SK,Home,허일영,4,2,4,50.0,0,1,0.0,2,5,40.0,0,0,0.0,1,0,1,0,0,0,0,0,0,1
../kbl_data/2022-2023,S41G01N236,서울 SK,Home,송창용,5,1,3,33.3,1,4,25.0,2,7,28.6,0,0,0.0,0,0,0,0,0,1,0,0,0,1
../kbl_data/2022-2023,S41G01N236,서울 SK,Home,김선형,14,5,11,45.5,1,4,25.0,6,15,40.0,1,4,25.0,2,3,5,11,0,1,1,0,3,3
../kbl_data/2022-2023,S41G01N236,서울 SK,Home,홍경기,0,0,0,0.0,0,0,0.0,0,0,0.0,0,0,0.0,0,0,0,0,0,0,0,0,0,0
../kbl_data/2022-2023,S41G01N236,서울 SK,Home,리온 윌리엄스,4,2,3,66.7,0,0,0.0,2,3,66.7,0,0,0.0,0,0,0,0,1,0,0,0,0,0
../kbl_data/2022-2023,S41G01N236,서울 SK,Home,최원혁,0,0,0,0.0,0,1,0.0,0,1,0.0,0,0,0.0,0,1,1,0,2,0,0,0,0,2
../kbl_data/2022-2023,S41G01N236,서울 SK,Home,자밀 워니,26,11,21,52.4,0,1,0.0,11,22,50.0,4,7,57.1,4,10,14,4,4,1,0,0,3,0
../kbl_data/2022-2023,S41G01N236,서울 SK,Home,김형빈,0,0,1,0.0,0,0,0.0,0,1,0.0,0,0,0.0,2,3,5,0,0,0,0,0,0,3
../kbl_data/2022-2023,S41G01N236,서울 SK,Home,오재현,13,2,4,50.0,3,9,33.3,5,13,38.5,0,0,0.0,1,2,3,2,2,1,0,0,0,5
../kbl_data/2022-2023,S41G01N236,서울 SK,Home,선상혁,6,3,6,50.0,0,0,0.0,3,6,50.0,0,0,0.0,3,3,6,0,0,0,0,0,1,3
../kbl_data/2022-2023,S41G01N236,서울 SK,Home,김수환,0,0,0,0.0,0,0,0.0,0,0,0.0,0,0,0.0,0,0,0,0,0,0,0,0,0,0
../kbl_data/2022-2023,S41G01N236,안양 KGC,Away,양희종,0,0,1,0.0,0,1,0.0,0,2,0.0,0,0,0.0,1,1,2,1,0,0,0,0,1,1
../kbl_data/2022-2023,S41G01N236,안양 KGC,Away,오세근,16,7,12,58.3,0,2,0.0,7,14,50.0,2,3,66.7,2,8,10,4,1,0,0,0,3,2
../kbl_data/2022-2023,S41G01N236,안양 KGC,Away,정준원,0,0,0,0.0,0,0,0.0,0,0,0.0,0,0,0.0,0,0,0,0,0,0,0,0,0,0
../kbl_data/2022-2023,S41G01N236,안양 KGC,Away,문성곤,2,1,2,50.0,0,2,0.0,1,4,25.0,0,0,0.0,0,2,2,2,1,0,0,0,0,1
../kbl_data/2022-2023,S41G01N236,안양 KGC,Away,박지훈,6,1,2,50.0,1,1,100.0,2,3,66.7,1,2,50.0,2,0,2,0,1,1,0,0,0,3
../kbl_data/2022-2023,S41G01N236,안양 KGC,Away,이우정,0,0,0,0.0,0,0,0.0,0,0,0.0,0,0,0.0,0,0,0,0,0,0,0,0,0,0
../kbl_data/2022-2023,S41G01N236,안양 KGC,Away,대릴 먼로,18,4,15,26.7,3,6,50.0,7,21,33.3,1,1,100.0,2,11,13,7,1,0,0,0,2,2
../kbl_data/2022-2023,S41G01N236,안양 KGC,Away,변준형,14,4,7,57.1,1,5,20.0,5,12,41.7,3,3,100.0,3,3,6,3,0,0,0,0,6,3
../kbl_data/2022-2023,S41G01N236,안양 KGC,Away,김경원,0,0,0,0.0,0,0,0.0,0,0,0.0,0,0,0.0,0,0,0,0,0,0,0,0,0,0
../kbl_data/2022-2023,S41G01N236,안양 KGC,Away,한승희,0,0,0,0.0,0,0,0.0,0,0,0.0,0,0,0.0,0,0,0,0,0,0,0,0,0,0
../kbl_data/2022-2023,S41G01N236,안양 KGC,Away,렌즈 아반도,17,6,9,66.7,1,3,33.3,7,12,58.3,2,3,66.7,1,3,4,3,0,2,0,0,2,2
../kbl_data/2022-2023,S41G01N236,안양 KGC,Away,고찬혁,0,0,0,0.0,0,0,0.0,0,0,0.0,0,0,0.0,0,0,0,0,0,0,0,0,0,0
../kbl_data/2022-2023,S41G01N237,원주 DB,Home,박찬희,2,1,4,25.0,0,2,0.0,1,6,16.7,0,0,0.0,0,2,2,12,2,0,0,0,5,4
../kbl_data/2022-2023,S41G01N237,원주 DB,Home,김현호,9,4,5,80.0,0,1,0.0,4,6,66.7,1,1,100.0,1,2,3,4,0,0,0,0,0,4
../kbl_data/2022-2023,S41G01N237,원주 DB,Home,김종규,16,6,9,66.7,0,0,0.0,6,9,66.7,4,6,66.7,1,1,2,0,0,1,0,1,3,1
../kbl_data/2022-2023,S41G01N237,원주 DB,Home,최승욱,4,2,6,33.3,0,3,0.0,2,9,22.2,0,0,0.0,0,2,2,1,0,0,0,0,2,2
../kbl_data/2022-2023,S41G01N237,원주 DB,Home,강상재,8,4,6,66.7,0,1,0.0,4,7,57.1,0,0,0.0,0,1,1,0,0,0,0,0,2,1
../kbl_data/2022-2023,S41G01N237,원주 DB,Home,윤성원,0,0,0,0.0,0,0,0.0,0,0,0.0,0,0,0.0,0,0,0,0,0,0,0,0,0,0
../kbl_data/2022-2023,S41G01N237,원주 DB,Home,레나드 프리먼,14,5,9,55.6,0,0,0.0,5,9,55.6,4,6,66.7,1,10,11,1,1,0,0,1,0,1
../kbl_data/2022-2023,S41G01N237,원주 DB,Home,정호영,0,0,0,0.0,0,0,0.0,0,0,0.0,0,0,0.0,0,0,0,0,0,0,0,0,0,0
../kbl_data/2022-2023,S41G01N237,원주 DB,Home,이민석,0,0,1,0.0,0,1,0.0,0,2,0.0,0,0,0.0,0,0,0,1,1,0,0,0,0,0
../kbl_data/2022-2023,S41G01N237,원주 DB,Home,이선 알바노,6,1,4,25.0,1,4,25.0,2,8,25.0,1,2,50.0,0,3,3,3,1,0,0,0,1,3
../kbl_data/2022-2023,S41G01N237,원주 DB,Home,인승찬,0,0,0,0.0,0,0,0.0,0,0,0.0,0,0,0.0,0,0,0,0,0,0,0,0,0,0
../kbl_data/2022-2023,S41G01N237,원주 DB,Home,디존 데이비스,7,2,3,66.7,1,1,100.0,3,4,75.0,0,0,0.0,2,0,2,1,1,0,0,0,0,2
../kbl_data/2022-2023,S41G01N237,울산 현대모비스,Away,함지훈,0,0,0,0.0,0,0,0.0,0,0,0.0,0,0,0.0,0,0,0,0,0,0,0,0,0,0
../kbl_data/2022-2023,S41G01N237,울산 현대모비스,Away,김현민,0,0,0,0.0,0,1,0.0,0,1,0.0,0,0,0.0,0,2,2,0,0,0,0,0,0,0
../kbl_data/2022-2023,S41G01N237,울산 현대모비스,Away,최진수,13,4,6,66.7,1,4,25.0,5,10,50.0,2,2,100.0,0,4,4,2,0,1,0,0,0,2
../kbl_data/2022-2023,S41G01N237,울산 현대모비스,Away,김영현,3,0,0,0.0,1,2,50.0,1,2,50.0,0,0,0.0,0,1,1,0,0,0,0,0,1,0
../kbl_data/2022-2023,S41G01N237,울산 현대모비스,Away,김국찬,0,0,0,0.0,0,0,0.0,0,0,0.0,0,0,0.0,0,0,0,0,0,0,0,0,0,0
../kbl_data/2022-2023,S41G01N237,울산 현대모비스,Away,서명진,10,2,4,50.0,2,5,40.0,4,9,44.4,0,0,0.0,3,0,3,0,0,0,0,0,2,3
../kbl_data/2022-2023,S41G01N237,울산 현대모비스,Away,저스틴 녹스,6,3,4,75.0,0,2,0.0,3,6,50.0,0,0,0.0,1,1,2,1,1,0,0,1,2,2
../kbl_data/2022-2023,S41G01N237,울산 현대모비스,Away,신민석,11,3,6,50.0,1,4,25.0,4,10,40.0,2,2,100.0,2,8,10,1,3,0,0,0,1,3
../kbl_data/2022-2023,S41G01N237,울산 현대모비스,Away,김동준,0,0,1,0.0,0,1,0.0,0,2,0.0,0,0,0.0,0,0,0,2,0,0,0,0,0,2
../kbl_data/2022-2023,S41G01N237,울산 현대모비스,Away,론제이 아바리엔토스,22,3,3,100.0,4,7,57.1,7,10,70.0,4,4,100.0,0,5,5,6,2,1,0,0,1,2
../kbl_data/2022-2023,S41G01N237,울산 현대모비스,Away,게이지 프림,17,5,17,29.4,0,0,0.0,5,17,29.4,7,8,87.5,4,9,13,4,0,2,0,0,2,1
../kbl_data/2022-2023,S41G01N237,울산 현대모비스,Away,김태완,2,1,1,100.0,0,0,0.0,1,1,100.0,0,0,0.0,0,0,0,0,0,0,1,0,3,2
../kbl_data/2022-2023,S41G01N238,수원 KT,Home,김영환,0,0,0,0.0,0,0,0.0,0,0,0.0,0,0,0.0,0,0,0,0,0,0,0,0,0,0
../kbl_data/2022-2023,S41G01N238,수원 KT,Home,한희원,8,1,1,100.0,2,3,66.7,3,4,75.0,0,0,0.0,2,2,4,2,2,0,0,0,2,5
../kbl_data/2022-2023,S41G01N238,수원 KT,Home,이현석,0,0,0,0.0,0,0,0.0,0,0,0.0,0,0,0.0,0,0,0,0,0,0,0,0,0,0
../kbl_data/2022-2023,S41G01N238,수원 KT,Home,정성우,0,0,1,0.0,0,2,0.0,0,3,0.0,0,0,0.0,0,3,3,3,1,0,0,0,3,1
../kbl_data/2022-2023,S41G01N238,수원 KT,Home,최성모,2,0,1,0.0,0,1,0.0,0,2,0.0,2,4,50.0,1,1,2,1,0,0,0,0,0,2
../kbl_data/2022-2023,S41G01N238,수원 KT,Home,양홍석,14,2,6,33.3,2,6,33.3,4,12,33.3,4,5,80.0,2,6,8,4,1,0,0,0,1,1
../kbl_data/2022-2023,S41G01N238,수원 KT,Home,박지원,0,0,0,0.0,0,0,0.0,0,0,0.0,0,0,0.0,0,0,0,0,0,0,0,0,0,0
../kbl_data/2022-2023,S41G01N238,수원 KT,Home,하윤기,12,4,11,36.4,0,0,0.0,4,11,36.4,4,6,66.7,1,3,4,3,0,1,0,2,1,3
../kbl_data/2022-2023,S41G01N238,수원 KT,Home,이두원,0,0,2,0.0,0,0,0.0,0,2,0.0,0,0,0.0,0,1,1,0,0,0,0,0,0,0
../kbl_data/2022-2023,S41G01N238,수원 KT,Home,레스터 프로스퍼,2,1,2,50.0,0,2,0.0,1,4,25.0,0,0,0.0,0,1,1,0,0,1,0,0,0,1
../kbl_data/2022-2023,S41G01N238,수원 KT,Home,재로드 존스,32,9,11,81.8,3,7,42.9,12,18,66.7,5,5,100.0,2,8,10,2,1,1,0,1,3,3
../kbl_data/2022-2023,S41G01N238,수원 KT,Home,데이브 일데폰소,2,1,2,50.0,0,2,0.0,1,4,25.0,0,0,0.0,0,3,3,4,0,0,0,0,2,3
../kbl_data/2022-2023,S41G01N238,고양 캐롯,Away,김강선,5,2,2,100.0,0,2,0.0,2,4,50.0,1,1,100.0,0,3,3,0,0,0,0,0,0,2
../kbl_data/2022-2023,S41G01N238,고양 캐롯,Away,최현민,0,0,0,0.0,0,0,0.0,0,0,0.0,0,0,0.0,0,0,0,0,0,0,0,0,0,1
../kbl_data/2022-2023,S41G01N238,고양 캐롯,Away,한호빈,0,0,1,0.0,0,1,0.0,0,2,0.0,0,0,0.0,0,1,1,0,0,0,0,0,1,1
../kbl_data/2022-2023,S41G01N238,고양 캐롯,Away,전성현,24,5,6,83.3,3,7,42.9,8,13,61.5,5,5,100.0,0,3,3,1,1,0,0,0,2,0
../kbl_data/2022-2023,S41G01N238,고양 캐롯,Away,김진유,0,0,0,0.0,0,0,0.0,0,0,0.0,0,0,0.0,0,0,0,0,0,0,0,0,0,0
../kbl_data/2022-2023,S41G01N238,고양 캐롯,Away,김진용,2,1,2,50.0,0,0,0.0,1,2,50.0,0,0,0.0,0,2,2,0,0,0,0,0,0,2
../kbl_data/2022-2023,S41G01N238,고양 캐롯,Away,조한진,0,0,0,0.0,0,0,0.0,0,0,0.0,0,0,0.0,1,1,2,0,1,0,0,0,0,3
../kbl_data/2022-2023,S41G01N238,고양 캐롯,Away,디드릭 로슨,0,0,0,0.0,0,1,0.0,0,1,0.0,0,0,0.0,0,0,0,0,0,0,0,0,0,0
../kbl_data/2022-2023,S41G01N238,고양 캐롯,Away,박진철,2,1,2,50.0,0,1,0.0,1,3,33.3,0,0,0.0,2,2,4,1,1,0,0,0,2,5
../kbl_data/2022-2023,S41G01N238,고양 캐롯,Away,이정현,14,3,6,50.0,0,6,0.0,3,12,25.0,8,10,80.0,1,2,3,8,4,0,0,0,1,1
../kbl_data/2022-2023,S41G01N238,고양 캐롯,Away,모리구치 히사시,2,1,1,100.0,0,0,0.0,1,1,100.0,0,0,0.0,0,0,0,0,0,0,0,0,0,1
../kbl_data/2022-2023,S41G01N238,고양 캐롯,Away,조나단 알렛지,27,4,11,36.4,5,10,50.0,9,21,42.9,4,4,100.0,2,9,11,1,1,1,0,0,0,4
../kbl_data/2022-2023,S41G01N239,울산 현대모비스,Home,김현민,0,0,0,0.0,0,0,0.0,0,0,0.0,0,0,0.0,0,0,0,1,1,0,0,0,2,0
../kbl_data/2022-2023,S41G01N239,울산 현대모비스,Home,최진수,6,0,2,0.0,2,5,40.0,2,7,28.6,0,0,0.0,0,2,2,3,1,0,0,0,0,3
../kbl_data/2022-2023,S41G01N239,울산 현대모비스,Home,김영현,3,0,1,0.0,1,2,50.0,1,3,33.3,0,0,0.0,1,1,2,1,1,0,0,0,0,4
../kbl_data/2022-2023,S41G01N239,울산 현대모비스,Home,김국찬,2,1,1,100.0,0,0,0.0,1,1,100.0,0,0,0.0,0,1,1,0,0,0,0,0,0,1
../kbl_data/2022-2023,S41G01N239,울산 현대모비스,Home,서명진,17,4,6,66.7,3,5,60.0,7,11,63.6,0,1,0.0,1,1,2,1,0,0,0,0,3,3
../kbl_data/2022-2023,S41G01N239,울산 현대모비스,Home,박준은,0,0,0,0.0,0,0,0.0,0,0,0.0,0,0,0.0,0,0,0,0,0,0,0,0,0,0
../kbl_data/2022-2023,S41G01N239,울산 현대모비스,Home,저스틴 녹스,2,1,2,50.0,0,0,0.0,1,2,50.0,0,0,0.0,1,3,4,2,0,1,0,0,1,0
../kbl_data/2022-2023,S41G01N239,울산 현대모비스,Home,신민석,8,1,3,33.3,2,5,40.0,3,8,37.5,0,0,0.0,0,3,3,1,2,2,0,0,1,1
../kbl_data/2022-2023,S41G01N239,울산 현대모비스,Home,김동준,2,1,1,100.0,0,0,0.0,1,1,100.0,0,0,0.0,0,0,0,0,0,0,0,0,2,2
../kbl_data/2022-2023,S41G01N239,울산 현대모비스,Home,론제이 아바리엔토스,18,3,5,60.0,4,10,40.0,7,15,46.7,0,0,0.0,0,3,3,13,2,0,0,0,1,3
../kbl_data/2022-2023,S41G01N239,울산 현대모비스,Home,게이지 프림,24,10,16,62.5,0,1,0.0,10,17,58.8,4,5,80.0,4,6,10,1,1,1,0,0,1,1
../kbl_data/2022-2023,S41G01N239,울산 현대모비스,Home,김태완,4,0,0,0.0,1,1,100.0,1,1,100.0,1,2,50.0,1,1,2,0,0,0,0,0,0,0
../kbl_data/2022-2023,S41G01N239,대구 한국가스공사,Away,차바위,4,0,1,0.0,1,2,50.0,1,3,33.3,1,2,50.0,0,1,1,2,1,0,0,0,2,5
../kbl_data/2022-2023,S41G01N239,대구 한국가스공사,Away,박지훈,0,0,0,0.0,0,0,0.0,0,0,0.0,0,0,0.0,0,0,0,0,0,0,0,0,0,0
../kbl_data/2022-2023,S41G01N239,대구 한국가스공사,Away,조상열,2,1,1,100.0,0,3,0.0,1,4,25.0,0,0,0.0,3,0,3,2,0,0,0,0,2,4
../kbl_data/2022-2023,S41G01N239,대구 한국가스공사,Away,이대헌,13,4,9,44.4,1,3,33.3,5,12,41.7,2,2,100.0,3,3,6,0,2,0,0,0,1,1
../kbl_data/2022-2023,S41G01N239,대구 한국가스공사,Away,이대성,20,4,11,36.4,2,6,33.3,6,17,35.3,6,6,100.0,2,3,5,4,1,0,0,0,2,1
../kbl_data/2022-2023,S41G01N239,대구 한국가스공사,Away,머피 할로웨이,4,2,6,33.3,0,0,0.0,2,6,33.3,0,0,0.0,3,8,11,4,2,0,0,0,2,0
../kbl_data/2022-2023,S41G01N239,대구 한국가스공사,Away,전현우,0,0,0,0.0,0,0,0.0,0,0,0.0,0,0,0.0,0,0,0,0,0,0,0,0,0,0
../kbl_data/2022-2023,S41G01N239,대구 한국가스공사,Away,박찬호,0,0,0,0.0,0,0,0.0,0,0,0.0,0,0,0.0,0,0,0,0,0,0,0,0,0,0
../kbl_data/2022-2023,S41G01N239,대구 한국가스공사,Away,데본 스캇,14,7,14,50.0,0,0,0.0,7,14,50.0,0,2,0.0,4,5,9,3,1,2,0,2,2,1
../kbl_data/2022-2023,S41G01N239,대구 한국가스공사,Away,신승민,2,1,3,33.3,0,3,0.0,1,6,16.7,0,0,0.0,5,3,8,3,0,0,0,0,0,1
../kbl_data/2022-2023,S41G01N239,대구 한국가스공사,Away,샘조세프 벨란겔,12,4,6,66.7,1,3,33.3,5,9,55.6,1,1,100.0,0,0,0,0,2,0,0,0,2,1
../kbl_data/2022-2023,S41G01N239,대구 한국가스공사,Away,염유성,4,2,3,66.7,0,2,0.0,2,5,40.0,0,0,0.0,1,0,1,0,0,0,0,0,0,0
../kbl_data/2022-2023,S41G01N240,고양 캐롯,Home,김강선,2,1,2,50.0,0,1,0.0,1,3,33.3,0,0,0.0,0,2,2,1,1,0,0,0,2,2
../kbl_data/2022-2023,S41G01N240,고양 캐롯,Home,최현민,5,0,1,0.0,1,2,50.0,1,3,33.3,2,2,100.0,1,2,3,1,1,1,0,0,1,2
../kbl_data/2022-2023,S41G01N240,고양 캐롯,Home,임종일,2,1,1,100.0,0,1,0.0,1,2,50.0,0,0,0.0,2,0,2,2,0,0,0,0,0,1
../kbl_data/2022-2023,S41G01N240,고양 캐롯,Home,한호빈,8,1,1,100.0,2,7,28.6,3,8,37.5,0,0,0.0,0,0,0,4,1,1,0,0,0,0
../kbl_data/2022-2023,S41G01N240,고양 캐롯,Home,전성현,9,0,2,0.0,3,8,37.5,3,10,30.0,0,0,0.0,0,0,0,0,2,0,0,0,1,1
../kbl_data/2022-2023,S41G01N240,고양 캐롯,Home,김진유,2,1,3,33.3,0,2,0.0,1,5,20.0,0,0,0.0,1,3,4,0,1,0,0,0,0,2
../kbl_data/2022-2023,S41G01N240,고양 캐롯,Home,김진용,0,0,0,0.0,0,0,0.0,0,0,0.0,0,0,0.0,0,0,0,0,0,0,0,0,0,0
../kbl_data/2022-2023,S41G01N240,고양 캐롯,Home,조한진,2,1,2,50.0,0,6,0.0,1,8,12.5,0,0,0.0,0,3,3,0,0,0,1,0,0,1
../kbl_data/2022-2023,S41G01N240,고양 캐롯,Home,김세창,14,2,2,100.0,3,4,75.0,5,6,83.3,1,2,50.0,0,2,2,1,0,0,0,0,2,3
../kbl_data/2022-2023,S41G01N240,고양 캐롯,Home,박진철,9,4,7,57.1,0,0,0.0,4,7,57.1,1,2,50.0,7,1,8,3,0,1,0,1,1,4
../kbl_data/2022-2023,S41G01N240,고양 캐롯,Home,모리구치 히사시,2,1,1,100.0,0,0,0.0,1,1,100.0,0,0,0.0,0,0,0,0,0,0,0,0,0,1
../kbl_data/2022-2023,S41G01N240,고양 캐롯,Home,조나단 알렛지,12,2,6,33.3,2,11,18.2,4,17,23.5,2,2,100.0,1,8,9,5,2,0,0,1,1,3
../kbl_data/2022-2023,S41G01N240,전주 KCC,Away,정창영,6,1,4,25.0,0,3,0.0,1,7,14.3,4,4,100.0,0,4,4,4,1,0,0,0,1,0
../kbl_data/2022-2023,S41G01N240,전주 KCC,Away,라건아,17,8,11,72.7,0,1,0.0,8,12,66.7,1,3,33.3,4,6,10,2,0,1,0,1,3,1
../kbl_data/2022-2023,S41G01N240,전주 KCC,Away,박경상,7,1,1,100.0,1,3,33.3,2,4,50.0,2,2,100.0,0,2,2,1,2,0,0,0,1,2
../kbl_data/2022-2023,S41G01N240,전주 KCC,Away,김지완,0,0,0,0.0,0,1,0.0,0,1,0.0,0,0,0.0,0,1,1,3,0,0,0,0,0,1
../kbl_data/2022-2023,S41G01N240,전주 KCC,Away,김상규,0,0,1,0.0,0,0,0.0,0,1,0.0,0,0,0.0,1,0,1,0,0,0,0,0,0,0
../kbl_data/2022-2023,S41G01N240,전주 KCC,Away,전준범,0,0,1,0.0,0,0,0.0,0,1,0.0,0,0,0.0,0,2,2,2,1,0,0,0,1,2
../kbl_data/2022-2023,S41G01N240,전주 KCC,Away,이승현,3,0,4,0.0,0,0,0.0,0,4,0.0,3,8,37.5,3,10,13,3,1,1,0,0,0,2
../kbl_data/2022-2023,S41G01N240,전주 KCC,Away,이종현,0,0,0,0.0,0,0,0.0,0,0,0.0,0,0,0.0,0,0,0,0,0,0,0,0,0,0
../kbl_data/2022-2023,S41G01N240,전주 KCC,Away,이진욱,0,0,0,0.0,0,0,0.0,0,0,0.0,0,0,0.0,0,0,0,0,0,0,0,0,0,2
../kbl_data/2022-2023,S41G01N240,전주 KCC,Away,이근휘,17,0,1,0.0,5,9,55.6,5,10,50.0,2,2,100.0,1,1,2,1,0,0,0,0,2,1
../kbl_data/2022-2023,S41G01N240,전주 KCC,Away,김동현,5,1,2,50.0,1,6,16.7,2,8,25.0,0,0,0.0,0,2,2,0,0,0,0,0,1,3
../kbl_data/2022-2023,S41G01N240,전주 KCC,Away,디온 탐슨,21,9,12,75.0,0,1,0.0,9,13,69.2,3,3,100.0,1,3,4,0,1,1,0,0,1,0
../kbl_data/2022-2023,S41G01N241,서울 삼성,Home,이정현,10,1,5,20.0,2,7,28.6,3,12,25.0,2,2,100.0,0,4,4,2,0,1,0,0,4,3
../kbl_data/2022-2023,S41G01N241,서울 삼성,Home,장민국,0,0,0,0.0,0,0,0.0,0,0,0.0,0,0,0.0,0,0,0,0,0,0,0,0,0,0
../kbl_data/2022-2023,S41G01N241,서울 삼성,Home,김승원,0,0,1,0.0,0,0,0.0,0,1,0.0,0,0,0.0,1,0,1,0,0,0,0,0,0,0
../kbl_data/2022-2023,S41G01N241,서울 삼성,Home,김시래,6,0,7,0.0,2,4,50.0,2,11,18.2,0,0,0.0,0,0,0,1,0,0,0,0,0,2
../kbl_data/2022-2023,S41G01N241,서울 삼성,Home,이동엽,4,1,6,16.7,0,1,0.0,1,7,14.3,2,2,100.0,0,1,1,2,1,0,0,0,1,1
../kbl_data/2022-2023,S41G01N241,서울 삼성,Home,이호현,7,2,11,18.2,1,1,100.0,3,12,25.0,0,0,0.0,0,0,0,3,2,0,0,0,2,1
../kbl_data/2022-2023,S41G01N241,서울 삼성,Home,김광철,2,0,0,0.0,0,0,0.0,0,0,0.0,2,2,100.0,0,0,0,0,0,0,0,0,0,0
../kbl_data/2022-2023,S41G01N241,서울 삼성,Home,최승욱,0,0,0,0.0,0,1,0.0,0,1,0.0,0,0,0.0,0,0,0,0,0,0,1,0,0,0
../kbl_data/2022-2023,S41G01N241,서울 삼성,Home,차민석,5,2,3,66.7,0,1,0.0,2,4,50.0,1,1,100.0,1,0,1,1,1,0,0,0,0,2
../kbl_data/2022-2023,S41G01N241,서울 삼성,Home,이원석,6,3,7,42.9,0,2,0.0,3,9,33.3,0,0,0.0,2,1,3,1,1,0,0,0,0,5
../kbl_data/2022-2023,S41G01N241,서울 삼성,Home,신동혁,3,0,5,0.0,1,2,50.0,1,7,14.3,0,0,0.0,1,2,3,2,1,0,0,0,1,2
../kbl_data/2022-2023,S41G01N241,서울 삼성,Home,앤서니 모스,15,4,12,33.3,0,0,0.0,4,12,33.3,7,8,87.5,13,15,28,2,1,1,0,1,2,3
../kbl_data/2022-2023,S41G01N241,원주 DB,Away,박찬희,5,2,3,66.7,0,3,0.0,2,6,33.3,1,4,25.0,1,7,8,4,2,1,0,0,3,2
../kbl_data/2022-2023,S41G01N241,원주 DB,Away,김현호,5,1,4,25.0,0,1,0.0,1,5,20.0,3,3,100.0,1,1,2,2,1,0,0,0,0,2
../kbl_data/2022-2023,S41G01N241,원주 DB,Away,김종규,13,5,15,33.3,0,0,0.0,5,15,33.3,3,4,75.0,3,12,15,2,3,4,0,0,2,5
../kbl_data/2022-2023,S41G01N241,원주 DB,Away,강상재,8,2,4,50.0,1,2,50.0,3,6,50.0,1,2,50.0,1,1,2,1,0,0,0,0,0,2
../kbl_data/2022-2023,S41G01N241,원주 DB,Away,윤성원,0,0,0,0.0,0,0,0.0,0,0,0.0,0,0,0.0,0,0,0,0,0,1,0,0,0,0
../kbl_data/2022-2023,S41G01N241,원주 DB,Away,이준희,0,0,0,0.0,0,0,0.0,0,0,0.0,0,0,0.0,0,0,0,0,0,0,0,0,0,0
../kbl_data/2022-2023,S41G01N241,원주 DB,Away,레나드 프리먼,10,4,7,57.1,0,0,0.0,4,7,57.1,2,4,50.0,5,7,12,0,0,0,0,1,1,4
../kbl_data/2022-2023,S41G01N241,원주 DB,Away,정호영,15,7,9,77.8,0,2,0.0,7,11,63.6,1,2,50.0,2,1,3,2,0,2,0,1,2,1
../kbl_data/2022-2023,S41G01N241,원주 DB,Away,이민석,0,0,0,0.0,0,0,0.0,0,0,0.0,0,0,0.0,0,0,0,0,0,0,0,0,0,0
../kbl_data/2022-2023,S41G01N241,원주 DB,Away,이선 알바노,10,2,7,28.6,2,4,50.0,4,11,36.4,0,0,0.0,0,1,1,4,2,0,1,0,3,4
../kbl_data/2022-2023,S41G01N241,원주 DB,Away,김형준,0,0,0,0.0,0,0,0.0,0,0,0.0,0,0,0.0,0,0,0,0,0,0,0,0,0,0
../kbl_data/2022-2023,S41G01N241,원주 DB,Away,디존 데이비스,5,2,2,100.0,0,0,0.0,2,2,100.0,1,2,50.0,0,0,0,0,0,0,0,0,0,2
../kbl_data/2022-2023,S41G01N242,안양 KGC,Home,양희종,0,0,0,0.0,0,1,0.0,0,1,0.0,0,0,0.0,0,0,0,1,1,0,0,0,0,3
../kbl_data/2022-2023,S41G01N242,안양 KGC,Home,오세근,16,4,7,57.1,2,2,100.0,6,9,66.7,2,2,100.0,1,4,5,1,0,0,0,0,2,4
../kbl_data/2022-2023,S41G01N242,안양 KGC,Home,정준원,0,0,0,0.0,0,0,0.0,0,0,0.0,0,0,0.0,0,1,1,0,0,0,0,0,0,0
../kbl_data/2022-2023,S41G01N242,안양 KGC,Home,문성곤,9,0,1,0.0,2,4,50.0,2,5,40.0,3,4,75.0,3,6,9,3,1,1,0,0,3,2
../kbl_data/2022-2023,S41G01N242,안양 KGC,Home,박지훈,9,2,5,40.0,1,3,33.3,3,8,37.5,2,2,100.0,2,2,4,2,0,0,0,0,1,5
../kbl_data/2022-2023,S41G01N242,안양 KGC,Home,이우정,0,0,0,0.0,0,0,0.0,0,0,0.0,0,0,0.0,0,0,0,0,0,0,0,0,0,0
../kbl_data/2022-2023,S41G01N242,안양 KGC,Home,변준형,13,5,10,50.0,1,3,33.3,6,13,46.2,0,0,0.0,1,3,4,4,0,0,1,0,2,3
../kbl_data/2022-2023,S41G01N242,안양 KGC,Home,김경원,0,0,0,0.0,0,0,0.0,0,0,0.0,0,0,0.0,0,0,0,0,0,0,0,0,0,0
../kbl_data/2022-2023,S41G01N242,안양 KGC,Home,한승희,0,0,0,0.0,0,0,0.0,0,0,0.0,0,0,0.0,0,0,0,0,0,0,0,0,0,0
../kbl_data/2022-2023,S41G01N242,안양 KGC,Home,오마리 스펠맨,18,3,7,42.9,3,10,30.0,6,17,35.3,3,4,75.0,2,10,12,3,1,1,0,0,3,4
../kbl_data/2022-2023,S41G01N242,안양 KGC,Home,렌즈 아반도,10,2,5,40.0,1,4,25.0,3,9,33.3,3,4,75.0,0,1,1,1,0,1,0,1,2,1
../kbl_data/2022-2023,S41G01N242,안양 KGC,Home,고찬혁,0,0,0,0.0,0,0,0.0,0,0,0.0,0,0,0.0,0,0,0,0,0,0,0,0,0,0
../kbl_data/2022-2023,S41G01N242,창원 LG,Away,이관희,5,0,4,0.0,1,3,33.3,1,7,14.3,2,2,100.0,1,1,2,2,2,1,0,0,2,2
../kbl_data/2022-2023,S41G01N242,창원 LG,Away,정희재,11,1,1,100.0,3,5,60.0,4,6,66.7,0,0,0.0,1,2,3,3,0,0,0,0,0,3
../kbl_data/2022-2023,S41G01N242,창원 LG,Away,임동섭,4,0,0,0.0,1,2,50.0,1,2,50.0,1,2,50.0,2,1,3,0,0,0,0,0,0,2
../kbl_data/2022-2023,S41G01N242,창원 LG,Away,이재도,16,4,9,44.4,2,8,25.0,6,17,35.3,2,3,66.7,0,5,5,4,0,1,0,0,1,2
../kbl_data/2022-2023,S41G01N242,창원 LG,Away,김준일,2,1,4,25.0,0,0,0.0,1,4,25.0,0,0,0.0,1,4,5,1,0,0,0,0,0,2
../kbl_data/2022-2023,S41G01N242,창원 LG,Away,정인덕,2,1,1,100.0,0,1,0.0,1,2,50.0,0,0,0.0,0,0,0,0,1,1,0,0,0,1
../kbl_data/2022-2023,S41G01N242,창원 LG,Away,윤원상,4,2,2,100.0,0,2,0.0,2,4,50.0,0,0,0.0,1,1,2,1,0,0,0,0,1,3
../kbl_data/2022-2023,S41G01N242,창원 LG,Away,아셈 마레이,21,8,15,53.3,0,0,0.0,8,15,53.3,5,12,41.7,6,10,16,1,2,0,0,0,3,3
../kbl_data/2022-2023,S41G01N242,창원 LG,Away,이승우,0,0,0,0.0,0,0,0.0,0,0,0.0,0,0,0.0,0,0,0,0,0,0,0,0,0,0
../kbl_data/2022-2023,S41G01N242,창원 LG,Away,저스틴 구탕,9,4,5,80.0,0,1,0.0,4,6,66.7,1,1,100.0,0,1,1,1,2,0,0,1,0,2
../kbl_data/2022-2023,S41G01N242,창원 LG,Away,양준석,0,0,0,0.0,0,0,0.0,0,0,0.0,0,0,0.0,0,0,0,0,0,0,0,0,0,0
../kbl_data/2022-2023,S41G01N242,창원 LG,Away,단테 커닝햄,2,1,6,16.7,0,0,0.0,1,6,16.7,0,0,0.0,0,2,2,1,0,0,0,1,0,1
../kbl_data/2022-2023,S41G01N243,대구 한국가스공사,Home,차바위,2,0,2,0.0,0,1,0.0,0,3,0.0,2,2,100.0,1,2,3,1,1,0,1,0,3,3
../kbl_data/2022-2023,S41G01N243,대구 한국가스공사,Home,박지훈,0,0,0,0.0,0,0,0.0,0,0,0.0,0,0,0.0,0,0,0,0,0,0,0,0,0,0
../kbl_data/2022-2023,S41G01N243,대구 한국가스공사,Home,조상열,13,0,1,0.0,3,5,60.0,3,6,50.0,4,5,80.0,1,2,3,5,2,0,0,0,2,3
../kbl_data/2022-2023,S41G01N243,대구 한국가스공사,Home,이대헌,18,4,10,40.0,3,8,37.5,7,18,38.9,1,2,50.0,0,6,6,2,1,3,0,0,4,5
../kbl_data/2022-2023,S41G01N243,대구 한국가스공사,Home,이대성,39,11,16,68.8,4,9,44.4,15,25,60.0,5,5,100.0,3,6,9,5,3,0,0,0,2,1
../kbl_data/2022-2023,S41G01N243,대구 한국가스공사,Home,머피 할로웨이,18,8,13,61.5,0,1,0.0,8,14,57.1,2,2,100.0,4,12,16,6,0,0,0,1,4,5
../kbl_data/2022-2023,S41G01N243,대구 한국가스공사,Home,전현우,2,1,1,100.0,0,1,0.0,1,2,50.0,0,0,0.0,0,0,0,1,1,0,0,0,1,3
../kbl_data/2022-2023,S41G01N243,대구 한국가스공사,Home,양준우,0,0,0,0.0,0,0,0.0,0,0,0.0,0,0,0.0,0,0,0,0,0,0,0,0,0,0
../kbl_data/2022-2023,S41G01N243,대구 한국가스공사,Home,데본 스캇,12,6,7,85.7,0,1,0.0,6,8,75.0,0,0,0.0,2,6,8,2,1,0,0,2,0,3
../kbl_data/2022-2023,S41G01N243,대구 한국가스공사,Home,신승민,0,0,3,0.0,0,1,0.0,0,4,0.0,0,0,0.0,0,0,0,1,0,0,0,0,1,3
../kbl_data/2022-2023,S41G01N243,대구 한국가스공사,Home,샘조세프 벨란겔,1,0,1,0.0,0,1,0.0,0,2,0.0,1,2,50.0,1,0,1,0,0,0,0,0,0,1
../kbl_data/2022-2023,S41G01N243,대구 한국가스공사,Home,염유성,0,0,0,0.0,0,0,0.0,0,0,0.0,0,0,0.0,0,0,0,0,0,0,0,0,0,0
../kbl_data/2022-2023,S41G01N243,서울 SK,Away,양우섭,2,1,1,100.0,0,0,0.0,1,1,100.0,0,0,0.0,0,1,1,0,0,0,0,0,1,1
../kbl_data/2022-2023,S41G01N243,서울 SK,Away,허일영,10,2,5,40.0,1,3,33.3,3,8,37.5,3,5,60.0,1,2,3,2,1,0,0,0,1,2
../kbl_data/2022-2023,S41G01N243,서울 SK,Away,송창용,3,1,2,50.0,0,2,0.0,1,4,25.0,1,1,100.0,0,0,0,1,1,0,1,0,0,1
../kbl_data/2022-2023,S41G01N243,서울 SK,Away,김선형,20,6,13,46.2,1,7,14.3,7,20,35.0,5,7,71.4,1,6,7,12,2,0,0,0,7,3
../kbl_data/2022-2023,S41G01N243,서울 SK,Away,홍경기,0,0,0,0.0,0,0,0.0,0,0,0.0,0,0,0.0,0,0,0,0,0,0,0,0,0,0
../kbl_data/2022-2023,S41G01N243,서울 SK,Away,최부경,14,4,8,50.0,0,0,0.0,4,8,50.0,6,7,85.7,1,1,2,0,2,0,1,0,2,4
../kbl_data/2022-2023,S41G01N243,서울 SK,Away,리온 윌리엄스,0,0,0,0.0,0,0,0.0,0,0,0.0,0,0,0.0,0,0,0,0,0,0,0,0,0,0
../kbl_data/2022-2023,S41G01N243,서울 SK,Away,최원혁,17,2,3,66.7,4,7,57.1,6,10,60.0,1,1,100.0,0,2,2,2,2,0,0,0,0,4
../kbl_data/2022-2023,S41G01N243,서울 SK,Away,자밀 워니,30,11,19,57.9,0,0,0.0,11,19,57.9,8,11,72.7,5,11,16,7,4,1,0,1,1,0
../kbl_data/2022-2023,S41G01N243,서울 SK,Away,김형빈,4,2,3,66.7,0,0,0.0,2,3,66.7,0,0,0.0,0,3,3,0,0,0,0,0,0,1
../kbl_data/2022-2023,S41G01N243,서울 SK,Away,오재현,5,1,2,50.0,1,4,25.0,2,6,33.3,0,0,0.0,0,0,0,2,0,0,1,0,0,3
../kbl_data/2022-2023,S41G01N243,서울 SK,Away,선상혁,2,1,1,100.0,0,0,0.0,1,1,100.0,0,0,0.0,1,1,2,0,0,0,0,0,0,2
../kbl_data/2022-2023,S41G01N244,울산 현대모비스,Home,김현민,8,1,1,100.0,2,5,40.0,3,6,50.0,0,0,0.0,0,0,0,2,0,0,0,0,3,3
../kbl_data/2022-2023,S41G01N244,울산 현대모비스,Home,최진수,4,2,4,50.0,0,1,0.0,2,5,40.0,0,0,0.0,1,3,4,1,0,0,0,0,0,4
../kbl_data/2022-2023,S41G01N244,울산 현대모비스,Home,김영현,0,0,0,0.0,0,0,0.0,0,0,0.0,0,0,0.0,1,1,2,0,0,0,0,0,0,1
../kbl_data/2022-2023,S41G01N244,울산 현대모비스,Home,김국찬,0,0,0,0.0,0,0,0.0,0,0,0.0,0,0,0.0,0,0,0,0,0,0,0,0,0,0
../kbl_data/2022-2023,S41G01N244,울산 현대모비스,Home,서명진,13,2,5,40.0,3,7,42.9,5,12,41.7,0,0,0.0,0,2,2,4,2,1,0,0,1,3
../kbl_data/2022-2023,S41G01N244,울산 현대모비스,Home,저스틴 녹스,6,2,2,100.0,0,0,0.0,2,2,100.0,2,2,100.0,2,0,2,0,1,0,0,0,0,1
../kbl_data/2022-2023,S41G01N244,울산 현대모비스,Home,신민석,11,4,5,80.0,1,2,50.0,5,7,71.4,0,0,0.0,1,2,3,0,0,0,0,0,0,3
../kbl_data/2022-2023,S41G01N244,울산 현대모비스,Home,김동준,0,0,2,0.0,0,0,0.0,0,2,0.0,0,0,0.0,0,0,0,1,0,0,0,0,0,0
../kbl_data/2022-2023,S41G01N244,울산 현대모비스,Home,정종현,0,0,0,0.0,0,1,0.0,0,1,0.0,0,0,0.0,0,0,0,0,0,0,0,0,0,0
../kbl_data/2022-2023,S41G01N244,울산 현대모비스,Home,론제이 아바리엔토스,20,1,3,33.3,5,9,55.6,6,12,50.0,3,3,100.0,0,3,3,6,2,0,0,0,2,3
../kbl_data/2022-2023,S41G01N244,울산 현대모비스,Home,게이지 프림,17,7,14,50.0,0,0,0.0,7,14,50.0,3,4,75.0,3,7,10,5,4,0,0,0,1,3
../kbl_data/2022-2023,S41G01N244,울산 현대모비스,Home,김태완,0,0,1,0.0,0,1,0.0,0,2,0.0,0,0,0.0,0,1,1,0,0,0,0,0,0,1
../kbl_data/2022-2023,S41G01N244,전주 KCC,Away,정창영,4,2,6,33.3,0,2,0.0,2,8,25.0,0,0,0.0,0,5,5,5,0,0,0,0,2,1
../kbl_data/2022-2023,S41G01N244,전주 KCC,Away,라건아,21,6,7,85.7,2,5,40.0,8,12,66.7,3,3,100.0,2,5,7,3,1,2,0,0,2,2
../kbl_data/2022-2023,S41G01N244,전주 KCC,Away,박경상,0,0,1,0.0,0,2,0.0,0,3,0.0,0,0,0.0,1,0,1,1,0,0,0,0,0,1
../kbl_data/2022-2023,S41G01N244,전주 KCC,Away,김지완,0,0,1,0.0,0,4,0.0,0,5,0.0,0,0,0.0,1,1,2,2,1,0,0,0,1,3
../kbl_data/2022-2023,S41G01N244,전주 KCC,Away,전준범,0,0,0,0.0,0,1,0.0,0,1,0.0,0,0,0.0,0,1,1,0,0,0,0,0,1,0
../kbl_data/2022-2023,S41G01N244,전주 KCC,Away,이승현,21,8,13,61.5,0,1,0.0,8,14,57.1,5,6,83.3,2,3,5,2,0,0,0,0,1,1
../kbl_data/2022-2023,S41G01N244,전주 KCC,Away,이종현,2,1,2,50.0,0,0,0.0,1,2,50.0,0,0,0.0,1,0,1,1,0,0,0,0,3,0
../kbl_data/2022-2023,S41G01N244,전주 KCC,Away,이진욱,1,0,2,0.0,0,0,0.0,0,2,0.0,1,2,50.0,0,1,1,0,0,0,0,0,0,3
../kbl_data/2022-2023,S41G01N244,전주 KCC,Away,이근휘,0,0,0,0.0,0,2,0.0,0,2,0.0,0,0,0.0,0,1,1,0,0,0,1,0,0,0
../kbl_data/2022-2023,S41G01N244,전주 KCC,Away,김동현,5,1,3,33.3,0,2,0.0,1,5,20.0,3,3,100.0,1,6,7,3,0,0,2,0,2,2
../kbl_data/2022-2023,S41G01N244,전주 KCC,Away,송동훈,0,0,0,0.0,0,0,0.0,0,0,0.0,0,0,0.0,0,0,0,1,0,0,1,0,0,3
../kbl_data/2022-2023,S41G01N244,전주 KCC,Away,디온 탐슨,14,6,10,60.0,0,0,0.0,6,10,60.0,2,2,100.0,6,1,7,1,1,0,0,1,1,0
../kbl_data/2022-2023,S41G01N245,서울 삼성,Home,이정현,15,4,11,36.4,2,7,28.6,6,18,33.3,1,2,50.0,3,2,5,3,1,1,0,0,1,2
../kbl_data/2022-2023,S41G01N245,서울 삼성,Home,장민국,0,0,0,0.0,0,0,0.0,0,0,0.0,0,0,0.0,0,0,0,0,0,0,0,0,0,1
../kbl_data/2022-2023,S41G01N245,서울 삼성,Home,김승원,0,0,0,0.0,0,0,0.0,0,0,0.0,0,0,0.0,0,0,0,0,0,0,0,0,0,0
../kbl_data/2022-2023,S41G01N245,서울 삼성,Home,김시래,11,2,4,50.0,1,3,33.3,3,7,42.9,4,4,100.0,1,0,1,4,1,0,0,0,1,1
../kbl_data/2022-2023,S41G01N245,서울 삼성,Home,이동엽,11,1,2,50.0,3,5,60.0,4,7,57.1,0,2,0.0,0,4,4,1,0,0,0,0,2,4
../kbl_data/2022-2023,S41G01N245,서울 삼성,Home,이호현,4,2,5,40.0,0,1,0.0,2,6,33.3,0,0,0.0,0,3,3,4,0,0,0,0,2,4
../kbl_data/2022-2023,S41G01N245,서울 삼성,Home,최승욱,0,0,1,0.0,0,0,0.0,0,1,0.0,0,0,0.0,1,0,1,0,0,0,0,0,0,1
../kbl_data/2022-2023,S41G01N245,서울 삼성,Home,김무성,0,0,0,0.0,0,0,0.0,0,0,0.0,0,0,0.0,0,0,0,0,0,0,0,0,0,0
../kbl_data/2022-2023,S41G01N245,서울 삼성,Home,차민석,15,5,6,83.3,1,1,100.0,6,7,85.7,2,3,66.7,1,3,4,1,0,0,0,0,1,3
../kbl_data/2022-2023,S41G01N245,서울 삼성,Home,이원석,7,2,5,40.0,0,3,0.0,2,8,25.0,3,4,75.0,4,3,7,0,1,1,0,0,3,2
../kbl_data/2022-2023,S41G01N245,서울 삼성,Home,신동혁,2,1,2,50.0,0,1,0.0,1,3,33.3,0,0,0.0,0,0,0,0,0,0,0,0,1,1
../kbl_data/2022-2023,S41G01N245,서울 삼성,Home,앤서니 모스,11,5,7,71.4,0,0,0.0,5,7,71.4,1,1,100.0,5,8,13,1,0,2,0,0,1,3
../kbl_data/2022-2023,S41G01N245,창원 LG,Away,이관희,9,3,9,33.3,0,3,0.0,3,12,25.0,3,5,60.0,2,0,2,0,2,0,0,0,1,5
../kbl_data/2022-2023,S41G01N245,창원 LG,Away,정희재,17,2,3,66.7,4,4,100.0,6,7,85.7,1,2,50.0,2,1,3,4,0,0,1,0,1,2
../kbl_data/2022-2023,S41G01N245,창원 LG,Away,임동섭,0,0,0,0.0,0,1,0.0,0,1,0.0,0,0,0.0,0,1,1,0,0,0,0,0,0,3
../kbl_data/2022-2023,S41G01N245,창원 LG,Away,이재도,18,3,7,42.9,3,7,42.9,6,14,42.9,3,4,75.0,1,1,2,5,0,0,0,0,0,1
../kbl_data/2022-2023,S41G01N245,창원 LG,Away,김준일,0,0,2,0.0,0,0,0.0,0,2,0.0,0,0,0.0,0,1,1,1,1,0,0,0,1,1
../kbl_data/2022-2023,S41G01N245,창원 LG,Away,정인덕,5,1,1,100.0,1,2,50.0,2,3,66.7,0,0,0.0,0,0,0,1,1,1,0,0,0,0
../kbl_data/2022-2023,S41G01N245,창원 LG,Away,윤원상,2,1,1,100.0,0,3,0.0,1,4,25.0,0,0,0.0,0,1,1,0,1,0,0,0,1,0
../kbl_data/2022-2023,S41G01N245,창원 LG,Away,아셈 마레이,15,7,12,58.3,0,0,0.0,7,12,58.3,1,5,20.0,5,11,16,3,3,0,0,2,1,3
../kbl_data/2022-2023,S41G01N245,창원 LG,Away,이승우,0,0,0,0.0,0,0,0.0,0,0,0.0,0,0,0.0,0,0,0,0,0,0,0,0,0,0
../kbl_data/2022-2023,S41G01N245,창원 LG,Away,저스틴 구탕,0,0,1,0.0,0,0,0.0,0,1,0.0,0,2,0.0,0,1,1,0,0,0,0,0,1,0
../kbl_data/2022-2023,S41G01N245,창원 LG,Away,양준석,5,1,1,100.0,1,1,100.0,2,2,100.0,0,0,0.0,0,0,0,1,0,0,0,0,1,1
../kbl_data/2022-2023,S41G01N245,창원 LG,Away,단테 커닝햄,6,2,4,50.0,0,0,0.0,2,4,50.0,2,2,100.0,0,2,2,0,0,1,0,0,0,4
../kbl_data/2022-2023,S41G01N246,원주 DB,Home,박찬희,4,2,4,50.0,0,4,0.0,2,8,25.0,0,0,0.0,0,8,8,5,0,0,0,0,2,2
../kbl_data/2022-2023,S41G01N246,원주 DB,Home,김현호,7,2,5,40.0,1,3,33.3,3,8,37.5,0,0,0.0,1,0,1,2,1,0,0,0,0,3
../kbl_data/2022-2023,S41G01N246,원주 DB,Home,김종규,6,3,6,50.0,0,0,0.0,3,6,50.0,0,0,0.0,1,5,6,0,0,1,0,0,1,0
../kbl_data/2022-2023,S41G01N246,원주 DB,Home,강상재,12,5,6,83.3,0,2,0.0,5,8,62.5,2,4,50.0,3,9,12,4,0,0,0,0,5,4
../kbl_data/2022-2023,S41G01N246,원주 DB,Home,윤성원,2,1,2,50.0,0,0,0.0,1,2,50.0,0,0,0.0,1,1,2,0,0,0,0,0,0,0
../kbl_data/2022-2023,S41G01N246,원주 DB,Home,이준희,0,0,0,0.0,0,0,0.0,0,0,0.0,0,0,0.0,0,0,0,0,0,0,0,0,0,0
../kbl_data/2022-2023,S41G01N246,원주 DB,Home,레나드 프리먼,9,4,7,57.1,0,0,0.0,4,7,57.1,1,2,50.0,3,5,8,0,0,0,0,0,1,1
../kbl_data/2022-2023,S41G01N246,원주 DB,Home,정호영,4,1,2,50.0,0,2,0.0,1,4,25.0,2,5,40.0,1,3,4,2,0,0,0,0,0,2
../kbl_data/2022-2023,S41G01N246,원주 DB,Home,이민석,0,0,1,0.0,0,0,0.0,0,1,0.0,0,0,0.0,0,0,0,0,0,0,0,0,0,0
../kbl_data/2022-2023,S41G01N246,원주 DB,Home,이선 알바노,5,1,4,25.0,1,6,16.7,2,10,20.0,0,0,0.0,1,3,4,7,0,0,1,0,1,3
../kbl_data/2022-2023,S41G01N246,원주 DB,Home,김형준,0,0,0,0.0,0,0,0.0,0,0,0.0,0,0,0.0,0,1,1,0,0,0,0,0,0,0
../kbl_data/2022-2023,S41G01N246,원주 DB,Home,디존 데이비스,19,5,10,50.0,3,6,50.0,8,16,50.0,0,0,0.0,2,7,9,0,0,0,0,1,0,3
../kbl_data/2022-2023,S41G01N246,고양 캐롯,Away,김강선,0,0,0,0.0,0,1,0.0,0,1,0.0,0,0,0.0,0,2,2,0,0,0,0,0,0,0
../kbl_data/2022-2023,S41G01N246,고양 캐롯,Away,최현민,6,0,0,0.0,2,6,33.3,2,6,33.3,0,0,0.0,0,7,7,1,1,0,1,0,1,3
../kbl_data/2022-2023,S41G01N246,고양 캐롯,Away,임종일,0,0,2,0.0,0,1,0.0,0,3,0.0,0,0,0.0,0,2,2,1,0,0,0,0,0,0
../kbl_data/2022-2023,S41G01N246,고양 캐롯,Away,한호빈,10,2,4,50.0,1,3,33.3,3,7,42.9,3,4,75.0,1,4,5,6,2,0,0,0,1,3
../kbl_data/2022-2023,S41G01N246,고양 캐롯,Away,전성현,8,1,6,16.7,2,11,18.2,3,17,17.6,0,0,0.0,0,3,3,3,1,0,0,0,0,0
../kbl_data/2022-2023,S41G01N246,고양 캐롯,Away,김진유,0,0,1,0.0,0,0,0.0,0,1,0.0,0,0,0.0,0,1,1,0,0,0,0,0,0,1
../kbl_data/2022-2023,S41G01N246,고양 캐롯,Away,김진용,11,4,8,50.0,0,1,0.0,4,9,44.4,3,4,75.0,2,3,5,0,0,1,0,0,0,1
../kbl_data/2022-2023,S41G01N246,고양 캐롯,Away,조한진,0,0,0,0.0,0,4,0.0,0,4,0.0,0,0,0.0,5,2,7,0,1,0,0,0,0,2
../kbl_data/2022-2023,S41G01N246,고양 캐롯,Away,김세창,4,1,2,50.0,0,1,0.0,1,3,33.3,2,2,100.0,0,1,1,1,0,0,0,0,0,2
../kbl_data/2022-2023,S41G01N246,고양 캐롯,Away,박진철,0,0,0,0.0,0,0,0.0,0,0,0.0,0,0,0.0,0,0,0,0,1,0,0,0,0,0
../kbl_data/2022-2023,S41G01N246,고양 캐롯,Away,모리구치 히사시,0,0,1,0.0,0,1,0.0,0,2,0.0,0,0,0.0,0,1,1,0,0,0,0,0,0,0
../kbl_data/2022-2023,S41G01N246,고양 캐롯,Away,조나단 알렛지,18,3,9,33.3,2,10,20.0,5,19,26.3,6,6,100.0,1,4,5,2,0,3,0,0,0,4
../kbl_data/2022-2023,S41G01N247,안양 KGC,Home,양희종,6,0,0,0.0,2,4,50.0,2,4,50.0,0,0,0.0,0,1,1,1,0,0,0,0,1,3
../kbl_data/2022-2023,S41G01N247,안양 KGC,Home,오세근,7,3,6,50.0,0,1,0.0,3,7,42.9,1,2,50.0,1,7,8,2,1,0,0,0,0,3
../kbl_data/2022-2023,S41G01N247,안양 KGC,Home,정준원,11,3,4,75.0,1,4,25.0,4,8,50.0,2,2,100.0,2,2,4,1,0,0,0,0,0,1
../kbl_data/2022-2023,S41G01N247,안양 KGC,Home,문성곤,2,0,1,0.0,0,3,0.0,0,4,0.0,2,4,50.0,2,6,8,2,1,0,2,0,0,3
../kbl_data/2022-2023,S41G01N247,안양 KGC,Home,박지훈,6,3,7,42.9,0,4,0.0,3,11,27.3,0,0,0.0,1,1,2,6,2,0,0,0,1,2
../kbl_data/2022-2023,S41G01N247,안양 KGC,Home,이우정,0,0,0,0.0,0,0,0.0,0,0,0.0,0,0,0.0,0,0,0,0,0,0,0,0,0,0
../kbl_data/2022-2023,S41G01N247,안양 KGC,Home,변준형,7,2,4,50.0,1,4,25.0,3,8,37.5,0,0,0.0,2,1,3,2,3,0,1,0,2,0
../kbl_data/2022-2023,S41G01N247,안양 KGC,Home,김경원,0,0,0,0.0,0,0,0.0,0,0,0.0,0,0,0.0,0,0,0,0,0,0,0,0,0,0
../kbl_data/2022-2023,S41G01N247,안양 KGC,Home,한승희,0,0,0,0.0,0,0,0.0,0,0,0.0,0,0,0.0,0,0,0,0,0,0,0,0,0,0
../kbl_data/2022-2023,S41G01N247,안양 KGC,Home,오마리 스펠맨,29,11,17,64.7,1,11,9.1,12,28,42.9,4,6,66.7,5,4,9,2,1,1,0,6,1,2
../kbl_data/2022-2023,S41G01N247,안양 KGC,Home,렌즈 아반도,8,2,5,40.0,1,2,50.0,3,7,42.9,1,1,100.0,0,0,0,1,1,0,0,0,0,2
../kbl_data/2022-2023,S41G01N247,안양 KGC,Home,고찬혁,0,0,0,0.0,0,0,0.0,0,0,0.0,0,0,0.0,0,0,0,0,0,0,0,0,0,0
../kbl_data/2022-2023,S41G01N247,수원 KT,Away,김영환,0,0,0,0.0,0,0,0.0,0,0,0.0,0,0,0.0,0,0,0,0,0,0,0,0,0,0
../kbl_data/2022-2023,S41G01N247,수원 KT,Away,한희원,6,3,4,75.0,0,1,0.0,3,5,60.0,0,0,0.0,0,3,3,0,0,1,0,0,0,3
../kbl_data/2022-2023,S41G01N247,수원 KT,Away,이현석,0,0,0,0.0,0,0,0.0,0,0,0.0,0,0,0.0,1,1,2,1,0,0,0,0,1,1
../kbl_data/2022-2023,S41G01N247,수원 KT,Away,정성우,4,1,3,33.3,0,3,0.0,1,6,16.7,2,2,100.0,1,4,5,4,0,1,1,0,0,0
../kbl_data/2022-2023,S41G01N247,수원 KT,Away,최성모,2,1,1,100.0,0,1,0.0,1,2,50.0,0,0,0.0,0,0,0,1,0,0,0,0,0,3
../kbl_data/2022-2023,S41G01N247,수원 KT,Away,양홍석,6,1,5,20.0,0,0,0.0,1,5,20.0,4,4,100.0,3,2,5,4,0,0,0,0,3,2
../kbl_data/2022-2023,S41G01N247,수원 KT,Away,박지원,5,1,2,50.0,1,2,50.0,2,4,50.0,0,0,0.0,2,1,3,2,1,0,0,0,2,1
../kbl_data/2022-2023,S41G01N247,수원 KT,Away,하윤기,15,5,6,83.3,0,0,0.0,5,6,83.3,5,6,83.3,1,4,5,0,1,1,0,1,1,2
../kbl_data/2022-2023,S41G01N247,수원 KT,Away,이두원,0,0,1,0.0,0,0,0.0,0,1,0.0,0,0,0.0,0,0,0,0,0,0,0,0,1,1
../kbl_data/2022-2023,S41G01N247,수원 KT,Away,레스터 프로스퍼,2,1,1,100.0,0,1,0.0,1,2,50.0,0,0,0.0,0,2,2,0,0,0,0,0,0,0
../kbl_data/2022-2023,S41G01N247,수원 KT,Away,재로드 존스,25,6,13,46.2,3,10,30.0,9,23,39.1,4,4,100.0,2,11,13,2,1,1,0,1,5,3
../kbl_data/2022-2023,S41G01N247,수원 KT,Away,데이브 일데폰소,3,1,2,50.0,0,5,0.0,1,7,14.3,1,2,50.0,0,3,3,3,0,0,0,0,1,4
../kbl_data/2022-2023,S41G01N248,서울 삼성,Home,이정현,22,3,7,42.9,4,10,40.0,7,17,41.2,4,4,100.0,0,5,5,5,0,0,0,0,3,3
../kbl_data/2022-2023,S41G01N248,서울 삼성,Home,장민국,0,0,0,0.0,0,0,0.0,0,0,0.0,0,0,0.0,1,0,1,2,0,0,0,0,0,0
../kbl_data/2022-2023,S41G01N248,서울 삼성,Home,김승원,1,0,0,0.0,0,0,0.0,0,0,0.0,1,2,50.0,1,0,1,0,0,0,0,0,0,2
../kbl_data/2022-2023,S41G01N248,서울 삼성,Home,김시래,9,0,2,0.0,3,6,50.0,3,8,37.5,0,0,0.0,0,0,0,1,0,0,0,0,0,2
../kbl_data/2022-2023,S41G01N248,서울 삼성,Home,이동엽,2,1,5,20.0,0,0,0.0,1,5,20.0,0,0,0.0,0,3,3,3,0,0,0,0,0,1
../kbl_data/2022-2023,S41G01N248,서울 삼성,Home,이호현,13,5,8,62.5,1,1,100.0,6,9,66.7,0,0,0.0,1,2,3,2,1,0,1,0,1,2
../kbl_data/2022-2023,S41G01N248,서울 삼성,Home,김광철,0,0,0,0.0,0,0,0.0,0,0,0.0,0,0,0.0,0,0,0,0,0,0,0,0,0,1
../kbl_data/2022-2023,S41G01N248,서울 삼성,Home,김무성,0,0,0,0.0,0,0,0.0,0,0,0.0,0,0,0.0,0,0,0,0,0,0,0,0,0,0
../kbl_data/2022-2023,S41G01N248,서울 삼성,Home,차민석,0,0,1,0.0,0,1,0.0,0,2,0.0,0,0,0.0,0,2,2,1,0,0,0,0,0,0
../kbl_data/2022-2023,S41G01N248,서울 삼성,Home,이원석,10,4,6,66.7,0,1,0.0,4,7,57.1,2,2,100.0,1,5,6,1,0,0,0,0,1,4
../kbl_data/2022-2023,S41G01N248,서울 삼성,Home,신동혁,0,0,2,0.0,0,2,0.0,0,4,0.0,0,0,0.0,1,0,1,0,0,0,0,0,0,1
../kbl_data/2022-2023,S41G01N248,서울 삼성,Home,앤서니 모스,15,6,12,50.0,0,0,0.0,6,12,50.0,3,5,60.0,1,12,13,1,1,0,0,0,3,4
../kbl_data/2022-2023,S41G01N248,서울 SK,Away,양우섭,0,0,2,0.0,0,0,0.0,0,2,0.0,0,0,0.0,0,0,0,0,0,0,0,0,0,0
../kbl_data/2022-2023,S41G01N248,서울 SK,Away,허일영,10,5,8,62.5,0,0,0.0,5,8,62.5,0,0,0.0,3,4,7,1,2,1,0,0,0,3
../kbl_data/2022-2023,S41G01N248,서울 SK,Away,송창용,0,0,1,0.0,0,0,0.0,0,1,0.0,0,0,0.0,0,0,0,0,0,0,0,0,1,3
../kbl_data/2022-2023,S41G01N248,서울 SK,Away,김선형,19,6,12,50.0,2,7,28.6,8,19,42.1,1,5,20.0,0,2,2,3,3,0,0,0,2,4
../kbl_data/2022-2023,S41G01N248,서울 SK,Away,홍경기,0,0,0,0.0,0,0,0.0,0,0,0.0,0,0,0.0,0,0,0,0,0,0,0,0,0,0
../kbl_data/2022-2023,S41G01N248,서울 SK,Away,최부경,9,3,5,60.0,0,0,0.0,3,5,60.0,3,4,75.0,3,8,11,1,1,1,0,0,0,1
../kbl_data/2022-2023,S41G01N248,서울 SK,Away,리온 윌리엄스,8,3,3,100.0,0,0,0.0,3,3,100.0,2,4,50.0,3,3,6,2,0,0,0,0,0,1
../kbl_data/2022-2023,S41G01N248,서울 SK,Away,최원혁,0,0,1,0.0,0,1,0.0,0,2,0.0,0,0,0.0,0,2,2,2,0,1,0,0,0,3
../kbl_data/2022-2023,S41G01N248,서울 SK,Away,자밀 워니,26,11,24,45.8,0,2,0.0,11,26,42.3,4,8,50.0,5,6,11,3,0,1,0,1,0,2
../kbl_data/2022-2023,S41G01N248,서울 SK,Away,김형빈,4,1,1,100.0,0,1,0.0,1,2,50.0,2,2,100.0,1,1,2,0,0,0,0,0,0,2
../kbl_data/2022-2023,S41G01N248,서울 SK,Away,오재현,2,1,2,50.0,0,2,0.0,1,4,25.0,0,0,0.0,0,1,1,1,0,1,0,0,0,3
../kbl_data/2022-2023,S41G01N248,서울 SK,Away,선상혁,0,0,0,0.0,0,0,0.0,0,0,0.0,0,0,0.0,0,0,0,0,0,0,0,0,0,0
../kbl_data/2022-2023,S41G01N249,수원 KT,Home,김영환,0,0,0,0.0,0,0,0.0,0,0,0.0,0,0,0.0,0,0,0,0,0,0,0,0,0,0
../kbl_data/2022-2023,S41G01N249,수원 KT,Home,한희원,1,0,0,0.0,0,2,0.0,0,2,0.0,1,2,50.0,2,1,3,2,1,0,0,0,1,2
../kbl_data/2022-2023,S41G01N249,수원 KT,Home,이현석,3,0,0,0.0,1,2,50.0,1,2,50.0,0,0,0.0,1,2,3,0,1,0,0,0,1,2
../kbl_data/2022-2023,S41G01N249,수원 KT,Home,정성우,10,5,9,55.6,0,4,0.0,5,13,38.5,0,0,0.0,2,0,2,7,0,0,0,0,1,2
../kbl_data/2022-2023,S41G01N249,수원 KT,Home,최성모,0,0,1,0.0,0,0,0.0,0,1,0.0,0,0,0.0,0,0,0,1,2,0,0,0,1,0
../kbl_data/2022-2023,S41G01N249,수원 KT,Home,양홍석,13,2,4,50.0,2,7,28.6,4,11,36.4,3,3,100.0,0,3,3,4,2,0,0,0,0,1
../kbl_data/2022-2023,S41G01N249,수원 KT,Home,박지원,0,0,0,0.0,0,0,0.0,0,0,0.0,0,0,0.0,0,0,0,0,0,0,0,0,0,0
../kbl_data/2022-2023,S41G01N249,수원 KT,Home,하윤기,20,7,16,43.8,0,0,0.0,7,16,43.8,6,7,85.7,3,4,7,0,0,1,0,1,1,3
../kbl_data/2022-2023,S41G01N249,수원 KT,Home,이두원,0,0,0,0.0,0,0,0.0,0,0,0.0,0,0,0.0,0,0,0,0,0,0,0,0,0,0
../kbl_data/2022-2023,S41G01N249,수원 KT,Home,레스터 프로스퍼,6,3,5,60.0,0,2,0.0,3,7,42.9,0,0,0.0,0,4,4,0,1,1,0,0,0,2
../kbl_data/2022-2023,S41G01N249,수원 KT,Home,재로드 존스,21,5,10,50.0,3,7,42.9,8,17,47.1,2,2,100.0,1,8,9,0,1,0,1,0,1,2
../kbl_data/2022-2023,S41G01N249,수원 KT,Home,데이브 일데폰소,3,0,3,0.0,1,1,100.0,1,4,25.0,0,0,0.0,2,0,2,1,1,1,0,0,0,2
../kbl_data/2022-2023,S41G01N249,울산 현대모비스,Away,김현민,8,1,1,100.0,2,4,50.0,3,5,60.0,0,0,0.0,1,3,4,0,0,0,0,0,0,2
../kbl_data/2022-2023,S41G01N249,울산 현대모비스,Away,최진수,7,2,3,66.7,1,3,33.3,3,6,50.0,0,0,0.0,1,2,3,1,0,0,0,0,0,4
../kbl_data/2022-2023,S41G01N249,울산 현대모비스,Away,김영현,3,0,0,0.0,1,1,100.0,1,1,100.0,0,0,0.0,1,1,2,2,0,0,0,0,0,0
../kbl_data/2022-2023,S41G01N249,울산 현대모비스,Away,김국찬,3,0,0,0.0,1,1,100.0,1,1,100.0,0,0,0.0,0,0,0,0,0,0,0,0,0,2
../kbl_data/2022-2023,S41G01N249,울산 현대모비스,Away,서명진,13,2,7,28.6,3,5,60.0,5,12,41.7,0,0,0.0,1,4,5,1,1,0,0,0,1,1
../kbl_data/2022-2023,S41G01N249,울산 현대모비스,Away,저스틴 녹스,10,5,8,62.5,0,0,0.0,5,8,62.5,0,0,0.0,2,4,6,3,0,0,0,0,2,2
../kbl_data/2022-2023,S41G01N249,울산 현대모비스,Away,신민석,8,1,3,33.3,2,5,40.0,3,8,37.5,0,0,0.0,1,4,5,1,2,0,0,0,2,4
../kbl_data/2022-2023,S41G01N249,울산 현대모비스,Away,김동준,0,0,0,0.0,0,0,0.0,0,0,0.0,0,0,0.0,0,0,0,1,0,0,0,0,0,0
../kbl_data/2022-2023,S41G01N249,울산 현대모비스,Away,정종현,0,0,0,0.0,0,3,0.0,0,3,0.0,0,0,0.0,1,0,1,0,0,0,0,0,0,0
../kbl_data/2022-2023,S41G01N249,울산 현대모비스,Away,론제이 아바리엔토스,20,1,2,50.0,6,12,50.0,7,14,50.0,0,0,0.0,0,5,5,3,0,0,0,0,3,1
../kbl_data/2022-2023,S41G01N249,울산 현대모비스,Away,게이지 프림,20,7,10,70.0,1,1,100.0,8,11,72.7,3,5,60.0,1,7,8,3,0,0,0,0,4,3
../kbl_data/2022-2023,S41G01N249,울산 현대모비스,Away,김태완,0,0,0,0.0,0,0,0.0,0,0,0.0,0,0,0.0,1,1,2,4,1,0,0,0,1,1
../kbl_data/2022-2023,S41G01N250,창원 LG,Home,이관희,3,0,5,0.0,1,3,33.3,1,8,12.5,0,0,0.0,0,2,2,3,0,0,0,0,0,0
../kbl_data/2022-2023,S41G01N250,창원 LG,Home,정희재,2,1,1,100.0,0,1,0.0,1,2,50.0,0,0,0.0,1,1,2,1,0,0,0,0,1,3
../kbl_data/2022-2023,S41G01N250,창원 LG,Home,임동섭,0,0,0,0.0,0,1,0.0,0,1,0.0,0,0,0.0,0,2,2,0,0,0,0,0,0,1
../kbl_data/2022-2023,S41G01N250,창원 LG,Home,이재도,12,2,7,28.6,2,5,40.0,4,12,33.3,2,2,100.0,0,1,1,2,1,0,0,0,2,1
../kbl_data/2022-2023,S41G01N250,창원 LG,Home,김준일,5,2,8,25.0,0,0,0.0,2,8,25.0,1,1,100.0,2,0,2,0,1,0,0,0,0,3
../kbl_data/2022-2023,S41G01N250,창원 LG,Home,정인덕,0,0,1,0.0,0,0,0.0,0,1,0.0,0,0,0.0,1,1,2,3,1,0,0,0,0,3
../kbl_data/2022-2023,S41G01N250,창원 LG,Home,윤원상,9,4,5,80.0,0,1,0.0,4,6,66.7,1,1,100.0,1,1,2,0,0,0,0,0,0,4
../kbl_data/2022-2023,S41G01N250,창원 LG,Home,아셈 마레이,16,8,16,50.0,0,0,0.0,8,16,50.0,0,2,0.0,2,16,18,1,3,0,1,1,4,2
../kbl_data/2022-2023,S41G01N250,창원 LG,Home,이승우,0,0,0,0.0,0,0,0.0,0,0,0.0,0,0,0.0,0,0,0,0,0,0,0,0,0,0
../kbl_data/2022-2023,S41G01N250,창원 LG,Home,저스틴 구탕,0,0,2,0.0,0,0,0.0,0,2,0.0,0,0,0.0,0,0,0,0,0,0,0,0,1,0
../kbl_data/2022-2023,S41G01N250,창원 LG,Home,양준석,10,4,10,40.0,0,4,0.0,4,14,28.6,2,2,100.0,0,3,3,0,2,0,1,0,1,2
../kbl_data/2022-2023,S41G01N250,창원 LG,Home,단테 커닝햄,2,0,1,0.0,0,0,0.0,0,1,0.0,2,2,100.0,1,3,4,1,0,0,0,0,0,0
../kbl_data/2022-2023,S41G01N250,원주 DB,Away,박찬희,5,1,4,25.0,1,7,14.3,2,11,18.2,0,0,0.0,0,3,3,3,0,0,0,0,3,3
../kbl_data/2022-2023,S41G01N250,원주 DB,Away,김현호,6,0,4,0.0,2,9,22.2,2,13,15.4,0,0,0.0,3,4,7,0,0,0,0,0,3,4
../kbl_data/2022-2023,S41G01N250,원주 DB,Away,김종규,5,2,6,33.3,0,0,0.0,2,6,33.3,1,2,50.0,2,4,6,1,1,1,0,0,1,3
../kbl_data/2022-2023,S41G01N250,원주 DB,Away,강상재,3,1,4,25.0,0,1,0.0,1,5,20.0,1,2,50.0,3,6,9,1,0,0,0,0,2,2
../kbl_data/2022-2023,S41G01N250,원주 DB,Away,윤성원,0,0,0,0.0,0,0,0.0,0,0,0.0,0,0,0.0,0,0,0,0,0,0,0,0,0,0
../kbl_data/2022-2023,S41G01N250,원주 DB,Away,이준희,1,0,0,0.0,0,0,0.0,0,0,0.0,1,2,50.0,1,0,1,4,1,1,0,0,0,1
../kbl_data/2022-2023,S41G01N250,원주 DB,Away,레나드 프리먼,6,3,3,100.0,0,0,0.0,3,3,100.0,0,0,0.0,1,3,4,1,2,1,0,1,0,0
../kbl_data/2022-2023,S41G01N250,원주 DB,Away,정호영,0,0,1,0.0,0,1,0.0,0,2,0.0,0,0,0.0,0,0,0,1,0,0,0,0,0,2
../kbl_data/2022-2023,S41G01N250,원주 DB,Away,이민석,0,0,0,0.0,0,0,0.0,0,0,0.0,0,0,0.0,0,0,0,0,0,0,0,0,0,0
../kbl_data/2022-2023,S41G01N250,원주 DB,Away,이선 알바노,26,8,13,61.5,2,6,33.3,10,19,52.6,4,7,57.1,0,6,6,2,1,0,0,0,2,1
../kbl_data/2022-2023,S41G01N250,원주 DB,Away,김형준,0,0,0,0.0,0,0,0.0,0,0,0.0,0,0,0.0,0,0,0,0,0,0,0,0,0,0
../kbl_data/2022-2023,S41G01N250,원주 DB,Away,디존 데이비스,13,3,6,50.0,2,5,40.0,5,11,45.5,1,1,100.0,4,7,11,0,0,1,0,0,2,4
../kbl_data/2022-2023,S41G01N251,안양 KGC,Home,양희종,8,1,1,100.0,2,3,66.7,3,4,75.0,0,0,0.0,0,4,4,1,0,1,0,0,0,0
../kbl_data/2022-2023,S41G01N251,안양 KGC,Home,오세근,8,4,4,100.0,0,1,0.0,4,5,80.0,0,0,0.0,0,6,6,1,0,0,0,0,1,3
../kbl_data/2022-2023,S41G01N251,안양 KGC,Home,정준원,8,4,6,66.7,0,5,0.0,4,11,36.4,0,0,0.0,2,2,4,4,0,0,0,0,0,1
../kbl_data/2022-2023,S41G01N251,안양 KGC,Home,배병준,5,1,2,50.0,1,2,50.0,2,4,50.0,0,2,0.0,0,0,0,0,0,0,0,0,0,0
../kbl_data/2022-2023,S41G01N251,안양 KGC,Home,문성곤,9,0,0,0.0,3,5,60.0,3,5,60.0,0,0,0.0,2,3,5,0,1,0,0,0,1,1
../kbl_data/2022-2023,S41G01N251,안양 KGC,Home,박지훈,11,5,7,71.4,0,0,0.0,5,7,71.4,1,1,100.0,1,3,4,6,1,0,0,0,0,0
../kbl_data/2022-2023,S41G01N251,안양 KGC,Home,이우정,2,1,1,100.0,0,1,0.0,1,2,50.0,0,0,0.0,0,1,1,3,0,0,0,0,0,1
../kbl_data/2022-2023,S41G01N251,안양 KGC,Home,변준형,5,0,2,0.0,1,2,50.0,1,4,25.0,2,3,66.7,0,2,2,6,0,0,0,0,0,1
../kbl_data/2022-2023,S41G01N251,안양 KGC,Home,김경원,2,1,2,50.0,0,0,0.0,1,2,50.0,0,0,0.0,3,0,3,0,0,1,0,0,0,1
../kbl_data/2022-2023,S41G01N251,안양 KGC,Home,한승희,9,3,9,33.3,1,1,100.0,4,10,40.0,0,0,0.0,2,3,5,2,0,0,1,0,0,4
../kbl_data/2022-2023,S41G01N251,안양 KGC,Home,오마리 스펠맨,20,3,10,30.0,4,5,80.0,7,15,46.7,2,2,100.0,0,8,8,2,0,2,0,0,0,0
../kbl_data/2022-2023,S41G01N251,안양 KGC,Home,렌즈 아반도,11,3,3,100.0,1,1,100.0,4,4,100.0,2,2,100.0,0,1,1,1,0,0,0,1,2,2
../kbl_data/2022-2023,S41G01N251,전주 KCC,Away,정창영,5,1,2,50.0,1,2,50.0,2,4,50.0,0,0,0.0,0,1,1,1,0,0,0,0,0,0
../kbl_data/2022-2023,S41G01N251,전주 KCC,Away,라건아,16,6,9,66.7,1,2,50.0,7,11,63.6,1,1,100.0,2,4,6,1,0,0,0,0,0,0
../kbl_data/2022-2023,S41G01N251,전주 KCC,Away,박경상,0,0,0,0.0,0,0,0.0,0,0,0.0,0,0,0.0,0,0,0,0,0,0,0,0,0,0
../kbl_data/2022-2023,S41G01N251,전주 KCC,Away,김지완,12,0,2,0.0,4,7,57.1,4,9,44.4,0,2,0.0,0,1,1,6,0,0,0,0,0,2
../kbl_data/2022-2023,S41G01N251,전주 KCC,Away,전준범,14,1,3,33.3,4,7,57.1,5,10,50.0,0,0,0.0,0,4,4,2,0,0,0,0,0,2
../kbl_data/2022-2023,S41G01N251,전주 KCC,Away,이승현,4,2,6,33.3,0,0,0.0,2,6,33.3,0,0,0.0,0,0,0,1,2,0,0,0,0,0
../kbl_data/2022-2023,S41G01N251,전주 KCC,Away,이종현,7,2,5,40.0,0,0,0.0,2,5,40.0,3,4,75.0,0,4,4,3,0,0,0,0,0,0
../kbl_data/2022-2023,S41G01N251,전주 KCC,Away,이근휘,0,0,1,0.0,0,0,0.0,0,1,0.0,0,0,0.0,1,1,2,0,0,0,0,0,1,2
../kbl_data/2022-2023,S41G01N251,전주 KCC,Away,김동현,8,0,4,0.0,2,5,40.0,2,9,22.2,2,2,100.0,0,5,5,0,0,0,1,0,0,3
../kbl_data/2022-2023,S41G01N251,전주 KCC,Away,송동훈,0,0,0,0.0,0,1,0.0,0,1,0.0,0,0,0.0,0,0,0,2,0,0,0,0,0,2
../kbl_data/2022-2023,S41G01N251,전주 KCC,Away,칼빈 제프리 에피스톨라,1,0,0,0.0,0,3,0.0,0,3,0.0,1,2,50.0,0,0,0,4,0,0,0,0,2,2
../kbl_data/2022-2023,S41G01N251,전주 KCC,Away,디온 탐슨,7,2,6,33.3,1,2,50.0,3,8,37.5,0,0,0.0,2,2,4,2,0,1,0,0,1,1
../kbl_data/2022-2023,S41G01N252,울산 현대모비스,Home,김현민,0,0,0,0.0,0,0,0.0,0,0,0.0,0,0,0.0,0,0,0,0,0,0,0,0,0,0
../kbl_data/2022-2023,S41G01N252,울산 현대모비스,Home,최진수,18,5,6,83.3,1,2,50.0,6,8,75.0,5,7,71.4,1,2,3,3,1,1,0,0,1,0
../kbl_data/2022-2023,S41G01N252,울산 현대모비스,Home,김영현,6,0,1,0.0,2,5,40.0,2,6,33.3,0,0,0.0,0,0,0,1,1,0,0,0,0,5
../kbl_data/2022-2023,S41G01N252,울산 현대모비스,Home,김국찬,3,0,0,0.0,1,2,50.0,1,2,50.0,0,0,0.0,0,1,1,0,0,0,0,0,0,2
../kbl_data/2022-2023,S41G01N252,울산 현대모비스,Home,서명진,7,3,7,42.9,0,3,0.0,3,10,30.0,1,2,50.0,4,2,6,5,3,0,0,0,2,3
../kbl_data/2022-2023,S41G01N252,울산 현대모비스,Home,저스틴 녹스,17,6,13,46.2,0,0,0.0,6,13,46.2,5,8,62.5,5,7,12,3,1,0,0,0,1,3
../kbl_data/2022-2023,S41G01N252,울산 현대모비스,Home,신민석,13,2,2,100.0,3,7,42.9,5,9,55.6,0,0,0.0,3,8,11,3,2,1,0,0,2,2
../kbl_data/2022-2023,S41G01N252,울산 현대모비스,Home,김동준,5,1,3,33.3,1,2,50.0,2,5,40.0,0,0,0.0,1,0,1,2,0,0,0,0,2,1
../kbl_data/2022-2023,S41G01N252,울산 현대모비스,Home,정종현,2,0,2,0.0,0,0,0.0,0,2,0.0,2,2,100.0,0,0,0,0,0,0,0,0,0,0
../kbl_data/2022-2023,S41G01N252,울산 현대모비스,Home,론제이 아바리엔토스,17,0,1,0.0,5,10,50.0,5,11,45.5,2,2,100.0,2,3,5,6,0,0,0,0,1,1
../kbl_data/2022-2023,S41G01N252,울산 현대모비스,Home,게이지 프림,5,2,3,66.7,0,0,0.0,2,3,66.7,1,1,100.0,0,1,1,1,0,0,0,0,2,5
../kbl_data/2022-2023,S41G01N252,울산 현대모비스,Home,김태완,5,2,4,50.0,0,0,0.0,2,4,50.0,1,2,50.0,0,4,4,3,0,0,0,0,0,0
../kbl_data/2022-2023,S41G01N252,서울 삼성,Away,이정현,8,1,4,25.0,1,6,16.7,2,10,20.0,3,5,60.0,1,8,9,3,0,0,0,0,0,1
../kbl_data/2022-2023,S41G01N252,서울 삼성,Away,장민국,4,2,3,66.7,0,0,0.0,2,3,66.7,0,0,0.0,1,0,1,0,0,0,0,0,0,1
../kbl_data/2022-2023,S41G01N252,서울 삼성,Away,김승원,11,4,5,80.0,0,0,0.0,4,5,80.0,3,3,100.0,3,3,6,1,2,0,0,0,1,1
../kbl_data/2022-2023,S41G01N252,서울 삼성,Away,김시래,3,1,3,33.3,0,2,0.0,1,5,20.0,1,2,50.0,1,0,1,3,1,0,0,0,1,3
../kbl_data/2022-2023,S41G01N252,서울 삼성,Away,이동엽,3,0,3,0.0,0,5,0.0,0,8,0.0,3,4,75.0,1,4,5,2,0,0,0,0,0,1
../kbl_data/2022-2023,S41G01N252,서울 삼성,Away,이호현,12,2,4,50.0,2,2,100.0,4,6,66.7,2,2,100.0,0,3,3,3,0,0,0,0,3,1
../kbl_data/2022-2023,S41G01N252,서울 삼성,Away,김광철,0,0,0,0.0,0,1,0.0,0,1,0.0,0,0,0.0,0,0,0,1,0,0,0,0,0,0
../kbl_data/2022-2023,S41G01N252,서울 삼성,Away,김한솔,0,0,1,0.0,0,0,0.0,0,1,0.0,0,0,0.0,0,0,0,0,0,0,0,0,0,2
../kbl_data/2022-2023,S41G01N252,서울 삼성,Away,김무성,0,0,0,0.0,0,0,0.0,0,0,0.0,0,0,0.0,0,0,0,0,0,0,0,0,0,0
../kbl_data/2022-2023,S41G01N252,서울 삼성,Away,차민석,3,1,4,25.0,0,0,0.0,1,4,25.0,1,2,50.0,0,3,3,1,1,0,1,0,2,5
../kbl_data/2022-2023,S41G01N252,서울 삼성,Away,이원석,15,7,12,58.3,0,2,0.0,7,14,50.0,1,2,50.0,2,5,7,1,0,0,0,1,2,5
../kbl_data/2022-2023,S41G01N252,서울 삼성,Away,신동혁,21,4,6,66.7,4,6,66.7,8,12,66.7,1,2,50.0,0,1,1,2,0,0,0,0,0,1
../kbl_data/2022-2023,S41G01N253,서울 SK,Home,양우섭,2,1,1,100.0,0,2,0.0,1,3,33.3,0,0,0.0,0,0,0,1,1,0,0,0,1,1
../kbl_data/2022-2023,S41G01N253,서울 SK,Home,허일영,11,3,5,60.0,1,4,25.0,4,9,44.4,2,4,50.0,3,3,6,0,0,0,0,0,0,2
../kbl_data/2022-2023,S41G01N253,서울 SK,Home,송창용,2,0,0,0.0,0,0,0.0,0,0,0.0,2,2,100.0,0,1,1,0,0,0,0,0,0,1
../kbl_data/2022-2023,S41G01N253,서울 SK,Home,김선형,13,5,8,62.5,0,2,0.0,5,10,50.0,3,5,60.0,0,4,4,12,3,0,0,0,1,1
../kbl_data/2022-2023,S41G01N253,서울 SK,Home,홍경기,6,0,0,0.0,2,3,66.7,2,3,66.7,0,0,0.0,1,0,1,0,0,0,0,0,0,2
../kbl_data/2022-2023,S41G01N253,서울 SK,Home,최부경,8,3,5,60.0,0,0,0.0,3,5,60.0,2,2,100.0,0,6,6,0,0,0,1,0,1,3
../kbl_data/2022-2023,S41G01N253,서울 SK,Home,리온 윌리엄스,3,0,1,0.0,1,2,50.0,1,3,33.3,0,0,0.0,1,1,2,1,0,0,0,0,0,3
../kbl_data/2022-2023,S41G01N253,서울 SK,Home,최원혁,2,1,1,100.0,0,2,0.0,1,3,33.3,0,0,0.0,0,1,1,0,1,0,0,0,0,2
../kbl_data/2022-2023,S41G01N253,서울 SK,Home,자밀 워니,25,12,19,63.2,0,0,0.0,12,19,63.2,1,2,50.0,4,6,10,4,2,0,0,1,0,1
../kbl_data/2022-2023,S41G01N253,서울 SK,Home,김형빈,5,2,4,50.0,0,0,0.0,2,4,50.0,1,2,50.0,1,3,4,0,0,0,0,0,0,0
../kbl_data/2022-2023,S41G01N253,서울 SK,Home,오재현,11,3,5,60.0,1,7,14.3,4,12,33.3,2,6,33.3,2,5,7,3,0,0,0,0,1,4
../kbl_data/2022-2023,S41G01N253,서울 SK,Home,선상혁,0,0,0,0.0,0,0,0.0,0,0,0.0,0,0,0.0,0,1,1,0,0,0,0,0,0,0
../kbl_data/2022-2023,S41G01N253,고양 캐롯,Away,김강선,5,0,2,0.0,1,5,20.0,1,7,14.3,2,2,100.0,0,1,1,0,0,0,0,0,0,2
../kbl_data/2022-2023,S41G01N253,고양 캐롯,Away,최현민,5,1,1,100.0,1,5,20.0,2,6,33.3,0,0,0.0,0,1,1,0,0,0,0,0,0,0
../kbl_data/2022-2023,S41G01N253,고양 캐롯,Away,임종일,0,0,0,0.0,0,1,0.0,0,1,0.0,0,0,0.0,0,3,3,0,0,0,0,0,1,2
../kbl_data/2022-2023,S41G01N253,고양 캐롯,Away,김진유,0,0,0,0.0,0,2,0.0,0,2,0.0,0,0,0.0,2,5,7,1,1,0,1,0,2,4
../kbl_data/2022-2023,S41G01N253,고양 캐롯,Away,김진용,6,3,7,42.9,0,1,0.0,3,8,37.5,0,0,0.0,2,1,3,0,0,0,0,0,0,3
../kbl_data/2022-2023,S41G01N253,고양 캐롯,Away,정해원,0,0,0,0.0,0,0,0.0,0,0,0.0,0,0,0.0,0,0,0,0,0,0,0,0,0,0
../kbl_data/2022-2023,S41G01N253,고양 캐롯,Away,조한진,6,0,2,0.0,2,4,50.0,2,6,33.3,0,0,0.0,4,2,6,1,0,0,0,0,1,4
../kbl_data/2022-2023,S41G01N253,고양 캐롯,Away,김세창,0,0,0,0.0,0,0,0.0,0,0,0.0,0,0,0.0,0,0,0,4,0,0,0,0,0,1
../kbl_data/2022-2023,S41G01N253,고양 캐롯,Away,박진철,0,0,0,0.0,0,0,0.0,0,0,0.0,0,0,0.0,0,1,1,0,0,0,0,0,1,0
../kbl_data/2022-2023,S41G01N253,고양 캐롯,Away,이정현,23,3,8,37.5,3,10,30.0,6,18,33.3,8,9,88.9,0,3,3,4,0,0,1,0,1,1
../kbl_data/2022-2023,S41G01N253,고양 캐롯,Away,모리구치 히사시,3,0,1,0.0,1,1,100.0,1,2,50.0,0,0,0.0,0,1,1,0,0,0,0,0,2,1
../kbl_data/2022-2023,S41G01N253,고양 캐롯,Away,조나단 알렛지,25,7,9,77.8,2,7,28.6,9,16,56.2,5,7,71.4,2,7,9,1,1,0,0,0,2,5
../kbl_data/2022-2023,S41G01N254,창원 LG,Home,이관희,23,5,8,62.5,3,11,27.3,8,19,42.1,4,4,100.0,0,3,3,2,1,0,0,0,4,3
../kbl_data/2022-2023,S41G01N254,창원 LG,Home,정희재,4,0,1,0.0,0,1,0.0,0,2,0.0,4,4,100.0,3,2,5,0,2,0,0,0,2,2
../kbl_data/2022-2023,S41G01N254,창원 LG,Home,임동섭,4,0,0,0.0,1,5,20.0,1,5,20.0,1,2,50.0,0,3,3,0,1,1,0,0,0,2
../kbl_data/2022-2023,S41G01N254,창원 LG,Home,서민수,0,0,0,0.0,0,2,0.0,0,2,0.0,0,0,0.0,1,1,2,1,0,0,0,0,0,1
../kbl_data/2022-2023,S41G01N254,창원 LG,Home,이재도,24,3,8,37.5,4,7,57.1,7,15,46.7,6,7,85.7,2,1,3,4,2,0,0,0,1,3
../kbl_data/2022-2023,S41G01N254,창원 LG,Home,김준일,6,3,6,50.0,0,0,0.0,3,6,50.0,0,0,0.0,1,2,3,0,0,0,0,0,1,0
../kbl_data/2022-2023,S41G01N254,창원 LG,Home,정인덕,2,1,1,100.0,0,3,0.0,1,4,25.0,0,0,0.0,2,1,3,2,0,0,0,0,0,2
../kbl_data/2022-2023,S41G01N254,창원 LG,Home,윤원상,0,0,0,0.0,0,1,0.0,0,1,0.0,0,0,0.0,0,1,1,1,0,0,0,0,1,0
../kbl_data/2022-2023,S41G01N254,창원 LG,Home,아셈 마레이,18,7,7,100.0,0,0,0.0,7,7,100.0,4,9,44.4,4,12,16,3,2,0,0,0,0,4
../kbl_data/2022-2023,S41G01N254,창원 LG,Home,저스틴 구탕,0,0,0,0.0,0,0,0.0,0,0,0.0,0,0,0.0,0,0,0,1,0,0,0,0,0,0
../kbl_data/2022-2023,S41G01N254,창원 LG,Home,양준석,0,0,1,0.0,0,1,0.0,0,2,0.0,0,0,0.0,0,0,0,0,0,0,0,0,1,1
../kbl_data/2022-2023,S41G01N254,창원 LG,Home,단테 커닝햄,2,1,5,20.0,0,0,0.0,1,5,20.0,0,0,0.0,1,3,4,1,2,0,0,1,2,1
../kbl_data/2022-2023,S41G01N254,대구 한국가스공사,Away,차바위,0,0,1,0.0,0,1,0.0,0,2,0.0,0,0,0.0,0,5,5,3,0,0,0,0,0,1
../kbl_data/2022-2023,S41G01N254,대구 한국가스공사,Away,박지훈,0,0,0,0.0,0,0,0.0,0,0,0.0,0,0,0.0,0,0,0,0,0,0,0,0,0,0
../kbl_data/2022-2023,S41G01N254,대구 한국가스공사,Away,조상열,0,0,1,0.0,0,2,0.0,0,3,0.0,0,0,0.0,1,2,3,1,0,0,0,0,1,4
../kbl_data/2022-2023,S41G01N254,대구 한국가스공사,Away,이원대,0,0,0,0.0,0,0,0.0,0,0,0.0,0,0,0.0,0,0,0,0,0,0,0,0,0,0
../kbl_data/2022-2023,S41G01N254,대구 한국가스공사,Away,이대헌,21,5,10,50.0,3,4,75.0,8,14,57.1,2,2,100.0,0,1,1,2,0,0,0,0,1,5
../kbl_data/2022-2023,S41G01N254,대구 한국가스공사,Away,이대성,12,3,8,37.5,1,3,33.3,4,11,36.4,3,3,100.0,0,0,0,6,2,0,0,0,1,1
../kbl_data/2022-2023,S41G01N254,대구 한국가스공사,Away,머피 할로웨이,16,7,12,58.3,0,0,0.0,7,12,58.3,2,2,100.0,4,9,13,0,2,0,0,0,1,1
../kbl_data/2022-2023,S41G01N254,대구 한국가스공사,Away,전현우,4,1,1,100.0,0,1,0.0,1,2,50.0,2,2,100.0,1,0,1,1,0,0,0,0,0,3
../kbl_data/2022-2023,S41G01N254,대구 한국가스공사,Away,데본 스캇,17,7,10,70.0,0,0,0.0,7,10,70.0,3,5,60.0,3,6,9,2,1,1,0,0,3,3
../kbl_data/2022-2023,S41G01N254,대구 한국가스공사,Away,신승민,0,0,2,0.0,0,2,0.0,0,4,0.0,0,0,0.0,0,2,2,0,1,1,0,0,1,0
../kbl_data/2022-2023,S41G01N254,대구 한국가스공사,Away,샘조세프 벨란겔,7,3,4,75.0,0,2,0.0,3,6,50.0,1,2,50.0,0,1,1,4,1,0,1,0,0,3
../kbl_data/2022-2023,S41G01N254,대구 한국가스공사,Away,염유성,2,1,4,25.0,0,1,0.0,1,5,20.0,0,0,0.0,0,0,0,1,1,0,0,0,2,4
../kbl_data/2022-2023,S41G01N255,원주 DB,Home,박찬희,2,1,2,50.0,0,2,0.0,1,4,25.0,0,3,0.0,1,3,4,3,0,0,0,0,1,2
../kbl_data/2022-2023,S41G01N255,원주 DB,Home,김종규,10,5,7,71.4,0,1,0.0,5,8,62.5,0,0,0.0,1,8,9,2,2,2,0,3,0,4
../kbl_data/2022-2023,S41G01N255,원주 DB,Home,최승욱,0,0,1,0.0,0,0,0.0,0,1,0.0,0,0,0.0,0,2,2,1,1,0,0,0,1,0
../kbl_data/2022-2023,S41G01N255,원주 DB,Home,강상재,14,3,4,75.0,2,5,40.0,5,9,55.6,2,2,100.0,1,5,6,2,0,1,0,0,3,2
../kbl_data/2022-2023,S41G01N255,원주 DB,Home,윤성원,0,0,0,0.0,0,0,0.0,0,0,0.0,0,0,0.0,0,0,0,0,0,0,0,0,0,0
../kbl_data/2022-2023,S41G01N255,원주 DB,Home,이준희,0,0,3,0.0,0,0,0.0,0,3,0.0,0,0,0.0,0,0,0,2,0,0,0,0,1,4
../kbl_data/2022-2023,S41G01N255,원주 DB,Home,레나드 프리먼,7,2,9,22.2,0,0,0.0,2,9,22.2,3,4,75.0,7,6,13,1,2,0,0,1,2,2
../kbl_data/2022-2023,S41G01N255,원주 DB,Home,정호영,10,2,5,40.0,2,4,50.0,4,9,44.4,0,0,0.0,1,0,1,2,0,0,0,0,1,3
../kbl_data/2022-2023,S41G01N255,원주 DB,Home,이민석,0,0,0,0.0,0,0,0.0,0,0,0.0,0,0,0.0,0,0,0,0,0,0,0,0,0,0
../kbl_data/2022-2023,S41G01N255,원주 DB,Home,이선 알바노,20,4,8,50.0,4,6,66.7,8,14,57.1,0,0,0.0,1,4,5,6,3,0,0,0,1,0
../kbl_data/2022-2023,S41G01N255,원주 DB,Home,인승찬,0,0,0,0.0,0,0,0.0,0,0,0.0,0,0,0.0,0,0,0,0,0,0,0,0,0,0
../kbl_data/2022-2023,S41G01N255,원주 DB,Home,디존 데이비스,19,4,6,66.7,3,7,42.9,7,13,53.8,2,2,100.0,1,1,2,1,1,0,0,0,1,1
../kbl_data/2022-2023,S41G01N255,수원 KT,Away,김영환,2,1,2,50.0,0,0,0.0,1,2,50.0,0,0,0.0,1,1,2,1,0,0,0,0,0,0
../kbl_data/2022-2023,S41G01N255,수원 KT,Away,한희원,0,0,0,0.0,0,1,0.0,0,1,0.0,0,0,0.0,0,0,0,0,0,0,0,0,0,1
../kbl_data/2022-2023,S41G01N255,수원 KT,Away,이현석,0,0,0,0.0,0,0,0.0,0,0,0.0,0,0,0.0,0,1,1,0,0,0,0,0,0,2
../kbl_data/2022-2023,S41G01N255,수원 KT,Away,정성우,4,2,5,40.0,0,2,0.0,2,7,28.6,0,0,0.0,0,3,3,5,0,0,0,0,0,3
../kbl_data/2022-2023,S41G01N255,수원 KT,Away,최성모,11,3,4,75.0,1,2,50.0,4,6,66.7,2,2,100.0,0,0,0,0,2,0,0,0,1,3
../kbl_data/2022-2023,S41G01N255,수원 KT,Away,양홍석,10,2,6,33.3,1,4,25.0,3,10,30.0,3,4,75.0,1,2,3,6,2,0,0,0,0,2
../kbl_data/2022-2023,S41G01N255,수원 KT,Away,박지원,1,0,0,0.0,0,2,0.0,0,2,0.0,1,2,50.0,2,3,5,4,2,1,0,0,1,2
../kbl_data/2022-2023,S41G01N255,수원 KT,Away,하윤기,22,9,12,75.0,0,0,0.0,9,12,75.0,4,5,80.0,2,1,3,3,0,2,0,2,3,0
../kbl_data/2022-2023,S41G01N255,수원 KT,Away,이두원,0,0,0,0.0,0,0,0.0,0,0,0.0,0,0,0.0,0,0,0,0,0,0,0,0,0,0
../kbl_data/2022-2023,S41G01N255,수원 KT,Away,레스터 프로스퍼,0,0,0,0.0,0,1,0.0,0,1,0.0,0,0,0.0,0,0,0,0,0,0,0,0,0,0
../kbl_data/2022-2023,S41G01N255,수원 KT,Away,재로드 존스,18,2,9,22.2,3,10,30.0,5,19,26.3,5,6,83.3,3,12,15,4,3,0,0,1,3,4
../kbl_data/2022-2023,S41G01N255,수원 KT,Away,데이브 일데폰소,2,1,2,50.0,0,0,0.0,1,2,50.0,0,3,0.0,0,1,1,0,0,0,0,0,2,0
../kbl_data/2022-2023,S41G01N256,서울 SK,Home,양우섭,0,0,0,0.0,0,0,0.0,0,0,0.0,0,0,0.0,0,0,0,0,0,0,0,0,0,0
../kbl_data/2022-2023,S41G01N256,서울 SK,Home,허일영,15,2,5,40.0,3,6,50.0,5,11,45.5,2,2,100.0,3,1,4,1,2,0,0,0,0,1
../kbl_data/2022-2023,S41G01N256,서울 SK,Home,송창용,0,0,0,0.0,0,0,0.0,0,0,0.0,0,0,0.0,0,0,0,0,0,0,0,0,0,0
../kbl_data/2022-2023,S41G01N256,서울 SK,Home,김선형,13,3,11,27.3,1,3,33.3,4,14,28.6,4,4,100.0,0,1,1,9,2,1,0,0,3,4
../kbl_data/2022-2023,S41G01N256,서울 SK,Home,홍경기,0,0,0,0.0,0,0,0.0,0,0,0.0,0,0,0.0,0,0,0,0,0,0,0,0,0,0
../kbl_data/2022-2023,S41G01N256,서울 SK,Home,최부경,16,8,11,72.7,0,0,0.0,8,11,72.7,0,1,0.0,0,3,3,5,2,0,0,1,1,5
../kbl_data/2022-2023,S41G01N256,서울 SK,Home,리온 윌리엄스,0,0,2,0.0,0,0,0.0,0,2,0.0,0,0,0.0,2,2,4,0,0,0,0,0,0,0
../kbl_data/2022-2023,S41G01N256,서울 SK,Home,최원혁,2,1,1,100.0,0,1,0.0,1,2,50.0,0,0,0.0,2,2,4,2,0,0,1,0,0,3
../kbl_data/2022-2023,S41G01N256,서울 SK,Home,최성원,0,0,0,0.0,0,3,0.0,0,3,0.0,0,0,0.0,0,2,2,0,1,0,0,0,0,3
../kbl_data/2022-2023,S41G01N256,서울 SK,Home,자밀 워니,45,20,33,60.6,0,0,0.0,20,33,60.6,5,6,83.3,4,7,11,3,3,0,0,4,2,2
../kbl_data/2022-2023,S41G01N256,서울 SK,Home,김형빈,2,1,1,100.0,0,0,0.0,1,1,100.0,0,0,0.0,1,1,2,1,0,0,0,0,0,3
../kbl_data/2022-2023,S41G01N256,서울 SK,Home,오재현,2,1,2,50.0,0,3,0.0,1,5,20.0,0,0,0.0,0,0,0,0,1,0,0,0,0,1
../kbl_data/2022-2023,S41G01N256,전주 KCC,Away,정창영,6,2,3,66.7,0,3,0.0,2,6,33.3,2,2,100.0,1,2,3,4,1,0,0,0,4,1
../kbl_data/2022-2023,S41G01N256,전주 KCC,Away,라건아,11,4,6,66.7,0,3,0.0,4,9,44.4,3,3,100.0,3,8,11,3,1,3,0,0,2,0
../kbl_data/2022-2023,S41G01N256,전주 KCC,Away,박경상,0,0,0,0.0,0,2,0.0,0,2,0.0,0,0,0.0,1,2,3,2,0,0,0,0,3,2
../kbl_data/2022-2023,S41G01N256,전주 KCC,Away,김지완,20,5,8,62.5,3,3,100.0,8,11,72.7,1,1,100.0,0,1,1,2,0,0,0,0,1,2
../kbl_data/2022-2023,S41G01N256,전주 KCC,Away,전준범,5,1,2,50.0,1,2,50.0,2,4,50.0,0,0,0.0,0,3,3,1,1,0,0,0,1,3
../kbl_data/2022-2023,S41G01N256,전주 KCC,Away,이승현,4,1,1,100.0,0,0,0.0,1,1,100.0,2,2,100.0,2,3,5,1,0,0,0,0,0,1
../kbl_data/2022-2023,S41G01N256,전주 KCC,Away,이종현,15,5,7,71.4,0,0,0.0,5,7,71.4,5,7,71.4,2,3,5,3,0,2,0,0,4,2
../kbl_data/2022-2023,S41G01N256,전주 KCC,Away,이진욱,0,0,0,0.0,0,0,0.0,0,0,0.0,0,0,0.0,0,0,0,0,0,0,0,0,1,0
../kbl_data/2022-2023,S41G01N256,전주 KCC,Away,이근휘,3,0,1,0.0,1,6,16.7,1,7,14.3,0,0,0.0,2,1,3,1,0,0,0,0,0,1
../kbl_data/2022-2023,S41G01N256,전주 KCC,Away,김동현,17,2,2,100.0,3,4,75.0,5,6,83.3,4,4,100.0,0,2,2,2,1,0,0,0,3,3
../kbl_data/2022-2023,S41G01N256,전주 KCC,Away,송동훈,0,0,0,0.0,0,0,0.0,0,0,0.0,0,0,0.0,0,0,0,0,0,0,0,0,0,0
../kbl_data/2022-2023,S41G01N256,전주 KCC,Away,디온 탐슨,10,5,11,45.5,0,0,0.0,5,11,45.5,0,1,0.0,2,4,6,3,1,3,1,0,1,2
../kbl_data/2022-2023,S41G01N257,울산 현대모비스,Home,함지훈,0,0,0,0.0,0,0,0.0,0,0,0.0,0,0,0.0,0,0,0,0,0,0,0,0,0,0
../kbl_data/2022-2023,S41G01N257,울산 현대모비스,Home,김현민,6,0,0,0.0,2,3,66.7,2,3,66.7,0,0,0.0,1,1,2,1,1,0,0,0,1,0
../kbl_data/2022-2023,S41G01N257,울산 현대모비스,Home,최진수,13,4,5,80.0,1,4,25.0,5,9,55.6,2,4,50.0,1,5,6,3,0,0,0,1,0,3
../kbl_data/2022-2023,S41G01N257,울산 현대모비스,Home,김영현,0,0,0,0.0,0,1,0.0,0,1,0.0,0,0,0.0,0,1,1,0,0,0,0,0,1,0
../kbl_data/2022-2023,S41G01N257,울산 현대모비스,Home,김국찬,0,0,0,0.0,0,0,0.0,0,0,0.0,0,0,0.0,0,0,0,0,0,0,0,0,0,0
../kbl_data/2022-2023,S41G01N257,울산 현대모비스,Home,서명진,18,3,5,60.0,4,7,57.1,7,12,58.3,0,0,0.0,1,2,3,7,1,0,0,0,0,3
../kbl_data/2022-2023,S41G01N257,울산 현대모비스,Home,저스틴 녹스,8,4,9,44.4,0,0,0.0,4,9,44.4,0,0,0.0,4,4,8,0,0,1,0,0,2,2
../kbl_data/2022-2023,S41G01N257,울산 현대모비스,Home,신민석,6,0,1,0.0,1,4,25.0,1,5,20.0,3,4,75.0,5,8,13,0,3,0,0,0,1,4
../kbl_data/2022-2023,S41G01N257,울산 현대모비스,Home,김동준,0,0,0,0.0,0,0,0.0,0,0,0.0,0,0,0.0,0,0,0,0,0,0,0,0,0,0
../kbl_data/2022-2023,S41G01N257,울산 현대모비스,Home,론제이 아바리엔토스,18,1,6,16.7,4,12,33.3,5,18,27.8,4,4,100.0,0,4,4,7,1,0,0,0,4,3
../kbl_data/2022-2023,S41G01N257,울산 현대모비스,Home,게이지 프림,23,11,21,52.4,0,0,0.0,11,21,52.4,1,1,100.0,3,7,10,2,1,3,0,1,2,3
../kbl_data/2022-2023,S41G01N257,울산 현대모비스,Home,김태완,2,1,3,33.3,0,1,0.0,1,4,25.0,0,0,0.0,1,1,2,1,0,0,0,0,0,1
../kbl_data/2022-2023,S41G01N257,안양 KGC,Away,양희종,0,0,1,0.0,0,0,0.0,0,1,0.0,0,0,0.0,0,0,0,0,0,0,0,0,1,0
../kbl_data/2022-2023,S41G01N257,안양 KGC,Away,오세근,16,5,11,45.5,2,5,40.0,7,16,43.8,0,0,0.0,1,4,5,5,0,2,1,0,0,1
../kbl_data/2022-2023,S41G01N257,안양 KGC,Away,정준원,2,1,2,50.0,0,1,0.0,1,3,33.3,0,0,0.0,1,0,1,1,1,0,0,0,0,0
../kbl_data/2022-2023,S41G01N257,안양 KGC,Away,배병준,10,2,3,66.7,2,6,33.3,4,9,44.4,0,0,0.0,0,3,3,1,0,1,1,0,1,2
../kbl_data/2022-2023,S41G01N257,안양 KGC,Away,문성곤,0,0,0,0.0,0,2,0.0,0,2,0.0,0,0,0.0,1,4,5,1,0,1,0,0,3,2
../kbl_data/2022-2023,S41G01N257,안양 KGC,Away,박지훈,11,4,7,57.1,0,1,0.0,4,8,50.0,3,3,100.0,0,1,1,5,2,0,1,0,1,3
../kbl_data/2022-2023,S41G01N257,안양 KGC,Away,이우정,0,0,0,0.0,0,0,0.0,0,0,0.0,0,0,0.0,0,0,0,0,0,0,0,0,0,0
../kbl_data/2022-2023,S41G01N257,안양 KGC,Away,대릴 먼로,0,0,0,0.0,0,0,0.0,0,0,0.0,0,0,0.0,0,0,0,0,0,0,0,0,0,0
../kbl_data/2022-2023,S41G01N257,안양 KGC,Away,변준형,16,5,5,100.0,2,9,22.2,7,14,50.0,0,3,0.0,1,3,4,1,0,0,0,0,2,3
../kbl_data/2022-2023,S41G01N257,안양 KGC,Away,한승희,0,0,1,0.0,0,0,0.0,0,1,0.0,0,0,0.0,0,0,0,0,0,1,0,0,0,1
../kbl_data/2022-2023,S41G01N257,안양 KGC,Away,오마리 스펠맨,32,7,9,77.8,4,10,40.0,11,19,57.9,6,6,100.0,2,12,14,2,4,1,0,2,1,3
../kbl_data/2022-2023,S41G01N257,안양 KGC,Away,렌즈 아반도,2,0,2,0.0,0,0,0.0,0,2,0.0,2,2,100.0,1,1,2,0,0,0,0,0,1,0
../kbl_data/2022-2023,S41G01N258,수원 KT,Home,김영환,7,2,2,100.0,1,3,33.3,3,5,60.0,0,0,0.0,2,0,2,2,0,0,0,0,2,3
../kbl_data/2022-2023,S41G01N258,수원 KT,Home,한희원,2,1,1,100.0,0,1,0.0,1,2,50.0,0,0,0.0,0,1,1,0,0,0,0,0,1,0
../kbl_data/2022-2023,S41G01N258,수원 KT,Home,이현석,0,0,0,0.0,0,0,0.0,0,0,0.0,0,0,0.0,0,0,0,0,0,0,0,0,0,0
../kbl_data/2022-2023,S41G01N258,수원 KT,Home,정성우,0,0,0,0.0,0,0,0.0,0,0,0.0,0,0,0.0,0,0,0,0,0,0,0,0,0,0
../kbl_data/2022-2023,S41G01N258,수원 KT,Home,최성모,15,4,6,66.7,2,3,66.7,6,9,66.7,1,3,33.3,2,2,4,6,1,0,0,0,0,4
../kbl_data/2022-2023,S41G01N258,수원 KT,Home,양홍석,17,7,10,70.0,1,5,20.0,8,15,53.3,0,0,0.0,2,5,7,4,0,0,0,0,2,3
../kbl_data/2022-2023,S41G01N258,수원 KT,Home,박지원,7,0,2,0.0,2,6,33.3,2,8,25.0,1,2,50.0,0,1,1,5,0,0,0,0,1,3
../kbl_data/2022-2023,S41G01N258,수원 KT,Home,김준환,10,3,4,75.0,1,4,25.0,4,8,50.0,1,2,50.0,0,1,1,0,0,0,1,0,0,1
../kbl_data/2022-2023,S41G01N258,수원 KT,Home,이두원,5,2,3,66.7,0,0,0.0,2,3,66.7,1,2,50.0,1,2,3,1,0,1,0,0,1,4
../kbl_data/2022-2023,S41G01N258,수원 KT,Home,레스터 프로스퍼,4,2,3,66.7,0,2,0.0,2,5,40.0,0,0,0.0,1,4,5,1,1,0,0,1,0,1
../kbl_data/2022-2023,S41G01N258,수원 KT,Home,재로드 존스,13,1,4,25.0,3,8,37.5,4,12,33.3,2,2,100.0,1,4,5,0,1,0,0,0,3,2
../kbl_data/2022-2023,S41G01N258,수원 KT,Home,데이브 일데폰소,0,0,0,0.0,0,1,0.0,0,1,0.0,0,0,0.0,0,0,0,1,1,0,0,0,1,0
../kbl_data/2022-2023,S41G01N258,창원 LG,Away,이관희,11,2,8,25.0,2,4,50.0,4,12,33.3,1,2,50.0,0,6,6,2,4,0,0,0,0,3
../kbl_data/2022-2023,S41G01N258,창원 LG,Away,정희재,5,1,1,100.0,1,3,33.3,2,4,50.0,0,0,0.0,0,2,2,3,1,0,0,0,2,3
../kbl_data/2022-2023,S41G01N258,창원 LG,Away,임동섭,5,1,1,100.0,1,1,100.0,2,2,100.0,0,0,0.0,0,1,1,1,0,0,0,0,0,0
../kbl_data/2022-2023,S41G01N258,창원 LG,Away,서민수,0,0,0,0.0,0,0,0.0,0,0,0.0,0,0,0.0,0,0,0,0,0,0,0,0,0,0
../kbl_data/2022-2023,S41G01N258,창원 LG,Away,이재도,27,9,11,81.8,2,5,40.0,11,16,68.8,3,3,100.0,1,4,5,3,1,0,0,0,2,1
../kbl_data/2022-2023,S41G01N258,창원 LG,Away,김준일,6,1,4,25.0,0,0,0.0,1,4,25.0,4,6,66.7,2,1,3,0,0,1,0,0,0,3
../kbl_data/2022-2023,S41G01N258,창원 LG,Away,정인덕,9,3,5,60.0,1,2,50.0,4,7,57.1,0,0,0.0,1,2,3,1,0,0,0,0,0,3
../kbl_data/2022-2023,S41G01N258,창원 LG,Away,윤원상,0,0,0,0.0,0,1,0.0,0,1,0.0,0,0,0.0,0,0,0,0,0,0,1,0,0,1
../kbl_data/2022-2023,S41G01N258,창원 LG,Away,아셈 마레이,12,5,11,45.5,0,0,0.0,5,11,45.5,2,5,40.0,6,6,12,3,1,0,0,0,2,2
../kbl_data/2022-2023,S41G01N258,창원 LG,Away,저스틴 구탕,2,1,2,50.0,0,0,0.0,1,2,50.0,0,0,0.0,0,0,0,1,0,0,0,0,0,0
../kbl_data/2022-2023,S41G01N258,창원 LG,Away,양준석,2,1,1,100.0,0,1,0.0,1,2,50.0,0,0,0.0,0,0,0,1,0,0,0,0,1,0
../kbl_data/2022-2023,S41G01N258,창원 LG,Away,단테 커닝햄,6,2,5,40.0,0,0,0.0,2,5,40.0,2,2,100.0,4,3,7,0,0,0,0,0,2,1
../kbl_data/2022-2023,S41G01N259,서울 삼성,Home,이정현,54,12,22,54.5,8,34,23.5,20,56,35.7,6,6,100.0,2,6,8,20,2,0,0,0,10,10
../kbl_data/2022-2023,S41G01N259,서울 삼성,Home,장민국,0,0,6,0.0,0,2,0.0,0,8,0.0,0,0,0.0,1,2,3,0,0,0,0,0,0,1
../kbl_data/2022-2023,S41G01N259,서울 삼성,Home,김승원,0,0,0,0.0,0,0,0.0,0,0,0.0,0,0,0.0,0,0,0,0,0,0,0,0,0,0
../kbl_data/2022-2023,S41G01N259,서울 삼성,Home,김시래,1,0,2,0.0,0,2,0.0,0,4,0.0,1,2,50.0,0,1,1,2,0,0,0,0,0,2
../kbl_data/2022-2023,S41G01N259,서울 삼성,Home,이동엽,1,0,3,0.0,0,2,0.0,0,5,0.0,1,1,100.0,1,3,4,1,0,0,0,0,1,1
../kbl_data/2022-2023,S41G01N259,서울 삼성,Home,이호현,5,2,5,40.0,0,1,0.0,2,6,33.3,1,2,50.0,2,1,3,4,0,0,0,0,2,0
../kbl_data/2022-2023,S41G01N259,서울 삼성,Home,김광철,0,0,0,0.0,0,0,0.0,0,0,0.0,0,0,0.0,0,0,0,1,0,0,0,0,0,1
../kbl_data/2022-2023,S41G01N259,서울 삼성,Home,김무성,0,0,0,0.0,0,1,0.0,0,1,0.0,0,0,0.0,0,0,0,0,0,0,0,0,0,0
../kbl_data/2022-2023,S41G01N259,서울 삼성,Home,차민석,4,2,2,100.0,0,0,0.0,2,2,100.0,0,0,0.0,0,1,1,0,0,0,0,0,0,2
../kbl_data/2022-2023,S41G01N259,서울 삼성,Home,이원석,14,6,9,66.7,0,0,0.0,6,9,66.7,2,2,100.0,2,1,3,3,0,0,0,0,2,3
../kbl_data/2022-2023,S41G01N259,서울 삼성,Home,신동혁,19,2,2,100.0,5,7,71.4,7,9,77.8,0,0,0.0,0,2,2,1,0,0,0,0,2,0
../kbl_data/2022-2023,S41G01N259,서울 삼성,Home,앤서니 모스,14,5,9,55.6,0,0,0.0,5,9,55.6,4,7,57.1,3,8,11,0,1,0,0,0,0,5
../kbl_data/2022-2023,S41G01N259,고양 캐롯,Away,김강선,13,2,2,100.0,2,7,28.6,4,9,44.4,3,4,75.0,1,2,3,2,1,0,0,0,0,3
../kbl_data/2022-2023,S41G01N259,고양 캐롯,Away,최현민,0,0,0,0.0,0,2,0.0,0,2,0.0,0,0,0.0,0,0,0,0,0,0,0,0,0,0
../kbl_data/2022-2023,S41G01N259,고양 캐롯,Away,임종일,0,0,0,0.0,0,0,0.0,0,0,0.0,0,0,0.0,0,0,0,0,0,0,0,0,0,0
../kbl_data/2022-2023,S41G01N259,고양 캐롯,Away,김진유,3,1,1,100.0,0,2,0.0,1,3,33.3,1,2,50.0,3,4,7,1,2,0,0,0,0,2
../kbl_data/2022-2023,S41G01N259,고양 캐롯,Away,김진용,11,4,5,80.0,0,0,0.0,4,5,80.0,3,3,100.0,1,3,4,0,1,0,0,0,0,1
../kbl_data/2022-2023,S41G01N259,고양 캐롯,Away,조한진,0,0,0,0.0,0,3,0.0,0,3,0.0,0,0,0.0,1,3,4,1,1,1,0,0,0,0
../kbl_data/2022-2023,S41G01N259,고양 캐롯,Away,김세창,0,0,0,0.0,0,0,0.0,0,0,0.0,0,0,0.0,0,0,0,0,0,0,0,0,0,0
../kbl_data/2022-2023,S41G01N259,고양 캐롯,Away,디드릭 로슨,33,10,16,62.5,2,3,66.7,12,19,63.2,7,10,70.0,2,8,10,1,2,2,0,0,2,3
../kbl_data/2022-2023,S41G01N259,고양 캐롯,Away,박진철,0,0,0,0.0,0,0,0.0,0,0,0.0,0,0,0.0,1,1,2,0,0,0,0,0,0,0
../kbl_data/2022-2023,S41G01N259,고양 캐롯,Away,이정현,54,12,22,54.5,8,34,23.5,20,56,35.7,6,6,100.0,2,6,8,20,2,0,0,0,10,10
../kbl_data/2022-2023,S41G01N259,고양 캐롯,Away,모리구치 히사시,4,2,2,100.0,0,0,0.0,2,2,100.0,0,0,0.0,0,1,1,2,1,0,0,0,0,4
../kbl_data/2022-2023,S41G01N259,고양 캐롯,Away,조나단 알렛지,5,1,2,50.0,1,4,25.0,2,6,33.3,0,0,0.0,1,0,1,1,0,0,0,0,1,2
../kbl_data/2022-2023,S41G01N260,원주 DB,Home,박찬희,2,1,1,100.0,0,0,0.0,1,1,100.0,0,0,0.0,0,0,0,0,0,0,0,0,0,1
../kbl_data/2022-2023,S41G01N260,원주 DB,Home,김종규,20,8,11,72.7,0,0,0.0,8,11,72.7,4,4,100.0,6,4,10,1,0,1,0,2,0,3
../kbl_data/2022-2023,S41G01N260,원주 DB,Home,최승욱,0,0,0,0.0,0,1,0.0,0,1,0.0,0,0,0.0,0,0,0,1,0,0,0,0,0,0
../kbl_data/2022-2023,S41G01N260,원주 DB,Home,강상재,15,4,5,80.0,2,4,50.0,6,9,66.7,1,1,100.0,0,3,3,6,1,0,0,0,4,0
../kbl_data/2022-2023,S41G01N260,원주 DB,Home,윤성원,0,0,0,0.0,0,1,0.0,0,1,0.0,0,0,0.0,0,2,2,0,0,0,0,0,0,0
../kbl_data/2022-2023,S41G01N260,원주 DB,Home,이준희,7,0,1,0.0,2,5,40.0,2,6,33.3,1,2,50.0,1,3,4,2,0,0,0,0,2,5
../kbl_data/2022-2023,S41G01N260,원주 DB,Home,레나드 프리먼,7,3,5,60.0,0,0,0.0,3,5,60.0,1,2,50.0,1,5,6,3,1,1,0,0,0,4
../kbl_data/2022-2023,S41G01N260,원주 DB,Home,정호영,2,1,3,33.3,0,3,0.0,1,6,16.7,0,0,0.0,0,0,0,0,0,0,0,0,0,3
../kbl_data/2022-2023,S41G01N260,원주 DB,Home,이민석,7,2,3,66.7,1,5,20.0,3,8,37.5,0,0,0.0,0,1,1,1,0,1,0,0,1,1
../kbl_data/2022-2023,S41G01N260,원주 DB,Home,이선 알바노,18,4,9,44.4,2,2,100.0,6,11,54.5,4,4,100.0,0,2,2,5,1,1,0,0,2,1
../kbl_data/2022-2023,S41G01N260,원주 DB,Home,김형준,0,0,0,0.0,0,0,0.0,0,0,0.0,0,0,0.0,0,0,0,0,0,0,0,0,0,0
../kbl_data/2022-2023,S41G01N260,원주 DB,Home,디존 데이비스,6,0,0,0.0,2,5,40.0,2,5,40.0,0,0,0.0,0,3,3,1,0,0,0,0,0,2
../kbl_data/2022-2023,S41G01N260,대구 한국가스공사,Away,차바위,5,0,2,0.0,1,1,100.0,1,3,33.3,2,2,100.0,1,3,4,2,0,1,0,0,0,1
../kbl_data/2022-2023,S41G01N260,대구 한국가스공사,Away,박지훈,0,0,0,0.0,0,0,0.0,0,0,0.0,0,0,0.0,0,0,0,0,0,0,0,0,0,0
../kbl_data/2022-2023,S41G01N260,대구 한국가스공사,Away,조상열,2,1,1,100.0,0,1,0.0,1,2,50.0,0,0,0.0,1,2,3,1,0,0,0,0,0,2
../kbl_data/2022-2023,S41G01N260,대구 한국가스공사,Away,이원대,0,0,0,0.0,0,0,0.0,0,0,0.0,0,0,0.0,0,0,0,0,0,0,0,0,0,0
../kbl_data/2022-2023,S41G01N260,대구 한국가스공사,Away,이대헌,24,9,12,75.0,1,5,20.0,10,17,58.8,3,6,50.0,2,4,6,0,1,0,0,0,0,3
../kbl_data/2022-2023,S41G01N260,대구 한국가스공사,Away,머피 할로웨이,12,5,9,55.6,0,0,0.0,5,9,55.6,2,2,100.0,1,5,6,2,1,1,0,0,1,1
../kbl_data/2022-2023,S41G01N260,대구 한국가스공사,Away,전현우,0,0,0,0.0,0,0,0.0,0,0,0.0,0,0,0.0,0,0,0,0,0,0,0,0,0,0
../kbl_data/2022-2023,S41G01N260,대구 한국가스공사,Away,양준우,5,1,2,50.0,1,1,100.0,2,3,66.7,0,1,0.0,0,0,0,2,3,0,0,0,1,1
../kbl_data/2022-2023,S41G01N260,대구 한국가스공사,Away,데본 스캇,9,4,7,57.1,0,0,0.0,4,7,57.1,1,2,50.0,3,1,4,2,1,1,0,0,0,1
../kbl_data/2022-2023,S41G01N260,대구 한국가스공사,Away,신승민,8,1,3,33.3,2,5,40.0,3,8,37.5,0,0,0.0,0,1,1,0,0,2,0,0,2,4
../kbl_data/2022-2023,S41G01N260,대구 한국가스공사,Away,샘조세프 벨란겔,15,3,8,37.5,2,5,40.0,5,13,38.5,3,6,50.0,3,4,7,4,0,0,0,0,3,3
../kbl_data/2022-2023,S41G01N260,대구 한국가스공사,Away,염유성,3,0,2,0.0,1,2,50.0,1,4,25.0,0,0,0.0,2,1,3,3,0,0,0,0,2,3
../kbl_data/2022-2023,S41G01N261,전주 KCC,Home,정창영,12,4,5,80.0,0,3,0.0,4,8,50.0,4,4,100.0,3,4,7,4,2,0,1,0,1,2
../kbl_data/2022-2023,S41G01N261,전주 KCC,Home,라건아,18,3,7,42.9,1,2,50.0,4,9,44.4,9,9,100.0,1,7,8,3,0,0,0,0,1,2
../kbl_data/2022-2023,S41G01N261,전주 KCC,Home,박경상,10,2,2,100.0,2,3,66.7,4,5,80.0,0,0,0.0,0,2,2,2,1,0,0,0,1,4
../kbl_data/2022-2023,S41G01N261,전주 KCC,Home,김지완,17,3,4,75.0,3,6,50.0,6,10,60.0,2,3,66.7,0,3,3,6,1,0,0,0,3,5
../kbl_data/2022-2023,S41G01N261,전주 KCC,Home,허웅,13,0,2,0.0,3,9,33.3,3,11,27.3,4,4,100.0,0,4,4,1,0,0,0,0,3,1
../kbl_data/2022-2023,S41G01N261,전주 KCC,Home,이승현,15,6,13,46.2,1,3,33.3,7,16,43.8,0,0,0.0,7,3,10,2,1,0,0,0,0,0
../kbl_data/2022-2023,S41G01N261,전주 KCC,Home,이종현,0,0,0,0.0,0,0,0.0,0,0,0.0,0,0,0.0,0,0,0,0,0,0,0,0,1,0
../kbl_data/2022-2023,S41G01N261,전주 KCC,Home,이진욱,0,0,0,0.0,0,0,0.0,0,0,0.0,0,0,0.0,0,0,0,0,0,0,0,0,0,1
../kbl_data/2022-2023,S41G01N261,전주 KCC,Home,이근휘,0,0,1,0.0,0,1,0.0,0,2,0.0,0,0,0.0,0,0,0,0,1,0,0,0,0,1
../kbl_data/2022-2023,S41G01N261,전주 KCC,Home,김동현,0,0,0,0.0,0,1,0.0,0,1,0.0,0,0,0.0,0,1,1,0,0,0,0,0,1,1
../kbl_data/2022-2023,S41G01N261,전주 KCC,Home,송동훈,0,0,0,0.0,0,0,0.0,0,0,0.0,0,0,0.0,0,0,0,0,0,0,0,0,0,0
../kbl_data/2022-2023,S41G01N261,전주 KCC,Home,디온 탐슨,4,2,3,66.7,0,1,0.0,2,4,50.0,0,0,0.0,0,1,1,0,0,0,0,1,0,0
../kbl_data/2022-2023,S41G01N261,수원 KT,Away,김영환,0,0,0,0.0,0,0,0.0,0,0,0.0,0,0,0.0,0,0,0,0,0,0,0,0,0,0
../kbl_data/2022-2023,S41G01N261,수원 KT,Away,한희원,0,0,0,0.0,0,0,0.0,0,0,0.0,0,0,0.0,0,0,0,0,0,0,0,0,0,1
../kbl_data/2022-2023,S41G01N261,수원 KT,Away,이현석,0,0,0,0.0,0,1,0.0,0,1,0.0,0,0,0.0,0,3,3,1,0,0,0,0,1,1
../kbl_data/2022-2023,S41G01N261,수원 KT,Away,정성우,28,7,12,58.3,4,6,66.7,11,18,61.1,2,2,100.0,1,4,5,3,1,0,0,0,1,3
../kbl_data/2022-2023,S41G01N261,수원 KT,Away,최성모,0,0,0,0.0,0,1,0.0,0,1,0.0,0,0,0.0,1,0,1,1,0,0,0,0,0,2
../kbl_data/2022-2023,S41G01N261,수원 KT,Away,양홍석,16,6,8,75.0,1,7,14.3,7,15,46.7,1,1,100.0,0,8,8,1,0,0,0,0,3,2
../kbl_data/2022-2023,S41G01N261,수원 KT,Away,박지원,0,0,0,0.0,0,0,0.0,0,0,0.0,0,0,0.0,0,0,0,0,0,0,0,0,0,0
../kbl_data/2022-2023,S41G01N261,수원 KT,Away,김준환,17,4,5,80.0,3,5,60.0,7,10,70.0,0,1,0.0,1,0,1,1,3,0,0,0,0,3
../kbl_data/2022-2023,S41G01N261,수원 KT,Away,이두원,10,4,9,44.4,0,0,0.0,4,9,44.4,2,2,100.0,4,3,7,1,1,1,0,1,3,5
../kbl_data/2022-2023,S41G01N261,수원 KT,Away,레스터 프로스퍼,7,2,4,50.0,1,2,50.0,3,6,50.0,0,0,0.0,1,2,3,1,1,0,0,0,0,4
../kbl_data/2022-2023,S41G01N261,수원 KT,Away,재로드 존스,10,2,4,50.0,2,5,40.0,4,9,44.4,0,0,0.0,0,5,5,3,1,1,0,1,2,2
../kbl_data/2022-2023,S41G01N261,수원 KT,Away,데이브 일데폰소,0,0,0,0.0,0,0,0.0,0,0,0.0,0,0,0.0,0,0,0,0,0,0,0,0,0,0
../kbl_data/2022-2023,S41G01N262,창원 LG,Home,이관희,15,3,4,75.0,3,4,75.0,6,8,75.0,0,0,0.0,0,5,5,3,2,0,0,0,2,1
../kbl_data/2022-2023,S41G01N262,창원 LG,Home,정희재,4,0,2,0.0,0,2,0.0,0,4,0.0,4,4,100.0,0,4,4,4,1,0,0,0,1,4
../kbl_data/2022-2023,S41G01N262,창원 LG,Home,임동섭,9,0,4,0.0,3,5,60.0,3,9,33.3,0,0,0.0,1,3,4,1,2,0,0,0,0,2
../kbl_data/2022-2023,S41G01N262,창원 LG,Home,서민수,0,0,0,0.0,0,0,0.0,0,0,0.0,0,0,0.0,0,1,1,0,0,0,0,0,0,0
../kbl_data/2022-2023,S41G01N262,창원 LG,Home,이재도,19,5,10,50.0,2,6,33.3,7,16,43.8,3,4,75.0,3,2,5,4,0,1,0,0,2,2
../kbl_data/2022-2023,S41G01N262,창원 LG,Home,김준일,0,0,2,0.0,0,0,0.0,0,2,0.0,0,0,0.0,0,3,3,0,1,0,0,0,2,1
../kbl_data/2022-2023,S41G01N262,창원 LG,Home,정인덕,0,0,2,0.0,0,0,0.0,0,2,0.0,0,0,0.0,1,0,1,0,0,0,0,0,2,1
../kbl_data/2022-2023,S41G01N262,창원 LG,Home,윤원상,9,0,2,0.0,3,5,60.0,3,7,42.9,0,0,0.0,0,0,0,1,0,0,0,0,1,2
../kbl_data/2022-2023,S41G01N262,창원 LG,Home,아셈 마레이,13,5,8,62.5,0,0,0.0,5,8,62.5,3,8,37.5,4,7,11,3,1,0,1,1,2,3
../kbl_data/2022-2023,S41G01N262,창원 LG,Home,저스틴 구탕,0,0,0,0.0,0,0,0.0,0,0,0.0,0,0,0.0,0,0,0,0,0,0,0,0,0,0
../kbl_data/2022-2023,S41G01N262,창원 LG,Home,양준석,0,0,0,0.0,0,0,0.0,0,0,0.0,0,0,0.0,0,0,0,0,0,0,0,0,1,0
../kbl_data/2022-2023,S41G01N262,창원 LG,Home,단테 커닝햄,0,0,2,0.0,0,0,0.0,0,2,0.0,0,0,0.0,1,1,2,2,0,0,0,0,0,2
../kbl_data/2022-2023,S41G01N262,서울 SK,Away,양우섭,0,0,0,0.0,0,0,0.0,0,0,0.0,0,0,0.0,0,0,0,0,0,0,0,0,0,0
../kbl_data/2022-2023,S41G01N262,서울 SK,Away,허일영,2,1,1,100.0,0,1,0.0,1,2,50.0,0,0,0.0,1,2,3,0,0,0,0,0,0,1
../kbl_data/2022-2023,S41G01N262,서울 SK,Away,송창용,0,0,0,0.0,0,0,0.0,0,0,0.0,0,0,0.0,0,0,0,0,0,0,0,0,0,0
../kbl_data/2022-2023,S41G01N262,서울 SK,Away,김선형,19,5,11,45.5,2,4,50.0,7,15,46.7,3,5,60.0,1,3,4,5,2,0,0,0,1,1
../kbl_data/2022-2023,S41G01N262,서울 SK,Away,홍경기,0,0,0,0.0,0,0,0.0,0,0,0.0,0,0,0.0,0,0,0,0,0,0,0,0,0,0
../kbl_data/2022-2023,S41G01N262,서울 SK,Away,최부경,6,1,2,50.0,0,0,0.0,1,2,50.0,4,4,100.0,5,5,10,1,0,0,0,0,2,4
../kbl_data/2022-2023,S41G01N262,서울 SK,Away,리온 윌리엄스,0,0,0,0.0,0,0,0.0,0,0,0.0,0,0,0.0,0,0,0,0,0,0,0,0,0,0
../kbl_data/2022-2023,S41G01N262,서울 SK,Away,최원혁,3,0,0,0.0,1,2,50.0,1,2,50.0,0,0,0.0,0,0,0,2,1,0,1,0,0,5
../kbl_data/2022-2023,S41G01N262,서울 SK,Away,최성원,6,0,1,0.0,2,7,28.6,2,8,25.0,0,0,0.0,0,1,1,2,2,0,0,0,0,4
../kbl_data/2022-2023,S41G01N262,서울 SK,Away,자밀 워니,23,10,23,43.5,0,4,0.0,10,27,37.0,3,3,100.0,3,8,11,0,1,0,0,1,5,2
../kbl_data/2022-2023,S41G01N262,서울 SK,Away,김형빈,6,2,3,66.7,0,0,0.0,2,3,66.7,2,2,100.0,1,2,3,0,0,0,1,0,1,2
../kbl_data/2022-2023,S41G01N262,서울 SK,Away,오재현,9,0,1,0.0,3,5,60.0,3,6,50.0,0,0,0.0,1,3,4,1,0,0,0,0,0,1
../kbl_data/2022-2023,S41G01N263,안양 KGC,Home,양희종,0,0,1,0.0,0,1,0.0,0,2,0.0,0,0,0.0,1,0,1,1,0,0,0,0,0,1
../kbl_data/2022-2023,S41G01N263,안양 KGC,Home,오세근,15,6,9,66.7,1,2,50.0,7,11,63.6,0,0,0.0,2,5,7,3,0,0,0,0,1,2
../kbl_data/2022-2023,S41G01N263,안양 KGC,Home,정준원,2,1,2,50.0,0,0,0.0,1,2,50.0,0,0,0.0,0,0,0,0,0,0,0,0,0,1
../kbl_data/2022-2023,S41G01N263,안양 KGC,Home,배병준,4,0,1,0.0,1,3,33.3,1,4,25.0,1,2,50.0,0,1,1,1,1,1,0,0,0,2
../kbl_data/2022-2023,S41G01N263,안양 KGC,Home,문성곤,1,0,2,0.0,0,2,0.0,0,4,0.0,1,2,50.0,1,1,2,0,0,1,0,0,0,2
../kbl_data/2022-2023,S41G01N263,안양 KGC,Home,박지훈,9,3,5,60.0,1,3,33.3,4,8,50.0,0,0,0.0,0,0,0,2,2,0,0,0,2,1
../kbl_data/2022-2023,S41G01N263,안양 KGC,Home,대릴 먼로,0,0,0,0.0,0,0,0.0,0,0,0.0,0,0,0.0,0,0,0,1,0,0,0,0,0,0
../kbl_data/2022-2023,S41G01N263,안양 KGC,Home,변준형,18,8,9,88.9,0,2,0.0,8,11,72.7,2,3,66.7,0,4,4,5,1,0,1,0,2,1
../kbl_data/2022-2023,S41G01N263,안양 KGC,Home,김경원,0,0,0,0.0,0,0,0.0,0,0,0.0,0,0,0.0,0,0,0,0,0,1,0,0,0,3
../kbl_data/2022-2023,S41G01N263,안양 KGC,Home,한승희,4,2,2,100.0,0,1,0.0,2,3,66.7,0,2,0.0,0,0,0,0,0,0,0,0,0,1
../kbl_data/2022-2023,S41G01N263,안양 KGC,Home,오마리 스펠맨,15,3,7,42.9,1,8,12.5,4,15,26.7,6,6,100.0,3,11,14,4,1,3,0,0,0,1
../kbl_data/2022-2023,S41G01N263,안양 KGC,Home,렌즈 아반도,8,3,3,100.0,0,1,0.0,3,4,75.0,2,2,100.0,0,2,2,1,1,1,0,0,1,2
../kbl_data/2022-2023,S41G01N263,원주 DB,Away,박찬희,8,0,3,0.0,2,2,100.0,2,5,40.0,2,2,100.0,0,4,4,5,2,0,0,0,1,4
../kbl_data/2022-2023,S41G01N263,원주 DB,Away,김종규,19,9,16,56.2,0,0,0.0,9,16,56.2,1,2,50.0,3,4,7,0,0,1,0,0,1,4
../kbl_data/2022-2023,S41G01N263,원주 DB,Away,최승욱,6,0,1,0.0,2,5,40.0,2,6,33.3,0,0,0.0,2,0,2,3,1,0,0,0,0,1
../kbl_data/2022-2023,S41G01N263,원주 DB,Away,강상재,15,7,10,70.0,0,1,0.0,7,11,63.6,1,2,50.0,4,3,7,4,0,0,0,0,4,0
../kbl_data/2022-2023,S41G01N263,원주 DB,Away,윤성원,0,0,0,0.0,0,0,0.0,0,0,0.0,0,0,0.0,0,0,0,0,0,0,0,0,0,0
../kbl_data/2022-2023,S41G01N263,원주 DB,Away,이준희,5,2,5,40.0,0,2,0.0,2,7,28.6,1,3,33.3,1,1,2,4,0,1,0,0,1,2
../kbl_data/2022-2023,S41G01N263,원주 DB,Away,레나드 프리먼,13,6,10,60.0,0,0,0.0,6,10,60.0,1,2,50.0,6,7,13,1,1,0,0,2,0,1
../kbl_data/2022-2023,S41G01N263,원주 DB,Away,정호영,0,0,0,0.0,0,0,0.0,0,0,0.0,0,0,0.0,0,0,0,0,0,0,0,0,0,0
../kbl_data/2022-2023,S41G01N263,원주 DB,Away,이민석,0,0,2,0.0,0,3,0.0,0,5,0.0,0,0,0.0,0,3,3,1,0,0,1,0,1,3
../kbl_data/2022-2023,S41G01N263,원주 DB,Away,이선 알바노,3,0,6,0.0,1,5,20.0,1,11,9.1,0,0,0.0,0,3,3,2,1,0,0,0,2,2
../kbl_data/2022-2023,S41G01N263,원주 DB,Away,인승찬,0,0,0,0.0,0,0,0.0,0,0,0.0,0,0,0.0,0,0,0,0,0,0,0,0,0,0
../kbl_data/2022-2023,S41G01N263,원주 DB,Away,디존 데이비스,2,1,1,100.0,0,2,0.0,1,3,33.3,0,0,0.0,1,2,3,0,0,0,0,0,0,1
../kbl_data/2022-2023,S41G01N264,고양 캐롯,Home,김강선,14,3,4,75.0,2,5,40.0,5,9,55.6,2,2,100.0,2,1,3,2,1,0,0,0,0,2
../kbl_data/2022-2023,S41G01N264,고양 캐롯,Home,최현민,3,0,1,0.0,1,2,50.0,1,3,33.3,0,0,0.0,1,0,1,0,1,0,0,0,0,1
../kbl_data/2022-2023,S41G01N264,고양 캐롯,Home,임종일,0,0,0,0.0,0,0,0.0,0,0,0.0,0,0,0.0,0,0,0,0,0,0,0,0,0,0
../kbl_data/2022-2023,S41G01N264,고양 캐롯,Home,김진유,3,0,0,0.0,1,4,25.0,1,4,25.0,0,0,0.0,2,1,3,0,1,0,1,0,0,1
../kbl_data/2022-2023,S41G01N264,고양 캐롯,Home,김진용,2,1,5,20.0,0,1,0.0,1,6,16.7,0,0,0.0,0,1,1,0,1,0,0,0,0,3
../kbl_data/2022-2023,S41G01N264,고양 캐롯,Home,조한진,11,2,3,66.7,2,5,40.0,4,8,50.0,1,1,100.0,3,3,6,0,1,0,1,0,1,1
../kbl_data/2022-2023,S41G01N264,고양 캐롯,Home,김세창,0,0,0,0.0,0,0,0.0,0,0,0.0,0,0,0.0,0,0,0,1,0,0,0,0,0,1
../kbl_data/2022-2023,S41G01N264,고양 캐롯,Home,디드릭 로슨,20,7,18,38.9,2,4,50.0,9,22,40.9,0,0,0.0,4,7,11,3,2,0,0,0,3,0
../kbl_data/2022-2023,S41G01N264,고양 캐롯,Home,박진철,2,1,2,50.0,0,0,0.0,1,2,50.0,0,2,0.0,0,4,4,1,1,0,0,0,1,2
../kbl_data/2022-2023,S41G01N264,고양 캐롯,Home,이정현,24,8,11,72.7,0,7,0.0,8,18,44.4,8,10,80.0,0,3,3,6,0,0,0,0,2,4
../kbl_data/2022-2023,S41G01N264,고양 캐롯,Home,모리구치 히사시,1,0,1,0.0,0,2,0.0,0,3,0.0,1,2,50.0,1,1,2,0,0,0,0,0,0,2
../kbl_data/2022-2023,S41G01N264,고양 캐롯,Home,조나단 알렛지,3,0,1,0.0,1,2,50.0,1,3,33.3,0,0,0.0,0,1,1,0,0,0,0,0,0,2
../kbl_data/2022-2023,S41G01N264,울산 현대모비스,Away,함지훈,0,0,0,0.0,0,0,0.0,0,0,0.0,0,0,0.0,0,1,1,1,0,0,0,0,0,0
../kbl_data/2022-2023,S41G01N264,울산 현대모비스,Away,김현민,0,0,0,0.0,0,0,0.0,0,0,0.0,0,0,0.0,0,0,0,0,0,0,0,0,0,0
../kbl_data/2022-2023,S41G01N264,울산 현대모비스,Away,최진수,8,2,5,40.0,1,4,25.0,3,9,33.3,1,2,50.0,0,2,2,0,0,2,0,0,0,3
../kbl_data/2022-2023,S41G01N264,울산 현대모비스,Away,장재석,0,0,0,0.0,0,0,0.0,0,0,0.0,0,0,0.0,0,0,0,0,0,0,0,0,0,0
../kbl_data/2022-2023,S41G01N264,울산 현대모비스,Away,김영현,0,0,0,0.0,0,0,0.0,0,0,0.0,0,0,0.0,2,3,5,1,0,0,0,0,0,4
../kbl_data/2022-2023,S41G01N264,울산 현대모비스,Away,서명진,21,6,8,75.0,3,7,42.9,9,15,60.0,0,2,0.0,1,5,6,6,2,0,0,0,1,3
../kbl_data/2022-2023,S41G01N264,울산 현대모비스,Away,저스틴 녹스,10,4,5,80.0,0,0,0.0,4,5,80.0,2,4,50.0,1,3,4,1,0,0,0,1,1,2
../kbl_data/2022-2023,S41G01N264,울산 현대모비스,Away,이우석,2,1,1,100.0,0,0,0.0,1,1,100.0,0,0,0.0,0,1,1,1,1,0,0,0,1,0
../kbl_data/2022-2023,S41G01N264,울산 현대모비스,Away,신민석,0,0,0,0.0,0,1,0.0,0,1,0.0,0,0,0.0,1,6,7,0,1,0,0,0,4,4
../kbl_data/2022-2023,S41G01N264,울산 현대모비스,Away,론제이 아바리엔토스,14,2,4,50.0,2,6,33.3,4,10,40.0,4,4,100.0,0,1,1,6,2,0,0,0,5,2
../kbl_data/2022-2023,S41G01N264,울산 현대모비스,Away,게이지 프림,18,4,10,40.0,1,1,100.0,5,11,45.5,7,10,70.0,4,8,12,2,0,3,0,0,1,3
../kbl_data/2022-2023,S41G01N264,울산 현대모비스,Away,김태완,15,4,5,80.0,2,4,50.0,6,9,66.7,1,1,100.0,1,1,2,2,0,0,0,0,0,3
../kbl_data/2022-2023,S41G01N265,서울 삼성,Home,이정현,13,3,4,75.0,2,7,28.6,5,11,45.5,1,2,50.0,0,3,3,4,1,0,0,0,2,3
../kbl_data/2022-2023,S41G01N265,서울 삼성,Home,장민국,0,0,0,0.0,0,0,0.0,0,0,0.0,0,0,0.0,0,0,0,0,0,0,0,0,0,0
../kbl_data/2022-2023,S41G01N265,서울 삼성,Home,김승원,4,2,3,66.7,0,0,0.0,2,3,66.7,0,0,0.0,1,1,2,1,0,0,0,0,0,2
../kbl_data/2022-2023,S41G01N265,서울 삼성,Home,김시래,0,0,2,0.0,0,3,0.0,0,5,0.0,0,0,0.0,0,1,1,0,0,0,1,0,0,1
../kbl_data/2022-2023,S41G01N265,서울 삼성,Home,이동엽,12,3,4,75.0,2,5,40.0,5,9,55.6,0,0,0.0,0,3,3,1,0,0,0,0,0,1
../kbl_data/2022-2023,S41G01N265,서울 삼성,Home,이호현,9,3,6,50.0,1,5,20.0,4,11,36.4,0,0,0.0,0,3,3,3,0,0,0,0,1,0
../kbl_data/2022-2023,S41G01N265,서울 삼성,Home,김광철,1,0,1,0.0,0,0,0.0,0,1,0.0,1,2,50.0,1,0,1,1,2,0,0,0,0,2
../kbl_data/2022-2023,S41G01N265,서울 삼성,Home,김무성,0,0,0,0.0,0,0,0.0,0,0,0.0,0,0,0.0,0,0,0,0,0,0,0,0,0,0
../kbl_data/2022-2023,S41G01N265,서울 삼성,Home,차민석,1,0,1,0.0,0,0,0.0,0,1,0.0,1,2,50.0,0,3,3,3,0,0,0,0,0,1
../kbl_data/2022-2023,S41G01N265,서울 삼성,Home,이원석,13,0,4,0.0,3,3,100.0,3,7,42.9,4,4,100.0,0,6,6,0,1,2,0,0,1,4
../kbl_data/2022-2023,S41G01N265,서울 삼성,Home,신동혁,18,6,6,100.0,2,3,66.7,8,9,88.9,0,0,0.0,2,2,4,3,2,0,0,0,2,3
../kbl_data/2022-2023,S41G01N265,서울 삼성,Home,앤서니 모스,7,3,6,50.0,0,0,0.0,3,6,50.0,1,2,50.0,3,8,11,1,0,2,0,0,2,4
../kbl_data/2022-2023,S41G01N265,대구 한국가스공사,Away,차바위,1,0,1,0.0,0,3,0.0,0,4,0.0,1,2,50.0,2,3,5,2,2,0,1,0,0,2
../kbl_data/2022-2023,S41G01N265,대구 한국가스공사,Away,박지훈,0,0,0,0.0,0,0,0.0,0,0,0.0,0,0,0.0,0,0,0,0,0,0,0,0,0,0
../kbl_data/2022-2023,S41G01N265,대구 한국가스공사,Away,조상열,5,0,1,0.0,1,5,20.0,1,6,16.7,2,6,33.3,4,5,9,0,0,0,1,0,1,4
../kbl_data/2022-2023,S41G01N265,대구 한국가스공사,Away,이원대,0,0,0,0.0,0,0,0.0,0,0,0.0,0,0,0.0,0,0,0,0,0,0,0,0,0,0
../kbl_data/2022-2023,S41G01N265,대구 한국가스공사,Away,박봉진,0,0,0,0.0,0,1,0.0,0,1,0.0,0,0,0.0,0,0,0,0,0,0,0,0,0,1
../kbl_data/2022-2023,S41G01N265,대구 한국가스공사,Away,머피 할로웨이,8,3,8,37.5,0,0,0.0,3,8,37.5,2,2,100.0,8,6,14,2,0,1,0,1,3,0
../kbl_data/2022-2023,S41G01N265,대구 한국가스공사,Away,전현우,0,0,1,0.0,0,1,0.0,0,2,0.0,0,0,0.0,0,0,0,0,0,0,0,0,0,1
../kbl_data/2022-2023,S41G01N265,대구 한국가스공사,Away,양준우,3,0,2,0.0,1,3,33.3,1,5,20.0,0,0,0.0,0,2,2,2,0,0,0,0,0,4
../kbl_data/2022-2023,S41G01N265,대구 한국가스공사,Away,데본 스캇,8,3,7,42.9,0,1,0.0,3,8,37.5,2,2,100.0,1,2,3,0,0,0,0,0,2,1
../kbl_data/2022-2023,S41G01N265,대구 한국가스공사,Away,신승민,24,5,9,55.6,4,14,28.6,9,23,39.1,2,2,100.0,2,1,3,2,2,1,0,0,3,1
../kbl_data/2022-2023,S41G01N265,대구 한국가스공사,Away,샘조세프 벨란겔,8,2,6,33.3,1,5,20.0,3,11,27.3,1,2,50.0,0,2,2,5,1,1,0,0,0,1
../kbl_data/2022-2023,S41G01N265,대구 한국가스공사,Away,염유성,0,0,4,0.0,0,1,0.0,0,5,0.0,0,0,0.0,0,0,0,0,0,0,0,0,0,0
../kbl_data/2022-2023,S41G01N266,서울 SK,Home,양우섭,0,0,0,0.0,0,0,0.0,0,0,0.0,0,0,0.0,0,0,0,0,0,0,0,0,0,0
../kbl_data/2022-2023,S41G01N266,서울 SK,Home,허일영,7,1,3,33.3,1,6,16.7,2,9,22.2,2,2,100.0,1,5,6,1,0,0,0,0,0,3
../kbl_data/2022-2023,S41G01N266,서울 SK,Home,송창용,0,0,0,0.0,0,0,0.0,0,0,0.0,0,0,0.0,0,0,0,0,0,0,0,0,1,1
../kbl_data/2022-2023,S41G01N266,서울 SK,Home,김선형,25,11,14,78.6,1,1,100.0,12,15,80.0,0,0,0.0,0,1,1,8,2,0,0,0,1,3
../kbl_data/2022-2023,S41G01N266,서울 SK,Home,홍경기,0,0,0,0.0,0,0,0.0,0,0,0.0,0,0,0.0,0,0,0,0,0,0,0,0,0,0
../kbl_data/2022-2023,S41G01N266,서울 SK,Home,최부경,19,9,12,75.0,0,1,0.0,9,13,69.2,1,2,50.0,5,6,11,0,2,0,0,0,0,1
../kbl_data/2022-2023,S41G01N266,서울 SK,Home,리온 윌리엄스,0,0,0,0.0,0,0,0.0,0,0,0.0,0,0,0.0,0,0,0,0,0,0,0,0,0,0
../kbl_data/2022-2023,S41G01N266,서울 SK,Home,최원혁,0,0,0,0.0,0,1,0.0,0,1,0.0,0,0,0.0,0,0,0,0,0,0,0,0,2,0
../kbl_data/2022-2023,S41G01N266,서울 SK,Home,최성원,8,0,0,0.0,2,4,50.0,2,4,50.0,2,2,100.0,1,3,4,2,1,0,0,0,0,4
../kbl_data/2022-2023,S41G01N266,서울 SK,Home,자밀 워니,18,7,18,38.9,0,1,0.0,7,19,36.8,4,5,80.0,2,7,9,5,1,1,0,0,0,0
../kbl_data/2022-2023,S41G01N266,서울 SK,Home,김형빈,0,0,1,0.0,0,1,0.0,0,2,0.0,0,0,0.0,0,1,1,0,0,0,0,0,1,1
../kbl_data/2022-2023,S41G01N266,서울 SK,Home,오재현,9,3,5,60.0,1,4,25.0,4,9,44.4,0,0,0.0,0,3,3,3,2,0,0,0,1,3
../kbl_data/2022-2023,S41G01N266,원주 DB,Away,김종규,19,9,14,64.3,0,1,0.0,9,15,60.0,1,1,100.0,1,6,7,3,0,1,0,0,1,3
../kbl_data/2022-2023,S41G01N266,원주 DB,Away,최승욱,4,2,3,66.7,0,1,0.0,2,4,50.0,0,0,0.0,1,3,4,0,0,0,0,0,0,1
../kbl_data/2022-2023,S41G01N266,원주 DB,Away,강상재,6,3,6,50.0,0,2,0.0,3,8,37.5,0,0,0.0,0,4,4,0,0,0,0,0,1,0
../kbl_data/2022-2023,S41G01N266,원주 DB,Away,윤성원,0,0,0,0.0,0,0,0.0,0,0,0.0,0,0,0.0,0,0,0,0,0,0,0,0,0,0
../kbl_data/2022-2023,S41G01N266,원주 DB,Away,이윤수,0,0,0,0.0,0,0,0.0,0,0,0.0,0,0,0.0,0,0,0,0,0,0,0,0,0,0
../kbl_data/2022-2023,S41G01N266,원주 DB,Away,이준희,8,1,3,33.3,1,4,25.0,2,7,28.6,3,4,75.0,1,1,2,2,0,0,0,0,2,2
../kbl_data/2022-2023,S41G01N266,원주 DB,Away,레나드 프리먼,8,4,5,80.0,0,0,0.0,4,5,80.0,0,0,0.0,2,6,8,2,1,0,0,0,0,3
../kbl_data/2022-2023,S41G01N266,원주 DB,Away,정호영,12,4,5,80.0,1,4,25.0,5,9,55.6,1,2,50.0,1,2,3,8,0,0,0,0,2,2
../kbl_data/2022-2023,S41G01N266,원주 DB,Away,이민석,0,0,0,0.0,0,0,0.0,0,0,0.0,0,0,0.0,0,0,0,0,0,0,0,0,0,0
../kbl_data/2022-2023,S41G01N266,원주 DB,Away,이선 알바노,12,2,4,50.0,2,3,66.7,4,7,57.1,2,2,100.0,0,1,1,3,1,0,1,0,3,1
../kbl_data/2022-2023,S41G01N266,원주 DB,Away,김형준,0,0,0,0.0,0,1,0.0,0,1,0.0,0,0,0.0,0,0,0,0,0,0,0,0,0,0
../kbl_data/2022-2023,S41G01N266,원주 DB,Away,디존 데이비스,6,3,4,75.0,0,4,0.0,3,8,37.5,0,0,0.0,1,1,2,0,0,0,0,1,1,1
../kbl_data/2022-2023,S41G01N267,창원 LG,Home,이관희,26,6,9,66.7,3,5,60.0,9,14,64.3,5,7,71.4,0,4,4,8,4,0,1,0,2,1
../kbl_data/2022-2023,S41G01N267,창원 LG,Home,정희재,2,1,1,100.0,0,0,0.0,1,1,100.0,0,0,0.0,1,0,1,2,1,0,0,0,1,1
../kbl_data/2022-2023,S41G01N267,창원 LG,Home,임동섭,0,0,1,0.0,0,0,0.0,0,1,0.0,0,0,0.0,0,0,0,0,0,0,0,0,0,1
../kbl_data/2022-2023,S41G01N267,창원 LG,Home,서민수,0,0,0,0.0,0,0,0.0,0,0,0.0,0,0,0.0,0,0,0,0,0,0,0,0,0,1
../kbl_data/2022-2023,S41G01N267,창원 LG,Home,이재도,7,3,5,60.0,0,4,0.0,3,9,33.3,1,2,50.0,0,3,3,6,3,0,0,0,2,2
../kbl_data/2022-2023,S41G01N267,창원 LG,Home,김준일,15,4,6,66.7,0,0,0.0,4,6,66.7,7,8,87.5,0,3,3,0,1,0,0,0,0,4
../kbl_data/2022-2023,S41G01N267,창원 LG,Home,정인덕,0,0,0,0.0,0,0,0.0,0,0,0.0,0,0,0.0,0,0,0,0,0,0,0,0,0,0
../kbl_data/2022-2023,S41G01N267,창원 LG,Home,윤원상,2,1,4,25.0,0,0,0.0,1,4,25.0,0,0,0.0,1,1,2,0,0,0,0,0,0,4
../kbl_data/2022-2023,S41G01N267,창원 LG,Home,아셈 마레이,6,2,4,50.0,0,0,0.0,2,4,50.0,2,2,100.0,1,3,4,3,0,0,0,1,2,0
../kbl_data/2022-2023,S41G01N267,창원 LG,Home,저스틴 구탕,9,3,4,75.0,1,1,100.0,4,5,80.0,0,0,0.0,1,3,4,4,1,0,0,1,2,2
../kbl_data/2022-2023,S41G01N267,창원 LG,Home,양준석,0,0,0,0.0,0,0,0.0,0,0,0.0,0,0,0.0,0,0,0,0,0,0,0,0,0,0
../kbl_data/2022-2023,S41G01N267,창원 LG,Home,단테 커닝햄,30,11,15,73.3,0,1,0.0,11,16,68.8,8,9,88.9,0,4,4,1,0,0,0,3,0,4
../kbl_data/2022-2023,S41G01N267,울산 현대모비스,Away,함지훈,2,0,1,0.0,0,0,0.0,0,1,0.0,2,2,100.0,2,1,3,1,0,0,0,0,0,1
../kbl_data/2022-2023,S41G01N267,울산 현대모비스,Away,김현민,0,0,0,0.0,0,0,0.0,0,0,0.0,0,0,0.0,0,0,0,0,0,0,0,0,0,0
../kbl_data/2022-2023,S41G01N267,울산 현대모비스,Away,최진수,7,2,5,40.0,1,1,100.0,3,6,50.0,0,0,0.0,1,1,2,2,0,0,0,0,1,4
../kbl_data/2022-2023,S41G01N267,울산 현대모비스,Away,장재석,2,1,3,33.3,0,0,0.0,1,3,33.3,0,0,0.0,1,1,2,0,1,0,0,0,1,4
../kbl_data/2022-2023,S41G01N267,울산 현대모비스,Away,김영현,2,1,1,100.0,0,0,0.0,1,1,100.0,0,0,0.0,0,0,0,0,1,0,0,0,1,2
../kbl_data/2022-2023,S41G01N267,울산 현대모비스,Away,서명진,17,6,10,60.0,1,6,16.7,7,16,43.8,2,2,100.0,2,2,4,3,1,0,0,0,3,3
../kbl_data/2022-2023,S41G01N267,울산 현대모비스,Away,저스틴 녹스,2,1,1,100.0,0,1,0.0,1,2,50.0,0,0,0.0,1,2,3,1,0,0,0,0,1,2
../kbl_data/2022-2023,S41G01N267,울산 현대모비스,Away,이우석,9,3,6,50.0,1,2,50.0,4,8,50.0,0,0,0.0,1,2,3,0,1,0,0,0,3,2
../kbl_data/2022-2023,S41G01N267,울산 현대모비스,Away,신민석,0,0,0,0.0,0,2,0.0,0,2,0.0,0,0,0.0,0,0,0,0,0,0,0,0,1,0
../kbl_data/2022-2023,S41G01N267,울산 현대모비스,Away,론제이 아바리엔토스,21,1,1,100.0,5,12,41.7,6,13,46.2,4,4,100.0,1,3,4,4,2,0,0,0,3,3
../kbl_data/2022-2023,S41G01N267,울산 현대모비스,Away,게이지 프림,26,11,15,73.3,0,2,0.0,11,17,64.7,4,5,80.0,5,6,11,3,2,2,0,0,0,2
../kbl_data/2022-2023,S41G01N267,울산 현대모비스,Away,김태완,0,0,0,0.0,0,0,0.0,0,0,0.0,0,0,0.0,0,0,0,1,0,0,0,0,0,2
../kbl_data/2022-2023,S41G01N268,수원 KT,Home,한희원,7,3,5,60.0,0,0,0.0,3,5,60.0,1,2,50.0,1,1,2,1,0,0,0,0,0,5
../kbl_data/2022-2023,S41G01N268,수원 KT,Home,최창진,0,0,0,0.0,0,0,0.0,0,0,0.0,0,0,0.0,0,0,0,0,0,0,0,0,0,0
../kbl_data/2022-2023,S41G01N268,수원 KT,Home,이현석,0,0,0,0.0,0,1,0.0,0,1,0.0,0,0,0.0,0,1,1,1,0,0,0,0,0,0
../kbl_data/2022-2023,S41G01N268,수원 KT,Home,정성우,17,4,6,66.7,2,4,50.0,6,10,60.0,3,3,100.0,0,3,3,7,2,0,0,0,1,3
../kbl_data/2022-2023,S41G01N268,수원 KT,Home,최성모,5,0,0,0.0,1,3,33.3,1,3,33.3,2,2,100.0,0,2,2,2,1,1,0,0,0,1
../kbl_data/2022-2023,S41G01N268,수원 KT,Home,양홍석,10,3,6,50.0,1,8,12.5,4,14,28.6,1,1,100.0,2,4,6,2,0,1,0,0,1,0
../kbl_data/2022-2023,S41G01N268,수원 KT,Home,박지원,0,0,1,0.0,0,0,0.0,0,1,0.0,0,0,0.0,0,0,0,0,0,0,0,0,0,1
../kbl_data/2022-2023,S41G01N268,수원 KT,Home,김준환,0,0,1,0.0,0,1,0.0,0,2,0.0,0,0,0.0,1,1,2,0,1,0,0,0,1,1
../kbl_data/2022-2023,S41G01N268,수원 KT,Home,이두원,16,5,8,62.5,0,0,0.0,5,8,62.5,6,8,75.0,2,6,8,0,0,1,0,3,0,1
../kbl_data/2022-2023,S41G01N268,수원 KT,Home,레스터 프로스퍼,20,5,7,71.4,3,6,50.0,8,13,61.5,1,1,100.0,1,6,7,0,0,1,0,1,1,3
../kbl_data/2022-2023,S41G01N268,수원 KT,Home,재로드 존스,7,1,6,16.7,1,5,20.0,2,11,18.2,2,2,100.0,2,6,8,2,1,1,0,0,2,2
../kbl_data/2022-2023,S41G01N268,수원 KT,Home,데이브 일데폰소,2,1,3,33.3,0,0,0.0,1,3,33.3,0,0,0.0,1,0,1,0,0,0,0,0,0,1
../kbl_data/2022-2023,S41G01N268,서울 삼성,Away,이정현,10,1,4,25.0,2,8,25.0,3,12,25.0,2,2,100.0,1,1,2,3,0,0,0,0,2,0
../kbl_data/2022-2023,S41G01N268,서울 삼성,Away,장민국,0,0,0,0.0,0,0,0.0,0,0,0.0,0,0,0.0,0,0,0,0,0,0,0,0,0,0
../kbl_data/2022-2023,S41G01N268,서울 삼성,Away,김승원,0,0,2,0.0,0,0,0.0,0,2,0.0,0,0,0.0,1,0,1,0,0,0,0,0,0,2
../kbl_data/2022-2023,S41G01N268,서울 삼성,Away,김시래,7,2,5,40.0,0,2,0.0,2,7,28.6,3,3,100.0,0,2,2,4,0,0,0,0,0,2
../kbl_data/2022-2023,S41G01N268,서울 삼성,Away,이동엽,5,1,4,25.0,1,3,33.3,2,7,28.6,0,0,0.0,2,3,5,2,1,0,0,0,0,4
../kbl_data/2022-2023,S41G01N268,서울 삼성,Away,이호현,15,6,8,75.0,1,3,33.3,7,11,63.6,0,0,0.0,2,1,3,2,1,0,0,0,0,1
../kbl_data/2022-2023,S41G01N268,서울 삼성,Away,김광철,0,0,0,0.0,0,0,0.0,0,0,0.0,0,0,0.0,0,0,0,0,0,0,0,0,0,0
../kbl_data/2022-2023,S41G01N268,서울 삼성,Away,김무성,0,0,0,0.0,0,0,0.0,0,0,0.0,0,0,0.0,0,0,0,0,0,0,0,0,0,0
../kbl_data/2022-2023,S41G01N268,서울 삼성,Away,차민석,4,2,4,50.0,0,0,0.0,2,4,50.0,0,0,0.0,1,1,2,0,0,0,0,0,2,3
../kbl_data/2022-2023,S41G01N268,서울 삼성,Away,이원석,9,4,10,40.0,0,3,0.0,4,13,30.8,1,1,100.0,1,2,3,1,1,2,0,1,0,3
../kbl_data/2022-2023,S41G01N268,서울 삼성,Away,신동혁,10,2,6,33.3,2,4,50.0,4,10,40.0,0,0,0.0,3,4,7,3,1,0,0,0,1,0
../kbl_data/2022-2023,S41G01N268,서울 삼성,Away,앤서니 모스,21,8,16,50.0,0,0,0.0,8,16,50.0,5,6,83.3,4,14,18,2,0,1,0,1,3,0
../kbl_data/2022-2023,S41G01N269,전주 KCC,Home,정창영,8,1,3,33.3,2,4,50.0,3,7,42.9,0,0,0.0,1,5,6,0,0,0,0,0,0,3
../kbl_data/2022-2023,S41G01N269,전주 KCC,Home,라건아,12,6,10,60.0,0,3,0.0,6,13,46.2,0,0,0.0,2,2,4,2,0,0,0,0,1,1
../kbl_data/2022-2023,S41G01N269,전주 KCC,Home,박경상,5,1,1,100.0,0,1,0.0,1,2,50.0,3,4,75.0,1,1,2,1,0,0,1,0,0,4
../kbl_data/2022-2023,S41G01N269,전주 KCC,Home,김지완,0,0,1,0.0,0,3,0.0,0,4,0.0,0,0,0.0,0,2,2,0,0,0,0,0,2,2
../kbl_data/2022-2023,S41G01N269,전주 KCC,Home,전준범,6,1,1,100.0,1,5,20.0,2,6,33.3,1,2,50.0,0,4,4,1,1,0,0,0,1,2
../kbl_data/2022-2023,S41G01N269,전주 KCC,Home,허웅,11,2,2,100.0,2,5,40.0,4,7,57.1,1,2,50.0,0,1,1,2,1,0,0,0,2,1
../kbl_data/2022-2023,S41G01N269,전주 KCC,Home,이승현,3,0,2,0.0,0,1,0.0,0,3,0.0,3,6,50.0,2,2,4,4,0,0,0,0,0,1
../kbl_data/2022-2023,S41G01N269,전주 KCC,Home,이종현,0,0,1,0.0,0,0,0.0,0,1,0.0,0,0,0.0,0,0,0,0,0,0,0,0,1,0
../kbl_data/2022-2023,S41G01N269,전주 KCC,Home,이진욱,2,1,1,100.0,0,0,0.0,1,1,100.0,0,0,0.0,0,0,0,1,1,0,0,0,0,0
../kbl_data/2022-2023,S41G01N269,전주 KCC,Home,이근휘,0,0,0,0.0,0,1,0.0,0,1,0.0,0,0,0.0,0,2,2,0,0,0,0,0,0,1
../kbl_data/2022-2023,S41G01N269,전주 KCC,Home,김동현,3,1,2,50.0,0,1,0.0,1,3,33.3,1,2,50.0,0,0,0,0,1,0,0,0,0,2
../kbl_data/2022-2023,S41G01N269,전주 KCC,Home,디온 탐슨,7,3,7,42.9,0,1,0.0,3,8,37.5,1,4,25.0,0,6,6,2,0,2,0,1,2,0
../kbl_data/2022-2023,S41G01N269,대구 한국가스공사,Away,차바위,0,0,0,0.0,0,0,0.0,0,0,0.0,0,0,0.0,0,0,0,0,0,0,0,0,0,0
../kbl_data/2022-2023,S41G01N269,대구 한국가스공사,Away,박지훈,11,1,2,50.0,3,3,100.0,4,5,80.0,0,0,0.0,5,3,8,1,0,0,0,0,0,4
../kbl_data/2022-2023,S41G01N269,대구 한국가스공사,Away,조상열,6,1,2,50.0,1,2,50.0,2,4,50.0,1,1,100.0,0,1,1,2,0,0,0,0,1,2
../kbl_data/2022-2023,S41G01N269,대구 한국가스공사,Away,이원대,2,1,2,50.0,0,1,0.0,1,3,33.3,0,0,0.0,0,1,1,0,0,0,0,0,2,0
../kbl_data/2022-2023,S41G01N269,대구 한국가스공사,Away,박봉진,5,0,2,0.0,1,2,50.0,1,4,25.0,2,2,100.0,0,1,1,0,1,0,0,0,0,2
../kbl_data/2022-2023,S41G01N269,대구 한국가스공사,Away,머피 할로웨이,10,5,10,50.0,0,0,0.0,5,10,50.0,0,0,0.0,4,12,16,2,3,1,0,2,3,3
../kbl_data/2022-2023,S41G01N269,대구 한국가스공사,Away,박찬호,0,0,1,0.0,0,0,0.0,0,1,0.0,0,0,0.0,0,0,0,0,0,0,0,0,0,1
../kbl_data/2022-2023,S41G01N269,대구 한국가스공사,Away,양준우,8,0,3,0.0,2,4,50.0,2,7,28.6,2,2,100.0,0,1,1,7,1,0,0,0,2,4
../kbl_data/2022-2023,S41G01N269,대구 한국가스공사,Away,데본 스캇,8,4,6,66.7,0,4,0.0,4,10,40.0,0,5,0.0,1,5,6,4,1,1,0,1,1,0
../kbl_data/2022-2023,S41G01N269,대구 한국가스공사,Away,신승민,9,4,4,100.0,0,4,0.0,4,8,50.0,1,2,50.0,1,2,3,3,0,0,0,0,0,2
../kbl_data/2022-2023,S41G01N269,대구 한국가스공사,Away,샘조세프 벨란겔,9,3,6,50.0,1,3,33.3,4,9,44.4,0,0,0.0,2,1,3,1,1,0,0,0,0,4
../kbl_data/2022-2023,S41G01N269,대구 한국가스공사,Away,염유성,7,2,3,66.7,1,4,25.0,3,7,42.9,0,0,0.0,0,2,2,0,1,0,0,0,1,0
../kbl_data/2022-2023,S41G01N270,고양 캐롯,Home,김강선,3,0,1,0.0,1,4,25.0,1,5,20.0,0,0,0.0,1,1,2,0,0,0,0,0,0,1
../kbl_data/2022-2023,S41G01N270,고양 캐롯,Home,최현민,19,4,5,80.0,2,7,28.6,6,12,50.0,5,5,100.0,3,3,6,0,0,0,0,0,0,3
../kbl_data/2022-2023,S41G01N270,고양 캐롯,Home,임종일,0,0,1,0.0,0,1,0.0,0,2,0.0,0,0,0.0,0,1,1,1,0,0,0,0,0,2
../kbl_data/2022-2023,S41G01N270,고양 캐롯,Home,김진유,6,1,1,100.0,0,4,0.0,1,5,20.0,4,5,80.0,1,11,12,4,2,0,0,0,1,3
../kbl_data/2022-2023,S41G01N270,고양 캐롯,Home,김진용,6,3,4,75.0,0,0,0.0,3,4,75.0,0,0,0.0,2,0,2,0,1,0,0,0,0,2
../kbl_data/2022-2023,S41G01N270,고양 캐롯,Home,조한진,15,0,0,0.0,5,12,41.7,5,12,41.7,0,0,0.0,0,3,3,1,0,1,0,0,0,2
../kbl_data/2022-2023,S41G01N270,고양 캐롯,Home,김세창,0,0,0,0.0,0,0,0.0,0,0,0.0,0,0,0.0,0,0,0,0,0,0,0,0,0,0
../kbl_data/2022-2023,S41G01N270,고양 캐롯,Home,디드릭 로슨,7,2,4,50.0,1,2,50.0,3,6,50.0,0,0,0.0,2,3,5,2,1,0,0,1,0,0
../kbl_data/2022-2023,S41G01N270,고양 캐롯,Home,박진철,5,2,3,66.7,0,0,0.0,2,3,66.7,1,1,100.0,1,0,1,0,0,0,0,0,0,0
../kbl_data/2022-2023,S41G01N270,고양 캐롯,Home,이정현,16,5,6,83.3,2,6,33.3,7,12,58.3,0,0,0.0,0,0,0,3,0,0,1,0,0,3
../kbl_data/2022-2023,S41G01N270,고양 캐롯,Home,모리구치 히사시,10,4,7,57.1,0,0,0.0,4,7,57.1,2,3,66.7,2,1,3,4,3,0,0,0,0,1
../kbl_data/2022-2023,S41G01N270,고양 캐롯,Home,조나단 알렛지,14,1,3,33.3,3,11,27.3,4,14,28.6,3,4,75.0,2,3,5,3,0,1,0,0,2,1
../kbl_data/2022-2023,S41G01N270,안양 KGC,Away,함준후,9,3,4,75.0,1,2,50.0,4,6,66.7,0,0,0.0,1,1,2,1,0,0,0,0,1,2
../kbl_data/2022-2023,S41G01N270,안양 KGC,Away,정준원,15,5,8,62.5,1,3,33.3,6,11,54.5,2,2,100.0,1,5,6,1,0,0,0,0,1,1
../kbl_data/2022-2023,S41G01N270,안양 KGC,Away,박지훈,11,4,7,57.1,1,2,50.0,5,9,55.6,0,0,0.0,1,2,3,5,0,0,0,0,1,3
../kbl_data/2022-2023,S41G01N270,안양 KGC,Away,이우정,3,0,1,0.0,1,6,16.7,1,7,14.3,0,0,0.0,1,1,2,3,1,0,0,0,3,0
../kbl_data/2022-2023,S41G01N270,안양 KGC,Away,대릴 먼로,2,1,4,25.0,0,1,0.0,1,5,20.0,0,0,0.0,0,8,8,6,0,0,0,0,1,2
../kbl_data/2022-2023,S41G01N270,안양 KGC,Away,변준형,0,0,0,0.0,0,0,0.0,0,0,0.0,0,0,0.0,0,0,0,0,0,0,0,0,0,0
../kbl_data/2022-2023,S41G01N270,안양 KGC,Away,김경원,4,2,3,66.7,0,0,0.0,2,3,66.7,0,0,0.0,1,3,4,0,0,2,0,0,1,3
../kbl_data/2022-2023,S41G01N270,안양 KGC,Away,한승희,12,4,7,57.1,1,3,33.3,5,10,50.0,1,2,50.0,2,2,4,0,0,0,0,0,3,3
../kbl_data/2022-2023,S41G01N270,안양 KGC,Away,오마리 스펠맨,0,0,0,0.0,0,0,0.0,0,0,0.0,0,0,0.0,0,0,0,0,0,0,0,0,0,0
../kbl_data/2022-2023,S41G01N270,안양 KGC,Away,렌즈 아반도,9,3,4,75.0,0,3,0.0,3,7,42.9,3,3,100.0,1,6,7,2,0,2,0,1,4,3
../kbl_data/2022-2023,S41G01N270,안양 KGC,Away,고찬혁,5,0,3,0.0,1,3,33.3,1,6,16.7,2,2,100.0,0,1,1,0,0,0,0,0,0,2
../kbl_data/2022-2023,S41G01N270,안양 KGC,Away,유진,2,0,0,0.0,0,1,0.0,0,1,0.0,2,2,100.0,0,1,1,1,0,0,0,0,0,1
../kbl_data/2023-2024,S43G01N1,안양 정관장,Home,정준원,0,0,0,0.0,0,0,0.0,0,0,0.0,0,0,0.0,0,0,0,0,0,0,0,0,0,0
../kbl_data/2023-2024,S43G01N1,안양 정관장,Home,배병준,7,2,2,100.0,1,3,33.3,3,5,60.0,0,0,0.0,0,1,1,3,0,0,0,0,3,3
../kbl_data/2023-2024,S43G01N1,안양 정관장,Home,이종현,11,4,4,100.0,0,0,0.0,4,4,100.0,3,4,75.0,0,2,2,0,0,1,0,0,0,1
../kbl_data/2023-2024,S43G01N1,안양 정관장,Home,김철욱,0,0,0,0.0,0,0,0.0,0,0,0.0,0,0,0.0,0,0,0,0,0,0,0,0,0,0
../kbl_data/2023-2024,S43G01N1,안양 정관장,Home,박지훈,6,1,6,16.7,1,1,100.0,2,7,28.6,1,2,50.0,0,2,2,3,0,0,0,0,2,1
../kbl_data/2023-2024,S43G01N1,안양 정관장,Home,최성원,3,0,3,0.0,1,5,20.0,1,8,12.5,0,0,0.0,0,1,1,6,0,0,0,0,5,2
../kbl_data/2023-2024,S43G01N1,안양 정관장,Home,대릴 먼로,21,8,12,66.7,1,2,50.0,9,14,64.3,2,2,100.0,1,5,6,2,1,0,0,1,0,0
../kbl_data/2023-2024,S43G01N1,안양 정관장,Home,김경원,4,2,3,66.7,0,0,0.0,2,3,66.7,0,0,0.0,5,3,8,2,0,2,0,0,0,3
../kbl_data/2023-2024,S43G01N1,안양 정관장,Home,조은후,0,0,0,0.0,0,0,0.0,0,0,0.0,0,0,0.0,0,0,0,0,0,0,0,0,0,0
../kbl_data/2023-2024,S43G01N1,안양 정관장,Home,렌즈 아반도,12,5,10,50.0,0,4,0.0,5,14,35.7,2,2,100.0,1,4,5,0,0,1,0,1,0,2
../kbl_data/2023-2024,S43G01N1,안양 정관장,Home,고찬혁,0,0,0,0.0,0,0,0.0,0,0,0.0,0,0,0.0,0,0,0,0,0,0,0,0,0,0
../kbl_data/2023-2024,S43G01N1,안양 정관장,Home,듀반 맥스웰,10,4,6,66.7,0,1,0.0,4,7,57.1,2,2,100.0,1,8,9,2,1,0,0,0,1,4
../kbl_data/2023-2024,S43G01N1,서울 SK,Away,허일영,4,2,3,66.7,0,3,0.0,2,6,33.3,0,0,0.0,3,0,3,2,1,0,0,0,0,2
../kbl_data/2023-2024,S43G01N1,서울 SK,Away,송창용,5,1,2,50.0,1,2,50.0,2,4,50.0,0,0,0.0,0,1,1,0,0,0,0,0,0,1
../kbl_data/2023-2024,S43G01N1,서울 SK,Away,김선형,7,2,6,33.3,1,3,33.3,3,9,33.3,0,0,0.0,2,2,4,6,1,0,0,0,1,4
../kbl_data/2023-2024,S43G01N1,서울 SK,Away,홍경기,0,0,0,0.0,0,0,0.0,0,0,0.0,0,0,0.0,0,0,0,0,0,0,0,0,0,0
../kbl_data/2023-2024,S43G01N1,서울 SK,Away,오세근,8,1,2,50.0,2,4,50.0,3,6,50.0,0,0,0.0,0,5,5,5,0,0,0,0,1,2
../kbl_data/2023-2024,S43G01N1,서울 SK,Away,최부경,2,0,3,0.0,0,2,0.0,0,5,0.0,2,2,100.0,0,2,2,0,0,0,0,0,0,1
../kbl_data/2023-2024,S43G01N1,서울 SK,Away,리온 윌리엄스,6,2,4,50.0,0,0,0.0,2,4,50.0,2,2,100.0,1,1,2,0,0,0,0,0,0,0
../kbl_data/2023-2024,S43G01N1,서울 SK,Away,최원혁,0,0,0,0.0,0,0,0.0,0,0,0.0,0,0,0.0,0,0,0,0,0,0,0,0,0,0
../kbl_data/2023-2024,S43G01N1,서울 SK,Away,자밀 워니,46,20,30,66.7,2,4,50.0,22,34,64.7,0,4,0.0,3,8,11,0,3,0,0,0,1,1
../kbl_data/2023-2024,S43G01N1,서울 SK,Away,김형빈,1,0,0,0.0,0,0,0.0,0,0,0.0,1,2,50.0,1,1,2,0,0,0,0,0,0,0
../kbl_data/2023-2024,S43G01N1,서울 SK,Away,오재현,2,0,1,0.0,0,2,0.0,0,3,0.0,2,2,100.0,1,1,2,3,2,0,0,0,0,3
../kbl_data/2023-2024,S43G01N1,서울 SK,Away,고메즈 딜 리아노,8,1,4,25.0,2,3,66.7,3,7,42.9,0,0,0.0,2,3,5,3,2,0,0,0,0,1
../kbl_data/2023-2024,S43G01N2,창원 LG,Home,이관희,14,4,9,44.4,2,6,33.3,6,15,40.0,0,0,0.0,1,2,3,2,0,0,0,0,2,0
../kbl_data/2023-2024,S43G01N2,창원 LG,Home,정희재,6,0,0,0.0,2,5,40.0,2,5,40.0,0,0,0.0,0,1,1,2,1,0,0,0,1,4
../kbl_data/2023-2024,S43G01N2,창원 LG,Home,임동섭,6,0,0,0.0,2,4,50.0,2,4,50.0,0,0,0.0,0,0,0,0,1,0,0,0,0,0
../kbl_data/2023-2024,S43G01N2,창원 LG,Home,이재도,7,2,5,40.0,1,5,20.0,3,10,30.0,0,0,0.0,1,1,2,2,1,0,1,0,3,3
../kbl_data/2023-2024,S43G01N2,창원 LG,Home,박인태,0,0,0,0.0,0,0,0.0,0,0,0.0,0,0,0.0,0,0,0,0,0,0,0,0,0,1
../kbl_data/2023-2024,S43G01N2,창원 LG,Home,양홍석,6,3,6,50.0,0,5,0.0,3,11,27.3,0,0,0.0,4,1,5,1,3,0,0,0,2,4
../kbl_data/2023-2024,S43G01N2,창원 LG,Home,윤원상,4,2,2,100.0,0,3,0.0,2,5,40.0,0,0,0.0,2,1,3,0,0,0,0,0,0,0
../kbl_data/2023-2024,S43G01N2,창원 LG,Home,아셈 마레이,17,7,18,38.9,0,0,0.0,7,18,38.9,3,6,50.0,6,7,13,3,2,1,1,0,2,4
../kbl_data/2023-2024,S43G01N2,창원 LG,Home,저스틴 구탕,0,0,0,0.0,0,0,0.0,0,0,0.0,0,0,0.0,2,0,2,0,0,0,0,0,1,0
../kbl_data/2023-2024,S43G01N2,창원 LG,Home,양준석,0,0,1,0.0,0,2,0.0,0,3,0.0,0,2,0.0,0,4,4,1,0,0,0,0,0,0
../kbl_data/2023-2024,S43G01N2,창원 LG,Home,단테 커닝햄,6,2,5,40.0,0,0,0.0,2,5,40.0,2,2,100.0,1,4,5,0,0,0,0,1,0,0
../kbl_data/2023-2024,S43G01N2,창원 LG,Home,유기상,0,0,0,0.0,0,0,0.0,0,0,0.0,0,0,0.0,0,0,0,0,0,0,0,0,0,0
../kbl_data/2023-2024,S43G01N2,수원 KT,Away,한희원,9,3,3,100.0,1,8,12.5,4,11,36.4,0,0,0.0,1,4,5,1,0,2,0,0,0,4
../kbl_data/2023-2024,S43G01N2,수원 KT,Away,최창진,2,1,2,50.0,0,1,0.0,1,3,33.3,0,0,0.0,2,3,5,2,0,0,0,0,0,2
../kbl_data/2023-2024,S43G01N2,수원 KT,Away,이현석,6,0,0,0.0,2,2,100.0,2,2,100.0,0,0,0.0,0,3,3,0,0,0,0,0,0,1
../kbl_data/2023-2024,S43G01N2,수원 KT,Away,정성우,3,1,5,20.0,0,5,0.0,1,10,10.0,1,2,50.0,0,0,0,5,1,0,1,0,2,2
../kbl_data/2023-2024,S43G01N2,수원 KT,Away,최성모,0,0,0,0.0,0,1,0.0,0,1,0.0,0,0,0.0,0,0,0,0,0,0,0,0,0,1
../kbl_data/2023-2024,S43G01N2,수원 KT,Away,최진광,0,0,0,0.0,0,0,0.0,0,0,0.0,0,0,0.0,0,0,0,1,0,0,0,0,0,0
../kbl_data/2023-2024,S43G01N2,수원 KT,Away,하윤기,20,6,11,54.5,0,0,0.0,6,11,54.5,8,10,80.0,2,3,5,0,0,1,0,1,3,3
../kbl_data/2023-2024,S43G01N2,수원 KT,Away,이두원,3,1,1,100.0,0,0,0.0,1,1,100.0,1,1,100.0,1,0,1,0,0,0,0,0,1,0
../kbl_data/2023-2024,S43G01N2,수원 KT,Away,숀 데이브 일데폰소,0,0,0,0.0,0,0,0.0,0,0,0.0,0,0,0.0,0,0,0,0,0,0,0,0,1,0
../kbl_data/2023-2024,S43G01N2,수원 KT,Away,문정현,2,1,1,100.0,0,2,0.0,1,3,33.3,0,0,0.0,3,3,6,2,2,0,0,0,1,1
../kbl_data/2023-2024,S43G01N2,수원 KT,Away,마이클 에릭,10,5,8,62.5,0,0,0.0,5,8,62.5,0,0,0.0,4,5,9,0,0,0,0,0,1,3
../kbl_data/2023-2024,S43G01N2,수원 KT,Away,패리스 배스,16,3,9,33.3,3,7,42.9,6,16,37.5,1,2,50.0,1,8,9,4,1,2,0,1,3,0
../kbl_data/2023-2024,S43G01N3,울산 현대모비스,Home,함지훈,2,1,1,100.0,0,0,0.0,1,1,100.0,0,0,0.0,0,1,1,0,0,0,0,0,0,0
../kbl_data/2023-2024,S43G01N3,울산 현대모비스,Home,장재석,6,3,6,50.0,0,0,0.0,3,6,50.0,0,0,0.0,0,1,1,0,1,0,0,0,1,5
../kbl_data/2023-2024,S43G01N3,울산 현대모비스,Home,김지완,0,0,0,0.0,0,0,0.0,0,0,0.0,0,0,0.0,0,0,0,2,0,0,0,0,0,0
../kbl_data/2023-2024,S43G01N3,울산 현대모비스,Home,김준일,9,3,4,75.0,0,0,0.0,3,4,75.0,3,4,75.0,2,2,4,3,3,0,0,1,3,4
../kbl_data/2023-2024,S43G01N3,울산 현대모비스,Home,김국찬,17,1,1,100.0,4,5,80.0,5,6,83.3,3,4,75.0,0,3,3,1,0,0,0,0,0,2
../kbl_data/2023-2024,S43G01N3,울산 현대모비스,Home,서명진,12,3,5,60.0,2,5,40.0,5,10,50.0,0,0,0.0,0,4,4,4,1,0,0,0,1,1
../kbl_data/2023-2024,S43G01N3,울산 현대모비스,Home,박준은,0,0,0,0.0,0,2,0.0,0,2,0.0,0,0,0.0,0,2,2,0,0,0,0,0,1,0
../kbl_data/2023-2024,S43G01N3,울산 현대모비스,Home,이우석,7,2,4,50.0,1,2,50.0,3,6,50.0,0,0,0.0,0,3,3,2,1,0,0,0,2,1
../kbl_data/2023-2024,S43G01N3,울산 현대모비스,Home,신민석,8,4,5,80.0,0,3,0.0,4,8,50.0,0,0,0.0,4,0,4,1,2,0,0,0,1,3
../kbl_data/2023-2024,S43G01N3,울산 현대모비스,Home,게이지 프림,6,3,6,50.0,0,0,0.0,3,6,50.0,0,0,0.0,1,0,1,3,2,1,0,0,0,0
../kbl_data/2023-2024,S43G01N3,울산 현대모비스,Home,김태완,7,3,4,75.0,0,2,0.0,3,6,50.0,1,2,50.0,0,5,5,3,1,1,1,0,0,3
../kbl_data/2023-2024,S43G01N3,울산 현대모비스,Home,케베 알루마,13,4,6,66.7,0,3,0.0,4,9,44.4,5,6,83.3,1,8,9,2,1,0,1,1,3,2
../kbl_data/2023-2024,S43G01N3,대구 한국가스공사,Away,김동량,5,1,4,25.0,1,2,50.0,2,6,33.3,0,0,0.0,1,1,2,3,1,0,0,0,1,2
../kbl_data/2023-2024,S43G01N3,대구 한국가스공사,Away,차바위,2,1,1,100.0,0,0,0.0,1,1,100.0,0,0,0.0,1,0,1,4,1,0,0,0,1,3
../kbl_data/2023-2024,S43G01N3,대구 한국가스공사,Away,조상열,2,0,0,0.0,0,4,0.0,0,4,0.0,2,2,100.0,0,0,0,0,0,0,2,0,1,3
../kbl_data/2023-2024,S43G01N3,대구 한국가스공사,Away,이원대,0,0,2,0.0,0,3,0.0,0,5,0.0,0,0,0.0,0,0,0,1,0,0,0,0,1,1
../kbl_data/2023-2024,S43G01N3,대구 한국가스공사,Away,이대헌,14,7,10,70.0,0,1,0.0,7,11,63.6,0,0,0.0,0,5,5,2,0,0,0,0,1,2
../kbl_data/2023-2024,S43G01N3,대구 한국가스공사,Away,박봉진,0,0,0,0.0,0,2,0.0,0,2,0.0,0,0,0.0,1,1,2,1,0,0,1,0,1,3
../kbl_data/2023-2024,S43G01N3,대구 한국가스공사,Away,양준우,2,1,2,50.0,0,1,0.0,1,3,33.3,0,0,0.0,1,1,2,1,0,0,0,0,3,1
../kbl_data/2023-2024,S43G01N3,대구 한국가스공사,Away,신승민,0,0,0,0.0,0,0,0.0,0,0,0.0,0,0,0.0,0,2,2,0,0,0,0,0,1,0
../kbl_data/2023-2024,S43G01N3,대구 한국가스공사,Away,최주영,2,1,2,50.0,0,0,0.0,1,2,50.0,0,0,0.0,0,1,1,0,0,0,0,0,0,0
../kbl_data/2023-2024,S43G01N3,대구 한국가스공사,Away,샘조세프 벨란겔,20,8,9,88.9,1,2,50.0,9,11,81.8,1,2,50.0,2,2,4,1,1,0,0,0,3,2
../kbl_data/2023-2024,S43G01N3,대구 한국가스공사,Away,염유성,4,2,3,66.7,0,4,0.0,2,7,28.6,0,0,0.0,0,1,1,0,2,0,1,0,0,1
../kbl_data/2023-2024,S43G01N3,대구 한국가스공사,Away,앤쏘니 모스,11,4,13,30.8,0,0,0.0,4,13,30.8,3,6,50.0,3,5,8,0,0,0,0,1,1,2
../kbl_data/2023-2024,S43G01N4,서울 SK,Home,허일영,15,3,5,60.0,3,4,75.0,6,9,66.7,0,0,0.0,0,6,6,0,1,0,0,0,1,2
../kbl_data/2023-2024,S43G01N4,서울 SK,Home,송창용,1,0,0,0.0,0,0,0.0,0,0,0.0,1,2,50.0,1,1,2,0,1,0,0,0,0,2
../kbl_data/2023-2024,S43G01N4,서울 SK,Home,김선형,10,4,8,50.0,0,4,0.0,4,12,33.3,2,2,100.0,0,2,2,6,1,0,0,0,3,3
../kbl_data/2023-2024,S43G01N4,서울 SK,Home,홍경기,0,0,0,0.0,0,0,0.0,0,0,0.0,0,0,0.0,0,0,0,0,0,0,0,0,0,0
../kbl_data/2023-2024,S43G01N4,서울 SK,Home,오세근,6,3,4,75.0,0,1,0.0,3,5,60.0,0,2,0.0,0,3,3,0,1,0,0,0,0,3
../kbl_data/2023-2024,S43G01N4,서울 SK,Home,최부경,6,1,1,100.0,0,1,0.0,1,2,50.0,4,4,100.0,2,3,5,0,0,1,1,0,0,0
../kbl_data/2023-2024,S43G01N4,서울 SK,Home,리온 윌리엄스,0,0,2,0.0,0,1,0.0,0,3,0.0,0,0,0.0,1,0,1,1,0,0,0,0,0,1
../kbl_data/2023-2024,S43G01N4,서울 SK,Home,최원혁,0,0,0,0.0,0,0,0.0,0,0,0.0,0,0,0.0,0,0,0,0,1,0,0,0,1,1
../kbl_data/2023-2024,S43G01N4,서울 SK,Home,자밀 워니,26,13,19,68.4,0,4,0.0,13,23,56.5,0,0,0.0,2,11,13,6,1,0,0,0,1,2
../kbl_data/2023-2024,S43G01N4,서울 SK,Home,김형빈,0,0,0,0.0,0,0,0.0,0,0,0.0,0,0,0.0,0,0,0,0,0,0,0,0,0,0
../kbl_data/2023-2024,S43G01N4,서울 SK,Home,오재현,11,0,0,0.0,3,5,60.0,3,5,60.0,2,2,100.0,0,1,1,2,0,0,0,0,3,2
../kbl_data/2023-2024,S43G01N4,서울 SK,Home,고메즈 딜 리아노,10,4,6,66.7,0,2,0.0,4,8,50.0,2,4,50.0,0,0,0,3,3,0,0,0,1,2
../kbl_data/2023-2024,S43G01N4,수원 KT,Away,한희원,8,4,6,66.7,0,2,0.0,4,8,50.0,0,0,0.0,1,3,4,2,1,0,0,0,1,0
../kbl_data/2023-2024,S43G01N4,수원 KT,Away,최창진,0,0,0,0.0,0,2,0.0,0,2,0.0,0,0,0.0,0,2,2,2,0,0,0,0,0,2
../kbl_data/2023-2024,S43G01N4,수원 KT,Away,이현석,0,0,0,0.0,0,2,0.0,0,2,0.0,0,0,0.0,0,0,0,1,1,0,0,0,2,0
../kbl_data/2023-2024,S43G01N4,수원 KT,Away,정성우,18,3,3,100.0,4,6,66.7,7,9,77.8,0,2,0.0,0,2,2,6,2,0,0,0,5,3
../kbl_data/2023-2024,S43G01N4,수원 KT,Away,최성모,6,0,2,0.0,2,4,50.0,2,6,33.3,0,0,0.0,0,1,1,0,1,1,1,0,0,5
../kbl_data/2023-2024,S43G01N4,수원 KT,Away,최진광,0,0,0,0.0,0,1,0.0,0,1,0.0,0,0,0.0,0,0,0,1,0,0,0,0,0,1
../kbl_data/2023-2024,S43G01N4,수원 KT,Away,하윤기,22,11,13,84.6,0,1,0.0,11,14,78.6,0,1,0.0,3,8,11,3,1,1,0,0,1,0
../kbl_data/2023-2024,S43G01N4,수원 KT,Away,이두원,0,0,2,0.0,0,0,0.0,0,2,0.0,0,0,0.0,1,0,1,0,0,0,0,0,0,1
../kbl_data/2023-2024,S43G01N4,수원 KT,Away,숀 데이브 일데폰소,0,0,0,0.0,0,0,0.0,0,0,0.0,0,0,0.0,0,0,0,0,0,0,0,0,0,0
../kbl_data/2023-2024,S43G01N4,수원 KT,Away,문정현,0,0,2,0.0,0,0,0.0,0,2,0.0,0,0,0.0,0,1,1,2,0,0,0,0,0,1
../kbl_data/2023-2024,S43G01N4,수원 KT,Away,마이클 에릭,2,1,3,33.3,0,0,0.0,1,3,33.3,0,0,0.0,1,2,3,1,0,0,0,0,3,2
../kbl_data/2023-2024,S43G01N4,수원 KT,Away,패리스 배스,24,5,10,50.0,4,11,36.4,9,21,42.9,2,4,50.0,3,6,9,5,2,0,0,1,2,3
../kbl_data/2023-2024,S43G01N5,고양 소노,Home,김강선,0,0,1,0.0,0,2,0.0,0,3,0.0,0,0,0.0,1,0,1,0,0,0,0,0,0,1
../kbl_data/2023-2024,S43G01N5,고양 소노,Home,최현민,8,2,2,100.0,1,3,33.3,3,5,60.0,1,2,50.0,1,3,4,1,0,0,0,0,0,4
../kbl_data/2023-2024,S43G01N5,고양 소노,Home,김민욱,6,0,0,0.0,2,4,50.0,2,4,50.0,0,0,0.0,1,1,2,0,0,0,0,0,0,0
../kbl_data/2023-2024,S43G01N5,고양 소노,Home,한호빈,7,0,0,0.0,2,5,40.0,2,5,40.0,1,2,50.0,1,0,1,1,0,0,0,0,0,1
../kbl_data/2023-2024,S43G01N5,고양 소노,Home,전성현,21,4,7,57.1,3,6,50.0,7,13,53.8,4,4,100.0,0,0,0,2,1,0,0,0,1,1
../kbl_data/2023-2024,S43G01N5,고양 소노,Home,김지후,0,0,0,0.0,0,0,0.0,0,0,0.0,0,0,0.0,0,1,1,0,0,0,0,0,0,0
../kbl_data/2023-2024,S43G01N5,고양 소노,Home,김진유,6,1,1,100.0,1,1,100.0,2,2,100.0,1,2,50.0,2,2,4,2,0,0,0,0,0,4
../kbl_data/2023-2024,S43G01N5,고양 소노,Home,김진용,0,0,0,0.0,0,0,0.0,0,0,0.0,0,0,0.0,0,0,0,0,0,0,0,0,0,1
../kbl_data/2023-2024,S43G01N5,고양 소노,Home,이정현,7,2,8,25.0,0,3,0.0,2,11,18.2,3,3,100.0,2,1,3,4,0,1,4,0,2,3
../kbl_data/2023-2024,S43G01N5,고양 소노,Home,재로드 존스,31,8,14,57.1,4,12,33.3,12,26,46.2,3,4,75.0,2,10,12,3,3,0,0,0,2,1
../kbl_data/2023-2024,S43G01N5,고양 소노,Home,조쉬 토랄바,0,0,0,0.0,0,0,0.0,0,0,0.0,0,0,0.0,0,0,0,0,0,0,0,0,0,0
../kbl_data/2023-2024,S43G01N5,고양 소노,Home,디욘테 데이비스,3,1,1,100.0,0,0,0.0,1,1,100.0,1,2,50.0,0,1,1,0,0,0,0,0,1,0
../kbl_data/2023-2024,S43G01N5,원주 DB,Away,박찬희,6,0,1,0.0,2,2,100.0,2,3,66.7,0,0,0.0,0,1,1,3,0,0,0,0,0,0
../kbl_data/2023-2024,S43G01N5,원주 DB,Away,김현호,0,0,0,0.0,0,0,0.0,0,0,0.0,0,0,0.0,0,0,0,0,0,0,0,0,0,0
../kbl_data/2023-2024,S43G01N5,원주 DB,Away,서민수,5,1,1,100.0,1,1,100.0,2,2,100.0,0,0,0.0,0,2,2,0,0,0,0,0,0,2
../kbl_data/2023-2024,S43G01N5,원주 DB,Away,김영현,11,1,2,50.0,3,4,75.0,4,6,66.7,0,0,0.0,0,1,1,3,0,0,0,0,0,3
../kbl_data/2023-2024,S43G01N5,원주 DB,Away,김종규,10,4,7,57.1,0,0,0.0,4,7,57.1,2,2,100.0,4,4,8,2,1,0,0,2,0,1
../kbl_data/2023-2024,S43G01N5,원주 DB,Away,최승욱,20,5,6,83.3,3,3,100.0,8,9,88.9,1,2,50.0,1,1,2,2,2,0,0,0,0,4
../kbl_data/2023-2024,S43G01N5,원주 DB,Away,강상재,2,1,3,33.3,0,0,0.0,1,3,33.3,0,0,0.0,0,4,4,1,1,1,0,0,1,4
../kbl_data/2023-2024,S43G01N5,원주 DB,Away,디드릭 로슨,23,4,7,57.1,5,10,50.0,9,17,52.9,0,0,0.0,1,9,10,9,0,2,0,0,2,1
../kbl_data/2023-2024,S43G01N5,원주 DB,Away,이준희,0,0,0,0.0,0,2,0.0,0,2,0.0,0,0,0.0,0,0,0,0,0,0,0,0,0,0
../kbl_data/2023-2024,S43G01N5,원주 DB,Away,이선 알바노,15,4,6,66.7,1,3,33.3,5,9,55.6,4,4,100.0,0,1,1,7,0,1,0,0,4,3
../kbl_data/2023-2024,S43G01N5,원주 DB,Away,박인웅,15,3,3,100.0,3,6,50.0,6,9,66.7,0,1,0.0,0,3,3,1,0,0,1,0,1,3
../kbl_data/2023-2024,S43G01N5,원주 DB,Away,개리슨 브룩스,3,1,1,100.0,0,0,0.0,1,1,100.0,1,2,50.0,1,1,2,1,0,0,0,0,1,3
../kbl_data/2023-2024,S43G01N6,부산 KCC,Home,정창영,11,1,3,33.3,2,2,100.0,3,5,60.0,3,4,75.0,2,0,2,6,2,0,0,0,0,2
../kbl_data/2023-2024,S43G01N6,부산 KCC,Home,라건아,9,4,6,66.7,0,2,0.0,4,8,50.0,1,1,100.0,1,3,4,2,0,0,0,0,1,2
../kbl_data/2023-2024,S43G01N6,부산 KCC,Home,허웅,23,7,10,70.0,2,6,33.3,9,16,56.2,3,3,100.0,0,1,1,3,3,0,0,0,0,0
../kbl_data/2023-2024,S43G01N6,부산 KCC,Home,이승현,18,7,12,58.3,1,3,33.3,8,15,53.3,1,2,50.0,1,4,5,4,2,1,0,0,1,2
../kbl_data/2023-2024,S43G01N6,부산 KCC,Home,이호현,17,5,6,83.3,1,1,100.0,6,7,85.7,4,6,66.7,1,2,3,5,1,0,0,0,0,3
../kbl_data/2023-2024,S43G01N6,부산 KCC,Home,이근휘,12,0,0,0.0,4,5,80.0,4,5,80.0,0,0,0.0,0,1,1,0,0,0,0,0,0,1
../kbl_data/2023-2024,S43G01N6,부산 KCC,Home,김동현,0,0,2,0.0,0,1,0.0,0,3,0.0,0,0,0.0,1,0,1,0,0,0,0,0,1,0
../kbl_data/2023-2024,S43G01N6,부산 KCC,Home,송동훈,0,0,0,0.0,0,0,0.0,0,0,0.0,0,0,0.0,0,2,2,2,0,0,0,0,0,2
../kbl_data/2023-2024,S43G01N6,부산 KCC,Home,여준형,0,0,1,0.0,0,0,0.0,0,1,0.0,0,0,0.0,1,0,1,0,0,0,0,0,0,0
../kbl_data/2023-2024,S43G01N6,부산 KCC,Home,캘빈 제프리 에피스톨라,0,0,0,0.0,0,0,0.0,0,0,0.0,0,0,0.0,0,0,0,0,0,0,0,0,1,2
../kbl_data/2023-2024,S43G01N6,부산 KCC,Home,이주영,0,0,0,0.0,0,1,0.0,0,1,0.0,0,0,0.0,0,0,0,0,0,0,0,0,0,0
../kbl_data/2023-2024,S43G01N6,부산 KCC,Home,알리제 드숀 존슨,16,7,11,63.6,0,1,0.0,7,12,58.3,2,2,100.0,1,10,11,6,1,0,0,3,1,0
../kbl_data/2023-2024,S43G01N6,서울 삼성,Away,이정현,19,2,2,100.0,5,8,62.5,7,10,70.0,0,0,0.0,0,4,4,6,0,0,0,0,2,1
../kbl_data/2023-2024,S43G01N6,서울 삼성,Away,김시래,16,2,4,50.0,3,6,50.0,5,10,50.0,3,3,100.0,1,0,1,3,0,0,0,0,0,4
../kbl_data/2023-2024,S43G01N6,서울 삼성,Away,이동엽,0,0,0,0.0,0,1,0.0,0,1,0.0,0,0,0.0,0,0,0,0,0,0,0,0,0,2
../kbl_data/2023-2024,S43G01N6,서울 삼성,Away,김광철,0,0,0,0.0,0,0,0.0,0,0,0.0,0,0,0.0,0,1,1,0,0,1,0,0,1,3
../kbl_data/2023-2024,S43G01N6,서울 삼성,Away,최승욱,4,2,4,50.0,0,0,0.0,2,4,50.0,0,0,0.0,1,2,3,0,0,0,0,0,1,0
../kbl_data/2023-2024,S43G01N6,서울 삼성,Away,윤성원,3,0,0,0.0,1,3,33.3,1,3,33.3,0,0,0.0,0,1,1,1,0,0,0,0,0,0
../kbl_data/2023-2024,S43G01N6,서울 삼성,Away,조우성,0,0,0,0.0,0,0,0.0,0,0,0.0,0,0,0.0,0,0,0,1,0,0,0,0,1,0
../kbl_data/2023-2024,S43G01N6,서울 삼성,Away,이원석,4,2,9,22.2,0,0,0.0,2,9,22.2,0,2,0.0,2,3,5,0,0,3,0,0,3,2
../kbl_data/2023-2024,S43G01N6,서울 삼성,Away,신동혁,8,1,2,50.0,2,2,100.0,3,4,75.0,0,0,0.0,1,3,4,5,0,0,0,0,1,4
../kbl_data/2023-2024,S43G01N6,서울 삼성,Away,아반 나바,17,1,3,33.3,5,8,62.5,6,11,54.5,0,0,0.0,0,4,4,3,0,1,0,0,1,2
../kbl_data/2023-2024,S43G01N6,서울 삼성,Away,이스마엘 레인,11,5,6,83.3,0,0,0.0,5,6,83.3,1,1,100.0,0,3,3,2,2,0,0,1,0,1
../kbl_data/2023-2024,S43G01N6,서울 삼성,Away,코피 코번,18,9,14,64.3,0,0,0.0,9,14,64.3,0,2,0.0,3,2,5,6,0,0,0,0,2,0
../kbl_data/2023-2024,S43G01N7,울산 현대모비스,Home,함지훈,2,1,3,33.3,0,1,0.0,1,4,25.0,0,0,0.0,1,0,1,1,1,0,1,0,1,0
../kbl_data/2023-2024,S43G01N7,울산 현대모비스,Home,장재석,4,1,3,33.3,0,0,0.0,1,3,33.3,2,4,50.0,1,3,4,1,2,1,0,0,1,4
../kbl_data/2023-2024,S43G01N7,울산 현대모비스,Home,김지완,0,0,0,0.0,0,0,0.0,0,0,0.0,0,0,0.0,0,1,1,0,0,0,0,0,0,1
../kbl_data/2023-2024,S43G01N7,울산 현대모비스,Home,김준일,8,2,3,66.7,0,0,0.0,2,3,66.7,4,4,100.0,0,1,1,1,0,0,0,0,1,5
../kbl_data/2023-2024,S43G01N7,울산 현대모비스,Home,김국찬,7,2,3,66.7,1,3,33.3,3,6,50.0,0,0,0.0,1,3,4,1,2,0,0,0,0,2
../kbl_data/2023-2024,S43G01N7,울산 현대모비스,Home,서명진,0,0,3,0.0,0,4,0.0,0,7,0.0,0,0,0.0,1,0,1,4,1,0,1,0,2,2
../kbl_data/2023-2024,S43G01N7,울산 현대모비스,Home,박준은,0,0,0,0.0,0,0,0.0,0,0,0.0,0,0,0.0,0,0,0,0,0,0,0,0,0,0
../kbl_data/2023-2024,S43G01N7,울산 현대모비스,Home,이우석,14,6,9,66.7,0,1,0.0,6,10,60.0,2,2,100.0,1,0,1,1,1,1,0,0,0,4
../kbl_data/2023-2024,S43G01N7,울산 현대모비스,Home,신민석,0,0,0,0.0,0,1,0.0,0,1,0.0,0,0,0.0,1,0,1,0,0,0,0,0,0,1
../kbl_data/2023-2024,S43G01N7,울산 현대모비스,Home,게이지 프림,23,10,17,58.8,0,2,0.0,10,19,52.6,3,4,75.0,3,10,13,2,1,0,0,0,1,1
../kbl_data/2023-2024,S43G01N7,울산 현대모비스,Home,김태완,7,1,5,20.0,1,3,33.3,2,8,25.0,2,6,33.3,0,2,2,3,1,0,0,0,1,4
../kbl_data/2023-2024,S43G01N7,울산 현대모비스,Home,케베 알루마,11,3,5,60.0,1,1,100.0,4,6,66.7,2,3,66.7,1,3,4,1,0,2,0,1,1,1
../kbl_data/2023-2024,S43G01N7,창원 LG,Away,이관희,13,2,4,50.0,1,3,33.3,3,7,42.9,6,6,100.0,1,2,3,0,0,0,0,0,3,2
../kbl_data/2023-2024,S43G01N7,창원 LG,Away,정희재,10,1,1,100.0,1,3,33.3,2,4,50.0,5,6,83.3,0,4,4,1,0,1,0,0,1,4
../kbl_data/2023-2024,S43G01N7,창원 LG,Away,임동섭,0,0,0,0.0,0,0,0.0,0,0,0.0,0,0,0.0,0,0,0,0,0,0,0,0,0,0
../kbl_data/2023-2024,S43G01N7,창원 LG,Away,이재도,0,0,0,0.0,0,0,0.0,0,0,0.0,0,0,0.0,0,1,1,1,2,0,0,0,1,1
../kbl_data/2023-2024,S43G01N7,창원 LG,Away,정인덕,0,0,0,0.0,0,0,0.0,0,0,0.0,0,0,0.0,0,0,0,0,0,0,0,0,0,0
../kbl_data/2023-2024,S43G01N7,창원 LG,Away,양홍석,7,0,5,0.0,2,5,40.0,2,10,20.0,1,4,25.0,3,2,5,1,0,0,0,0,1,1
../kbl_data/2023-2024,S43G01N7,창원 LG,Away,윤원상,7,1,2,50.0,1,1,100.0,2,3,66.7,2,2,100.0,1,3,4,0,1,0,1,0,0,1
../kbl_data/2023-2024,S43G01N7,창원 LG,Away,아셈 마레이,17,7,14,50.0,0,0,0.0,7,14,50.0,3,5,60.0,6,12,18,0,0,0,0,0,6,5
../kbl_data/2023-2024,S43G01N7,창원 LG,Away,저스틴 구탕,4,2,3,66.7,0,0,0.0,2,3,66.7,0,0,0.0,1,0,1,1,0,0,0,0,0,1
../kbl_data/2023-2024,S43G01N7,창원 LG,Away,양준석,8,3,7,42.9,0,3,0.0,3,10,30.0,2,2,100.0,0,4,4,3,0,0,0,0,2,3
../kbl_data/2023-2024,S43G01N7,창원 LG,Away,단테 커닝햄,8,4,10,40.0,0,0,0.0,4,10,40.0,0,0,0.0,1,1,2,1,1,0,0,0,1,4
../kbl_data/2023-2024,S43G01N7,창원 LG,Away,유기상,0,0,0,0.0,0,0,0.0,0,0,0.0,0,2,0.0,0,1,1,0,0,1,0,0,1,0
../kbl_data/2023-2024,S43G01N8,고양 소노,Home,김강선,3,0,0,0.0,1,2,50.0,1,2,50.0,0,0,0.0,0,2,2,0,1,0,0,0,1,0
../kbl_data/2023-2024,S43G01N8,고양 소노,Home,최현민,2,0,0,0.0,0,1,0.0,0,1,0.0,2,2,100.0,0,1,1,1,0,0,1,0,0,2
../kbl_data/2023-2024,S43G01N8,고양 소노,Home,김민욱,3,1,1,100.0,0,1,0.0,1,2,50.0,1,2,50.0,2,0,2,0,1,0,0,0,0,1
../kbl_data/2023-2024,S43G01N8,고양 소노,Home,전성현,27,2,6,33.3,6,11,54.5,8,17,47.1,5,5,100.0,0,2,2,0,0,0,0,0,3,3
../kbl_data/2023-2024,S43G01N8,고양 소노,Home,김진유,0,0,0,0.0,0,3,0.0,0,3,0.0,0,0,0.0,6,6,12,2,0,0,1,0,0,3
../kbl_data/2023-2024,S43G01N8,고양 소노,Home,이정현,15,5,9,55.6,1,8,12.5,6,17,35.3,2,2,100.0,0,3,3,8,1,0,0,0,2,2
../kbl_data/2023-2024,S43G01N8,고양 소노,Home,안정욱,6,0,0,0.0,1,2,50.0,1,2,50.0,3,3,100.0,0,1,1,0,0,0,0,0,0,5
../kbl_data/2023-2024,S43G01N8,고양 소노,Home,재로드 존스,11,5,10,50.0,0,6,0.0,5,16,31.2,1,1,100.0,1,4,5,2,0,1,0,0,0,0
../kbl_data/2023-2024,S43G01N8,고양 소노,Home,박종하,0,0,1,0.0,0,2,0.0,0,3,0.0,0,0,0.0,0,0,0,0,1,0,0,0,0,2
../kbl_data/2023-2024,S43G01N8,고양 소노,Home,민기남,0,0,0,0.0,0,0,0.0,0,0,0.0,0,0,0.0,0,0,0,0,0,0,0,0,0,0
../kbl_data/2023-2024,S43G01N8,고양 소노,Home,조쉬 토랄바,2,1,1,100.0,0,1,0.0,1,2,50.0,0,0,0.0,0,0,0,1,0,0,0,0,0,2
../kbl_data/2023-2024,S43G01N8,고양 소노,Home,디욘테 데이비스,10,5,5,100.0,0,0,0.0,5,5,100.0,0,2,0.0,2,2,4,1,0,3,0,1,0,2
../kbl_data/2023-2024,S43G01N8,서울 SK,Away,허일영,17,4,9,44.4,3,4,75.0,7,13,53.8,0,0,0.0,1,3,4,1,0,0,0,0,0,1
../kbl_data/2023-2024,S43G01N8,서울 SK,Away,송창용,4,0,0,0.0,0,0,0.0,0,0,0.0,4,4,100.0,1,1,2,1,1,0,1,0,0,2
../kbl_data/2023-2024,S43G01N8,서울 SK,Away,김선형,12,1,7,14.3,2,3,66.7,3,10,30.0,4,5,80.0,1,2,3,8,1,1,0,0,1,0
../kbl_data/2023-2024,S43G01N8,서울 SK,Away,홍경기,0,0,0,0.0,0,0,0.0,0,0,0.0,0,0,0.0,0,0,0,0,0,0,0,0,0,0
../kbl_data/2023-2024,S43G01N8,서울 SK,Away,오세근,4,2,4,50.0,0,2,0.0,2,6,33.3,0,0,0.0,2,6,8,3,0,0,0,0,1,3
../kbl_data/2023-2024,S43G01N8,서울 SK,Away,최부경,4,2,4,50.0,0,0,0.0,2,4,50.0,0,0,0.0,3,1,4,1,0,0,0,0,0,2
../kbl_data/2023-2024,S43G01N8,서울 SK,Away,리온 윌리엄스,6,2,2,100.0,0,2,0.0,2,4,50.0,2,2,100.0,1,0,1,0,1,0,0,0,1,2
../kbl_data/2023-2024,S43G01N8,서울 SK,Away,최원혁,0,0,0,0.0,0,0,0.0,0,0,0.0,0,0,0.0,0,0,0,0,0,0,0,0,0,0
../kbl_data/2023-2024,S43G01N8,서울 SK,Away,자밀 워니,30,10,17,58.8,1,1,100.0,11,18,61.1,7,9,77.8,6,11,17,5,0,0,0,0,3,1
../kbl_data/2023-2024,S43G01N8,서울 SK,Away,김형빈,0,0,0,0.0,0,0,0.0,0,0,0.0,0,0,0.0,0,0,0,0,0,0,0,0,0,0
../kbl_data/2023-2024,S43G01N8,서울 SK,Away,오재현,11,1,6,16.7,3,8,37.5,4,14,28.6,0,0,0.0,1,0,1,1,0,0,0,0,0,4
../kbl_data/2023-2024,S43G01N8,서울 SK,Away,고메즈 딜 리아노,2,1,1,100.0,0,2,0.0,1,3,33.3,0,0,0.0,0,2,2,0,0,0,0,0,2,2
../kbl_data/2023-2024,S43G01N9,창원 LG,Home,이관희,9,3,6,50.0,1,4,25.0,4,10,40.0,0,0,0.0,2,0,2,3,0,0,0,0,1,1
../kbl_data/2023-2024,S43G01N9,창원 LG,Home,정희재,2,0,1,0.0,0,5,0.0,0,6,0.0,2,2,100.0,0,2,2,0,2,0,1,0,1,3
../kbl_data/2023-2024,S43G01N9,창원 LG,Home,임동섭,0,0,0,0.0,0,0,0.0,0,0,0.0,0,0,0.0,0,0,0,0,0,0,0,0,1,0
../kbl_data/2023-2024,S43G01N9,창원 LG,Home,이재도,0,0,1,0.0,0,1,0.0,0,2,0.0,0,0,0.0,0,0,0,2,0,0,0,0,2,3
../kbl_data/2023-2024,S43G01N9,창원 LG,Home,정인덕,19,5,6,83.3,3,4,75.0,8,10,80.0,0,0,0.0,0,1,1,2,1,0,0,0,0,2
../kbl_data/2023-2024,S43G01N9,창원 LG,Home,양홍석,9,2,5,40.0,1,4,25.0,3,9,33.3,2,2,100.0,2,2,4,4,0,0,0,0,0,1
../kbl_data/2023-2024,S43G01N9,창원 LG,Home,윤원상,3,1,2,50.0,0,3,0.0,1,5,20.0,1,2,50.0,1,1,2,2,0,0,0,0,2,2
../kbl_data/2023-2024,S43G01N9,창원 LG,Home,아셈 마레이,14,7,11,63.6,0,0,0.0,7,11,63.6,0,2,0.0,5,11,16,2,1,1,1,1,2,1
../kbl_data/2023-2024,S43G01N9,창원 LG,Home,저스틴 구탕,8,4,5,80.0,0,0,0.0,4,5,80.0,0,0,0.0,0,1,1,0,0,0,0,0,1,1
../kbl_data/2023-2024,S43G01N9,창원 LG,Home,양준석,2,1,3,33.3,0,4,0.0,1,7,14.3,0,0,0.0,1,0,1,6,0,0,0,0,1,3
../kbl_data/2023-2024,S43G01N9,창원 LG,Home,단테 커닝햄,4,2,3,66.7,0,0,0.0,2,3,66.7,0,0,0.0,0,1,1,0,0,0,0,0,0,2
../kbl_data/2023-2024,S43G01N9,창원 LG,Home,유기상,6,0,0,0.0,1,2,50.0,1,2,50.0,3,3,100.0,2,0,2,0,0,0,0,0,1,2
../kbl_data/2023-2024,S43G01N9,원주 DB,Away,박찬희,0,0,1,0.0,0,0,0.0,0,1,0.0,0,0,0.0,0,0,0,0,0,0,0,0,0,0
../kbl_data/2023-2024,S43G01N9,원주 DB,Away,김현호,0,0,0,0.0,0,0,0.0,0,0,0.0,0,0,0.0,0,0,0,0,0,0,0,0,0,0
../kbl_data/2023-2024,S43G01N9,원주 DB,Away,서민수,8,2,2,100.0,1,2,50.0,3,4,75.0,1,1,100.0,1,3,4,1,0,0,0,0,0,4
../kbl_data/2023-2024,S43G01N9,원주 DB,Away,김영현,3,0,0,0.0,0,0,0.0,0,0,0.0,3,4,75.0,1,2,3,1,1,0,0,0,0,3
../kbl_data/2023-2024,S43G01N9,원주 DB,Away,김종규,10,5,8,62.5,0,0,0.0,5,8,62.5,0,0,0.0,0,4,4,0,0,3,0,3,5,3
../kbl_data/2023-2024,S43G01N9,원주 DB,Away,최승욱,3,0,2,0.0,1,2,50.0,1,4,25.0,0,0,0.0,0,0,0,0,2,0,0,0,0,3
../kbl_data/2023-2024,S43G01N9,원주 DB,Away,강상재,13,5,9,55.6,1,1,100.0,6,10,60.0,0,0,0.0,3,9,12,3,0,0,0,0,4,4
../kbl_data/2023-2024,S43G01N9,원주 DB,Away,이윤수,0,0,0,0.0,0,0,0.0,0,0,0.0,0,0,0.0,0,0,0,0,0,0,0,0,0,0
../kbl_data/2023-2024,S43G01N9,원주 DB,Away,디드릭 로슨,29,6,12,50.0,4,8,50.0,10,20,50.0,5,8,62.5,2,4,6,6,0,0,1,0,0,2
../kbl_data/2023-2024,S43G01N9,원주 DB,Away,이준희,0,0,0,0.0,0,0,0.0,0,0,0.0,0,0,0.0,0,0,0,0,0,0,0,0,0,0
../kbl_data/2023-2024,S43G01N9,원주 DB,Away,이선 알바노,16,8,13,61.5,0,2,0.0,8,15,53.3,0,0,0.0,0,1,1,3,3,0,0,0,1,0
../kbl_data/2023-2024,S43G01N9,원주 DB,Away,박인웅,3,0,1,0.0,1,1,100.0,1,2,50.0,0,0,0.0,0,0,0,2,0,0,0,0,1,0
../kbl_data/2023-2024,S43G01N10,울산 현대모비스,Home,함지훈,11,3,3,100.0,1,2,50.0,4,5,80.0,2,2,100.0,1,2,3,3,2,1,0,0,0,2
../kbl_data/2023-2024,S43G01N10,울산 현대모비스,Home,최진수,0,0,0,0.0,0,0,0.0,0,0,0.0,0,0,0.0,0,0,0,0,0,0,0,0,0,0
../kbl_data/2023-2024,S43G01N10,울산 현대모비스,Home,장재석,0,0,0,0.0,0,0,0.0,0,0,0.0,0,0,0.0,0,0,0,0,0,0,0,0,0,0
../kbl_data/2023-2024,S43G01N10,울산 현대모비스,Home,김지완,2,1,2,50.0,0,0,0.0,1,2,50.0,0,0,0.0,1,0,1,1,0,0,0,0,1,2
../kbl_data/2023-2024,S43G01N10,울산 현대모비스,Home,김준일,4,2,4,50.0,0,0,0.0,2,4,50.0,0,0,0.0,2,4,6,1,0,1,1,0,3,4
../kbl_data/2023-2024,S43G01N10,울산 현대모비스,Home,김국찬,0,0,1,0.0,0,1,0.0,0,2,0.0,0,0,0.0,1,2,3,1,0,0,0,0,3,3
../kbl_data/2023-2024,S43G01N10,울산 현대모비스,Home,서명진,11,1,2,50.0,3,7,42.9,4,9,44.4,0,0,0.0,0,0,0,0,1,1,0,0,0,3
../kbl_data/2023-2024,S43G01N10,울산 현대모비스,Home,이우석,15,7,10,70.0,0,2,0.0,7,12,58.3,1,2,50.0,0,6,6,2,1,0,0,0,1,2
../kbl_data/2023-2024,S43G01N10,울산 현대모비스,Home,신민석,0,0,0,0.0,0,0,0.0,0,0,0.0,0,0,0.0,0,0,0,0,0,0,0,0,0,0
../kbl_data/2023-2024,S43G01N10,울산 현대모비스,Home,게이지 프림,14,7,16,43.8,0,1,0.0,7,17,41.2,0,0,0.0,0,4,4,2,0,0,0,0,1,2
../kbl_data/2023-2024,S43G01N10,울산 현대모비스,Home,김태완,1,0,2,0.0,0,3,0.0,0,5,0.0,1,2,50.0,1,1,2,6,2,0,1,0,1,3
../kbl_data/2023-2024,S43G01N10,울산 현대모비스,Home,케베 알루마,20,5,10,50.0,2,5,40.0,7,15,46.7,4,8,50.0,5,4,9,0,0,1,0,1,0,1
../kbl_data/2023-2024,S43G01N10,서울 SK,Away,허일영,8,1,3,33.3,2,5,40.0,3,8,37.5,0,2,0.0,1,4,5,1,1,0,0,0,0,3
../kbl_data/2023-2024,S43G01N10,서울 SK,Away,송창용,0,0,0,0.0,0,1,0.0,0,1,0.0,0,0,0.0,0,0,0,1,0,0,1,0,0,1
../kbl_data/2023-2024,S43G01N10,서울 SK,Away,김선형,12,3,7,42.9,1,3,33.3,4,10,40.0,3,4,75.0,1,2,3,7,1,0,0,0,3,1
../kbl_data/2023-2024,S43G01N10,서울 SK,Away,홍경기,0,0,0,0.0,0,0,0.0,0,0,0.0,0,0,0.0,0,0,0,0,0,0,0,0,0,0
../kbl_data/2023-2024,S43G01N10,서울 SK,Away,오세근,6,1,5,20.0,0,4,0.0,1,9,11.1,4,7,57.1,1,3,4,2,0,1,0,0,2,4
../kbl_data/2023-2024,S43G01N10,서울 SK,Away,최부경,5,1,2,50.0,0,0,0.0,1,2,50.0,3,3,100.0,1,1,2,0,0,1,1,0,0,2
../kbl_data/2023-2024,S43G01N10,서울 SK,Away,리온 윌리엄스,20,8,11,72.7,0,2,0.0,8,13,61.5,4,4,100.0,3,8,11,0,2,1,0,0,4,5
../kbl_data/2023-2024,S43G01N10,서울 SK,Away,최원혁,0,0,0,0.0,0,0,0.0,0,0,0.0,0,0,0.0,0,0,0,0,0,0,0,0,0,0
../kbl_data/2023-2024,S43G01N10,서울 SK,Away,자밀 워니,0,0,0,0.0,0,0,0.0,0,0,0.0,0,0,0.0,0,0,0,0,0,0,0,0,0,0
../kbl_data/2023-2024,S43G01N10,서울 SK,Away,김형빈,0,0,0,0.0,0,0,0.0,0,0,0.0,0,0,0.0,0,0,0,0,0,0,0,0,0,0
../kbl_data/2023-2024,S43G01N10,서울 SK,Away,오재현,6,1,3,33.3,1,3,33.3,2,6,33.3,1,1,100.0,0,0,0,0,0,0,0,0,1,1
../kbl_data/2023-2024,S43G01N10,서울 SK,Away,고메즈 딜 리아노,10,3,7,42.9,1,2,50.0,4,9,44.4,1,3,33.3,0,5,5,4,1,0,0,0,1,1
../kbl_data/2023-2024,S43G01N11,서울 삼성,Home,이정현,54,10,20,50.0,4,14,28.6,14,34,41.2,22,24,91.7,0,8,8,14,4,0,0,0,2,10
../kbl_data/2023-2024,S43G01N11,서울 삼성,Home,김시래,7,1,1,100.0,1,2,50.0,2,3,66.7,2,2,100.0,0,4,4,5,0,0,0,0,1,2
../kbl_data/2023-2024,S43G01N11,서울 삼성,Home,이동엽,3,1,4,25.0,0,3,0.0,1,7,14.3,1,4,25.0,3,1,4,2,0,0,0,0,1,4
../kbl_data/2023-2024,S43G01N11,서울 삼성,Home,김광철,0,0,0,0.0,0,0,0.0,0,0,0.0,0,0,0.0,1,0,1,1,0,0,0,0,0,0
../kbl_data/2023-2024,S43G01N11,서울 삼성,Home,최승욱,11,5,5,100.0,0,1,0.0,5,6,83.3,1,2,50.0,1,6,7,2,0,0,0,0,0,4
../kbl_data/2023-2024,S43G01N11,서울 삼성,Home,윤성원,3,0,0,0.0,1,2,50.0,1,2,50.0,0,0,0.0,1,2,3,2,0,0,0,0,1,2
../kbl_data/2023-2024,S43G01N11,서울 삼성,Home,김무성,3,0,0,0.0,1,1,100.0,1,1,100.0,0,0,0.0,0,0,0,0,0,0,0,0,0,3
../kbl_data/2023-2024,S43G01N11,서울 삼성,Home,이원석,10,4,7,57.1,0,0,0.0,4,7,57.1,2,4,50.0,1,5,6,0,0,1,0,0,1,2
../kbl_data/2023-2024,S43G01N11,서울 삼성,Home,신동혁,7,0,0,0.0,2,6,33.3,2,6,33.3,1,2,50.0,0,3,3,2,0,1,0,0,1,5
../kbl_data/2023-2024,S43G01N11,서울 삼성,Home,아반 나바,3,0,2,0.0,1,2,50.0,1,4,25.0,0,0,0.0,0,0,0,1,1,0,0,0,0,0
../kbl_data/2023-2024,S43G01N11,서울 삼성,Home,이스마엘 레인,11,5,5,100.0,0,2,0.0,5,7,71.4,1,2,50.0,2,4,6,1,0,0,0,1,1,0
../kbl_data/2023-2024,S43G01N11,서울 삼성,Home,코피 코번,33,10,17,58.8,0,0,0.0,10,17,58.8,13,16,81.2,8,6,14,2,0,0,0,0,2,1
../kbl_data/2023-2024,S43G01N11,고양 소노,Away,김강선,6,0,0,0.0,2,4,50.0,2,4,50.0,0,0,0.0,1,0,1,1,0,0,0,0,0,1
../kbl_data/2023-2024,S43G01N11,고양 소노,Away,김민욱,0,0,0,0.0,0,1,0.0,0,1,0.0,0,0,0.0,0,1,1,0,1,2,0,0,0,1
../kbl_data/2023-2024,S43G01N11,고양 소노,Away,한호빈,6,0,1,0.0,1,2,50.0,1,3,33.3,3,4,75.0,0,0,0,3,0,0,1,0,0,5
../kbl_data/2023-2024,S43G01N11,고양 소노,Away,전성현,21,2,5,40.0,4,12,33.3,6,17,35.3,5,5,100.0,0,1,1,1,0,0,0,0,0,2
../kbl_data/2023-2024,S43G01N11,고양 소노,Away,김지후,0,0,0,0.0,0,1,0.0,0,1,0.0,0,0,0.0,0,0,0,0,0,0,0,0,0,0
../kbl_data/2023-2024,S43G01N11,고양 소노,Away,김진유,2,1,1,100.0,0,0,0.0,1,1,100.0,0,0,0.0,1,0,1,1,1,0,0,0,0,2
../kbl_data/2023-2024,S43G01N11,고양 소노,Away,김진용,0,0,2,0.0,0,0,0.0,0,2,0.0,0,0,0.0,0,0,0,0,0,1,0,0,0,3
../kbl_data/2023-2024,S43G01N11,고양 소노,Away,이정현,54,10,20,50.0,4,14,28.6,14,34,41.2,22,24,91.7,0,8,8,14,4,0,0,0,2,10
../kbl_data/2023-2024,S43G01N11,고양 소노,Away,안정욱,3,0,0,0.0,1,2,50.0,1,2,50.0,0,0,0.0,1,2,3,0,0,0,0,0,0,4
../kbl_data/2023-2024,S43G01N11,고양 소노,Away,재로드 존스,13,2,7,28.6,3,9,33.3,5,16,31.2,0,0,0.0,1,7,8,3,0,0,0,0,2,3
../kbl_data/2023-2024,S43G01N11,고양 소노,Away,조쉬 토랄바,0,0,0,0.0,0,0,0.0,0,0,0.0,0,0,0.0,0,0,0,0,0,0,0,0,0,1
../kbl_data/2023-2024,S43G01N11,고양 소노,Away,디욘테 데이비스,7,3,8,37.5,0,2,0.0,3,10,30.0,1,1,100.0,2,3,5,0,1,1,0,1,0,3
../kbl_data/2023-2024,S43G01N12,원주 DB,Home,박찬희,0,0,0,0.0,0,1,0.0,0,1,0.0,0,0,0.0,0,0,0,0,0,0,0,0,1,1
../kbl_data/2023-2024,S43G01N12,원주 DB,Home,김현호,0,0,0,0.0,0,0,0.0,0,0,0.0,0,0,0.0,0,0,0,0,0,0,0,0,0,0
../kbl_data/2023-2024,S43G01N12,원주 DB,Home,서민수,8,1,1,100.0,2,2,100.0,3,3,100.0,0,0,0.0,1,3,4,0,0,0,1,0,0,1
../kbl_data/2023-2024,S43G01N12,원주 DB,Home,김영현,3,0,0,0.0,1,4,25.0,1,4,25.0,0,0,0.0,0,1,1,0,1,0,0,0,1,2
../kbl_data/2023-2024,S43G01N12,원주 DB,Home,김종규,4,2,5,40.0,0,0,0.0,2,5,40.0,0,0,0.0,2,3,5,1,1,3,0,1,1,0
../kbl_data/2023-2024,S43G01N12,원주 DB,Home,최승욱,7,2,3,66.7,1,2,50.0,3,5,60.0,0,0,0.0,0,0,0,2,1,1,0,0,1,4
../kbl_data/2023-2024,S43G01N12,원주 DB,Home,강상재,20,6,9,66.7,2,3,66.7,8,12,66.7,2,2,100.0,3,3,6,7,1,1,0,0,1,3
../kbl_data/2023-2024,S43G01N12,원주 DB,Home,이윤수,0,0,0,0.0,0,0,0.0,0,0,0.0,0,0,0.0,0,1,1,0,0,0,0,0,0,0
../kbl_data/2023-2024,S43G01N12,원주 DB,Home,디드릭 로슨,38,13,17,76.5,3,10,30.0,16,27,59.3,3,3,100.0,1,9,10,1,3,1,0,1,4,2
../kbl_data/2023-2024,S43G01N12,원주 DB,Home,이준희,0,0,0,0.0,0,0,0.0,0,0,0.0,0,0,0.0,0,0,0,0,0,0,0,0,0,0
../kbl_data/2023-2024,S43G01N12,원주 DB,Home,이선 알바노,18,5,8,62.5,1,2,50.0,6,10,60.0,5,7,71.4,0,4,4,9,2,1,0,0,1,4
../kbl_data/2023-2024,S43G01N12,원주 DB,Home,박인웅,3,0,0,0.0,1,3,33.3,1,3,33.3,0,0,0.0,0,0,0,1,0,0,0,0,1,1
../kbl_data/2023-2024,S43G01N12,부산 KCC,Away,정창영,16,0,2,0.0,5,7,71.4,5,9,55.6,1,4,25.0,0,0,0,3,1,0,0,0,0,2
../kbl_data/2023-2024,S43G01N12,부산 KCC,Away,라건아,5,2,4,50.0,0,0,0.0,2,4,50.0,1,1,100.0,1,0,1,1,0,0,0,0,2,2
../kbl_data/2023-2024,S43G01N12,부산 KCC,Away,허웅,19,4,7,57.1,3,8,37.5,7,15,46.7,2,4,50.0,0,4,4,3,1,0,0,0,1,2
../kbl_data/2023-2024,S43G01N12,부산 KCC,Away,이승현,4,2,6,33.3,0,2,0.0,2,8,25.0,0,0,0.0,2,0,2,1,2,0,0,0,2,3
../kbl_data/2023-2024,S43G01N12,부산 KCC,Away,이호현,12,6,9,66.7,0,0,0.0,6,9,66.7,0,0,0.0,1,1,2,9,2,0,1,0,0,4
../kbl_data/2023-2024,S43G01N12,부산 KCC,Away,이진욱,0,0,0,0.0,0,0,0.0,0,0,0.0,0,0,0.0,0,0,0,0,0,0,0,0,0,0
../kbl_data/2023-2024,S43G01N12,부산 KCC,Away,이근휘,11,1,1,100.0,3,4,75.0,4,5,80.0,0,0,0.0,0,2,2,1,0,0,0,0,0,2
../kbl_data/2023-2024,S43G01N12,부산 KCC,Away,김동현,0,0,0,0.0,0,0,0.0,0,0,0.0,0,0,0.0,0,0,0,0,0,0,0,0,0,0
../kbl_data/2023-2024,S43G01N12,부산 KCC,Away,송동훈,0,0,0,0.0,0,0,0.0,0,0,0.0,0,0,0.0,0,1,1,0,1,0,0,0,1,0
../kbl_data/2023-2024,S43G01N12,부산 KCC,Away,여준형,0,0,2,0.0,0,0,0.0,0,2,0.0,0,0,0.0,0,1,1,0,0,0,0,0,0,0
../kbl_data/2023-2024,S43G01N12,부산 KCC,Away,캘빈 제프리 에피스톨라,0,0,0,0.0,0,0,0.0,0,0,0.0,0,0,0.0,0,0,0,0,0,0,0,0,0,0
../kbl_data/2023-2024,S43G01N12,부산 KCC,Away,알리제 드숀 존슨,23,10,19,52.6,0,2,0.0,10,21,47.6,3,4,75.0,7,14,21,4,2,0,0,0,6,1
../kbl_data/2023-2024,S43G01N13,대구 한국가스공사,Home,김동량,0,0,0,0.0,0,0,0.0,0,0,0.0,0,0,0.0,0,1,1,0,0,0,0,0,0,0
../kbl_data/2023-2024,S43G01N13,대구 한국가스공사,Home,차바위,5,1,1,100.0,1,3,33.3,2,4,50.0,0,0,0.0,0,2,2,2,0,0,0,0,4,3
../kbl_data/2023-2024,S43G01N13,대구 한국가스공사,Home,박지훈,0,0,0,0.0,0,0,0.0,0,0,0.0,0,0,0.0,0,0,0,0,0,0,0,0,0,2
../kbl_data/2023-2024,S43G01N13,대구 한국가스공사,Home,조상열,0,0,1,0.0,0,2,0.0,0,3,0.0,0,0,0.0,0,0,0,0,1,0,0,0,0,0
../kbl_data/2023-2024,S43G01N13,대구 한국가스공사,Home,이원대,0,0,0,0.0,0,0,0.0,0,0,0.0,0,0,0.0,0,0,0,0,0,0,0,0,0,0
../kbl_data/2023-2024,S43G01N13,대구 한국가스공사,Home,이대헌,12,5,8,62.5,0,3,0.0,5,11,45.5,2,2,100.0,2,6,8,4,0,0,0,0,1,2
../kbl_data/2023-2024,S43G01N13,대구 한국가스공사,Home,박봉진,3,0,0,0.0,1,5,20.0,1,5,20.0,0,0,0.0,3,1,4,2,0,0,1,0,0,4
../kbl_data/2023-2024,S43G01N13,대구 한국가스공사,Home,양준우,6,0,1,0.0,2,2,100.0,2,3,66.7,0,2,0.0,1,2,3,0,0,0,0,0,0,0
../kbl_data/2023-2024,S43G01N13,대구 한국가스공사,Home,앤드류 니콜슨,31,7,14,50.0,4,7,57.1,11,21,52.4,5,8,62.5,5,5,10,1,1,0,0,1,0,2
../kbl_data/2023-2024,S43G01N13,대구 한국가스공사,Home,샘조세프 벨란겔,19,3,4,75.0,3,6,50.0,6,10,60.0,4,4,100.0,0,1,1,4,0,0,0,0,1,3
../kbl_data/2023-2024,S43G01N13,대구 한국가스공사,Home,염유성,3,0,0,0.0,1,3,33.3,1,3,33.3,0,0,0.0,1,0,1,1,0,0,0,0,1,1
../kbl_data/2023-2024,S43G01N13,대구 한국가스공사,Home,앤쏘니 모스,4,2,3,66.7,0,0,0.0,2,3,66.7,0,0,0.0,0,0,0,0,0,0,1,1,0,1
../kbl_data/2023-2024,S43G01N13,창원 LG,Away,이관희,6,0,1,0.0,2,5,40.0,2,6,33.3,0,0,0.0,0,2,2,0,0,0,0,0,0,0
../kbl_data/2023-2024,S43G01N13,창원 LG,Away,정희재,3,0,0,0.0,1,1,100.0,1,1,100.0,0,0,0.0,0,3,3,3,0,0,0,0,0,2
../kbl_data/2023-2024,S43G01N13,창원 LG,Away,이재도,10,4,8,50.0,0,1,0.0,4,9,44.4,2,2,100.0,0,1,1,5,0,0,0,0,0,2
../kbl_data/2023-2024,S43G01N13,창원 LG,Away,정인덕,8,1,2,50.0,2,4,50.0,3,6,50.0,0,0,0.0,0,0,0,2,1,0,0,0,0,2
../kbl_data/2023-2024,S43G01N13,창원 LG,Away,양홍석,15,1,3,33.3,4,8,50.0,5,11,45.5,1,2,50.0,1,1,2,3,1,0,0,0,3,4
../kbl_data/2023-2024,S43G01N13,창원 LG,Away,윤원상,7,2,2,100.0,1,5,20.0,3,7,42.9,0,0,0.0,1,2,3,1,0,0,0,0,0,1
../kbl_data/2023-2024,S43G01N13,창원 LG,Away,아셈 마레이,20,9,13,69.2,0,0,0.0,9,13,69.2,2,6,33.3,7,7,14,2,0,1,0,0,1,2
../kbl_data/2023-2024,S43G01N13,창원 LG,Away,이승우,0,0,0,0.0,0,0,0.0,0,0,0.0,0,0,0.0,0,0,0,0,0,0,0,0,0,0
../kbl_data/2023-2024,S43G01N13,창원 LG,Away,저스틴 구탕,12,4,5,80.0,1,1,100.0,5,6,83.3,1,1,100.0,0,3,3,2,0,0,0,1,1,4
../kbl_data/2023-2024,S43G01N13,창원 LG,Away,양준석,7,2,4,50.0,1,1,100.0,3,5,60.0,0,0,0.0,0,2,2,3,0,0,0,0,1,2
../kbl_data/2023-2024,S43G01N13,창원 LG,Away,단테 커닝햄,4,2,2,100.0,0,0,0.0,2,2,100.0,0,0,0.0,1,4,5,1,2,0,0,0,0,3
../kbl_data/2023-2024,S43G01N13,창원 LG,Away,유기상,0,0,0,0.0,0,0,0.0,0,0,0.0,0,0,0.0,0,0,0,0,0,0,0,0,0,0
../kbl_data/2023-2024,S43G01N14,수원 KT,Home,한희원,12,3,4,75.0,2,3,66.7,5,7,71.4,0,0,0.0,2,0,2,2,1,1,0,0,1,2
../kbl_data/2023-2024,S43G01N14,수원 KT,Home,최창진,2,0,1,0.0,0,1,0.0,0,2,0.0,2,2,100.0,1,2,3,5,1,0,1,0,3,1
../kbl_data/2023-2024,S43G01N14,수원 KT,Home,이현석,0,0,0,0.0,0,2,0.0,0,2,0.0,0,0,0.0,3,3,6,0,1,0,0,0,0,2
../kbl_data/2023-2024,S43G01N14,수원 KT,Home,정성우,2,1,2,50.0,0,4,0.0,1,6,16.7,0,0,0.0,0,3,3,3,1,0,0,0,2,1
../kbl_data/2023-2024,S43G01N14,수원 KT,Home,최성모,4,2,2,100.0,0,0,0.0,2,2,100.0,0,0,0.0,0,1,1,2,1,0,0,0,2,2
../kbl_data/2023-2024,S43G01N14,수원 KT,Home,최진광,0,0,0,0.0,0,0,0.0,0,0,0.0,0,0,0.0,0,0,0,0,0,0,0,0,0,0
../kbl_data/2023-2024,S43G01N14,수원 KT,Home,하윤기,9,3,9,33.3,0,0,0.0,3,9,33.3,3,4,75.0,1,5,6,0,0,0,0,0,1,4
../kbl_data/2023-2024,S43G01N14,수원 KT,Home,이두원,0,0,2,0.0,0,0,0.0,0,2,0.0,0,0,0.0,0,0,0,0,0,0,0,0,0,3
../kbl_data/2023-2024,S43G01N14,수원 KT,Home,숀 데이브 일데폰소,0,0,1,0.0,0,1,0.0,0,2,0.0,0,0,0.0,0,0,0,0,0,1,0,0,0,1
../kbl_data/2023-2024,S43G01N14,수원 KT,Home,문정현,0,0,1,0.0,0,2,0.0,0,3,0.0,0,0,0.0,0,2,2,0,1,0,0,0,3,1
../kbl_data/2023-2024,S43G01N14,수원 KT,Home,마이클 에릭,2,1,2,50.0,0,0,0.0,1,2,50.0,0,0,0.0,2,3,5,0,0,0,0,0,3,0
../kbl_data/2023-2024,S43G01N14,수원 KT,Home,패리스 배스,28,6,17,35.3,4,12,33.3,10,29,34.5,4,4,100.0,3,12,15,3,2,3,0,1,2,3
../kbl_data/2023-2024,S43G01N14,안양 정관장,Away,정준원,0,0,2,0.0,0,0,0.0,0,2,0.0,0,0,0.0,0,1,1,0,1,0,1,0,1,0
../kbl_data/2023-2024,S43G01N14,안양 정관장,Away,배병준,7,1,4,25.0,1,6,16.7,2,10,20.0,2,2,100.0,0,5,5,1,3,0,0,0,1,0
../kbl_data/2023-2024,S43G01N14,안양 정관장,Away,이종현,3,1,2,50.0,0,0,0.0,1,2,50.0,1,2,50.0,0,1,1,0,1,0,0,0,2,1
../kbl_data/2023-2024,S43G01N14,안양 정관장,Away,김철욱,6,0,2,0.0,2,3,66.7,2,5,40.0,0,0,0.0,1,3,4,0,0,0,0,0,0,2
../kbl_data/2023-2024,S43G01N14,안양 정관장,Away,박지훈,10,5,7,71.4,0,6,0.0,5,13,38.5,0,0,0.0,2,3,5,4,2,0,0,0,1,4
../kbl_data/2023-2024,S43G01N14,안양 정관장,Away,최성원,9,1,2,50.0,1,4,25.0,2,6,33.3,4,5,80.0,1,2,3,2,0,0,0,0,2,0
../kbl_data/2023-2024,S43G01N14,안양 정관장,Away,대릴 먼로,5,2,7,28.6,0,2,0.0,2,9,22.2,1,2,50.0,3,3,6,4,0,1,0,0,3,0
../kbl_data/2023-2024,S43G01N14,안양 정관장,Away,김경원,4,2,4,50.0,0,0,0.0,2,4,50.0,0,0,0.0,1,0,1,0,0,2,0,0,1,4
../kbl_data/2023-2024,S43G01N14,안양 정관장,Away,조은후,0,0,0,0.0,0,0,0.0,0,0,0.0,0,0,0.0,0,0,0,0,0,0,0,0,0,0
../kbl_data/2023-2024,S43G01N14,안양 정관장,Away,렌즈 아반도,11,3,4,75.0,1,4,25.0,4,8,50.0,2,2,100.0,0,9,9,2,1,1,0,0,0,3
../kbl_data/2023-2024,S43G01N14,안양 정관장,Away,고찬혁,0,0,0,0.0,0,0,0.0,0,0,0.0,0,0,0.0,0,0,0,0,0,0,0,0,0,0
../kbl_data/2023-2024,S43G01N14,안양 정관장,Away,듀반 맥스웰,8,3,4,75.0,0,0,0.0,3,4,75.0,2,3,66.7,0,1,1,1,1,3,0,0,2,1
../kbl_data/2023-2024,S43G01N15,서울 삼성,Home,이정현,5,1,3,33.3,1,6,16.7,2,9,22.2,0,0,0.0,0,2,2,1,0,0,0,0,0,0
../kbl_data/2023-2024,S43G01N15,서울 삼성,Home,김시래,4,0,0,0.0,1,2,50.0,1,2,50.0,1,1,100.0,0,0,0,4,0,0,0,0,1,3
../kbl_data/2023-2024,S43G01N15,서울 삼성,Home,이동엽,0,0,1,0.0,0,0,0.0,0,1,0.0,0,0,0.0,1,1,2,0,0,0,0,0,0,1
../kbl_data/2023-2024,S43G01N15,서울 삼성,Home,최승욱,2,1,3,33.3,0,1,0.0,1,4,25.0,0,0,0.0,0,0,0,0,0,0,0,0,0,2
../kbl_data/2023-2024,S43G01N15,서울 삼성,Home,윤성원,0,0,0,0.0,0,0,0.0,0,0,0.0,0,0,0.0,0,1,1,1,0,0,0,0,0,1
../kbl_data/2023-2024,S43G01N15,서울 삼성,Home,김무성,0,0,0,0.0,0,0,0.0,0,0,0.0,0,0,0.0,0,0,0,0,0,0,0,0,0,0
../kbl_data/2023-2024,S43G01N15,서울 삼성,Home,이원석,8,3,6,50.0,0,1,0.0,3,7,42.9,2,3,66.7,3,3,6,1,1,0,1,0,1,1
../kbl_data/2023-2024,S43G01N15,서울 삼성,Home,신동혁,7,0,5,0.0,1,5,20.0,1,10,10.0,4,4,100.0,0,1,1,1,0,0,0,0,3,3
../kbl_data/2023-2024,S43G01N15,서울 삼성,Home,조준희,10,2,3,66.7,2,3,66.7,4,6,66.7,0,0,0.0,0,1,1,0,1,0,0,0,2,2
../kbl_data/2023-2024,S43G01N15,서울 삼성,Home,아반 나바,2,1,1,100.0,0,1,0.0,1,2,50.0,0,0,0.0,0,1,1,1,0,0,0,0,0,3
../kbl_data/2023-2024,S43G01N15,서울 삼성,Home,이스마엘 레인,16,7,10,70.0,0,2,0.0,7,12,58.3,2,3,66.7,3,5,8,0,1,1,0,3,2,0
../kbl_data/2023-2024,S43G01N15,서울 삼성,Home,코피 코번,15,6,14,42.9,0,0,0.0,6,14,42.9,3,8,37.5,5,6,11,1,2,1,0,0,3,5
../kbl_data/2023-2024,S43G01N15,창원 LG,Away,이관희,5,1,4,25.0,0,0,0.0,1,4,25.0,3,3,100.0,1,2,3,0,0,0,0,0,1,0
../kbl_data/2023-2024,S43G01N15,창원 LG,Away,정희재,0,0,0,0.0,0,4,0.0,0,4,0.0,0,0,0.0,0,1,1,1,0,0,0,0,0,4
../kbl_data/2023-2024,S43G01N15,창원 LG,Away,이재도,18,4,7,57.1,1,2,50.0,5,9,55.6,7,8,87.5,0,3,3,6,2,1,1,0,1,1
../kbl_data/2023-2024,S43G01N15,창원 LG,Away,정인덕,4,2,2,100.0,0,0,0.0,2,2,100.0,0,0,0.0,1,1,2,0,0,1,0,0,0,1
../kbl_data/2023-2024,S43G01N15,창원 LG,Away,양홍석,12,4,6,66.7,1,5,20.0,5,11,45.5,1,2,50.0,1,2,3,2,0,0,0,0,2,3
../kbl_data/2023-2024,S43G01N15,창원 LG,Away,윤원상,0,0,0,0.0,0,0,0.0,0,0,0.0,0,0,0.0,0,0,0,0,0,0,0,0,0,0
../kbl_data/2023-2024,S43G01N15,창원 LG,Away,아셈 마레이,7,2,6,33.3,0,0,0.0,2,6,33.3,3,4,75.0,3,2,5,0,1,1,0,0,0,4
../kbl_data/2023-2024,S43G01N15,창원 LG,Away,이승우,0,0,0,0.0,0,0,0.0,0,0,0.0,0,0,0.0,2,0,2,0,0,0,0,0,0,0
../kbl_data/2023-2024,S43G01N15,창원 LG,Away,저스틴 구탕,19,7,10,70.0,1,1,100.0,8,11,72.7,2,2,100.0,1,7,8,2,0,1,0,1,1,3
../kbl_data/2023-2024,S43G01N15,창원 LG,Away,양준석,0,0,2,0.0,0,0,0.0,0,2,0.0,0,0,0.0,0,0,0,2,0,0,0,0,0,2
../kbl_data/2023-2024,S43G01N15,창원 LG,Away,단테 커닝햄,20,9,15,60.0,0,0,0.0,9,15,60.0,2,3,66.7,2,8,10,1,4,2,0,0,2,4
../kbl_data/2023-2024,S43G01N15,창원 LG,Away,유기상,5,1,2,50.0,1,4,25.0,2,6,33.3,0,0,0.0,1,0,1,0,1,0,0,0,0,1
../kbl_data/2023-2024,S43G01N16,대구 한국가스공사,Home,김동량,4,2,2,100.0,0,0,0.0,2,2,100.0,0,0,0.0,1,1,2,0,1,0,0,0,1,1
../kbl_data/2023-2024,S43G01N16,대구 한국가스공사,Home,차바위,3,0,1,0.0,1,2,50.0,1,3,33.3,0,0,0.0,2,0,2,4,0,0,0,0,0,1
../kbl_data/2023-2024,S43G01N16,대구 한국가스공사,Home,조상열,0,0,0,0.0,0,1,0.0,0,1,0.0,0,0,0.0,0,1,1,0,0,0,0,0,1,1
../kbl_data/2023-2024,S43G01N16,대구 한국가스공사,Home,이대헌,12,6,8,75.0,0,2,0.0,6,10,60.0,0,2,0.0,0,6,6,4,0,0,0,1,1,1
../kbl_data/2023-2024,S43G01N16,대구 한국가스공사,Home,박봉진,0,0,0,0.0,0,0,0.0,0,0,0.0,0,0,0.0,0,0,0,0,0,0,0,0,0,2
../kbl_data/2023-2024,S43G01N16,대구 한국가스공사,Home,양준우,10,2,2,100.0,2,4,50.0,4,6,66.7,0,0,0.0,1,2,3,1,0,0,0,0,1,3
../kbl_data/2023-2024,S43G01N16,대구 한국가스공사,Home,앤드류 니콜슨,37,7,11,63.6,5,9,55.6,12,20,60.0,8,8,100.0,1,4,5,0,1,0,0,1,1,2
../kbl_data/2023-2024,S43G01N16,대구 한국가스공사,Home,신승민,21,9,11,81.8,0,0,0.0,9,11,81.8,3,6,50.0,3,2,5,3,1,0,1,0,1,5
../kbl_data/2023-2024,S43G01N16,대구 한국가스공사,Home,샘조세프 벨란겔,9,3,7,42.9,1,2,50.0,4,9,44.4,0,3,0.0,1,0,1,5,0,0,1,0,0,3
../kbl_data/2023-2024,S43G01N16,대구 한국가스공사,Home,염유성,0,0,0,0.0,0,1,0.0,0,1,0.0,0,0,0.0,1,0,1,0,0,0,0,0,0,1
../kbl_data/2023-2024,S43G01N16,대구 한국가스공사,Home,앤쏘니 모스,0,0,1,0.0,0,0,0.0,0,1,0.0,0,0,0.0,1,1,2,1,1,0,0,0,1,1
../kbl_data/2023-2024,S43G01N16,대구 한국가스공사,Home,김태호,0,0,0,0.0,0,0,0.0,0,0,0.0,0,0,0.0,0,0,0,0,0,0,0,0,0,1
../kbl_data/2023-2024,S43G01N16,서울 SK,Away,허일영,21,7,9,77.8,1,4,25.0,8,13,61.5,4,4,100.0,2,3,5,1,1,0,0,0,0,3
../kbl_data/2023-2024,S43G01N16,서울 SK,Away,송창용,0,0,1,0.0,0,0,0.0,0,1,0.0,0,0,0.0,0,1,1,0,0,0,0,0,0,1
../kbl_data/2023-2024,S43G01N16,서울 SK,Away,김선형,27,6,11,54.5,4,9,44.4,10,20,50.0,3,5,60.0,0,0,0,8,2,1,0,0,2,3
../kbl_data/2023-2024,S43G01N16,서울 SK,Away,홍경기,0,0,0,0.0,0,0,0.0,0,0,0.0,0,0,0.0,0,0,0,0,1,0,0,0,1,1
../kbl_data/2023-2024,S43G01N16,서울 SK,Away,오세근,6,2,7,28.6,0,0,0.0,2,7,28.6,2,3,66.7,4,2,6,3,0,0,0,0,1,1
../kbl_data/2023-2024,S43G01N16,서울 SK,Away,최부경,1,0,0,0.0,0,0,0.0,0,0,0.0,1,2,50.0,1,4,5,0,0,0,0,0,2,4
../kbl_data/2023-2024,S43G01N16,서울 SK,Away,리온 윌리엄스,16,2,5,40.0,3,6,50.0,5,11,45.5,3,3,100.0,4,4,8,0,0,0,0,0,0,3
../kbl_data/2023-2024,S43G01N16,서울 SK,Away,최원혁,3,0,0,0.0,1,1,100.0,1,1,100.0,0,0,0.0,0,0,0,0,0,0,0,0,0,2
../kbl_data/2023-2024,S43G01N16,서울 SK,Away,자밀 워니,0,0,0,0.0,0,0,0.0,0,0,0.0,0,0,0.0,0,0,0,0,0,0,0,0,0,0
../kbl_data/2023-2024,S43G01N16,서울 SK,Away,전성환,0,0,0,0.0,0,0,0.0,0,0,0.0,0,0,0.0,0,0,0,0,0,0,0,0,0,0
../kbl_data/2023-2024,S43G01N16,서울 SK,Away,김형빈,0,0,0,0.0,0,0,0.0,0,0,0.0,0,0,0.0,0,2,2,0,0,0,0,0,0,2
../kbl_data/2023-2024,S43G01N16,서울 SK,Away,오재현,20,5,8,62.5,2,5,40.0,7,13,53.8,4,6,66.7,0,1,1,1,0,0,1,0,0,2
../kbl_data/2023-2024,S43G01N17,고양 소노,Home,김강선,8,2,2,100.0,1,3,33.3,3,5,60.0,1,2,50.0,2,3,5,0,1,0,1,0,0,4
../kbl_data/2023-2024,S43G01N17,고양 소노,Home,최현민,0,0,0,0.0,0,0,0.0,0,0,0.0,0,0,0.0,0,2,2,0,0,0,0,0,1,4
../kbl_data/2023-2024,S43G01N17,고양 소노,Home,한호빈,0,0,0,0.0,0,1,0.0,0,1,0.0,0,0,0.0,0,0,0,0,0,0,0,0,0,0
../kbl_data/2023-2024,S43G01N17,고양 소노,Home,전성현,12,1,4,25.0,3,9,33.3,4,13,30.8,1,4,25.0,0,2,2,3,0,0,0,0,0,0
../kbl_data/2023-2024,S43G01N17,고양 소노,Home,김진유,0,0,0,0.0,0,0,0.0,0,0,0.0,0,0,0.0,0,2,2,0,0,0,0,0,1,0
../kbl_data/2023-2024,S43G01N17,고양 소노,Home,이정현,34,2,3,66.7,7,7,100.0,9,10,90.0,9,10,90.0,2,5,7,12,2,0,1,0,3,2
../kbl_data/2023-2024,S43G01N17,고양 소노,Home,안정욱,3,0,0,0.0,1,1,100.0,1,1,100.0,0,0,0.0,0,0,0,0,0,0,0,0,0,5
../kbl_data/2023-2024,S43G01N17,고양 소노,Home,재로드 존스,5,2,5,40.0,0,5,0.0,2,10,20.0,1,2,50.0,1,6,7,3,1,1,0,0,2,5
../kbl_data/2023-2024,S43G01N17,고양 소노,Home,박종하,0,0,0,0.0,0,0,0.0,0,0,0.0,0,0,0.0,0,0,0,0,0,0,0,0,0,0
../kbl_data/2023-2024,S43G01N17,고양 소노,Home,민기남,0,0,0,0.0,0,0,0.0,0,0,0.0,0,0,0.0,0,0,0,0,0,0,0,0,0,0
../kbl_data/2023-2024,S43G01N17,고양 소노,Home,조쉬 토랄바,14,4,8,50.0,2,6,33.3,6,14,42.9,0,0,0.0,0,2,2,2,2,0,0,0,1,4
../kbl_data/2023-2024,S43G01N17,고양 소노,Home,디욘테 데이비스,23,6,7,85.7,3,5,60.0,9,12,75.0,2,3,66.7,0,4,4,0,0,0,0,3,0,4
../kbl_data/2023-2024,S43G01N17,울산 현대모비스,Away,함지훈,7,2,3,66.7,0,0,0.0,2,3,66.7,3,3,100.0,1,1,2,2,0,0,0,0,1,2
../kbl_data/2023-2024,S43G01N17,울산 현대모비스,Away,최진수,0,0,0,0.0,0,0,0.0,0,0,0.0,0,0,0.0,0,0,0,0,0,0,0,0,0,0
../kbl_data/2023-2024,S43G01N17,울산 현대모비스,Away,장재석,0,0,1,0.0,0,0,0.0,0,1,0.0,0,0,0.0,0,0,0,0,0,0,0,0,0,0
../kbl_data/2023-2024,S43G01N17,울산 현대모비스,Away,김지완,0,0,1,0.0,0,2,0.0,0,3,0.0,0,0,0.0,0,0,0,4,0,0,1,0,1,2
../kbl_data/2023-2024,S43G01N17,울산 현대모비스,Away,김준일,12,2,5,40.0,0,0,0.0,2,5,40.0,8,10,80.0,2,5,7,3,0,1,0,0,3,2
../kbl_data/2023-2024,S43G01N17,울산 현대모비스,Away,김국찬,8,1,2,50.0,2,7,28.6,3,9,33.3,0,0,0.0,2,3,5,1,0,0,1,0,0,4
../kbl_data/2023-2024,S43G01N17,울산 현대모비스,Away,서명진,0,0,2,0.0,0,1,0.0,0,3,0.0,0,0,0.0,0,1,1,2,0,0,0,0,2,1
../kbl_data/2023-2024,S43G01N17,울산 현대모비스,Away,이우석,19,6,11,54.5,2,4,50.0,8,15,53.3,1,2,50.0,0,4,4,1,2,0,0,0,2,3
../kbl_data/2023-2024,S43G01N17,울산 현대모비스,Away,신민석,0,0,0,0.0,0,0,0.0,0,0,0.0,0,0,0.0,0,0,0,0,0,0,0,0,0,0
../kbl_data/2023-2024,S43G01N17,울산 현대모비스,Away,게이지 프림,21,8,11,72.7,0,2,0.0,8,13,61.5,5,7,71.4,3,9,12,1,1,1,0,1,0,3
../kbl_data/2023-2024,S43G01N17,울산 현대모비스,Away,김태완,5,0,2,0.0,1,2,50.0,1,4,25.0,2,2,100.0,0,0,0,2,0,0,1,0,0,1
../kbl_data/2023-2024,S43G01N17,울산 현대모비스,Away,케베 알루마,16,4,4,100.0,1,5,20.0,5,9,55.6,5,6,83.3,1,3,4,0,1,0,1,1,1,4
../kbl_data/2023-2024,S43G01N18,수원 KT,Home,한희원,9,0,0,0.0,3,8,37.5,3,8,37.5,0,0,0.0,0,2,2,1,1,0,1,0,2,3
../kbl_data/2023-2024,S43G01N18,수원 KT,Home,최창진,0,0,0,0.0,0,0,0.0,0,0,0.0,0,0,0.0,0,0,0,0,0,0,0,0,0,0
../kbl_data/2023-2024,S43G01N18,수원 KT,Home,이현석,0,0,0,0.0,0,0,0.0,0,0,0.0,0,0,0.0,0,0,0,0,0,0,0,0,0,0
../kbl_data/2023-2024,S43G01N18,수원 KT,Home,정성우,8,2,3,66.7,1,3,33.3,3,6,50.0,1,2,50.0,1,2,3,8,2,0,0,0,3,3
../kbl_data/2023-2024,S43G01N18,수원 KT,Home,최성모,0,0,1,0.0,0,0,0.0,0,1,0.0,0,0,0.0,0,0,0,0,0,0,0,0,0,0
../kbl_data/2023-2024,S43G01N18,수원 KT,Home,김준환,0,0,0,0.0,0,0,0.0,0,0,0.0,0,0,0.0,0,0,0,0,0,0,0,0,0,0
../kbl_data/2023-2024,S43G01N18,수원 KT,Home,하윤기,25,12,19,63.2,0,0,0.0,12,19,63.2,1,1,100.0,3,3,6,2,3,0,0,1,1,3
../kbl_data/2023-2024,S43G01N18,수원 KT,Home,이두원,6,3,4,75.0,0,0,0.0,3,4,75.0,0,0,0.0,2,4,6,0,0,0,0,0,1,1
../kbl_data/2023-2024,S43G01N18,수원 KT,Home,숀 데이브 일데폰소,15,3,7,42.9,3,8,37.5,6,15,40.0,0,0,0.0,4,0,4,3,3,0,0,0,3,2
../kbl_data/2023-2024,S43G01N18,수원 KT,Home,문정현,3,0,0,0.0,1,3,33.3,1,3,33.3,0,0,0.0,0,1,1,1,1,0,0,0,0,2
../kbl_data/2023-2024,S43G01N18,수원 KT,Home,마이클 에릭,10,5,7,71.4,0,0,0.0,5,7,71.4,0,0,0.0,1,3,4,1,0,1,0,0,1,1
../kbl_data/2023-2024,S43G01N18,수원 KT,Home,패리스 배스,8,2,9,22.2,0,3,0.0,2,12,16.7,4,4,100.0,3,4,7,3,1,0,0,0,0,2
../kbl_data/2023-2024,S43G01N18,원주 DB,Away,박찬희,0,0,0,0.0,0,0,0.0,0,0,0.0,0,0,0.0,0,0,0,0,0,0,0,0,0,0
../kbl_data/2023-2024,S43G01N18,원주 DB,Away,김현호,3,0,1,0.0,1,1,100.0,1,2,50.0,0,0,0.0,0,1,1,1,0,0,0,0,0,0
../kbl_data/2023-2024,S43G01N18,원주 DB,Away,서민수,2,1,2,50.0,0,1,0.0,1,3,33.3,0,1,0.0,0,1,1,1,1,0,0,0,1,0
../kbl_data/2023-2024,S43G01N18,원주 DB,Away,김영현,8,1,1,100.0,2,2,100.0,3,3,100.0,0,0,0.0,0,2,2,0,0,0,0,0,1,2
../kbl_data/2023-2024,S43G01N18,원주 DB,Away,김종규,7,2,3,66.7,0,0,0.0,2,3,66.7,3,4,75.0,1,3,4,0,1,3,0,0,1,2
../kbl_data/2023-2024,S43G01N18,원주 DB,Away,최승욱,7,2,2,100.0,1,1,100.0,3,3,100.0,0,0,0.0,0,1,1,1,2,0,0,0,0,1
../kbl_data/2023-2024,S43G01N18,원주 DB,Away,강상재,10,3,6,50.0,0,3,0.0,3,9,33.3,4,5,80.0,4,5,9,5,0,2,0,0,4,2
../kbl_data/2023-2024,S43G01N18,원주 DB,Away,이윤수,0,0,0,0.0,0,0,0.0,0,0,0.0,0,0,0.0,0,0,0,0,0,0,0,0,0,0
../kbl_data/2023-2024,S43G01N18,원주 DB,Away,디드릭 로슨,35,7,12,58.3,5,9,55.6,12,21,57.1,6,7,85.7,2,6,8,4,2,1,0,0,2,2
../kbl_data/2023-2024,S43G01N18,원주 DB,Away,이준희,0,0,0,0.0,0,0,0.0,0,0,0.0,0,0,0.0,0,0,0,0,0,0,0,0,0,0
../kbl_data/2023-2024,S43G01N18,원주 DB,Away,이선 알바노,19,8,10,80.0,0,5,0.0,8,15,53.3,3,4,75.0,1,2,3,6,2,0,0,0,4,3
../kbl_data/2023-2024,S43G01N18,원주 DB,Away,박인웅,0,0,0,0.0,0,1,0.0,0,1,0.0,0,0,0.0,1,0,1,0,0,0,0,0,1,3
../kbl_data/2023-2024,S43G01N19,안양 정관장,Home,정준원,0,0,0,0.0,0,1,0.0,0,1,0.0,0,0,0.0,0,0,0,0,0,0,0,0,0,0
../kbl_data/2023-2024,S43G01N19,안양 정관장,Home,배병준,10,1,2,50.0,2,6,33.3,3,8,37.5,2,2,100.0,0,1,1,2,0,0,0,0,2,1
../kbl_data/2023-2024,S43G01N19,안양 정관장,Home,정효근,8,1,3,33.3,2,4,50.0,3,7,42.9,0,0,0.0,1,2,3,0,0,0,0,0,0,1
../kbl_data/2023-2024,S43G01N19,안양 정관장,Home,이종현,7,3,3,100.0,0,1,0.0,3,4,75.0,1,2,50.0,0,2,2,0,0,0,0,0,0,2
../kbl_data/2023-2024,S43G01N19,안양 정관장,Home,김철욱,4,1,2,50.0,0,0,0.0,1,2,50.0,2,2,100.0,0,0,0,1,0,0,0,0,0,2
../kbl_data/2023-2024,S43G01N19,안양 정관장,Home,박지훈,9,2,7,28.6,1,4,25.0,3,11,27.3,2,2,100.0,1,2,3,1,1,0,0,0,2,4
../kbl_data/2023-2024,S43G01N19,안양 정관장,Home,최성원,4,1,3,33.3,0,2,0.0,1,5,20.0,2,2,100.0,0,1,1,2,0,0,0,0,0,1
../kbl_data/2023-2024,S43G01N19,안양 정관장,Home,대릴 먼로,15,5,8,62.5,0,1,0.0,5,9,55.6,5,6,83.3,5,6,11,4,0,0,0,0,1,2
../kbl_data/2023-2024,S43G01N19,안양 정관장,Home,김경원,6,3,8,37.5,0,0,0.0,3,8,37.5,0,0,0.0,4,2,6,0,2,1,0,0,0,3
../kbl_data/2023-2024,S43G01N19,안양 정관장,Home,조은후,0,0,0,0.0,0,0,0.0,0,0,0.0,0,0,0.0,0,0,0,1,0,0,0,0,0,0
../kbl_data/2023-2024,S43G01N19,안양 정관장,Home,렌즈 아반도,6,3,6,50.0,0,3,0.0,3,9,33.3,0,0,0.0,1,6,7,2,1,2,0,0,1,0
../kbl_data/2023-2024,S43G01N19,안양 정관장,Home,듀반 맥스웰,6,3,5,60.0,0,0,0.0,3,5,60.0,0,0,0.0,1,2,3,1,0,1,0,1,2,4
../kbl_data/2023-2024,S43G01N19,울산 현대모비스,Away,함지훈,1,0,1,0.0,0,3,0.0,0,4,0.0,1,2,50.0,1,2,3,1,0,0,0,0,0,1
../kbl_data/2023-2024,S43G01N19,울산 현대모비스,Away,최진수,0,0,0,0.0,0,0,0.0,0,0,0.0,0,0,0.0,0,0,0,0,0,0,0,0,0,0
../kbl_data/2023-2024,S43G01N19,울산 현대모비스,Away,김현수,0,0,0,0.0,0,0,0.0,0,0,0.0,0,0,0.0,0,0,0,0,0,0,0,0,0,0
../kbl_data/2023-2024,S43G01N19,울산 현대모비스,Away,장재석,12,6,9,66.7,0,0,0.0,6,9,66.7,0,0,0.0,3,3,6,4,0,2,0,0,0,1
../kbl_data/2023-2024,S43G01N19,울산 현대모비스,Away,김지완,6,2,3,66.7,0,0,0.0,2,3,66.7,2,2,100.0,0,1,1,2,0,0,0,0,0,3
../kbl_data/2023-2024,S43G01N19,울산 현대모비스,Away,김준일,10,3,4,75.0,0,0,0.0,3,4,75.0,4,4,100.0,0,1,1,4,1,0,0,0,0,2
../kbl_data/2023-2024,S43G01N19,울산 현대모비스,Away,김국찬,5,1,2,50.0,1,4,25.0,2,6,33.3,0,0,0.0,0,2,2,2,0,0,0,0,0,4
../kbl_data/2023-2024,S43G01N19,울산 현대모비스,Away,이우석,11,4,9,44.4,1,3,33.3,5,12,41.7,0,0,0.0,2,6,8,4,0,0,0,0,0,3
../kbl_data/2023-2024,S43G01N19,울산 현대모비스,Away,신민석,0,0,0,0.0,0,3,0.0,0,3,0.0,0,0,0.0,0,0,0,3,0,0,0,0,0,0
../kbl_data/2023-2024,S43G01N19,울산 현대모비스,Away,게이지 프림,8,4,5,80.0,0,0,0.0,4,5,80.0,0,1,0.0,0,5,5,0,1,0,0,1,2,1
../kbl_data/2023-2024,S43G01N19,울산 현대모비스,Away,김태완,4,1,2,50.0,0,1,0.0,1,3,33.3,2,2,100.0,0,2,2,2,3,0,0,0,2,2
../kbl_data/2023-2024,S43G01N19,울산 현대모비스,Away,케베 알루마,29,9,15,60.0,2,4,50.0,11,19,57.9,5,8,62.5,6,4,10,0,0,1,0,1,1,2
../kbl_data/2023-2024,S43G01N20,서울 삼성,Home,이정현,32,5,6,83.3,6,9,66.7,11,15,73.3,4,5,80.0,0,4,4,6,0,0,0,0,2,1
../kbl_data/2023-2024,S43G01N20,서울 삼성,Home,김승원,0,0,0,0.0,0,0,0.0,0,0,0.0,0,0,0.0,1,0,1,0,0,0,0,0,0,3
../kbl_data/2023-2024,S43G01N20,서울 삼성,Home,김시래,1,0,1,0.0,0,1,0.0,0,2,0.0,1,2,50.0,0,2,2,3,0,0,0,0,1,2
../kbl_data/2023-2024,S43G01N20,서울 삼성,Home,이동엽,1,0,2,0.0,0,2,0.0,0,4,0.0,1,2,50.0,0,1,1,1,0,0,0,0,0,3
../kbl_data/2023-2024,S43G01N20,서울 삼성,Home,최승욱,8,1,2,50.0,2,2,100.0,3,4,75.0,0,0,0.0,2,1,3,1,0,0,0,0,0,2
../kbl_data/2023-2024,S43G01N20,서울 삼성,Home,윤성원,0,0,0,0.0,0,1,0.0,0,1,0.0,0,0,0.0,0,2,2,0,0,0,0,0,0,3
../kbl_data/2023-2024,S43G01N20,서울 삼성,Home,이원석,9,4,4,100.0,0,0,0.0,4,4,100.0,1,2,50.0,1,4,5,0,1,2,0,1,1,3
../kbl_data/2023-2024,S43G01N20,서울 삼성,Home,신동혁,6,0,3,0.0,2,4,50.0,2,7,28.6,0,0,0.0,0,1,1,2,0,0,0,0,0,2
../kbl_data/2023-2024,S43G01N20,서울 삼성,Home,조준희,0,0,0,0.0,0,1,0.0,0,1,0.0,0,0,0.0,0,0,0,0,0,0,0,0,1,2
../kbl_data/2023-2024,S43G01N20,서울 삼성,Home,아반 나바,0,0,4,0.0,0,1,0.0,0,5,0.0,0,0,0.0,0,0,0,0,2,0,0,0,0,0
../kbl_data/2023-2024,S43G01N20,서울 삼성,Home,이스마엘 레인,1,0,0,0.0,0,1,0.0,0,1,0.0,1,2,50.0,1,1,2,0,0,0,0,0,0,0
../kbl_data/2023-2024,S43G01N20,서울 삼성,Home,코피 코번,26,11,18,61.1,0,0,0.0,11,18,61.1,4,10,40.0,8,5,13,2,0,3,0,0,6,3
../kbl_data/2023-2024,S43G01N20,대구 한국가스공사,Away,김동량,0,0,0,0.0,0,0,0.0,0,0,0.0,0,0,0.0,0,0,0,0,0,0,0,0,0,1
../kbl_data/2023-2024,S43G01N20,대구 한국가스공사,Away,차바위,7,1,2,50.0,1,2,50.0,2,4,50.0,2,3,66.7,2,3,5,4,2,0,0,0,1,4
../kbl_data/2023-2024,S43G01N20,대구 한국가스공사,Away,조상열,0,0,0,0.0,0,0,0.0,0,0,0.0,0,0,0.0,0,0,0,0,0,0,0,0,1,0
../kbl_data/2023-2024,S43G01N20,대구 한국가스공사,Away,이대헌,11,4,14,28.6,0,3,0.0,4,17,23.5,3,5,60.0,1,8,9,2,1,0,0,0,0,2
../kbl_data/2023-2024,S43G01N20,대구 한국가스공사,Away,박봉진,0,0,0,0.0,0,0,0.0,0,0,0.0,0,0,0.0,1,1,2,0,0,0,0,0,0,1
../kbl_data/2023-2024,S43G01N20,대구 한국가스공사,Away,양준우,4,2,2,100.0,0,1,0.0,2,3,66.7,0,0,0.0,1,0,1,1,2,0,0,0,0,1
../kbl_data/2023-2024,S43G01N20,대구 한국가스공사,Away,앤드류 니콜슨,33,10,16,62.5,3,8,37.5,13,24,54.2,4,6,66.7,0,8,8,0,2,0,0,1,2,3
../kbl_data/2023-2024,S43G01N20,대구 한국가스공사,Away,신승민,12,2,2,100.0,0,0,0.0,2,2,100.0,8,8,100.0,1,2,3,1,0,1,2,0,0,3
../kbl_data/2023-2024,S43G01N20,대구 한국가스공사,Away,샘조세프 벨란겔,11,4,6,66.7,0,3,0.0,4,9,44.4,3,3,100.0,0,1,1,2,0,0,0,0,0,5
../kbl_data/2023-2024,S43G01N20,대구 한국가스공사,Away,염유성,0,0,0,0.0,0,0,0.0,0,0,0.0,0,0,0.0,0,0,0,0,0,0,0,0,0,0
../kbl_data/2023-2024,S43G01N20,대구 한국가스공사,Away,앤쏘니 모스,2,1,3,33.3,0,0,0.0,1,3,33.3,0,0,0.0,0,0,0,0,0,0,0,0,0,2
../kbl_data/2023-2024,S43G01N20,대구 한국가스공사,Away,김태호,0,0,0,0.0,0,0,0.0,0,0,0.0,0,0,0.0,0,0,0,0,0,0,0,0,0,0
../kbl_data/2023-2024,S43G01N21,창원 LG,Home,이관희,11,4,5,80.0,1,6,16.7,5,11,45.5,0,1,0.0,0,2,2,3,1,1,0,0,2,2
../kbl_data/2023-2024,S43G01N21,창원 LG,Home,정희재,9,1,1,100.0,2,4,50.0,3,5,60.0,1,2,50.0,0,0,0,0,0,1,0,0,0,2
../kbl_data/2023-2024,S43G01N21,창원 LG,Home,이재도,12,0,1,0.0,1,3,33.3,1,4,25.0,9,10,90.0,1,2,3,2,1,0,1,0,1,2
../kbl_data/2023-2024,S43G01N21,창원 LG,Home,정인덕,3,1,2,50.0,0,1,0.0,1,3,33.3,1,2,50.0,1,5,6,0,1,0,0,0,1,1
../kbl_data/2023-2024,S43G01N21,창원 LG,Home,양홍석,12,2,6,33.3,2,3,66.7,4,9,44.4,2,2,100.0,2,5,7,2,0,0,0,0,1,0
../kbl_data/2023-2024,S43G01N21,창원 LG,Home,윤원상,2,1,2,50.0,0,2,0.0,1,4,25.0,0,0,0.0,0,3,3,1,0,0,0,0,0,1
../kbl_data/2023-2024,S43G01N21,창원 LG,Home,아셈 마레이,18,9,12,75.0,0,0,0.0,9,12,75.0,0,4,0.0,8,2,10,5,0,0,0,0,1,1
../kbl_data/2023-2024,S43G01N21,창원 LG,Home,이승우,0,0,0,0.0,0,0,0.0,0,0,0.0,0,0,0.0,0,0,0,0,0,0,0,0,0,0
../kbl_data/2023-2024,S43G01N21,창원 LG,Home,저스틴 구탕,0,0,4,0.0,0,0,0.0,0,4,0.0,0,0,0.0,0,5,5,4,0,0,0,0,1,2
../kbl_data/2023-2024,S43G01N21,창원 LG,Home,양준석,4,1,3,33.3,0,1,0.0,1,4,25.0,2,2,100.0,0,0,0,3,0,0,0,0,0,2
../kbl_data/2023-2024,S43G01N21,창원 LG,Home,단테 커닝햄,8,4,7,57.1,0,0,0.0,4,7,57.1,0,0,0.0,4,2,6,0,1,0,0,0,0,0
../kbl_data/2023-2024,S43G01N21,창원 LG,Home,유기상,8,2,2,100.0,1,3,33.3,3,5,60.0,1,3,33.3,0,3,3,1,2,1,0,0,3,4
../kbl_data/2023-2024,S43G01N21,고양 소노,Away,김강선,0,0,0,0.0,0,1,0.0,0,1,0.0,0,0,0.0,0,0,0,0,0,0,0,0,0,3
../kbl_data/2023-2024,S43G01N21,고양 소노,Away,최현민,2,1,1,100.0,0,3,0.0,1,4,25.0,0,0,0.0,0,2,2,1,0,0,0,0,0,2
../kbl_data/2023-2024,S43G01N21,고양 소노,Away,한호빈,3,0,0,0.0,1,5,20.0,1,5,20.0,0,0,0.0,0,0,0,3,0,0,0,0,0,4
../kbl_data/2023-2024,S43G01N21,고양 소노,Away,전성현,5,0,2,0.0,1,4,25.0,1,6,16.7,2,3,66.7,1,0,1,0,0,0,0,0,1,3
../kbl_data/2023-2024,S43G01N21,고양 소노,Away,이정현,20,2,7,28.6,5,9,55.6,7,16,43.8,1,1,100.0,0,2,2,12,2,0,0,0,4,1
../kbl_data/2023-2024,S43G01N21,고양 소노,Away,백지웅,3,0,0,0.0,1,1,100.0,1,1,100.0,0,0,0.0,0,0,0,1,0,0,0,0,0,0
../kbl_data/2023-2024,S43G01N21,고양 소노,Away,안정욱,2,1,2,50.0,0,2,0.0,1,4,25.0,0,0,0.0,0,0,0,1,0,0,0,0,1,0
../kbl_data/2023-2024,S43G01N21,고양 소노,Away,재로드 존스,6,1,2,50.0,1,3,33.3,2,5,40.0,1,2,50.0,0,3,3,0,1,0,0,0,3,2
../kbl_data/2023-2024,S43G01N21,고양 소노,Away,박종하,0,0,0,0.0,0,0,0.0,0,0,0.0,0,0,0.0,0,0,0,0,0,0,0,0,0,0
../kbl_data/2023-2024,S43G01N21,고양 소노,Away,민기남,6,0,0,0.0,2,2,100.0,2,2,100.0,0,0,0.0,0,1,1,2,2,0,1,0,0,3
../kbl_data/2023-2024,S43G01N21,고양 소노,Away,조쉬 토랄바,12,1,2,50.0,3,5,60.0,4,7,57.1,1,2,50.0,0,1,1,0,0,0,0,0,0,2
../kbl_data/2023-2024,S43G01N21,고양 소노,Away,디욘테 데이비스,14,7,9,77.8,0,3,0.0,7,12,58.3,0,0,0.0,3,11,14,1,1,2,0,4,2,3
../kbl_data/2023-2024,S43G01N22,서울 삼성,Home,이정현,0,0,2,0.0,0,6,0.0,0,8,0.0,0,0,0.0,0,2,2,3,0,0,0,0,2,2
../kbl_data/2023-2024,S43G01N22,서울 삼성,Home,김승원,0,0,0,0.0,0,0,0.0,0,0,0.0,0,0,0.0,1,0,1,0,0,0,0,0,0,2
../kbl_data/2023-2024,S43G01N22,서울 삼성,Home,김시래,3,0,0,0.0,0,0,0.0,0,0,0.0,3,3,100.0,0,0,0,4,0,0,0,0,1,1
../kbl_data/2023-2024,S43G01N22,서울 삼성,Home,이동엽,2,1,2,50.0,0,2,0.0,1,4,25.0,0,0,0.0,0,3,3,2,0,0,0,0,3,2
../kbl_data/2023-2024,S43G01N22,서울 삼성,Home,최승욱,0,0,1,0.0,0,1,0.0,0,2,0.0,0,0,0.0,0,3,3,0,0,0,1,0,0,1
../kbl_data/2023-2024,S43G01N22,서울 삼성,Home,윤성원,0,0,1,0.0,0,3,0.0,0,4,0.0,0,0,0.0,2,2,4,3,1,0,0,0,0,2
../kbl_data/2023-2024,S43G01N22,서울 삼성,Home,김무성,3,1,1,100.0,0,1,0.0,1,2,50.0,1,2,50.0,0,1,1,1,0,0,0,0,0,1
../kbl_data/2023-2024,S43G01N22,서울 삼성,Home,이원석,1,0,4,0.0,0,0,0.0,0,4,0.0,1,2,50.0,3,4,7,1,0,0,0,0,2,3
../kbl_data/2023-2024,S43G01N22,서울 삼성,Home,조준희,15,1,2,50.0,4,12,33.3,5,14,35.7,1,2,50.0,0,0,0,1,0,0,1,0,2,0
../kbl_data/2023-2024,S43G01N22,서울 삼성,Home,아반 나바,11,1,3,33.3,3,8,37.5,4,11,36.4,0,0,0.0,2,1,3,3,1,0,0,0,1,1
../kbl_data/2023-2024,S43G01N22,서울 삼성,Home,이스마엘 레인,15,6,10,60.0,0,0,0.0,6,10,60.0,3,6,50.0,3,6,9,0,1,0,0,1,2,1
../kbl_data/2023-2024,S43G01N22,서울 삼성,Home,코피 코번,24,10,14,71.4,0,0,0.0,10,14,71.4,4,4,100.0,6,4,10,0,0,2,0,1,3,1
../kbl_data/2023-2024,S43G01N22,안양 정관장,Away,정준원,2,1,4,25.0,0,2,0.0,1,6,16.7,0,0,0.0,1,1,2,0,0,0,0,0,1,0
../kbl_data/2023-2024,S43G01N22,안양 정관장,Away,배병준,22,4,5,80.0,4,5,80.0,8,10,80.0,2,2,100.0,0,1,1,0,0,0,0,0,0,1
../kbl_data/2023-2024,S43G01N22,안양 정관장,Away,정효근,7,3,7,42.9,0,2,0.0,3,9,33.3,1,2,50.0,1,6,7,1,1,0,0,1,1,2
../kbl_data/2023-2024,S43G01N22,안양 정관장,Away,이종현,13,6,9,66.7,0,0,0.0,6,9,66.7,1,1,100.0,3,7,10,0,0,1,0,0,1,3
../kbl_data/2023-2024,S43G01N22,안양 정관장,Away,박지훈,8,4,5,80.0,0,1,0.0,4,6,66.7,0,0,0.0,0,0,0,3,3,0,1,0,0,2
../kbl_data/2023-2024,S43G01N22,안양 정관장,Away,최성원,7,1,4,25.0,1,6,16.7,2,10,20.0,2,2,100.0,1,1,2,2,0,0,0,0,0,2
../kbl_data/2023-2024,S43G01N22,안양 정관장,Away,이우정,0,0,1,0.0,0,0,0.0,0,1,0.0,0,0,0.0,0,0,0,0,0,0,0,0,1,0
../kbl_data/2023-2024,S43G01N22,안양 정관장,Away,대릴 먼로,2,1,4,25.0,0,1,0.0,1,5,20.0,0,0,0.0,1,4,5,9,2,0,0,0,1,4
../kbl_data/2023-2024,S43G01N22,안양 정관장,Away,김경원,8,4,5,80.0,0,1,0.0,4,6,66.7,0,0,0.0,4,3,7,1,2,1,0,0,0,4
../kbl_data/2023-2024,S43G01N22,안양 정관장,Away,렌즈 아반도,11,5,7,71.4,0,0,0.0,5,7,71.4,1,2,50.0,3,0,3,0,1,1,1,1,0,2
../kbl_data/2023-2024,S43G01N22,안양 정관장,Away,고찬혁,5,0,1,0.0,1,2,50.0,1,3,33.3,2,2,100.0,1,1,2,0,0,0,0,0,1,1
../kbl_data/2023-2024,S43G01N22,안양 정관장,Away,듀반 맥스웰,11,5,9,55.6,0,1,0.0,5,10,50.0,1,2,50.0,0,4,4,2,2,1,0,0,0,1
../kbl_data/2023-2024,S43G01N23,울산 현대모비스,Home,함지훈,0,0,0,0.0,0,0,0.0,0,0,0.0,0,0,0.0,1,1,2,1,0,0,0,0,1,1
../kbl_data/2023-2024,S43G01N23,울산 현대모비스,Home,최진수,0,0,0,0.0,0,0,0.0,0,0,0.0,0,0,0.0,0,0,0,0,0,0,0,0,0,1
../kbl_data/2023-2024,S43G01N23,울산 현대모비스,Home,김현수,2,0,0,0.0,0,0,0.0,0,0,0.0,2,2,100.0,0,0,0,0,1,0,0,0,0,0
../kbl_data/2023-2024,S43G01N23,울산 현대모비스,Home,장재석,0,0,0,0.0,0,0,0.0,0,0,0.0,0,0,0.0,0,0,0,0,0,1,0,0,0,0
../kbl_data/2023-2024,S43G01N23,울산 현대모비스,Home,김지완,4,2,3,66.7,0,3,0.0,2,6,33.3,0,0,0.0,0,1,1,2,1,0,0,0,0,0
../kbl_data/2023-2024,S43G01N23,울산 현대모비스,Home,김준일,12,5,10,50.0,0,0,0.0,5,10,50.0,2,2,100.0,4,1,5,5,1,2,0,1,1,3
../kbl_data/2023-2024,S43G01N23,울산 현대모비스,Home,김국찬,15,4,5,80.0,2,4,50.0,6,9,66.7,1,1,100.0,1,4,5,4,0,0,0,0,1,4
../kbl_data/2023-2024,S43G01N23,울산 현대모비스,Home,이우석,4,2,7,28.6,0,0,0.0,2,7,28.6,0,0,0.0,1,2,3,2,0,0,0,0,1,2
../kbl_data/2023-2024,S43G01N23,울산 현대모비스,Home,신민석,0,0,1,0.0,0,0,0.0,0,1,0.0,0,0,0.0,0,0,0,0,0,0,0,0,0,0
../kbl_data/2023-2024,S43G01N23,울산 현대모비스,Home,게이지 프림,20,9,18,50.0,0,0,0.0,9,18,50.0,2,4,50.0,3,5,8,0,0,1,0,0,2,4
../kbl_data/2023-2024,S43G01N23,울산 현대모비스,Home,김태완,5,1,2,50.0,1,5,20.0,2,7,28.6,0,0,0.0,0,0,0,4,3,1,0,0,0,3
../kbl_data/2023-2024,S43G01N23,울산 현대모비스,Home,케베 알루마,17,7,11,63.6,1,4,25.0,8,15,53.3,0,3,0.0,2,4,6,1,0,0,0,0,1,1
../kbl_data/2023-2024,S43G01N23,부산 KCC,Away,정창영,0,0,2,0.0,0,1,0.0,0,3,0.0,0,0,0.0,1,1,2,3,0,0,0,0,0,2
../kbl_data/2023-2024,S43G01N23,부산 KCC,Away,라건아,20,9,12,75.0,0,1,0.0,9,13,69.2,2,3,66.7,3,9,12,0,0,0,0,0,0,3
../kbl_data/2023-2024,S43G01N23,부산 KCC,Away,허웅,7,2,5,40.0,0,4,0.0,2,9,22.2,3,3,100.0,0,1,1,5,0,0,0,0,1,1
../kbl_data/2023-2024,S43G01N23,부산 KCC,Away,이승현,4,2,6,33.3,0,1,0.0,2,7,28.6,0,0,0.0,2,7,9,3,0,0,0,0,1,1
../kbl_data/2023-2024,S43G01N23,부산 KCC,Away,이호현,7,2,7,28.6,1,1,100.0,3,8,37.5,0,0,0.0,0,1,1,6,0,0,1,0,2,0
../kbl_data/2023-2024,S43G01N23,부산 KCC,Away,이근휘,6,0,0,0.0,2,4,50.0,2,4,50.0,0,0,0.0,0,0,0,0,1,0,0,0,0,2
../kbl_data/2023-2024,S43G01N23,부산 KCC,Away,김동현,0,0,0,0.0,0,0,0.0,0,0,0.0,0,0,0.0,0,0,0,0,0,0,0,0,1,0
../kbl_data/2023-2024,S43G01N23,부산 KCC,Away,서정현,0,0,0,0.0,0,0,0.0,0,0,0.0,0,0,0.0,0,0,0,0,0,0,0,0,0,0
../kbl_data/2023-2024,S43G01N23,부산 KCC,Away,송동훈,2,1,2,50.0,0,2,0.0,1,4,25.0,0,0,0.0,0,0,0,0,2,0,0,0,1,3
../kbl_data/2023-2024,S43G01N23,부산 KCC,Away,여준형,8,4,5,80.0,0,1,0.0,4,6,66.7,0,0,0.0,0,0,0,0,0,0,0,0,0,2
../kbl_data/2023-2024,S43G01N23,부산 KCC,Away,캘빈 제프리 에피스톨라,0,0,0,0.0,0,0,0.0,0,0,0.0,0,0,0.0,0,0,0,0,0,0,0,0,0,0
../kbl_data/2023-2024,S43G01N23,부산 KCC,Away,알리제 드숀 존슨,37,10,15,66.7,4,6,66.7,14,21,66.7,5,6,83.3,9,8,17,4,0,0,0,0,2,4
../kbl_data/2023-2024,S43G01N24,대구 한국가스공사,Home,김동량,0,0,0,0.0,0,0,0.0,0,0,0.0,0,0,0.0,0,0,0,0,0,0,0,0,1,0
../kbl_data/2023-2024,S43G01N24,대구 한국가스공사,Home,차바위,2,1,2,50.0,0,2,0.0,1,4,25.0,0,0,0.0,1,1,2,1,0,0,0,0,0,3
../kbl_data/2023-2024,S43G01N24,대구 한국가스공사,Home,박지훈,0,0,1,0.0,0,0,0.0,0,1,0.0,0,0,0.0,0,0,0,0,0,0,0,0,0,0
../kbl_data/2023-2024,S43G01N24,대구 한국가스공사,Home,조상열,0,0,0,0.0,0,0,0.0,0,0,0.0,0,0,0.0,0,0,0,0,0,0,0,0,0,1
../kbl_data/2023-2024,S43G01N24,대구 한국가스공사,Home,박봉진,9,0,1,0.0,3,6,50.0,3,7,42.9,0,0,0.0,4,9,13,1,1,0,2,0,0,4
../kbl_data/2023-2024,S43G01N24,대구 한국가스공사,Home,양준우,16,1,2,50.0,4,8,50.0,5,10,50.0,2,3,66.7,0,1,1,2,2,0,1,0,2,3
../kbl_data/2023-2024,S43G01N24,대구 한국가스공사,Home,앤드류 니콜슨,18,6,20,30.0,0,3,0.0,6,23,26.1,6,7,85.7,4,1,5,2,1,0,0,0,4,0
../kbl_data/2023-2024,S43G01N24,대구 한국가스공사,Home,신승민,16,2,5,40.0,3,8,37.5,5,13,38.5,3,4,75.0,1,1,2,2,2,0,0,0,0,2
../kbl_data/2023-2024,S43G01N24,대구 한국가스공사,Home,샘조세프 벨란겔,8,3,5,60.0,0,3,0.0,3,8,37.5,2,2,100.0,0,1,1,1,1,0,0,0,2,1
../kbl_data/2023-2024,S43G01N24,대구 한국가스공사,Home,염유성,0,0,0,0.0,0,0,0.0,0,0,0.0,0,0,0.0,0,0,0,0,0,0,0,0,0,0
../kbl_data/2023-2024,S43G01N24,대구 한국가스공사,Home,앤쏘니 모스,7,3,4,75.0,0,0,0.0,3,4,75.0,1,2,50.0,4,2,6,1,0,0,0,0,0,1
../kbl_data/2023-2024,S43G01N24,대구 한국가스공사,Home,신주영,3,1,4,25.0,0,1,0.0,1,5,20.0,1,1,100.0,2,2,4,0,0,0,0,0,2,2
../kbl_data/2023-2024,S43G01N24,원주 DB,Away,박찬희,8,1,2,50.0,2,5,40.0,3,7,42.9,0,0,0.0,0,0,0,0,0,1,0,0,1,1
../kbl_data/2023-2024,S43G01N24,원주 DB,Away,김현호,0,0,0,0.0,0,0,0.0,0,0,0.0,0,0,0.0,0,0,0,0,0,0,0,0,0,0
../kbl_data/2023-2024,S43G01N24,원주 DB,Away,서민수,9,3,3,100.0,1,4,25.0,4,7,57.1,0,0,0.0,1,4,5,2,1,0,0,0,1,2
../kbl_data/2023-2024,S43G01N24,원주 DB,Away,김영현,0,0,2,0.0,0,0,0.0,0,2,0.0,0,0,0.0,0,1,1,0,1,0,0,0,0,3
../kbl_data/2023-2024,S43G01N24,원주 DB,Away,김종규,8,4,6,66.7,0,0,0.0,4,6,66.7,0,0,0.0,0,4,4,1,1,1,0,3,0,2
../kbl_data/2023-2024,S43G01N24,원주 DB,Away,최승욱,4,2,2,100.0,0,0,0.0,2,2,100.0,0,0,0.0,2,0,2,2,1,0,0,0,1,1
../kbl_data/2023-2024,S43G01N24,원주 DB,Away,강상재,16,4,7,57.1,1,1,100.0,5,8,62.5,5,5,100.0,2,5,7,6,3,0,0,0,5,4
../kbl_data/2023-2024,S43G01N24,원주 DB,Away,디드릭 로슨,21,5,8,62.5,3,8,37.5,8,16,50.0,2,2,100.0,2,11,13,6,0,4,0,0,4,2
../kbl_data/2023-2024,S43G01N24,원주 DB,Away,이선 알바노,18,3,7,42.9,3,4,75.0,6,11,54.5,3,3,100.0,1,2,3,5,1,0,0,0,2,4
../kbl_data/2023-2024,S43G01N24,원주 DB,Away,박인웅,10,2,3,66.7,2,3,66.7,4,6,66.7,0,0,0.0,0,2,2,1,1,0,0,0,0,2
../kbl_data/2023-2024,S43G01N24,원주 DB,Away,인승찬,0,0,0,0.0,0,0,0.0,0,0,0.0,0,0,0.0,0,0,0,0,0,0,0,0,0,0
../kbl_data/2023-2024,S43G01N24,원주 DB,Away,제프 위디,0,0,1,0.0,0,0,0.0,0,1,0.0,0,0,0.0,0,0,0,0,0,0,0,0,1,1
../kbl_data/2023-2024,S43G01N25,창원 LG,Home,이관희,9,2,5,40.0,1,4,25.0,3,9,33.3,2,2,100.0,0,3,3,2,0,0,0,0,0,2
../kbl_data/2023-2024,S43G01N25,창원 LG,Home,정희재,0,0,0,0.0,0,1,0.0,0,1,0.0,0,0,0.0,0,2,2,1,1,0,0,0,1,2
../kbl_data/2023-2024,S43G01N25,창원 LG,Home,임동섭,3,0,1,0.0,1,1,100.0,1,2,50.0,0,0,0.0,0,1,1,0,1,0,0,0,0,0
../kbl_data/2023-2024,S43G01N25,창원 LG,Home,이재도,7,3,7,42.9,0,0,0.0,3,7,42.9,1,1,100.0,0,5,5,6,4,0,0,0,1,2
../kbl_data/2023-2024,S43G01N25,창원 LG,Home,정인덕,0,0,4,0.0,0,1,0.0,0,5,0.0,0,0,0.0,0,1,1,1,0,0,0,0,0,1
../kbl_data/2023-2024,S43G01N25,창원 LG,Home,양홍석,10,2,6,33.3,2,4,50.0,4,10,40.0,0,0,0.0,1,4,5,1,0,0,0,0,0,2
../kbl_data/2023-2024,S43G01N25,창원 LG,Home,윤원상,2,1,1,100.0,0,2,0.0,1,3,33.3,0,0,0.0,0,0,0,0,0,0,0,0,0,0
../kbl_data/2023-2024,S43G01N25,창원 LG,Home,아셈 마레이,16,6,12,50.0,0,0,0.0,6,12,50.0,4,8,50.0,7,13,20,2,0,2,0,0,1,2
../kbl_data/2023-2024,S43G01N25,창원 LG,Home,저스틴 구탕,9,3,4,75.0,1,1,100.0,4,5,80.0,0,0,0.0,0,1,1,1,0,0,0,0,1,2
../kbl_data/2023-2024,S43G01N25,창원 LG,Home,양준석,7,2,4,50.0,1,2,50.0,3,6,50.0,0,0,0.0,0,1,1,2,0,0,0,0,1,2
../kbl_data/2023-2024,S43G01N25,창원 LG,Home,단테 커닝햄,2,1,1,100.0,0,0,0.0,1,1,100.0,0,0,0.0,0,2,2,0,0,1,0,0,1,0
../kbl_data/2023-2024,S43G01N25,창원 LG,Home,유기상,4,2,4,50.0,0,3,0.0,2,7,28.6,0,0,0.0,0,2,2,2,4,0,0,0,1,0
../kbl_data/2023-2024,S43G01N25,서울 SK,Away,허일영,7,3,8,37.5,0,2,0.0,3,10,30.0,1,2,50.0,1,4,5,0,2,0,0,0,1,2
../kbl_data/2023-2024,S43G01N25,서울 SK,Away,김선형,4,2,6,33.3,0,4,0.0,2,10,20.0,0,0,0.0,0,2,2,1,1,1,0,0,3,2
../kbl_data/2023-2024,S43G01N25,서울 SK,Away,홍경기,0,0,0,0.0,0,2,0.0,0,2,0.0,0,0,0.0,0,0,0,0,0,0,0,0,1,1
../kbl_data/2023-2024,S43G01N25,서울 SK,Away,오세근,1,0,6,0.0,0,0,0.0,0,6,0.0,1,2,50.0,1,4,5,3,0,0,0,0,1,1
../kbl_data/2023-2024,S43G01N25,서울 SK,Away,최부경,2,1,4,25.0,0,0,0.0,1,4,25.0,0,0,0.0,1,4,5,0,0,0,0,0,0,3
../kbl_data/2023-2024,S43G01N25,서울 SK,Away,리온 윌리엄스,0,0,1,0.0,0,0,0.0,0,1,0.0,0,0,0.0,2,0,2,0,0,0,0,0,1,0
../kbl_data/2023-2024,S43G01N25,서울 SK,Away,최원혁,5,1,2,50.0,1,2,50.0,2,4,50.0,0,0,0.0,1,3,4,2,2,0,0,0,2,4
../kbl_data/2023-2024,S43G01N25,서울 SK,Away,자밀 워니,22,7,16,43.8,2,6,33.3,9,22,40.9,2,3,66.7,4,9,13,4,0,1,0,0,1,2
../kbl_data/2023-2024,S43G01N25,서울 SK,Away,전성환,0,0,0,0.0,0,0,0.0,0,0,0.0,0,0,0.0,0,0,0,0,0,0,0,0,0,0
../kbl_data/2023-2024,S43G01N25,서울 SK,Away,김형빈,0,0,0,0.0,0,0,0.0,0,0,0.0,0,0,0.0,0,0,0,0,0,0,0,0,0,0
../kbl_data/2023-2024,S43G01N25,서울 SK,Away,오재현,9,0,1,0.0,2,5,40.0,2,6,33.3,3,4,75.0,0,5,5,2,1,0,0,0,2,4
../kbl_data/2023-2024,S43G01N25,서울 SK,Away,문가온,0,0,0,0.0,0,0,0.0,0,0,0.0,0,0,0.0,0,0,0,0,0,0,0,0,0,0
../kbl_data/2023-2024,S43G01N26,안양 정관장,Home,정준원,0,0,0,0.0,0,0,0.0,0,0,0.0,0,0,0.0,0,0,0,0,0,0,0,0,0,0
../kbl_data/2023-2024,S43G01N26,안양 정관장,Home,배병준,8,1,2,50.0,2,6,33.3,3,8,37.5,0,0,0.0,0,1,1,2,0,0,1,0,1,4
../kbl_data/2023-2024,S43G01N26,안양 정관장,Home,정효근,9,3,8,37.5,1,3,33.3,4,11,36.4,0,0,0.0,1,3,4,0,0,1,1,0,0,2
../kbl_data/2023-2024,S43G01N26,안양 정관장,Home,이종현,0,0,0,0.0,0,0,0.0,0,0,0.0,0,0,0.0,0,0,0,0,0,0,0,0,0,0
../kbl_data/2023-2024,S43G01N26,안양 정관장,Home,박지훈,21,6,12,50.0,3,5,60.0,9,17,52.9,0,0,0.0,3,4,7,6,0,0,2,0,3,2
../kbl_data/2023-2024,S43G01N26,안양 정관장,Home,최성원,4,0,1,0.0,0,5,0.0,0,6,0.0,4,4,100.0,0,2,2,3,0,0,0,0,1,3
../kbl_data/2023-2024,S43G01N26,안양 정관장,Home,이우정,0,0,0,0.0,0,0,0.0,0,0,0.0,0,0,0.0,0,0,0,0,0,0,0,0,0,0
../kbl_data/2023-2024,S43G01N26,안양 정관장,Home,대릴 먼로,11,3,3,100.0,1,2,50.0,4,5,80.0,2,2,100.0,2,12,14,2,0,0,0,0,3,3
../kbl_data/2023-2024,S43G01N26,안양 정관장,Home,김경원,5,1,5,20.0,1,1,100.0,2,6,33.3,0,0,0.0,1,3,4,2,0,1,0,0,0,0
../kbl_data/2023-2024,S43G01N26,안양 정관장,Home,렌즈 아반도,16,5,7,71.4,1,3,33.3,6,10,60.0,3,4,75.0,2,1,3,2,0,0,0,1,3,3
../kbl_data/2023-2024,S43G01N26,안양 정관장,Home,고찬혁,2,1,1,100.0,0,1,0.0,1,2,50.0,0,0,0.0,0,0,0,0,0,0,0,0,0,0
../kbl_data/2023-2024,S43G01N26,안양 정관장,Home,듀반 맥스웰,6,3,3,100.0,0,0,0.0,3,3,100.0,0,0,0.0,0,2,2,2,0,1,0,0,1,2
../kbl_data/2023-2024,S43G01N26,고양 소노,Away,김강선,3,0,0,0.0,1,2,50.0,1,2,50.0,0,0,0.0,0,1,1,1,0,0,0,0,0,1
../kbl_data/2023-2024,S43G01N26,고양 소노,Away,최현민,11,0,2,0.0,3,6,50.0,3,8,37.5,2,2,100.0,4,3,7,3,0,0,0,0,2,4
../kbl_data/2023-2024,S43G01N26,고양 소노,Away,김민욱,0,0,2,0.0,0,2,0.0,0,4,0.0,0,0,0.0,0,1,1,0,0,0,1,0,0,1
../kbl_data/2023-2024,S43G01N26,고양 소노,Away,한호빈,8,1,3,33.3,2,5,40.0,3,8,37.5,0,0,0.0,0,1,1,2,3,0,0,0,1,1
../kbl_data/2023-2024,S43G01N26,고양 소노,Away,전성현,20,1,4,25.0,5,10,50.0,6,14,42.9,3,4,75.0,0,1,1,0,1,0,0,0,0,1
../kbl_data/2023-2024,S43G01N26,고양 소노,Away,이정현,19,6,9,66.7,2,6,33.3,8,15,53.3,1,2,50.0,1,6,7,8,2,1,2,0,2,2
../kbl_data/2023-2024,S43G01N26,고양 소노,Away,백지웅,0,0,0,0.0,0,1,0.0,0,1,0.0,0,0,0.0,0,0,0,0,0,0,0,0,0,1
../kbl_data/2023-2024,S43G01N26,고양 소노,Away,안정욱,0,0,0,0.0,0,0,0.0,0,0,0.0,0,0,0.0,1,0,1,0,0,0,0,0,0,1
../kbl_data/2023-2024,S43G01N26,고양 소노,Away,재로드 존스,9,4,7,57.1,0,5,0.0,4,12,33.3,1,3,33.3,3,2,5,0,0,0,0,0,1,1
../kbl_data/2023-2024,S43G01N26,고양 소노,Away,민기남,0,0,0,0.0,0,0,0.0,0,0,0.0,0,0,0.0,0,0,0,0,0,0,0,0,0,0
../kbl_data/2023-2024,S43G01N26,고양 소노,Away,조쉬 토랄바,0,0,0,0.0,0,0,0.0,0,0,0.0,0,0,0.0,0,0,0,0,0,0,0,0,0,0
../kbl_data/2023-2024,S43G01N26,고양 소노,Away,디욘테 데이비스,14,7,9,77.8,0,3,0.0,7,12,58.3,0,0,0.0,2,8,10,1,0,2,0,3,2,4
../kbl_data/2023-2024,S43G01N27,서울 삼성,Home,이정현,2,0,4,0.0,0,5,0.0,0,9,0.0,2,2,100.0,0,1,1,3,0,0,0,0,1,4
../kbl_data/2023-2024,S43G01N27,서울 삼성,Home,김승원,0,0,0,0.0,0,0,0.0,0,0,0.0,0,0,0.0,0,0,0,0,0,0,0,0,0,0
../kbl_data/2023-2024,S43G01N27,서울 삼성,Home,김시래,8,0,1,0.0,2,4,50.0,2,5,40.0,2,2,100.0,0,5,5,4,0,0,0,0,2,3
../kbl_data/2023-2024,S43G01N27,서울 삼성,Home,이동엽,6,1,2,50.0,1,2,50.0,2,4,50.0,1,2,50.0,0,4,4,1,0,0,0,0,1,1
../kbl_data/2023-2024,S43G01N27,서울 삼성,Home,최승욱,2,1,5,20.0,0,1,0.0,1,6,16.7,0,0,0.0,4,2,6,1,1,0,0,0,1,3
../kbl_data/2023-2024,S43G01N27,서울 삼성,Home,김무성,0,0,1,0.0,0,0,0.0,0,1,0.0,0,0,0.0,1,0,1,1,0,0,0,0,0,2
../kbl_data/2023-2024,S43G01N27,서울 삼성,Home,조우성,0,0,0,0.0,0,0,0.0,0,0,0.0,0,0,0.0,1,0,1,0,0,0,0,0,1,3
../kbl_data/2023-2024,S43G01N27,서울 삼성,Home,이원석,17,4,10,40.0,2,4,50.0,6,14,42.9,3,7,42.9,1,7,8,2,0,3,1,0,2,3
../kbl_data/2023-2024,S43G01N27,서울 삼성,Home,조준희,9,1,3,33.3,1,3,33.3,2,6,33.3,4,5,80.0,0,3,3,0,0,0,0,0,0,4
../kbl_data/2023-2024,S43G01N27,서울 삼성,Home,아반 나바,2,1,3,33.3,0,2,0.0,1,5,20.0,0,0,0.0,0,1,1,1,0,0,0,0,0,0
../kbl_data/2023-2024,S43G01N27,서울 삼성,Home,이스마엘 레인,2,1,2,50.0,0,0,0.0,1,2,50.0,0,0,0.0,1,0,1,0,0,0,0,1,0,0
../kbl_data/2023-2024,S43G01N27,서울 삼성,Home,코피 코번,39,16,22,72.7,0,0,0.0,16,22,72.7,7,11,63.6,12,7,19,6,1,1,0,0,4,1
../kbl_data/2023-2024,S43G01N27,수원 KT,Away,한희원,12,2,2,100.0,2,2,100.0,4,4,100.0,2,2,100.0,1,1,2,1,0,0,0,0,0,0
../kbl_data/2023-2024,S43G01N27,수원 KT,Away,최창진,0,0,1,0.0,0,1,0.0,0,2,0.0,0,0,0.0,0,0,0,6,2,0,0,0,0,4
../kbl_data/2023-2024,S43G01N27,수원 KT,Away,이현석,0,0,0,0.0,0,0,0.0,0,0,0.0,0,0,0.0,1,0,1,1,0,0,0,0,0,2
../kbl_data/2023-2024,S43G01N27,수원 KT,Away,정성우,10,2,5,40.0,0,0,0.0,2,5,40.0,6,6,100.0,0,4,4,4,0,0,0,0,0,3
../kbl_data/2023-2024,S43G01N27,수원 KT,Away,최성모,0,0,1,0.0,0,0,0.0,0,1,0.0,0,0,0.0,0,0,0,0,0,0,0,0,1,1
../kbl_data/2023-2024,S43G01N27,수원 KT,Away,김준환,18,3,6,50.0,2,3,66.7,5,9,55.6,6,8,75.0,0,1,1,2,2,1,0,0,0,2
../kbl_data/2023-2024,S43G01N27,수원 KT,Away,하윤기,16,5,8,62.5,0,0,0.0,5,8,62.5,6,6,100.0,3,5,8,1,1,1,0,0,0,5
../kbl_data/2023-2024,S43G01N27,수원 KT,Away,이두원,8,3,6,50.0,0,0,0.0,3,6,50.0,2,2,100.0,1,2,3,0,0,1,0,0,0,2
../kbl_data/2023-2024,S43G01N27,수원 KT,Away,숀 데이브 일데폰소,0,0,1,0.0,0,0,0.0,0,1,0.0,0,0,0.0,0,0,0,0,1,0,0,0,2,1
../kbl_data/2023-2024,S43G01N27,수원 KT,Away,문정현,0,0,1,0.0,0,0,0.0,0,1,0.0,0,0,0.0,0,1,1,0,1,0,0,0,0,1
../kbl_data/2023-2024,S43G01N27,수원 KT,Away,마이클 에릭,4,2,3,66.7,0,0,0.0,2,3,66.7,0,0,0.0,0,1,1,0,0,0,0,0,0,2
../kbl_data/2023-2024,S43G01N27,수원 KT,Away,패리스 배스,22,9,22,40.9,1,4,25.0,10,26,38.5,1,2,50.0,1,7,8,4,2,4,0,0,0,4
../kbl_data/2023-2024,S43G01N28,울산 현대모비스,Home,함지훈,11,4,5,80.0,0,2,0.0,4,7,57.1,3,5,60.0,4,2,6,2,1,0,0,0,1,2
../kbl_data/2023-2024,S43G01N28,울산 현대모비스,Home,김현민,2,1,1,100.0,0,1,0.0,1,2,50.0,0,0,0.0,2,0,2,1,1,0,0,0,0,0
../kbl_data/2023-2024,S43G01N28,울산 현대모비스,Home,최진수,0,0,2,0.0,0,0,0.0,0,2,0.0,0,0,0.0,0,0,0,0,0,0,0,0,0,0
../kbl_data/2023-2024,S43G01N28,울산 현대모비스,Home,김현수,0,0,0,0.0,0,0,0.0,0,0,0.0,0,0,0.0,0,0,0,0,0,0,0,0,0,0
../kbl_data/2023-2024,S43G01N28,울산 현대모비스,Home,김지완,5,0,1,0.0,1,4,25.0,1,5,20.0,2,2,100.0,0,4,4,5,2,0,0,0,2,4
../kbl_data/2023-2024,S43G01N28,울산 현대모비스,Home,김준일,6,3,5,60.0,0,0,0.0,3,5,60.0,0,0,0.0,3,2,5,1,0,0,0,0,2,1
../kbl_data/2023-2024,S43G01N28,울산 현대모비스,Home,김국찬,8,1,4,25.0,2,8,25.0,3,12,25.0,0,0,0.0,1,2,3,3,0,0,0,0,2,4
../kbl_data/2023-2024,S43G01N28,울산 현대모비스,Home,이우석,19,6,9,66.7,2,3,66.7,8,12,66.7,1,2,50.0,1,3,4,6,1,0,0,0,3,3
../kbl_data/2023-2024,S43G01N28,울산 현대모비스,Home,신민석,0,0,0,0.0,0,1,0.0,0,1,0.0,0,0,0.0,0,0,0,0,0,0,0,0,0,1
../kbl_data/2023-2024,S43G01N28,울산 현대모비스,Home,게이지 프림,18,7,14,50.0,0,0,0.0,7,14,50.0,4,4,100.0,5,6,11,3,0,1,0,0,2,5
../kbl_data/2023-2024,S43G01N28,울산 현대모비스,Home,김태완,0,0,1,0.0,0,1,0.0,0,2,0.0,0,0,0.0,0,1,1,1,0,0,0,0,0,1
../kbl_data/2023-2024,S43G01N28,울산 현대모비스,Home,케베 알루마,10,4,9,44.4,0,6,0.0,4,15,26.7,2,2,100.0,3,5,8,2,0,0,0,0,3,2
../kbl_data/2023-2024,S43G01N28,원주 DB,Away,박찬희,0,0,0,0.0,0,0,0.0,0,0,0.0,0,0,0.0,0,0,0,0,0,0,0,0,0,0
../kbl_data/2023-2024,S43G01N28,원주 DB,Away,김현호,0,0,0,0.0,0,2,0.0,0,2,0.0,0,0,0.0,0,1,1,2,0,0,0,0,0,1
../kbl_data/2023-2024,S43G01N28,원주 DB,Away,서민수,4,2,3,66.7,0,0,0.0,2,3,66.7,0,0,0.0,1,2,3,0,0,0,0,0,0,1
../kbl_data/2023-2024,S43G01N28,원주 DB,Away,김영현,1,0,0,0.0,0,3,0.0,0,3,0.0,1,2,50.0,3,0,3,0,0,0,0,0,0,1
../kbl_data/2023-2024,S43G01N28,원주 DB,Away,김종규,13,4,6,66.7,0,0,0.0,4,6,66.7,5,6,83.3,1,5,6,0,0,0,1,0,0,3
../kbl_data/2023-2024,S43G01N28,원주 DB,Away,최승욱,7,2,4,50.0,1,2,50.0,3,6,50.0,0,0,0.0,2,1,3,2,2,0,0,1,0,3
../kbl_data/2023-2024,S43G01N28,원주 DB,Away,강상재,10,1,4,25.0,1,5,20.0,2,9,22.2,5,8,62.5,1,4,5,1,1,0,0,0,3,4
../kbl_data/2023-2024,S43G01N28,원주 DB,Away,디드릭 로슨,36,14,24,58.3,2,6,33.3,16,30,53.3,2,2,100.0,5,6,11,3,0,3,0,0,0,2
../kbl_data/2023-2024,S43G01N28,원주 DB,Away,이선 알바노,14,2,11,18.2,2,2,100.0,4,13,30.8,4,6,66.7,0,2,2,7,2,0,0,0,3,1
../kbl_data/2023-2024,S43G01N28,원주 DB,Away,박인웅,3,0,1,0.0,1,3,33.3,1,4,25.0,0,0,0.0,0,2,2,2,2,0,0,0,1,1
../kbl_data/2023-2024,S43G01N28,원주 DB,Away,인승찬,0,0,0,0.0,0,0,0.0,0,0,0.0,0,0,0.0,0,0,0,0,0,0,0,0,0,0
../kbl_data/2023-2024,S43G01N28,원주 DB,Away,제프 위디,2,0,0,0.0,0,0,0.0,0,0,0.0,2,2,100.0,0,1,1,0,0,0,0,0,0,0
../kbl_data/2023-2024,S43G01N29,대구 한국가스공사,Home,김동량,0,0,1,0.0,0,0,0.0,0,1,0.0,0,0,0.0,1,0,1,0,0,0,0,0,0,0
../kbl_data/2023-2024,S43G01N29,대구 한국가스공사,Home,차바위,2,1,1,100.0,0,4,0.0,1,5,20.0,0,0,0.0,1,0,1,2,3,0,0,0,0,2
../kbl_data/2023-2024,S43G01N29,대구 한국가스공사,Home,조상열,0,0,0,0.0,0,0,0.0,0,0,0.0,0,0,0.0,0,0,0,0,0,0,0,0,1,2
../kbl_data/2023-2024,S43G01N29,대구 한국가스공사,Home,이대헌,12,4,9,44.4,1,3,33.3,5,12,41.7,1,2,50.0,3,8,11,3,1,0,0,0,0,2
../kbl_data/2023-2024,S43G01N29,대구 한국가스공사,Home,박봉진,3,0,0,0.0,1,2,50.0,1,2,50.0,0,0,0.0,1,2,3,1,1,0,0,0,1,3
../kbl_data/2023-2024,S43G01N29,대구 한국가스공사,Home,양준우,10,2,5,40.0,2,5,40.0,4,10,40.0,0,0,0.0,0,1,1,7,0,0,1,0,2,4
../kbl_data/2023-2024,S43G01N29,대구 한국가스공사,Home,앤드류 니콜슨,26,6,15,40.0,4,7,57.1,10,22,45.5,2,3,66.7,1,4,5,0,1,0,0,0,1,0
../kbl_data/2023-2024,S43G01N29,대구 한국가스공사,Home,신승민,7,1,2,50.0,1,3,33.3,2,5,40.0,2,2,100.0,4,2,6,1,0,0,0,0,2,2
../kbl_data/2023-2024,S43G01N29,대구 한국가스공사,Home,샘조세프 벨란겔,2,1,3,33.3,0,1,0.0,1,4,25.0,0,0,0.0,0,0,0,4,0,0,1,0,1,3
../kbl_data/2023-2024,S43G01N29,대구 한국가스공사,Home,앤쏘니 모스,8,2,6,33.3,0,0,0.0,2,6,33.3,4,4,100.0,3,2,5,0,0,0,0,1,0,0
../kbl_data/2023-2024,S43G01N29,대구 한국가스공사,Home,김태호,0,0,0,0.0,0,0,0.0,0,0,0.0,0,0,0.0,0,0,0,0,0,0,0,0,0,0
../kbl_data/2023-2024,S43G01N29,대구 한국가스공사,Home,신주영,10,2,3,66.7,2,4,50.0,4,7,57.1,0,2,0.0,0,2,2,1,0,0,0,0,0,0
../kbl_data/2023-2024,S43G01N29,안양 정관장,Away,정준원,2,1,1,100.0,0,0,0.0,1,1,100.0,0,0,0.0,0,0,0,0,0,0,0,0,0,0
../kbl_data/2023-2024,S43G01N29,안양 정관장,Away,배병준,4,2,4,50.0,0,5,0.0,2,9,22.2,0,0,0.0,0,3,3,1,1,0,0,0,1,2
../kbl_data/2023-2024,S43G01N29,안양 정관장,Away,정효근,3,0,1,0.0,1,1,100.0,1,2,50.0,0,0,0.0,1,2,3,0,0,0,0,0,0,0
../kbl_data/2023-2024,S43G01N29,안양 정관장,Away,이종현,10,5,7,71.4,0,0,0.0,5,7,71.4,0,0,0.0,2,1,3,2,1,0,0,1,0,2
../kbl_data/2023-2024,S43G01N29,안양 정관장,Away,박지훈,10,3,5,60.0,1,2,50.0,4,7,57.1,1,1,100.0,1,2,3,9,2,0,0,0,3,4
../kbl_data/2023-2024,S43G01N29,안양 정관장,Away,최성원,20,2,3,66.7,4,8,50.0,6,11,54.5,4,4,100.0,0,4,4,1,1,0,0,0,4,3
../kbl_data/2023-2024,S43G01N29,안양 정관장,Away,대릴 먼로,14,7,10,70.0,0,1,0.0,7,11,63.6,0,0,0.0,2,8,10,2,0,2,0,0,0,2
../kbl_data/2023-2024,S43G01N29,안양 정관장,Away,장태빈,0,0,0,0.0,0,0,0.0,0,0,0.0,0,0,0.0,0,0,0,0,0,0,0,0,0,0
../kbl_data/2023-2024,S43G01N29,안양 정관장,Away,김경원,2,1,2,50.0,0,0,0.0,1,2,50.0,0,0,0.0,2,0,2,2,0,1,0,0,0,2
../kbl_data/2023-2024,S43G01N29,안양 정관장,Away,렌즈 아반도,12,5,7,71.4,0,0,0.0,5,7,71.4,2,2,100.0,0,1,1,0,0,0,0,0,1,1
../kbl_data/2023-2024,S43G01N29,안양 정관장,Away,고찬혁,0,0,0,0.0,0,1,0.0,0,1,0.0,0,0,0.0,0,0,0,0,0,0,0,0,0,0
../kbl_data/2023-2024,S43G01N29,안양 정관장,Away,듀반 맥스웰,14,6,10,60.0,0,0,0.0,6,10,60.0,2,2,100.0,0,5,5,2,0,2,0,1,3,2
../kbl_data/2023-2024,S43G01N30,수원 KT,Home,한희원,12,1,2,50.0,3,4,75.0,4,6,66.7,1,2,50.0,1,3,4,2,0,1,0,0,1,0
../kbl_data/2023-2024,S43G01N30,수원 KT,Home,최창진,2,1,2,50.0,0,0,0.0,1,2,50.0,0,0,0.0,2,2,4,5,1,1,0,0,1,1
../kbl_data/2023-2024,S43G01N30,수원 KT,Home,이현석,6,0,0,0.0,2,2,100.0,2,2,100.0,0,0,0.0,0,2,2,0,0,0,0,0,2,2
../kbl_data/2023-2024,S43G01N30,수원 KT,Home,정성우,9,2,4,50.0,1,2,50.0,3,6,50.0,2,2,100.0,2,2,4,7,0,0,0,0,1,2
../kbl_data/2023-2024,S43G01N30,수원 KT,Home,최성모,2,1,1,100.0,0,0,0.0,1,1,100.0,0,0,0.0,0,0,0,0,0,0,0,0,0,0
../kbl_data/2023-2024,S43G01N30,수원 KT,Home,김준환,7,2,3,66.7,1,4,25.0,3,7,42.9,0,0,0.0,0,0,0,0,0,0,0,0,0,1
../kbl_data/2023-2024,S43G01N30,수원 KT,Home,하윤기,21,7,7,100.0,0,0,0.0,7,7,100.0,7,10,70.0,0,6,6,2,0,0,0,3,1,2
../kbl_data/2023-2024,S43G01N30,수원 KT,Home,이두원,4,2,5,40.0,0,0,0.0,2,5,40.0,0,0,0.0,2,1,3,1,1,2,0,1,0,2
../kbl_data/2023-2024,S43G01N30,수원 KT,Home,숀 데이브 일데폰소,3,0,0,0.0,1,1,100.0,1,1,100.0,0,0,0.0,0,0,0,0,0,0,0,0,0,0
../kbl_data/2023-2024,S43G01N30,수원 KT,Home,문정현,10,5,7,71.4,0,2,0.0,5,9,55.6,0,0,0.0,3,5,8,2,0,1,0,0,0,4
../kbl_data/2023-2024,S43G01N30,수원 KT,Home,마이클 에릭,4,2,2,100.0,0,0,0.0,2,2,100.0,0,0,0.0,0,6,6,1,0,0,0,0,1,0
../kbl_data/2023-2024,S43G01N30,수원 KT,Home,패리스 배스,21,6,10,60.0,2,4,50.0,8,14,57.1,3,4,75.0,2,10,12,8,2,2,0,1,7,1
../kbl_data/2023-2024,S43G01N30,고양 소노,Away,김강선,6,0,0,0.0,2,5,40.0,2,5,40.0,0,0,0.0,1,2,3,0,1,0,0,0,0,3
../kbl_data/2023-2024,S43G01N30,고양 소노,Away,최현민,3,0,0,0.0,1,6,16.7,1,6,16.7,0,0,0.0,0,0,0,3,1,0,0,0,0,4
../kbl_data/2023-2024,S43G01N30,고양 소노,Away,김민욱,0,0,0,0.0,0,0,0.0,0,0,0.0,0,0,0.0,0,0,0,1,0,0,0,0,0,0
../kbl_data/2023-2024,S43G01N30,고양 소노,Away,한호빈,5,1,1,100.0,1,4,25.0,2,5,40.0,0,0,0.0,2,0,2,0,0,0,0,0,0,0
../kbl_data/2023-2024,S43G01N30,고양 소노,Away,전성현,10,2,5,40.0,1,8,12.5,3,13,23.1,3,3,100.0,1,2,3,1,2,0,0,0,1,2
../kbl_data/2023-2024,S43G01N30,고양 소노,Away,이정현,21,4,8,50.0,4,10,40.0,8,18,44.4,1,1,100.0,0,1,1,3,3,0,0,0,2,2
../kbl_data/2023-2024,S43G01N30,고양 소노,Away,백지웅,0,0,0,0.0,0,3,0.0,0,3,0.0,0,0,0.0,0,0,0,0,0,0,0,0,0,0
../kbl_data/2023-2024,S43G01N30,고양 소노,Away,안정욱,3,0,0,0.0,1,2,50.0,1,2,50.0,0,0,0.0,1,0,1,0,0,0,0,0,0,0
../kbl_data/2023-2024,S43G01N30,고양 소노,Away,재로드 존스,2,0,4,0.0,0,3,0.0,0,7,0.0,2,2,100.0,0,1,1,0,0,0,0,0,0,0
../kbl_data/2023-2024,S43G01N30,고양 소노,Away,민기남,0,0,0,0.0,0,0,0.0,0,0,0.0,0,0,0.0,0,0,0,1,1,0,0,0,0,1
../kbl_data/2023-2024,S43G01N30,고양 소노,Away,조쉬 토랄바,5,0,1,0.0,1,5,20.0,1,6,16.7,2,2,100.0,0,0,0,1,2,0,0,0,0,1
../kbl_data/2023-2024,S43G01N30,고양 소노,Away,디욘테 데이비스,10,2,6,33.3,1,3,33.3,3,9,33.3,3,4,75.0,4,7,11,1,2,4,0,1,3,2
../kbl_data/2023-2024,S43G01N31,안양 정관장,Home,정준원,0,0,0,0.0,0,0,0.0,0,0,0.0,0,0,0.0,0,0,0,0,0,0,0,0,0,0
../kbl_data/2023-2024,S43G01N31,안양 정관장,Home,정효근,3,0,1,0.0,0,3,0.0,0,4,0.0,3,4,75.0,2,2,4,1,2,1,0,0,0,2
../kbl_data/2023-2024,S43G01N31,안양 정관장,Home,이종현,4,1,6,16.7,0,0,0.0,1,6,16.7,2,4,50.0,1,7,8,1,2,3,0,0,3,3
../kbl_data/2023-2024,S43G01N31,안양 정관장,Home,김철욱,0,0,0,0.0,0,0,0.0,0,0,0.0,0,0,0.0,0,0,0,0,0,0,0,0,0,0
../kbl_data/2023-2024,S43G01N31,안양 정관장,Home,박지훈,15,3,8,37.5,2,5,40.0,5,13,38.5,3,4,75.0,1,2,3,4,1,0,0,0,0,2
../kbl_data/2023-2024,S43G01N31,안양 정관장,Home,최성원,9,2,4,50.0,1,4,25.0,3,8,37.5,2,2,100.0,0,2,2,1,1,0,0,0,0,3
../kbl_data/2023-2024,S43G01N31,안양 정관장,Home,대릴 먼로,11,4,6,66.7,1,2,50.0,5,8,62.5,0,0,0.0,1,9,10,0,1,0,0,0,2,1
../kbl_data/2023-2024,S43G01N31,안양 정관장,Home,장태빈,0,0,0,0.0,0,0,0.0,0,0,0.0,0,0,0.0,0,0,0,0,0,0,0,0,0,0
../kbl_data/2023-2024,S43G01N31,안양 정관장,Home,김경원,2,1,2,50.0,0,1,0.0,1,3,33.3,0,0,0.0,0,1,1,0,0,0,0,0,0,1
../kbl_data/2023-2024,S43G01N31,안양 정관장,Home,렌즈 아반도,16,8,11,72.7,0,1,0.0,8,12,66.7,0,0,0.0,2,5,7,1,1,0,0,1,1,2
../kbl_data/2023-2024,S43G01N31,안양 정관장,Home,고찬혁,0,0,0,0.0,0,1,0.0,0,1,0.0,0,0,0.0,0,0,0,0,0,0,0,0,1,0
../kbl_data/2023-2024,S43G01N31,안양 정관장,Home,듀반 맥스웰,14,7,13,53.8,0,1,0.0,7,14,50.0,0,2,0.0,3,4,7,1,2,3,1,0,1,4
../kbl_data/2023-2024,S43G01N31,부산 KCC,Away,정창영,8,1,2,50.0,2,3,66.7,3,5,60.0,0,0,0.0,0,1,1,4,1,0,0,0,0,0
../kbl_data/2023-2024,S43G01N31,부산 KCC,Away,라건아,10,4,7,57.1,0,0,0.0,4,7,57.1,2,4,50.0,1,4,5,1,0,1,0,0,4,1
../kbl_data/2023-2024,S43G01N31,부산 KCC,Away,허웅,10,1,6,16.7,2,7,28.6,3,13,23.1,2,3,66.7,1,2,3,1,0,0,0,0,2,1
../kbl_data/2023-2024,S43G01N31,부산 KCC,Away,이승현,7,2,7,28.6,1,3,33.3,3,10,30.0,0,0,0.0,3,3,6,4,1,0,1,0,1,1
../kbl_data/2023-2024,S43G01N31,부산 KCC,Away,이호현,10,5,8,62.5,0,2,0.0,5,10,50.0,0,0,0.0,1,0,1,4,0,0,1,0,0,1
../kbl_data/2023-2024,S43G01N31,부산 KCC,Away,이근휘,8,1,1,100.0,2,7,28.6,3,8,37.5,0,0,0.0,0,0,0,2,1,0,0,0,1,4
../kbl_data/2023-2024,S43G01N31,부산 KCC,Away,김동현,0,0,0,0.0,0,0,0.0,0,0,0.0,0,0,0.0,0,0,0,0,0,0,0,0,0,0
../kbl_data/2023-2024,S43G01N31,부산 KCC,Away,서정현,0,0,1,0.0,0,0,0.0,0,1,0.0,0,0,0.0,0,2,2,0,0,0,0,0,0,1
../kbl_data/2023-2024,S43G01N31,부산 KCC,Away,송동훈,0,0,0,0.0,0,0,0.0,0,0,0.0,0,2,0.0,0,0,0,1,1,0,0,0,0,2
../kbl_data/2023-2024,S43G01N31,부산 KCC,Away,여준형,0,0,1,0.0,0,0,0.0,0,1,0.0,0,2,0.0,0,0,0,0,0,0,0,0,0,1
../kbl_data/2023-2024,S43G01N31,부산 KCC,Away,캘빈 제프리 에피스톨라,0,0,0,0.0,0,0,0.0,0,0,0.0,0,0,0.0,0,0,0,0,0,0,0,0,0,0
../kbl_data/2023-2024,S43G01N31,부산 KCC,Away,알리제 드숀 존슨,19,5,9,55.6,1,4,25.0,6,13,46.2,6,7,85.7,4,17,21,3,1,0,0,2,5,3
../kbl_data/2023-2024,S43G01N32,원주 DB,Home,박찬희,5,1,2,50.0,1,3,33.3,2,5,40.0,0,0,0.0,1,0,1,0,0,0,0,0,0,2
../kbl_data/2023-2024,S43G01N32,원주 DB,Home,김현호,2,1,1,100.0,0,0,0.0,1,1,100.0,0,0,0.0,0,0,0,0,0,0,0,0,0,0
../kbl_data/2023-2024,S43G01N32,원주 DB,Home,서민수,6,3,4,75.0,0,4,0.0,3,8,37.5,0,0,0.0,2,3,5,0,1,0,0,0,3,2
../kbl_data/2023-2024,S43G01N32,원주 DB,Home,김영현,0,0,0,0.0,0,1,0.0,0,1,0.0,0,0,0.0,1,1,2,0,0,0,0,0,0,2
../kbl_data/2023-2024,S43G01N32,원주 DB,Home,김종규,6,3,4,75.0,0,0,0.0,3,4,75.0,0,0,0.0,2,3,5,1,0,2,0,0,2,2
../kbl_data/2023-2024,S43G01N32,원주 DB,Home,최승욱,28,10,18,55.6,0,2,0.0,10,20,50.0,8,12,66.7,2,4,6,2,2,0,0,0,0,4
../kbl_data/2023-2024,S43G01N32,원주 DB,Home,강상재,18,4,4,100.0,2,3,66.7,6,7,85.7,4,4,100.0,0,2,2,0,1,0,0,0,2,3
../kbl_data/2023-2024,S43G01N32,원주 DB,Home,디드릭 로슨,12,3,5,60.0,1,5,20.0,4,10,40.0,3,3,100.0,0,4,4,5,1,2,0,0,0,1
../kbl_data/2023-2024,S43G01N32,원주 DB,Home,이선 알바노,10,5,9,55.6,0,0,0.0,5,9,55.6,0,0,0.0,1,1,2,11,4,0,0,0,1,1
../kbl_data/2023-2024,S43G01N32,원주 DB,Home,박인웅,12,2,5,40.0,2,6,33.3,4,11,36.4,2,2,100.0,3,3,6,1,1,0,0,0,1,2
../kbl_data/2023-2024,S43G01N32,원주 DB,Home,박승재,6,3,4,75.0,0,0,0.0,3,4,75.0,0,0,0.0,0,3,3,3,0,0,1,0,0,1
../kbl_data/2023-2024,S43G01N32,원주 DB,Home,제프 위디,9,4,7,57.1,0,1,0.0,4,8,50.0,1,2,50.0,3,8,11,1,0,1,0,1,1,2
../kbl_data/2023-2024,S43G01N32,서울 삼성,Away,이정현,2,0,2,0.0,0,2,0.0,0,4,0.0,2,2,100.0,0,1,1,5,1,0,0,0,2,3
../kbl_data/2023-2024,S43G01N32,서울 삼성,Away,김승원,0,0,0,0.0,0,0,0.0,0,0,0.0,0,0,0.0,0,0,0,0,0,0,0,0,0,0
../kbl_data/2023-2024,S43G01N32,서울 삼성,Away,김시래,3,0,0,0.0,1,2,50.0,1,2,50.0,0,2,0.0,0,2,2,3,0,0,0,0,0,1
../kbl_data/2023-2024,S43G01N32,서울 삼성,Away,이동엽,2,1,1,100.0,0,1,0.0,1,2,50.0,0,0,0.0,1,3,4,1,0,0,1,0,1,1
../kbl_data/2023-2024,S43G01N32,서울 삼성,Away,최승욱,28,10,18,55.6,0,2,0.0,10,20,50.0,8,12,66.7,2,4,6,2,2,0,0,0,0,4
../kbl_data/2023-2024,S43G01N32,서울 삼성,Away,윤성원,2,1,4,25.0,0,1,0.0,1,5,20.0,0,0,0.0,0,3,3,0,4,0,0,0,1,2
../kbl_data/2023-2024,S43G01N32,서울 삼성,Away,김무성,0,0,0,0.0,0,1,0.0,0,1,0.0,0,0,0.0,0,0,0,0,0,0,0,0,0,3
../kbl_data/2023-2024,S43G01N32,서울 삼성,Away,이원석,8,2,7,28.6,1,2,50.0,3,9,33.3,1,4,25.0,2,2,4,0,0,1,0,0,3,0
../kbl_data/2023-2024,S43G01N32,서울 삼성,Away,조준희,1,0,2,0.0,0,1,0.0,0,3,0.0,1,2,50.0,0,1,1,0,2,0,0,0,1,1
../kbl_data/2023-2024,S43G01N32,서울 삼성,Away,아반 나바,5,1,3,33.3,1,2,50.0,2,5,40.0,0,0,0.0,0,1,1,4,0,0,0,0,1,2
../kbl_data/2023-2024,S43G01N32,서울 삼성,Away,이스마엘 레인,14,7,9,77.8,0,2,0.0,7,11,63.6,0,0,0.0,2,2,4,1,0,0,0,1,0,1
../kbl_data/2023-2024,S43G01N32,서울 삼성,Away,코피 코번,15,6,15,40.0,0,0,0.0,6,15,40.0,3,4,75.0,1,4,5,2,0,0,0,1,7,2
../kbl_data/2023-2024,S43G01N33,수원 KT,Home,한희원,10,5,7,71.4,0,3,0.0,5,10,50.0,0,0,0.0,1,7,8,0,2,0,0,0,1,1
../kbl_data/2023-2024,S43G01N33,수원 KT,Home,최창진,0,0,1,0.0,0,0,0.0,0,1,0.0,0,0,0.0,0,0,0,0,0,0,0,0,0,0
../kbl_data/2023-2024,S43G01N33,수원 KT,Home,이현석,0,0,0,0.0,0,0,0.0,0,0,0.0,0,0,0.0,0,0,0,0,0,0,0,0,0,0
../kbl_data/2023-2024,S43G01N33,수원 KT,Home,정성우,18,3,5,60.0,3,6,50.0,6,11,54.5,3,5,60.0,0,2,2,6,0,0,0,0,2,3
../kbl_data/2023-2024,S43G01N33,수원 KT,Home,최성모,1,0,0,0.0,0,1,0.0,0,1,0.0,1,2,50.0,0,1,1,0,0,1,0,0,0,2
../kbl_data/2023-2024,S43G01N33,수원 KT,Home,김준환,0,0,0,0.0,0,1,0.0,0,1,0.0,0,0,0.0,0,0,0,0,0,0,0,0,0,0
../kbl_data/2023-2024,S43G01N33,수원 KT,Home,하윤기,22,7,11,63.6,0,0,0.0,7,11,63.6,8,10,80.0,1,9,10,3,0,1,0,0,1,3
../kbl_data/2023-2024,S43G01N33,수원 KT,Home,이두원,0,0,1,0.0,0,0,0.0,0,1,0.0,0,0,0.0,1,0,1,0,0,0,0,0,0,1
../kbl_data/2023-2024,S43G01N33,수원 KT,Home,숀 데이브 일데폰소,5,1,1,100.0,1,2,50.0,2,3,66.7,0,0,0.0,0,0,0,0,1,0,0,0,0,1
../kbl_data/2023-2024,S43G01N33,수원 KT,Home,문정현,6,3,5,60.0,0,1,0.0,3,6,50.0,0,0,0.0,5,3,8,2,2,0,0,0,0,2
../kbl_data/2023-2024,S43G01N33,수원 KT,Home,마이클 에릭,0,0,0,0.0,0,0,0.0,0,0,0.0,0,0,0.0,0,0,0,0,0,0,0,0,0,2
../kbl_data/2023-2024,S43G01N33,수원 KT,Home,패리스 배스,29,10,15,66.7,2,7,28.6,12,22,54.5,3,4,75.0,3,10,13,11,1,0,0,1,2,3
../kbl_data/2023-2024,S43G01N33,대구 한국가스공사,Away,김동량,3,0,0,0.0,0,0,0.0,0,0,0.0,3,4,75.0,0,1,1,2,0,0,0,0,0,1
../kbl_data/2023-2024,S43G01N33,대구 한국가스공사,Away,차바위,0,0,0,0.0,0,2,0.0,0,2,0.0,0,0,0.0,0,0,0,0,0,0,0,0,0,1
../kbl_data/2023-2024,S43G01N33,대구 한국가스공사,Away,조상열,0,0,0,0.0,0,1,0.0,0,1,0.0,0,0,0.0,0,0,0,0,0,0,0,0,0,1
../kbl_data/2023-2024,S43G01N33,대구 한국가스공사,Away,이대헌,12,6,9,66.7,0,3,0.0,6,12,50.0,0,2,0.0,3,3,6,2,1,0,0,0,0,2
../kbl_data/2023-2024,S43G01N33,대구 한국가스공사,Away,박봉진,2,1,1,100.0,0,2,0.0,1,3,33.3,0,0,0.0,0,0,0,2,1,0,0,0,0,2
../kbl_data/2023-2024,S43G01N33,대구 한국가스공사,Away,양준우,0,0,1,0.0,0,2,0.0,0,3,0.0,0,0,0.0,0,0,0,3,0,0,0,0,2,2
../kbl_data/2023-2024,S43G01N33,대구 한국가스공사,Away,앤드류 니콜슨,16,5,10,50.0,1,4,25.0,6,14,42.9,3,4,75.0,1,0,1,0,0,0,0,0,1,0
../kbl_data/2023-2024,S43G01N33,대구 한국가스공사,Away,신승민,2,1,3,33.3,0,0,0.0,1,3,33.3,0,0,0.0,3,0,3,1,0,0,0,0,0,3
../kbl_data/2023-2024,S43G01N33,대구 한국가스공사,Away,샘조세프 벨란겔,19,4,4,100.0,3,5,60.0,7,9,77.8,2,3,66.7,0,6,6,1,0,0,1,0,1,2
../kbl_data/2023-2024,S43G01N33,대구 한국가스공사,Away,염유성,2,1,2,50.0,0,5,0.0,1,7,14.3,0,0,0.0,0,0,0,0,1,0,0,0,2,2
../kbl_data/2023-2024,S43G01N33,대구 한국가스공사,Away,앤쏘니 모스,13,5,8,62.5,0,0,0.0,5,8,62.5,3,7,42.9,1,4,5,1,0,1,0,0,0,1
../kbl_data/2023-2024,S43G01N33,대구 한국가스공사,Away,신주영,0,0,0,0.0,0,4,0.0,0,4,0.0,0,0,0.0,3,4,7,0,0,0,0,0,2,4
../kbl_data/2023-2024,S43G01N34,울산 현대모비스,Home,함지훈,18,4,5,80.0,2,3,66.7,6,8,75.0,4,6,66.7,0,1,1,9,1,0,0,0,3,0
../kbl_data/2023-2024,S43G01N34,울산 현대모비스,Home,최진수,4,2,4,50.0,0,1,0.0,2,5,40.0,0,0,0.0,0,4,4,1,1,0,0,0,3,3
../kbl_data/2023-2024,S43G01N34,울산 현대모비스,Home,김현수,0,0,0,0.0,0,0,0.0,0,0,0.0,0,0,0.0,0,0,0,0,0,0,0,0,0,0
../kbl_data/2023-2024,S43G01N34,울산 현대모비스,Home,장재석,2,1,2,50.0,0,0,0.0,1,2,50.0,0,1,0.0,0,2,2,0,0,0,0,0,0,1
../kbl_data/2023-2024,S43G01N34,울산 현대모비스,Home,김지완,8,3,6,50.0,0,4,0.0,3,10,30.0,2,2,100.0,0,4,4,5,1,0,0,0,1,2
../kbl_data/2023-2024,S43G01N34,울산 현대모비스,Home,김준일,4,1,2,50.0,0,0,0.0,1,2,50.0,2,2,100.0,1,1,2,0,0,0,0,0,1,1
../kbl_data/2023-2024,S43G01N34,울산 현대모비스,Home,김국찬,8,0,2,0.0,2,3,66.7,2,5,40.0,2,2,100.0,1,5,6,1,1,0,0,0,2,4
../kbl_data/2023-2024,S43G01N34,울산 현대모비스,Home,박준은,0,0,0,0.0,0,0,0.0,0,0,0.0,0,0,0.0,0,0,0,0,0,0,0,0,0,0
../kbl_data/2023-2024,S43G01N34,울산 현대모비스,Home,신민석,4,2,4,50.0,0,0,0.0,2,4,50.0,0,0,0.0,2,1,3,0,1,0,0,0,1,1
../kbl_data/2023-2024,S43G01N34,울산 현대모비스,Home,게이지 프림,12,6,8,75.0,0,0,0.0,6,8,75.0,0,0,0.0,0,4,4,0,0,1,0,0,1,2
../kbl_data/2023-2024,S43G01N34,울산 현대모비스,Home,김태완,0,0,4,0.0,0,0,0.0,0,4,0.0,0,0,0.0,0,2,2,1,1,0,0,0,0,2
../kbl_data/2023-2024,S43G01N34,울산 현대모비스,Home,케베 알루마,17,6,10,60.0,1,6,16.7,7,16,43.8,2,3,66.7,4,4,8,0,0,3,0,1,1,1
../kbl_data/2023-2024,S43G01N34,서울 삼성,Away,이정현,14,2,6,33.3,2,7,28.6,4,13,30.8,4,5,80.0,0,0,0,3,2,0,0,0,1,3
../kbl_data/2023-2024,S43G01N34,서울 삼성,Away,김승원,1,0,0,0.0,0,0,0.0,0,0,0.0,1,2,50.0,2,3,5,2,0,0,0,0,0,2
../kbl_data/2023-2024,S43G01N34,서울 삼성,Away,김시래,4,0,2,0.0,1,3,33.3,1,5,20.0,1,2,50.0,0,4,4,5,2,0,0,0,0,1
../kbl_data/2023-2024,S43G01N34,서울 삼성,Away,이동엽,8,1,4,25.0,2,6,33.3,3,10,30.0,0,0,0.0,0,4,4,2,3,0,0,0,0,2
../kbl_data/2023-2024,S43G01N34,서울 삼성,Away,최승욱,4,2,4,50.0,0,2,0.0,2,6,33.3,0,0,0.0,1,2,3,0,1,0,0,0,2,1
../kbl_data/2023-2024,S43G01N34,서울 삼성,Away,윤성원,3,0,0,0.0,1,1,100.0,1,1,100.0,0,0,0.0,0,0,0,0,0,0,0,0,0,2
../kbl_data/2023-2024,S43G01N34,서울 삼성,Away,김무성,0,0,1,0.0,0,0,0.0,0,1,0.0,0,0,0.0,0,0,0,0,0,0,0,0,0,1
../kbl_data/2023-2024,S43G01N34,서울 삼성,Away,이원석,6,1,6,16.7,1,2,50.0,2,8,25.0,1,2,50.0,1,2,3,2,0,1,0,0,1,3
../kbl_data/2023-2024,S43G01N34,서울 삼성,Away,조준희,0,0,0,0.0,0,0,0.0,0,0,0.0,0,0,0.0,0,0,0,0,0,0,0,0,0,0
../kbl_data/2023-2024,S43G01N34,서울 삼성,Away,아반 나바,0,0,2,0.0,0,1,0.0,0,3,0.0,0,0,0.0,0,0,0,3,0,0,0,0,0,0
../kbl_data/2023-2024,S43G01N34,서울 삼성,Away,이스마엘 레인,6,3,4,75.0,0,1,0.0,3,5,60.0,0,0,0.0,0,3,3,0,1,1,0,1,2,1
../kbl_data/2023-2024,S43G01N34,서울 삼성,Away,코피 코번,23,9,12,75.0,0,0,0.0,9,12,75.0,5,6,83.3,3,7,10,3,0,0,0,2,5,4
../kbl_data/2023-2024,S43G01N35,창원 LG,Home,이관희,3,1,2,50.0,0,2,0.0,1,4,25.0,1,2,50.0,1,1,2,1,0,0,0,0,0,0
../kbl_data/2023-2024,S43G01N35,창원 LG,Home,정희재,11,2,3,66.7,2,3,66.7,4,6,66.7,1,1,100.0,0,2,2,3,0,0,0,0,0,1
../kbl_data/2023-2024,S43G01N35,창원 LG,Home,이재도,14,2,4,50.0,3,5,60.0,5,9,55.6,1,1,100.0,0,5,5,4,0,0,0,0,0,1
../kbl_data/2023-2024,S43G01N35,창원 LG,Home,정인덕,5,1,1,100.0,1,1,100.0,2,2,100.0,0,0,0.0,0,0,0,0,0,0,0,0,0,2
../kbl_data/2023-2024,S43G01N35,창원 LG,Home,양홍석,10,1,4,25.0,2,4,50.0,3,8,37.5,2,3,66.7,0,4,4,3,1,1,0,0,0,5
../kbl_data/2023-2024,S43G01N35,창원 LG,Home,윤원상,3,0,0,0.0,1,2,50.0,1,2,50.0,0,0,0.0,0,1,1,0,0,0,0,0,0,0
../kbl_data/2023-2024,S43G01N35,창원 LG,Home,아셈 마레이,13,6,9,66.7,0,0,0.0,6,9,66.7,1,1,100.0,6,5,11,3,3,1,0,0,0,1
../kbl_data/2023-2024,S43G01N35,창원 LG,Home,이승우,1,0,2,0.0,0,0,0.0,0,2,0.0,1,2,50.0,1,0,1,0,0,0,0,0,0,1
../kbl_data/2023-2024,S43G01N35,창원 LG,Home,저스틴 구탕,6,2,4,50.0,0,1,0.0,2,5,40.0,2,2,100.0,0,2,2,4,1,1,0,1,0,2
../kbl_data/2023-2024,S43G01N35,창원 LG,Home,양준석,5,2,4,50.0,0,1,0.0,2,5,40.0,1,2,50.0,0,5,5,6,0,0,0,0,0,3
../kbl_data/2023-2024,S43G01N35,창원 LG,Home,단테 커닝햄,15,6,10,60.0,1,1,100.0,7,11,63.6,0,2,0.0,0,5,5,1,0,0,0,4,3,3
../kbl_data/2023-2024,S43G01N35,창원 LG,Home,유기상,18,0,1,0.0,6,8,75.0,6,9,66.7,0,0,0.0,1,1,2,1,0,0,0,0,1,2
../kbl_data/2023-2024,S43G01N35,부산 KCC,Away,정창영,5,0,2,0.0,1,3,33.3,1,5,20.0,2,4,50.0,1,2,3,2,0,0,1,0,0,2
../kbl_data/2023-2024,S43G01N35,부산 KCC,Away,라건아,9,3,5,60.0,1,3,33.3,4,8,50.0,0,0,0.0,1,6,7,1,0,1,0,0,0,1
../kbl_data/2023-2024,S43G01N35,부산 KCC,Away,허웅,3,0,4,0.0,1,5,20.0,1,9,11.1,0,0,0.0,1,0,1,3,0,0,0,0,1,1
../kbl_data/2023-2024,S43G01N35,부산 KCC,Away,이승현,6,1,4,25.0,0,0,0.0,1,4,25.0,4,4,100.0,0,1,1,3,0,0,0,0,1,1
../kbl_data/2023-2024,S43G01N35,부산 KCC,Away,이호현,16,5,10,50.0,0,0,0.0,5,10,50.0,6,6,100.0,1,2,3,1,0,0,0,0,1,1
../kbl_data/2023-2024,S43G01N35,부산 KCC,Away,이근휘,6,0,1,0.0,2,2,100.0,2,3,66.7,0,0,0.0,0,1,1,0,0,0,0,0,0,1
../kbl_data/2023-2024,S43G01N35,부산 KCC,Away,김동현,17,2,5,40.0,4,7,57.1,6,12,50.0,1,1,100.0,0,4,4,2,0,0,0,0,0,4
../kbl_data/2023-2024,S43G01N35,부산 KCC,Away,서정현,0,0,0,0.0,0,0,0.0,0,0,0.0,0,0,0.0,0,0,0,0,0,0,0,0,0,0
../kbl_data/2023-2024,S43G01N35,부산 KCC,Away,송동훈,4,1,1,100.0,0,0,0.0,1,1,100.0,2,2,100.0,0,2,2,0,0,0,0,0,0,1
../kbl_data/2023-2024,S43G01N35,부산 KCC,Away,여준형,6,2,3,66.7,0,0,0.0,2,3,66.7,2,4,50.0,0,1,1,1,0,0,0,0,0,2
../kbl_data/2023-2024,S43G01N35,부산 KCC,Away,캘빈 제프리 에피스톨라,0,0,0,0.0,0,0,0.0,0,0,0.0,0,2,0.0,0,0,0,2,0,0,0,0,0,0
../kbl_data/2023-2024,S43G01N35,부산 KCC,Away,알리제 드숀 존슨,12,5,6,83.3,0,1,0.0,5,7,71.4,2,4,50.0,1,8,9,0,1,0,0,0,2,2
../kbl_data/2023-2024,S43G01N36,원주 DB,Home,박찬희,0,0,0,0.0,0,1,0.0,0,1,0.0,0,0,0.0,0,0,0,0,0,0,0,0,0,1
../kbl_data/2023-2024,S43G01N36,원주 DB,Home,김현호,2,1,1,100.0,0,0,0.0,1,1,100.0,0,0,0.0,0,1,1,0,0,0,0,0,0,0
../kbl_data/2023-2024,S43G01N36,원주 DB,Home,서민수,4,1,1,100.0,0,2,0.0,1,3,33.3,2,2,100.0,0,1,1,1,0,0,0,0,0,3
../kbl_data/2023-2024,S43G01N36,원주 DB,Home,김영현,0,0,0,0.0,0,0,0.0,0,0,0.0,0,0,0.0,0,0,0,0,0,0,0,0,0,0
../kbl_data/2023-2024,S43G01N36,원주 DB,Home,김종규,19,6,10,60.0,0,0,0.0,6,10,60.0,7,7,100.0,5,4,9,2,0,1,0,3,1,3
../kbl_data/2023-2024,S43G01N36,원주 DB,Home,최승욱,4,2,2,100.0,0,1,0.0,2,3,66.7,0,0,0.0,0,0,0,1,0,0,0,0,0,1
../kbl_data/2023-2024,S43G01N36,원주 DB,Home,강상재,10,2,4,50.0,2,5,40.0,4,9,44.4,0,0,0.0,1,5,6,7,1,1,0,0,3,4
../kbl_data/2023-2024,S43G01N36,원주 DB,Home,디드릭 로슨,15,3,9,33.3,2,9,22.2,5,18,27.8,3,4,75.0,1,8,9,1,1,0,0,0,2,3
../kbl_data/2023-2024,S43G01N36,원주 DB,Home,이선 알바노,19,5,8,62.5,1,5,20.0,6,13,46.2,6,9,66.7,1,1,2,12,4,0,0,0,3,4
../kbl_data/2023-2024,S43G01N36,원주 DB,Home,박인웅,15,3,3,100.0,3,4,75.0,6,7,85.7,0,0,0.0,0,1,1,0,0,0,0,0,0,4
../kbl_data/2023-2024,S43G01N36,원주 DB,Home,박승재,0,0,0,0.0,0,0,0.0,0,0,0.0,0,0,0.0,0,0,0,0,0,0,0,0,0,0
../kbl_data/2023-2024,S43G01N36,원주 DB,Home,제프 위디,6,1,1,100.0,0,0,0.0,1,1,100.0,4,6,66.7,0,1,1,1,1,2,0,0,0,1
../kbl_data/2023-2024,S43G01N36,안양 정관장,Away,정준원,0,0,0,0.0,0,0,0.0,0,0,0.0,0,0,0.0,0,0,0,0,0,0,0,0,0,0
../kbl_data/2023-2024,S43G01N36,안양 정관장,Away,배병준,12,1,3,33.3,3,4,75.0,4,7,57.1,1,1,100.0,0,1,1,1,1,0,0,0,2,3
../kbl_data/2023-2024,S43G01N36,안양 정관장,Away,정효근,11,4,6,66.7,0,2,0.0,4,8,50.0,3,6,50.0,0,2,2,1,2,0,0,0,0,2
../kbl_data/2023-2024,S43G01N36,안양 정관장,Away,이종현,14,6,11,54.5,0,0,0.0,6,11,54.5,2,3,66.7,3,4,7,0,0,1,1,0,1,1
../kbl_data/2023-2024,S43G01N36,안양 정관장,Away,박지훈,15,4,7,57.1,1,3,33.3,5,10,50.0,4,4,100.0,2,2,4,4,0,0,0,0,0,3
../kbl_data/2023-2024,S43G01N36,안양 정관장,Away,최성원,9,1,3,33.3,1,4,25.0,2,7,28.6,4,4,100.0,0,4,4,5,0,0,0,0,2,3
../kbl_data/2023-2024,S43G01N36,안양 정관장,Away,이우정,0,0,0,0.0,0,0,0.0,0,0,0.0,0,0,0.0,0,0,0,0,0,0,0,0,0,0
../kbl_data/2023-2024,S43G01N36,안양 정관장,Away,대릴 먼로,22,4,10,40.0,3,5,60.0,7,15,46.7,5,6,83.3,4,5,9,5,1,0,0,1,2,2
../kbl_data/2023-2024,S43G01N36,안양 정관장,Away,김경원,4,2,2,100.0,0,0,0.0,2,2,100.0,0,0,0.0,1,0,1,0,0,0,0,0,0,1
../kbl_data/2023-2024,S43G01N36,안양 정관장,Away,렌즈 아반도,4,2,8,25.0,0,1,0.0,2,9,22.2,0,0,0.0,4,2,6,1,0,0,0,1,1,1
../kbl_data/2023-2024,S43G01N36,안양 정관장,Away,고찬혁,0,0,0,0.0,0,0,0.0,0,0,0.0,0,0,0.0,0,0,0,0,0,0,0,0,0,0
../kbl_data/2023-2024,S43G01N36,안양 정관장,Away,듀반 맥스웰,8,3,7,42.9,0,0,0.0,3,7,42.9,2,2,100.0,3,3,6,0,1,0,0,0,0,4
../kbl_data/2023-2024,S43G01N37,서울 삼성,Home,이정현,14,2,2,100.0,2,6,33.3,4,8,50.0,4,4,100.0,0,4,4,6,0,0,0,0,3,4
../kbl_data/2023-2024,S43G01N37,서울 삼성,Home,김승원,0,0,1,0.0,0,0,0.0,0,1,0.0,0,0,0.0,1,0,1,0,1,1,0,0,0,0
../kbl_data/2023-2024,S43G01N37,서울 삼성,Home,김시래,8,0,1,0.0,2,7,28.6,2,8,25.0,2,2,100.0,0,4,4,3,2,0,0,0,0,2
../kbl_data/2023-2024,S43G01N37,서울 삼성,Home,이동엽,2,1,2,50.0,0,3,0.0,1,5,20.0,0,0,0.0,0,1,1,0,0,0,0,0,2,4
../kbl_data/2023-2024,S43G01N37,서울 삼성,Home,최승욱,5,1,3,33.3,1,2,50.0,2,5,40.0,0,0,0.0,3,4,7,3,1,0,0,0,0,3
../kbl_data/2023-2024,S43G01N37,서울 삼성,Home,윤성원,0,0,0,0.0,0,0,0.0,0,0,0.0,0,0,0.0,0,0,0,0,0,0,0,0,0,0
../kbl_data/2023-2024,S43G01N37,서울 삼성,Home,김무성,0,0,1,0.0,0,0,0.0,0,1,0.0,0,0,0.0,0,0,0,0,0,0,0,0,0,0
../kbl_data/2023-2024,S43G01N37,서울 삼성,Home,조우성,0,0,0,0.0,0,0,0.0,0,0,0.0,0,0,0.0,0,0,0,0,0,0,0,0,0,0
../kbl_data/2023-2024,S43G01N37,서울 삼성,Home,이원석,12,6,10,60.0,0,0,0.0,6,10,60.0,0,0,0.0,3,5,8,2,0,0,0,0,1,4
../kbl_data/2023-2024,S43G01N37,서울 삼성,Home,아반 나바,6,0,4,0.0,2,4,50.0,2,8,25.0,0,0,0.0,2,0,2,0,1,0,0,0,0,3
../kbl_data/2023-2024,S43G01N37,서울 삼성,Home,이스마엘 레인,4,2,2,100.0,0,0,0.0,2,2,100.0,0,0,0.0,0,1,1,0,0,0,0,0,0,1
../kbl_data/2023-2024,S43G01N37,서울 삼성,Home,코피 코번,29,12,27,44.4,0,0,0.0,12,27,44.4,5,7,71.4,4,6,10,4,2,1,0,1,2,1
../kbl_data/2023-2024,S43G01N37,서울 SK,Away,허일영,2,1,3,33.3,0,4,0.0,1,7,14.3,0,1,0.0,0,4,4,1,1,0,0,0,1,2
../kbl_data/2023-2024,S43G01N37,서울 SK,Away,송창용,8,1,1,100.0,1,3,33.3,2,4,50.0,3,3,100.0,0,1,1,1,1,0,0,0,0,2
../kbl_data/2023-2024,S43G01N37,서울 SK,Away,김선형,15,4,7,57.1,1,3,33.3,5,10,50.0,4,4,100.0,1,1,2,7,2,0,0,0,1,2
../kbl_data/2023-2024,S43G01N37,서울 SK,Away,홍경기,0,0,0,0.0,0,0,0.0,0,0,0.0,0,0,0.0,0,0,0,0,0,0,0,0,0,0
../kbl_data/2023-2024,S43G01N37,서울 SK,Away,오세근,8,0,5,0.0,2,3,66.7,2,8,25.0,2,2,100.0,1,3,4,0,1,1,0,0,1,2
../kbl_data/2023-2024,S43G01N37,서울 SK,Away,최부경,2,1,4,25.0,0,0,0.0,1,4,25.0,0,0,0.0,1,2,3,0,0,0,0,0,0,1
../kbl_data/2023-2024,S43G01N37,서울 SK,Away,리온 윌리엄스,2,1,2,50.0,0,0,0.0,1,2,50.0,0,0,0.0,1,2,3,0,0,0,0,0,0,0
../kbl_data/2023-2024,S43G01N37,서울 SK,Away,최원혁,3,0,0,0.0,1,1,100.0,1,1,100.0,0,0,0.0,3,1,4,3,0,0,0,0,2,3
../kbl_data/2023-2024,S43G01N37,서울 SK,Away,자밀 워니,25,9,18,50.0,1,3,33.3,10,21,47.6,4,8,50.0,3,12,15,4,2,2,0,0,5,4
../kbl_data/2023-2024,S43G01N37,서울 SK,Away,전성환,0,0,0,0.0,0,0,0.0,0,0,0.0,0,0,0.0,0,0,0,0,0,0,0,0,0,0
../kbl_data/2023-2024,S43G01N37,서울 SK,Away,김형빈,0,0,0,0.0,0,0,0.0,0,0,0.0,0,0,0.0,0,0,0,0,0,0,0,0,0,0
../kbl_data/2023-2024,S43G01N37,서울 SK,Away,오재현,17,6,7,85.7,0,3,0.0,6,10,60.0,5,5,100.0,1,0,1,3,0,0,0,0,0,2
../kbl_data/2023-2024,S43G01N38,대구 한국가스공사,Home,김동량,0,0,0,0.0,0,0,0.0,0,0,0.0,0,0,0.0,0,0,0,0,0,0,0,0,0,0
../kbl_data/2023-2024,S43G01N38,대구 한국가스공사,Home,차바위,5,2,3,66.7,0,3,0.0,2,6,33.3,1,2,50.0,2,2,4,2,0,0,0,0,0,3
../kbl_data/2023-2024,S43G01N38,대구 한국가스공사,Home,이원대,0,0,1,0.0,0,0,0.0,0,1,0.0,0,0,0.0,0,1,1,0,0,0,1,0,1,2
../kbl_data/2023-2024,S43G01N38,대구 한국가스공사,Home,이대헌,17,7,9,77.8,0,0,0.0,7,9,77.8,3,4,75.0,2,3,5,3,1,0,0,0,3,1
../kbl_data/2023-2024,S43G01N38,대구 한국가스공사,Home,박봉진,0,0,0,0.0,0,1,0.0,0,1,0.0,0,0,0.0,0,0,0,0,0,0,0,0,0,0
../kbl_data/2023-2024,S43G01N38,대구 한국가스공사,Home,양준우,5,0,2,0.0,1,2,50.0,1,4,25.0,2,4,50.0,0,0,0,3,0,0,0,0,1,1
../kbl_data/2023-2024,S43G01N38,대구 한국가스공사,Home,앤드류 니콜슨,20,3,10,30.0,4,7,57.1,7,17,41.2,2,2,100.0,2,7,9,1,0,0,0,0,1,0
../kbl_data/2023-2024,S43G01N38,대구 한국가스공사,Home,신승민,10,3,4,75.0,1,1,100.0,4,5,80.0,1,1,100.0,3,1,4,2,1,1,0,0,0,4
../kbl_data/2023-2024,S43G01N38,대구 한국가스공사,Home,샘조세프 벨란겔,14,3,4,75.0,2,4,50.0,5,8,62.5,2,4,50.0,0,2,2,5,2,0,1,0,3,4
../kbl_data/2023-2024,S43G01N38,대구 한국가스공사,Home,염유성,7,2,3,66.7,1,2,50.0,3,5,60.0,0,0,0.0,1,0,1,1,1,0,0,0,0,1
../kbl_data/2023-2024,S43G01N38,대구 한국가스공사,Home,앤쏘니 모스,10,5,6,83.3,0,0,0.0,5,6,83.3,0,0,0.0,1,3,4,0,2,0,0,1,0,1
../kbl_data/2023-2024,S43G01N38,대구 한국가스공사,Home,신주영,2,1,1,100.0,0,1,0.0,1,2,50.0,0,0,0.0,1,1,2,0,1,0,0,0,2,4
../kbl_data/2023-2024,S43G01N38,고양 소노,Away,김강선,3,0,0,0.0,1,2,50.0,1,2,50.0,0,0,0.0,1,1,2,0,1,0,0,0,0,3
../kbl_data/2023-2024,S43G01N38,고양 소노,Away,함준후,0,0,1,0.0,0,0,0.0,0,1,0.0,0,0,0.0,2,1,3,1,1,0,0,0,0,1
../kbl_data/2023-2024,S43G01N38,고양 소노,Away,최현민,8,2,4,50.0,1,1,100.0,3,5,60.0,1,2,50.0,3,2,5,4,0,0,0,0,1,3
../kbl_data/2023-2024,S43G01N38,고양 소노,Away,한호빈,7,1,1,100.0,1,2,50.0,2,3,66.7,2,2,100.0,0,1,1,2,1,0,0,0,2,2
../kbl_data/2023-2024,S43G01N38,고양 소노,Away,전성현,13,2,5,40.0,2,7,28.6,4,12,33.3,3,3,100.0,1,2,3,0,3,0,0,0,2,3
../kbl_data/2023-2024,S43G01N38,고양 소노,Away,이정현,23,2,2,100.0,4,7,57.1,6,9,66.7,7,8,87.5,0,4,4,7,0,0,0,0,4,1
../kbl_data/2023-2024,S43G01N38,고양 소노,Away,안정욱,3,0,0,0.0,1,1,100.0,1,1,100.0,0,0,0.0,0,0,0,0,0,0,0,0,0,3
../kbl_data/2023-2024,S43G01N38,고양 소노,Away,재로드 존스,31,8,11,72.7,4,8,50.0,12,19,63.2,3,4,75.0,1,3,4,2,2,0,0,3,2,1
../kbl_data/2023-2024,S43G01N38,고양 소노,Away,박종하,6,0,0,0.0,2,4,50.0,2,4,50.0,0,0,0.0,0,1,1,0,0,0,1,0,0,2
../kbl_data/2023-2024,S43G01N38,고양 소노,Away,민기남,0,0,0,0.0,0,0,0.0,0,0,0.0,0,0,0.0,0,0,0,0,0,0,0,0,0,0
../kbl_data/2023-2024,S43G01N38,고양 소노,Away,조쉬 토랄바,0,0,0,0.0,0,0,0.0,0,0,0.0,0,0,0.0,0,0,0,0,0,0,0,0,1,0
../kbl_data/2023-2024,S43G01N38,고양 소노,Away,디욘테 데이비스,6,1,1,100.0,1,3,33.3,2,4,50.0,1,2,50.0,0,2,2,1,0,1,0,0,0,0
../kbl_data/2023-2024,S43G01N39,수원 KT,Home,한희원,12,1,2,50.0,3,6,50.0,4,8,50.0,1,2,50.0,4,4,8,1,1,0,0,0,2,2
../kbl_data/2023-2024,S43G01N39,수원 KT,Home,최창진,2,0,0,0.0,0,0,0.0,0,0,0.0,2,2,100.0,2,1,3,1,0,0,0,0,0,1
../kbl_data/2023-2024,S43G01N39,수원 KT,Home,이현석,0,0,0,0.0,0,0,0.0,0,0,0.0,0,0,0.0,0,1,1,0,0,0,0,0,0,0
../kbl_data/2023-2024,S43G01N39,수원 KT,Home,정성우,9,1,8,12.5,2,3,66.7,3,11,27.3,1,2,50.0,1,1,2,7,0,0,0,0,0,2
../kbl_data/2023-2024,S43G01N39,수원 KT,Home,최성모,0,0,0,0.0,0,0,0.0,0,0,0.0,0,0,0.0,0,0,0,0,0,0,0,0,0,0
../kbl_data/2023-2024,S43G01N39,수원 KT,Home,김준환,2,0,0,0.0,0,0,0.0,0,0,0.0,2,4,50.0,0,0,0,0,0,0,0,0,0,1
../kbl_data/2023-2024,S43G01N39,수원 KT,Home,하윤기,18,8,13,61.5,0,0,0.0,8,13,61.5,2,2,100.0,0,5,5,1,0,0,0,1,4,3
../kbl_data/2023-2024,S43G01N39,수원 KT,Home,이두원,5,2,5,40.0,0,0,0.0,2,5,40.0,1,2,50.0,3,3,6,0,1,0,1,0,0,5
../kbl_data/2023-2024,S43G01N39,수원 KT,Home,숀 데이브 일데폰소,5,1,2,50.0,1,1,100.0,2,3,66.7,0,0,0.0,0,2,2,0,0,0,0,0,1,0
../kbl_data/2023-2024,S43G01N39,수원 KT,Home,문정현,2,1,2,50.0,0,1,0.0,1,3,33.3,0,2,0.0,1,1,2,1,0,0,0,0,0,3
../kbl_data/2023-2024,S43G01N39,수원 KT,Home,마이클 에릭,0,0,1,0.0,0,0,0.0,0,1,0.0,0,0,0.0,0,2,2,1,0,0,0,0,0,3
../kbl_data/2023-2024,S43G01N39,수원 KT,Home,패리스 배스,20,4,12,33.3,4,7,57.1,8,19,42.1,0,0,0.0,2,6,8,3,2,1,0,0,4,1
../kbl_data/2023-2024,S43G01N39,울산 현대모비스,Away,함지훈,7,2,7,28.6,1,2,50.0,3,9,33.3,0,0,0.0,1,3,4,2,1,2,0,0,1,4
../kbl_data/2023-2024,S43G01N39,울산 현대모비스,Away,최진수,7,2,3,66.7,1,6,16.7,3,9,33.3,0,0,0.0,1,0,1,1,2,0,0,0,0,4
../kbl_data/2023-2024,S43G01N39,울산 현대모비스,Away,김현수,0,0,0,0.0,0,0,0.0,0,0,0.0,0,0,0.0,0,0,0,0,0,0,0,0,0,0
../kbl_data/2023-2024,S43G01N39,울산 현대모비스,Away,장재석,0,0,1,0.0,0,0,0.0,0,1,0.0,0,0,0.0,0,0,0,0,0,0,0,0,0,0
../kbl_data/2023-2024,S43G01N39,울산 현대모비스,Away,김지완,8,3,4,75.0,0,5,0.0,3,9,33.3,2,2,100.0,0,3,3,4,1,0,0,0,1,3
../kbl_data/2023-2024,S43G01N39,울산 현대모비스,Away,김준일,4,1,2,50.0,0,0,0.0,1,2,50.0,2,2,100.0,1,2,3,0,0,0,0,0,2,3
../kbl_data/2023-2024,S43G01N39,울산 현대모비스,Away,김국찬,8,1,3,33.3,2,4,50.0,3,7,42.9,0,0,0.0,2,3,5,3,1,0,0,0,1,1
../kbl_data/2023-2024,S43G01N39,울산 현대모비스,Away,박준은,0,0,0,0.0,0,0,0.0,0,0,0.0,0,0,0.0,0,0,0,0,0,0,0,0,0,0
../kbl_data/2023-2024,S43G01N39,울산 현대모비스,Away,신민석,0,0,0,0.0,0,0,0.0,0,0,0.0,0,0,0.0,0,0,0,0,0,0,0,0,0,0
../kbl_data/2023-2024,S43G01N39,울산 현대모비스,Away,게이지 프림,26,10,19,52.6,0,1,0.0,10,20,50.0,6,9,66.7,8,4,12,2,1,1,0,0,1,1
../kbl_data/2023-2024,S43G01N39,울산 현대모비스,Away,김태완,2,1,3,33.3,0,2,0.0,1,5,20.0,0,0,0.0,1,4,5,2,0,0,0,0,1,2
../kbl_data/2023-2024,S43G01N39,울산 현대모비스,Away,케베 알루마,12,5,7,71.4,0,3,0.0,5,10,50.0,2,4,50.0,1,2,3,0,0,1,0,0,1,0
../kbl_data/2023-2024,S43G01N40,원주 DB,Home,김현호,3,0,1,0.0,1,2,50.0,1,3,33.3,0,0,0.0,0,0,0,0,0,0,1,0,1,1
../kbl_data/2023-2024,S43G01N40,원주 DB,Home,서민수,2,1,1,100.0,0,0,0.0,1,1,100.0,0,0,0.0,2,0,2,1,0,0,0,0,0,1
../kbl_data/2023-2024,S43G01N40,원주 DB,Home,김영현,5,0,0,0.0,1,3,33.3,1,3,33.3,2,2,100.0,0,2,2,1,1,0,0,0,1,3
../kbl_data/2023-2024,S43G01N40,원주 DB,Home,김종규,16,7,11,63.6,0,0,0.0,7,11,63.6,2,2,100.0,3,5,8,1,0,1,0,3,0,2
../kbl_data/2023-2024,S43G01N40,원주 DB,Home,최승욱,9,3,4,75.0,1,1,100.0,4,5,80.0,0,0,0.0,1,2,3,3,0,0,0,0,0,1
../kbl_data/2023-2024,S43G01N40,원주 DB,Home,강상재,20,4,4,100.0,4,6,66.7,8,10,80.0,0,0,0.0,2,3,5,5,2,0,0,0,1,1
../kbl_data/2023-2024,S43G01N40,원주 DB,Home,디드릭 로슨,15,6,7,85.7,0,7,0.0,6,14,42.9,3,3,100.0,1,9,10,10,0,1,0,0,0,2
../kbl_data/2023-2024,S43G01N40,원주 DB,Home,이선 알바노,17,4,6,66.7,2,4,50.0,6,10,60.0,3,3,100.0,0,2,2,6,0,0,0,0,3,3
../kbl_data/2023-2024,S43G01N40,원주 DB,Home,박인웅,10,2,4,50.0,1,5,20.0,3,9,33.3,3,3,100.0,0,2,2,1,0,0,0,0,1,2
../kbl_data/2023-2024,S43G01N40,원주 DB,Home,김형준,6,0,0,0.0,2,2,100.0,2,2,100.0,0,0,0.0,0,0,0,0,0,0,0,0,0,2
../kbl_data/2023-2024,S43G01N40,원주 DB,Home,박승재,3,0,0,0.0,1,1,100.0,1,1,100.0,0,0,0.0,0,0,0,1,0,0,0,0,1,1
../kbl_data/2023-2024,S43G01N40,원주 DB,Home,제프 위디,0,0,1,0.0,0,0,0.0,0,1,0.0,0,0,0.0,0,3,3,0,0,0,0,0,0,2
../kbl_data/2023-2024,S43G01N40,서울 SK,Away,허일영,11,1,1,100.0,3,4,75.0,4,5,80.0,0,0,0.0,0,0,0,0,0,0,0,0,0,1
../kbl_data/2023-2024,S43G01N40,서울 SK,Away,송창용,3,0,4,0.0,0,1,0.0,0,5,0.0,3,4,75.0,3,3,6,2,1,0,0,0,1,2
../kbl_data/2023-2024,S43G01N40,서울 SK,Away,김선형,4,1,5,20.0,0,3,0.0,1,8,12.5,2,2,100.0,1,0,1,3,1,1,0,0,1,0
../kbl_data/2023-2024,S43G01N40,서울 SK,Away,홍경기,3,1,2,50.0,0,2,0.0,1,4,25.0,1,2,50.0,1,2,3,1,0,0,0,0,0,2
../kbl_data/2023-2024,S43G01N40,서울 SK,Away,오세근,2,1,3,33.3,0,2,0.0,1,5,20.0,0,0,0.0,2,1,3,0,0,0,0,0,0,1
../kbl_data/2023-2024,S43G01N40,서울 SK,Away,최부경,12,4,10,40.0,0,0,0.0,4,10,40.0,4,4,100.0,2,5,7,2,0,0,0,0,0,4
../kbl_data/2023-2024,S43G01N40,서울 SK,Away,리온 윌리엄스,4,2,5,40.0,0,0,0.0,2,5,40.0,0,0,0.0,0,1,1,0,0,0,0,0,0,2
../kbl_data/2023-2024,S43G01N40,서울 SK,Away,최원혁,10,3,3,100.0,1,1,100.0,4,4,100.0,1,1,100.0,2,3,5,6,1,0,0,0,1,4
../kbl_data/2023-2024,S43G01N40,서울 SK,Away,자밀 워니,15,6,17,35.3,0,1,0.0,6,18,33.3,3,4,75.0,4,4,8,1,1,0,0,0,0,0
../kbl_data/2023-2024,S43G01N40,서울 SK,Away,전성환,0,0,0,0.0,0,0,0.0,0,0,0.0,0,0,0.0,0,0,0,0,0,0,1,0,0,0
../kbl_data/2023-2024,S43G01N40,서울 SK,Away,김형빈,2,1,2,50.0,0,1,0.0,1,3,33.3,0,0,0.0,1,1,2,0,0,0,0,0,1,0
../kbl_data/2023-2024,S43G01N40,서울 SK,Away,오재현,10,1,2,50.0,2,3,66.7,3,5,60.0,2,2,100.0,0,0,0,1,0,0,0,0,3,1
../kbl_data/2023-2024,S43G01N41,안양 정관장,Home,정준원,9,3,6,50.0,1,3,33.3,4,9,44.4,0,0,0.0,1,5,6,0,0,0,0,0,3,2
../kbl_data/2023-2024,S43G01N41,안양 정관장,Home,정효근,10,2,3,66.7,2,3,66.7,4,6,66.7,0,1,0.0,1,4,5,1,1,0,0,0,1,3
../kbl_data/2023-2024,S43G01N41,안양 정관장,Home,이종현,7,2,5,40.0,1,1,100.0,3,6,50.0,0,0,0.0,1,2,3,1,1,0,0,0,2,1
../kbl_data/2023-2024,S43G01N41,안양 정관장,Home,박지훈,14,5,12,41.7,1,1,100.0,6,13,46.2,1,1,100.0,2,2,4,5,1,0,0,0,2,1
../kbl_data/2023-2024,S43G01N41,안양 정관장,Home,최성원,10,2,4,50.0,2,4,50.0,4,8,50.0,0,0,0.0,1,2,3,5,0,0,0,0,2,2
../kbl_data/2023-2024,S43G01N41,안양 정관장,Home,이우정,0,0,0,0.0,0,0,0.0,0,0,0.0,0,0,0.0,1,0,1,0,0,0,0,0,1,0
../kbl_data/2023-2024,S43G01N41,안양 정관장,Home,대릴 먼로,9,2,5,40.0,1,3,33.3,3,8,37.5,2,2,100.0,1,4,5,2,1,0,0,0,0,0
../kbl_data/2023-2024,S43G01N41,안양 정관장,Home,김경원,0,0,1,0.0,0,0,0.0,0,1,0.0,0,0,0.0,0,0,0,0,0,0,0,0,0,0
../kbl_data/2023-2024,S43G01N41,안양 정관장,Home,렌즈 아반도,18,7,8,87.5,0,2,0.0,7,10,70.0,4,5,80.0,1,5,6,1,0,2,0,2,1,1
../kbl_data/2023-2024,S43G01N41,안양 정관장,Home,고찬혁,0,0,0,0.0,0,1,0.0,0,1,0.0,0,0,0.0,1,2,3,0,0,0,0,0,0,2
../kbl_data/2023-2024,S43G01N41,안양 정관장,Home,나성호,0,0,0,0.0,0,1,0.0,0,1,0.0,0,0,0.0,0,0,0,0,0,0,0,0,2,1
../kbl_data/2023-2024,S43G01N41,안양 정관장,Home,듀반 맥스웰,8,4,5,80.0,0,0,0.0,4,5,80.0,0,0,0.0,1,9,10,2,1,3,0,1,3,4
../kbl_data/2023-2024,S43G01N41,창원 LG,Away,이관희,5,1,4,25.0,1,3,33.3,2,7,28.6,0,0,0.0,0,1,1,1,1,0,0,0,0,0
../kbl_data/2023-2024,S43G01N41,창원 LG,Away,정희재,3,0,2,0.0,1,2,50.0,1,4,25.0,0,0,0.0,1,2,3,1,0,0,0,0,1,2
../kbl_data/2023-2024,S43G01N41,창원 LG,Away,이재도,13,4,8,50.0,1,3,33.3,5,11,45.5,2,2,100.0,1,2,3,7,2,0,0,0,0,3
../kbl_data/2023-2024,S43G01N41,창원 LG,Away,정인덕,5,1,1,100.0,1,1,100.0,2,2,100.0,0,0,0.0,0,1,1,0,1,0,0,0,0,1
../kbl_data/2023-2024,S43G01N41,창원 LG,Away,양홍석,3,0,3,0.0,1,5,20.0,1,8,12.5,0,0,0.0,0,1,1,2,1,0,0,0,0,2
../kbl_data/2023-2024,S43G01N41,창원 LG,Away,윤원상,2,0,1,0.0,0,3,0.0,0,4,0.0,2,2,100.0,0,0,0,2,1,0,0,0,0,0
../kbl_data/2023-2024,S43G01N41,창원 LG,Away,아셈 마레이,14,7,19,36.8,0,0,0.0,7,19,36.8,0,0,0.0,9,6,15,0,0,2,0,1,3,4
../kbl_data/2023-2024,S43G01N41,창원 LG,Away,이승우,0,0,0,0.0,0,0,0.0,0,0,0.0,0,0,0.0,0,0,0,0,0,0,0,0,0,0
../kbl_data/2023-2024,S43G01N41,창원 LG,Away,저스틴 구탕,6,2,3,66.7,0,0,0.0,2,3,66.7,2,2,100.0,0,1,1,3,1,1,0,1,1,1
../kbl_data/2023-2024,S43G01N41,창원 LG,Away,양준석,3,0,1,0.0,1,1,100.0,1,2,50.0,0,0,0.0,0,0,0,0,0,0,0,0,0,2
../kbl_data/2023-2024,S43G01N41,창원 LG,Away,단테 커닝햄,11,4,11,36.4,0,0,0.0,4,11,36.4,3,3,100.0,3,5,8,2,1,1,0,1,2,2
../kbl_data/2023-2024,S43G01N41,창원 LG,Away,유기상,6,2,2,100.0,0,5,0.0,2,7,28.6,2,2,100.0,0,3,3,2,4,2,0,0,0,1
../kbl_data/2023-2024,S43G01N42,고양 소노,Home,김강선,6,0,0,0.0,2,4,50.0,2,4,50.0,0,0,0.0,0,5,5,1,1,0,0,0,0,1
../kbl_data/2023-2024,S43G01N42,고양 소노,Home,함준후,0,0,1,0.0,0,1,0.0,0,2,0.0,0,0,0.0,2,1,3,1,1,0,0,0,2,3
../kbl_data/2023-2024,S43G01N42,고양 소노,Home,최현민,8,1,2,50.0,2,4,50.0,3,6,50.0,0,0,0.0,2,5,7,1,0,1,0,0,2,4
../kbl_data/2023-2024,S43G01N42,고양 소노,Home,한호빈,22,2,4,50.0,6,10,60.0,8,14,57.1,0,0,0.0,1,3,4,9,0,0,0,0,2,1
../kbl_data/2023-2024,S43G01N42,고양 소노,Home,이정현,29,4,9,44.4,6,15,40.0,10,24,41.7,3,4,75.0,0,2,2,6,1,0,1,0,2,3
../kbl_data/2023-2024,S43G01N42,고양 소노,Home,백지웅,0,0,0,0.0,0,0,0.0,0,0,0.0,0,0,0.0,0,0,0,0,0,0,0,0,0,0
../kbl_data/2023-2024,S43G01N42,고양 소노,Home,안정욱,0,0,0,0.0,0,0,0.0,0,0,0.0,0,0,0.0,0,0,0,0,0,0,0,0,0,1
../kbl_data/2023-2024,S43G01N42,고양 소노,Home,재로드 존스,26,7,12,58.3,3,6,50.0,10,18,55.6,3,3,100.0,2,7,9,3,1,0,0,0,1,4
../kbl_data/2023-2024,S43G01N42,고양 소노,Home,박종하,0,0,0,0.0,0,1,0.0,0,1,0.0,0,0,0.0,0,0,0,0,0,0,0,0,0,1
../kbl_data/2023-2024,S43G01N42,고양 소노,Home,민기남,0,0,0,0.0,0,0,0.0,0,0,0.0,0,0,0.0,0,0,0,0,0,0,0,0,0,0
../kbl_data/2023-2024,S43G01N42,고양 소노,Home,조쉬 토랄바,0,0,1,0.0,0,0,0.0,0,1,0.0,0,0,0.0,0,0,0,0,0,0,0,0,0,1
../kbl_data/2023-2024,S43G01N42,고양 소노,Home,디욘테 데이비스,2,1,1,100.0,0,1,0.0,1,2,50.0,0,0,0.0,0,2,2,0,0,1,0,1,0,1
../kbl_data/2023-2024,S43G01N42,부산 KCC,Away,정창영,5,1,3,33.3,1,4,25.0,2,7,28.6,0,0,0.0,0,1,1,3,0,1,0,0,0,0
../kbl_data/2023-2024,S43G01N42,부산 KCC,Away,라건아,2,0,0,0.0,0,1,0.0,0,1,0.0,2,2,100.0,0,1,1,0,0,0,0,0,1,0
../kbl_data/2023-2024,S43G01N42,부산 KCC,Away,허웅,15,3,4,75.0,3,7,42.9,6,11,54.5,0,0,0.0,0,0,0,2,0,0,1,0,3,3
../kbl_data/2023-2024,S43G01N42,부산 KCC,Away,이승현,4,1,3,33.3,0,0,0.0,1,3,33.3,2,2,100.0,0,3,3,2,2,2,0,0,1,2
../kbl_data/2023-2024,S43G01N42,부산 KCC,Away,이호현,12,6,9,66.7,0,1,0.0,6,10,60.0,0,0,0.0,0,3,3,6,0,0,0,0,1,2
../kbl_data/2023-2024,S43G01N42,부산 KCC,Away,최준용,22,6,9,66.7,1,4,25.0,7,13,53.8,7,9,77.8,0,4,4,0,2,2,0,1,0,3
../kbl_data/2023-2024,S43G01N42,부산 KCC,Away,이근휘,2,1,2,50.0,0,0,0.0,1,2,50.0,0,0,0.0,2,0,2,3,1,0,0,0,0,0
../kbl_data/2023-2024,S43G01N42,부산 KCC,Away,김동현,0,0,0,0.0,0,2,0.0,0,2,0.0,0,0,0.0,0,0,0,0,0,0,0,0,0,2
../kbl_data/2023-2024,S43G01N42,부산 KCC,Away,송동훈,0,0,0,0.0,0,0,0.0,0,0,0.0,0,0,0.0,0,2,2,1,0,0,0,0,0,2
../kbl_data/2023-2024,S43G01N42,부산 KCC,Away,여준형,0,0,0,0.0,0,0,0.0,0,0,0.0,0,0,0.0,0,0,0,0,0,0,0,0,0,0
../kbl_data/2023-2024,S43G01N42,부산 KCC,Away,캘빈 제프리 에피스톨라,0,0,0,0.0,0,0,0.0,0,0,0.0,0,0,0.0,0,0,0,0,0,0,0,0,0,0
../kbl_data/2023-2024,S43G01N42,부산 KCC,Away,알리제 드숀 존슨,22,8,10,80.0,0,1,0.0,8,11,72.7,6,6,100.0,1,9,10,4,1,0,0,0,2,4
../kbl_data/2023-2024,S43G01N43,울산 현대모비스,Home,함지훈,2,1,2,50.0,0,0,0.0,1,2,50.0,0,0,0.0,4,0,4,1,0,0,0,0,1,1
../kbl_data/2023-2024,S43G01N43,울산 현대모비스,Home,최진수,0,0,2,0.0,0,2,0.0,0,4,0.0,0,0,0.0,0,1,1,1,1,0,0,0,0,0
../kbl_data/2023-2024,S43G01N43,울산 현대모비스,Home,김현수,0,0,0,0.0,0,0,0.0,0,0,0.0,0,0,0.0,0,0,0,0,0,0,0,0,0,0
../kbl_data/2023-2024,S43G01N43,울산 현대모비스,Home,장재석,2,1,1,100.0,0,0,0.0,1,1,100.0,0,0,0.0,0,2,2,1,0,0,0,0,0,2
../kbl_data/2023-2024,S43G01N43,울산 현대모비스,Home,김지완,4,2,5,40.0,0,3,0.0,2,8,25.0,0,0,0.0,0,6,6,3,1,0,0,0,3,2
../kbl_data/2023-2024,S43G01N43,울산 현대모비스,Home,김준일,6,3,6,50.0,0,0,0.0,3,6,50.0,0,0,0.0,2,0,2,0,2,0,0,0,1,3
../kbl_data/2023-2024,S43G01N43,울산 현대모비스,Home,김국찬,13,3,3,100.0,2,7,28.6,5,10,50.0,1,1,100.0,0,4,4,1,2,0,0,0,2,4
../kbl_data/2023-2024,S43G01N43,울산 현대모비스,Home,이우석,6,0,7,0.0,2,5,40.0,2,12,16.7,0,0,0.0,1,2,3,4,0,0,0,0,0,3
../kbl_data/2023-2024,S43G01N43,울산 현대모비스,Home,신민석,0,0,0,0.0,0,1,0.0,0,1,0.0,0,0,0.0,0,1,1,0,0,0,0,0,0,0
../kbl_data/2023-2024,S43G01N43,울산 현대모비스,Home,게이지 프림,16,7,14,50.0,0,0,0.0,7,14,50.0,2,2,100.0,5,5,10,1,1,0,0,0,0,1
../kbl_data/2023-2024,S43G01N43,울산 현대모비스,Home,김태완,3,0,3,0.0,1,5,20.0,1,8,12.5,0,0,0.0,1,3,4,1,0,0,0,0,2,4
../kbl_data/2023-2024,S43G01N43,울산 현대모비스,Home,케베 알루마,9,4,5,80.0,0,3,0.0,4,8,50.0,1,1,100.0,1,2,3,0,0,0,0,0,2,0
../kbl_data/2023-2024,S43G01N43,수원 KT,Away,한희원,5,2,3,66.7,0,6,0.0,2,9,22.2,1,2,50.0,2,4,6,0,4,0,0,0,0,3
../kbl_data/2023-2024,S43G01N43,수원 KT,Away,최창진,0,0,1,0.0,0,1,0.0,0,2,0.0,0,0,0.0,2,0,2,1,1,0,1,0,1,1
../kbl_data/2023-2024,S43G01N43,수원 KT,Away,이현석,0,0,1,0.0,0,2,0.0,0,3,0.0,0,0,0.0,1,1,2,0,0,0,0,0,0,1
../kbl_data/2023-2024,S43G01N43,수원 KT,Away,정성우,11,2,4,50.0,2,2,100.0,4,6,66.7,1,2,50.0,0,2,2,6,1,0,0,0,3,1
../kbl_data/2023-2024,S43G01N43,수원 KT,Away,최성모,1,0,0,0.0,0,0,0.0,0,0,0.0,1,2,50.0,0,1,1,0,0,0,0,0,0,0
../kbl_data/2023-2024,S43G01N43,수원 KT,Away,김준환,0,0,0,0.0,0,1,0.0,0,1,0.0,0,0,0.0,0,0,0,0,0,0,0,0,0,0
../kbl_data/2023-2024,S43G01N43,수원 KT,Away,하윤기,23,9,15,60.0,0,0,0.0,9,15,60.0,5,6,83.3,1,5,6,1,0,0,0,0,0,1
../kbl_data/2023-2024,S43G01N43,수원 KT,Away,이두원,0,0,2,0.0,0,0,0.0,0,2,0.0,0,0,0.0,1,0,1,0,0,0,0,0,1,3
../kbl_data/2023-2024,S43G01N43,수원 KT,Away,숀 데이브 일데폰소,11,3,4,75.0,1,4,25.0,4,8,50.0,2,2,100.0,2,1,3,0,0,0,0,0,0,0
../kbl_data/2023-2024,S43G01N43,수원 KT,Away,문정현,2,1,2,50.0,0,4,0.0,1,6,16.7,0,0,0.0,0,2,2,1,0,0,0,0,1,1
../kbl_data/2023-2024,S43G01N43,수원 KT,Away,마이클 에릭,0,0,0,0.0,0,0,0.0,0,0,0.0,0,0,0.0,0,2,2,0,0,1,0,0,0,0
../kbl_data/2023-2024,S43G01N43,수원 KT,Away,패리스 배스,24,10,14,71.4,0,4,0.0,10,18,55.6,4,4,100.0,4,8,12,2,1,1,0,2,3,2
../kbl_data/2023-2024,S43G01N44,원주 DB,Home,김현호,0,0,0,0.0,0,0,0.0,0,0,0.0,0,0,0.0,0,1,1,0,0,0,0,0,0,0
../kbl_data/2023-2024,S43G01N44,원주 DB,Home,서민수,0,0,1,0.0,0,0,0.0,0,1,0.0,0,2,0.0,2,0,2,0,0,0,0,0,1,1
../kbl_data/2023-2024,S43G01N44,원주 DB,Home,김영현,0,0,0,0.0,0,1,0.0,0,1,0.0,0,0,0.0,0,1,1,0,0,0,0,0,0,0
../kbl_data/2023-2024,S43G01N44,원주 DB,Home,김종규,7,3,4,75.0,0,0,0.0,3,4,75.0,1,2,50.0,1,4,5,1,0,2,0,1,0,2
../kbl_data/2023-2024,S43G01N44,원주 DB,Home,최승욱,12,2,4,50.0,2,4,50.0,4,8,50.0,2,2,100.0,1,0,1,1,1,0,0,0,1,2
../kbl_data/2023-2024,S43G01N44,원주 DB,Home,강상재,25,9,16,56.2,2,5,40.0,11,21,52.4,1,1,100.0,2,5,7,7,0,0,0,0,2,3
../kbl_data/2023-2024,S43G01N44,원주 DB,Home,디드릭 로슨,20,5,10,50.0,1,4,25.0,6,14,42.9,7,7,100.0,3,9,12,5,0,0,0,1,2,3
../kbl_data/2023-2024,S43G01N44,원주 DB,Home,이준희,0,0,0,0.0,0,0,0.0,0,0,0.0,0,0,0.0,0,0,0,0,0,0,0,0,0,0
../kbl_data/2023-2024,S43G01N44,원주 DB,Home,이선 알바노,17,2,7,28.6,4,7,57.1,6,14,42.9,1,2,50.0,3,6,9,7,3,0,1,0,3,3
../kbl_data/2023-2024,S43G01N44,원주 DB,Home,박인웅,3,0,2,0.0,1,2,50.0,1,4,25.0,0,0,0.0,2,0,2,0,1,0,0,0,0,1
../kbl_data/2023-2024,S43G01N44,원주 DB,Home,박승재,0,0,0,0.0,0,0,0.0,0,0,0.0,0,0,0.0,0,0,0,0,0,0,0,0,0,0
../kbl_data/2023-2024,S43G01N44,원주 DB,Home,제프 위디,3,0,1,0.0,1,1,100.0,1,2,50.0,0,2,0.0,0,2,2,0,0,1,0,0,1,2
../kbl_data/2023-2024,S43G01N44,부산 KCC,Away,정창영,4,2,5,40.0,0,0,0.0,2,5,40.0,0,0,0.0,2,2,4,1,0,0,0,0,0,3
../kbl_data/2023-2024,S43G01N44,부산 KCC,Away,라건아,6,1,3,33.3,0,0,0.0,1,3,33.3,4,4,100.0,1,3,4,0,0,0,0,0,0,1
../kbl_data/2023-2024,S43G01N44,부산 KCC,Away,허웅,18,2,4,50.0,4,12,33.3,6,16,37.5,2,2,100.0,0,3,3,3,2,0,0,0,3,4
../kbl_data/2023-2024,S43G01N44,부산 KCC,Away,이승현,6,3,10,30.0,0,1,0.0,3,11,27.3,0,0,0.0,0,2,2,1,0,0,0,0,0,4
../kbl_data/2023-2024,S43G01N44,부산 KCC,Away,이호현,12,3,5,60.0,2,3,66.7,5,8,62.5,0,0,0.0,3,0,3,2,0,0,0,0,0,2
../kbl_data/2023-2024,S43G01N44,부산 KCC,Away,최준용,17,4,7,57.1,3,10,30.0,7,17,41.2,0,1,0.0,2,0,2,7,2,2,0,0,2,1
../kbl_data/2023-2024,S43G01N44,부산 KCC,Away,이근휘,0,0,0,0.0,0,0,0.0,0,0,0.0,0,0,0.0,0,1,1,0,0,0,0,0,0,0
../kbl_data/2023-2024,S43G01N44,부산 KCC,Away,김동현,0,0,0,0.0,0,1,0.0,0,1,0.0,0,0,0.0,0,0,0,1,0,0,1,0,0,0
../kbl_data/2023-2024,S43G01N44,부산 KCC,Away,송동훈,0,0,0,0.0,0,0,0.0,0,0,0.0,0,0,0.0,0,0,0,0,0,0,0,0,0,1
../kbl_data/2023-2024,S43G01N44,부산 KCC,Away,여준형,0,0,0,0.0,0,0,0.0,0,0,0.0,0,0,0.0,0,0,0,0,0,0,0,0,0,0
../kbl_data/2023-2024,S43G01N44,부산 KCC,Away,캘빈 제프리 에피스톨라,0,0,0,0.0,0,0,0.0,0,0,0.0,0,0,0.0,0,0,0,0,0,0,0,0,0,0
../kbl_data/2023-2024,S43G01N44,부산 KCC,Away,알리제 드숀 존슨,22,8,14,57.1,1,3,33.3,9,17,52.9,3,7,42.9,9,11,20,3,1,1,0,0,2,4
../kbl_data/2023-2024,S43G01N45,서울 삼성,Home,이정현,3,0,2,0.0,0,3,0.0,0,5,0.0,3,5,60.0,0,1,1,2,0,0,0,0,1,3
../kbl_data/2023-2024,S43G01N45,서울 삼성,Home,김승원,0,0,0,0.0,0,0,0.0,0,0,0.0,0,0,0.0,1,0,1,0,0,0,0,0,1,2
../kbl_data/2023-2024,S43G01N45,서울 삼성,Home,김시래,4,1,2,50.0,0,4,0.0,1,6,16.7,2,2,100.0,1,4,5,2,0,0,0,0,2,3
../kbl_data/2023-2024,S43G01N45,서울 삼성,Home,이동엽,0,0,2,0.0,0,1,0.0,0,3,0.0,0,0,0.0,2,1,3,3,0,0,0,0,0,2
../kbl_data/2023-2024,S43G01N45,서울 삼성,Home,김광철,0,0,1,0.0,0,0,0.0,0,1,0.0,0,0,0.0,0,0,0,1,0,0,0,0,0,1
../kbl_data/2023-2024,S43G01N45,서울 삼성,Home,최승욱,3,1,4,25.0,0,2,0.0,1,6,16.7,1,2,50.0,4,2,6,1,1,0,0,0,1,2
../kbl_data/2023-2024,S43G01N45,서울 삼성,Home,윤성원,3,0,0,0.0,1,4,25.0,1,4,25.0,0,0,0.0,1,1,2,0,1,0,0,0,0,0
../kbl_data/2023-2024,S43G01N45,서울 삼성,Home,김무성,0,0,2,0.0,0,2,0.0,0,4,0.0,0,0,0.0,1,1,2,0,0,0,0,0,0,1
../kbl_data/2023-2024,S43G01N45,서울 삼성,Home,이원석,4,2,7,28.6,0,1,0.0,2,8,25.0,0,0,0.0,5,4,9,2,3,1,0,0,1,2
../kbl_data/2023-2024,S43G01N45,서울 삼성,Home,아반 나바,7,2,4,50.0,1,4,25.0,3,8,37.5,0,2,0.0,1,3,4,1,0,0,0,0,1,2
../kbl_data/2023-2024,S43G01N45,서울 삼성,Home,이스마엘 레인,7,3,6,50.0,0,1,0.0,3,7,42.9,1,2,50.0,1,4,5,0,0,0,0,1,0,2
../kbl_data/2023-2024,S43G01N45,서울 삼성,Home,코피 코번,32,13,27,48.1,0,0,0.0,13,27,48.1,6,7,85.7,12,6,18,0,0,0,0,2,6,3
../kbl_data/2023-2024,S43G01N45,안양 정관장,Away,정준원,3,1,2,50.0,0,0,0.0,1,2,50.0,1,2,50.0,1,2,3,0,0,0,0,0,1,0
../kbl_data/2023-2024,S43G01N45,안양 정관장,Away,정효근,8,4,6,66.7,0,3,0.0,4,9,44.4,0,0,0.0,3,1,4,1,1,0,0,0,0,1
../kbl_data/2023-2024,S43G01N45,안양 정관장,Away,이종현,11,3,5,60.0,1,1,100.0,4,6,66.7,2,2,100.0,0,3,3,0,0,2,0,0,2,3
../kbl_data/2023-2024,S43G01N45,안양 정관장,Away,김철욱,0,0,0,0.0,0,2,0.0,0,2,0.0,0,0,0.0,0,1,1,2,0,0,0,0,0,3
../kbl_data/2023-2024,S43G01N45,안양 정관장,Away,박지훈,16,8,12,66.7,0,0,0.0,8,12,66.7,0,0,0.0,1,5,6,2,2,0,0,0,2,4
../kbl_data/2023-2024,S43G01N45,안양 정관장,Away,최성원,12,1,3,33.3,3,9,33.3,4,12,33.3,1,1,100.0,0,3,3,5,0,0,0,0,0,1
../kbl_data/2023-2024,S43G01N45,안양 정관장,Away,이우정,2,0,1,0.0,0,0,0.0,0,1,0.0,2,2,100.0,0,1,1,0,0,0,0,0,0,0
../kbl_data/2023-2024,S43G01N45,안양 정관장,Away,대릴 먼로,7,2,4,50.0,0,2,0.0,2,6,33.3,3,4,75.0,0,3,3,2,2,1,0,0,0,2
../kbl_data/2023-2024,S43G01N45,안양 정관장,Away,김경원,4,2,3,66.7,0,0,0.0,2,3,66.7,0,0,0.0,0,0,0,0,0,1,0,0,1,1
../kbl_data/2023-2024,S43G01N45,안양 정관장,Away,렌즈 아반도,7,2,3,66.7,1,2,50.0,3,5,60.0,0,0,0.0,0,4,4,2,2,1,0,0,0,2
../kbl_data/2023-2024,S43G01N45,안양 정관장,Away,고찬혁,2,0,1,0.0,0,2,0.0,0,3,0.0,2,2,100.0,0,0,0,0,0,0,0,0,0,0
../kbl_data/2023-2024,S43G01N45,안양 정관장,Away,듀반 맥스웰,9,3,5,60.0,0,1,0.0,3,6,50.0,3,4,75.0,1,2,3,0,1,3,1,1,1,2
../kbl_data/2023-2024,S43G01N46,원주 DB,Home,김현호,5,1,1,100.0,1,2,50.0,2,3,66.7,0,0,0.0,0,0,0,0,1,0,0,0,1,2
../kbl_data/2023-2024,S43G01N46,원주 DB,Home,서민수,1,0,1,0.0,0,0,0.0,0,1,0.0,1,2,50.0,0,2,2,0,0,0,0,0,0,2
../kbl_data/2023-2024,S43G01N46,원주 DB,Home,김영현,0,0,0,0.0,0,0,0.0,0,0,0.0,0,0,0.0,1,0,1,0,0,0,0,0,0,1
../kbl_data/2023-2024,S43G01N46,원주 DB,Home,김종규,26,8,13,61.5,2,3,66.7,10,16,62.5,4,5,80.0,4,5,9,1,0,2,0,3,3,4
../kbl_data/2023-2024,S43G01N46,원주 DB,Home,최승욱,2,1,2,50.0,0,2,0.0,1,4,25.0,0,0,0.0,1,4,5,2,1,2,0,0,0,1
../kbl_data/2023-2024,S43G01N46,원주 DB,Home,강상재,17,4,4,100.0,3,7,42.9,7,11,63.6,0,1,0.0,2,3,5,1,4,0,0,0,4,1
../kbl_data/2023-2024,S43G01N46,원주 DB,Home,유현준,0,0,0,0.0,0,0,0.0,0,0,0.0,0,0,0.0,0,0,0,0,0,0,0,0,0,0
../kbl_data/2023-2024,S43G01N46,원주 DB,Home,디드릭 로슨,14,5,11,45.5,1,4,25.0,6,15,40.0,1,4,25.0,4,9,13,4,1,2,0,0,1,2
../kbl_data/2023-2024,S43G01N46,원주 DB,Home,이용우,0,0,0,0.0,0,1,0.0,0,1,0.0,0,0,0.0,0,0,0,0,0,0,0,0,0,0
../kbl_data/2023-2024,S43G01N46,원주 DB,Home,이선 알바노,10,5,12,41.7,0,2,0.0,5,14,35.7,0,0,0.0,0,0,0,12,0,0,0,0,1,2
../kbl_data/2023-2024,S43G01N46,원주 DB,Home,박인웅,2,1,2,50.0,0,0,0.0,1,2,50.0,0,0,0.0,1,1,2,0,0,0,0,0,0,1
../kbl_data/2023-2024,S43G01N46,원주 DB,Home,제프 위디,4,2,4,50.0,0,0,0.0,2,4,50.0,0,0,0.0,1,3,4,0,0,0,0,1,0,1
../kbl_data/2023-2024,S43G01N46,울산 현대모비스,Away,함지훈,9,3,5,60.0,1,2,50.0,4,7,57.1,0,1,0.0,0,3,3,2,0,0,0,0,1,2
../kbl_data/2023-2024,S43G01N46,울산 현대모비스,Away,김현민,0,0,0,0.0,0,1,0.0,0,1,0.0,0,0,0.0,0,0,0,0,0,0,0,0,0,0
../kbl_data/2023-2024,S43G01N46,울산 현대모비스,Away,최진수,0,0,0,0.0,0,0,0.0,0,0,0.0,0,0,0.0,0,0,0,0,0,0,0,0,0,0
../kbl_data/2023-2024,S43G01N46,울산 현대모비스,Away,김현수,0,0,0,0.0,0,0,0.0,0,0,0.0,0,0,0.0,0,0,0,0,0,0,0,0,0,0
../kbl_data/2023-2024,S43G01N46,울산 현대모비스,Away,장재석,3,1,3,33.3,0,0,0.0,1,3,33.3,1,2,50.0,2,1,3,1,0,0,0,0,0,4
../kbl_data/2023-2024,S43G01N46,울산 현대모비스,Away,김지완,4,2,4,50.0,0,1,0.0,2,5,40.0,0,0,0.0,2,3,5,3,0,0,0,0,1,2
../kbl_data/2023-2024,S43G01N46,울산 현대모비스,Away,김국찬,7,2,4,50.0,1,6,16.7,3,10,30.0,0,0,0.0,1,6,7,1,2,0,0,0,1,2
../kbl_data/2023-2024,S43G01N46,울산 현대모비스,Away,이우석,3,0,2,0.0,1,1,100.0,1,3,33.3,0,0,0.0,0,5,5,3,0,0,0,0,3,1
../kbl_data/2023-2024,S43G01N46,울산 현대모비스,Away,신민석,16,1,4,25.0,4,7,57.1,5,11,45.5,2,2,100.0,4,3,7,1,1,0,0,0,1,4
../kbl_data/2023-2024,S43G01N46,울산 현대모비스,Away,게이지 프림,13,5,15,33.3,0,0,0.0,5,15,33.3,3,3,100.0,4,0,4,2,2,2,0,0,0,1
../kbl_data/2023-2024,S43G01N46,울산 현대모비스,Away,김태완,5,1,1,100.0,1,2,50.0,2,3,66.7,0,0,0.0,0,0,0,2,1,0,0,0,1,1
../kbl_data/2023-2024,S43G01N46,울산 현대모비스,Away,케베 알루마,12,6,14,42.9,0,5,0.0,6,19,31.6,0,0,0.0,3,5,8,1,0,0,0,2,1,1
../kbl_data/2023-2024,S43G01N47,대구 한국가스공사,Home,김동량,4,2,2,100.0,0,0,0.0,2,2,100.0,0,0,0.0,1,3,4,1,0,0,0,0,1,1
../kbl_data/2023-2024,S43G01N47,대구 한국가스공사,Home,차바위,0,0,0,0.0,0,1,0.0,0,1,0.0,0,0,0.0,0,2,2,1,0,0,0,0,0,3
../kbl_data/2023-2024,S43G01N47,대구 한국가스공사,Home,이대헌,4,2,6,33.3,0,1,0.0,2,7,28.6,0,2,0.0,7,5,12,3,0,0,0,0,2,1
../kbl_data/2023-2024,S43G01N47,대구 한국가스공사,Home,박봉진,0,0,0,0.0,0,0,0.0,0,0,0.0,0,0,0.0,0,1,1,0,0,0,0,0,0,1
../kbl_data/2023-2024,S43G01N47,대구 한국가스공사,Home,김낙현,26,6,9,66.7,3,9,33.3,9,18,50.0,5,6,83.3,1,0,1,6,0,0,0,0,2,4
../kbl_data/2023-2024,S43G01N47,대구 한국가스공사,Home,양준우,0,0,0,0.0,0,0,0.0,0,0,0.0,0,0,0.0,0,0,0,0,0,0,0,0,1,0
../kbl_data/2023-2024,S43G01N47,대구 한국가스공사,Home,앤드류 니콜슨,24,3,6,50.0,6,7,85.7,9,13,69.2,0,2,0.0,0,4,4,0,0,0,0,0,2,3
../kbl_data/2023-2024,S43G01N47,대구 한국가스공사,Home,신승민,4,2,4,50.0,0,4,0.0,2,8,25.0,0,3,0.0,1,2,3,1,0,0,1,0,1,2
../kbl_data/2023-2024,S43G01N47,대구 한국가스공사,Home,샘조세프 벨란겔,7,2,3,66.7,1,4,25.0,3,7,42.9,0,0,0.0,0,0,0,1,1,0,1,0,1,4
../kbl_data/2023-2024,S43G01N47,대구 한국가스공사,Home,염유성,0,0,0,0.0,0,1,0.0,0,1,0.0,0,0,0.0,0,1,1,0,0,0,0,0,0,1
../kbl_data/2023-2024,S43G01N47,대구 한국가스공사,Home,앤쏘니 모스,5,2,6,33.3,0,0,0.0,2,6,33.3,1,2,50.0,3,6,9,2,0,0,0,0,1,3
../kbl_data/2023-2024,S43G01N47,대구 한국가스공사,Home,신주영,0,0,0,0.0,0,0,0.0,0,0,0.0,0,0,0.0,0,0,0,0,0,0,0,0,0,0
../kbl_data/2023-2024,S43G01N47,서울 SK,Away,허일영,6,0,1,0.0,0,2,0.0,0,3,0.0,6,6,100.0,2,5,7,1,1,0,0,0,1,3
../kbl_data/2023-2024,S43G01N47,서울 SK,Away,송창용,0,0,0,0.0,0,0,0.0,0,0,0.0,0,0,0.0,0,1,1,0,1,0,0,0,0,3
../kbl_data/2023-2024,S43G01N47,서울 SK,Away,김선형,14,6,10,60.0,0,1,0.0,6,11,54.5,2,2,100.0,0,0,0,8,3,0,0,0,0,2
../kbl_data/2023-2024,S43G01N47,서울 SK,Away,홍경기,0,0,0,0.0,0,0,0.0,0,0,0.0,0,0,0.0,0,0,0,0,0,0,0,0,0,0
../kbl_data/2023-2024,S43G01N47,서울 SK,Away,오세근,9,3,4,75.0,1,2,50.0,4,6,66.7,0,0,0.0,2,5,7,1,0,0,2,0,1,4
../kbl_data/2023-2024,S43G01N47,서울 SK,Away,최부경,0,0,2,0.0,0,0,0.0,0,2,0.0,0,0,0.0,1,2,3,0,1,0,0,0,0,2
../kbl_data/2023-2024,S43G01N47,서울 SK,Away,리온 윌리엄스,2,1,2,50.0,0,1,0.0,1,3,33.3,0,0,0.0,0,2,2,0,0,0,1,0,1,2
../kbl_data/2023-2024,S43G01N47,서울 SK,Away,최원혁,2,0,1,0.0,0,1,0.0,0,2,0.0,2,2,100.0,0,1,1,3,0,0,0,0,0,1
../kbl_data/2023-2024,S43G01N47,서울 SK,Away,자밀 워니,33,13,27,48.1,1,2,50.0,14,29,48.3,4,5,80.0,4,6,10,0,0,2,0,2,0,0
../kbl_data/2023-2024,S43G01N47,서울 SK,Away,전성환,0,0,0,0.0,0,0,0.0,0,0,0.0,0,0,0.0,0,0,0,0,0,0,0,0,0,0
../kbl_data/2023-2024,S43G01N47,서울 SK,Away,김형빈,0,0,0,0.0,0,0,0.0,0,0,0.0,0,0,0.0,0,0,0,0,0,0,0,0,0,0
../kbl_data/2023-2024,S43G01N47,서울 SK,Away,오재현,10,3,4,75.0,1,5,20.0,4,9,44.4,1,1,100.0,0,2,2,1,0,0,1,0,1,4
../kbl_data/2023-2024,S43G01N48,부산 KCC,Home,정창영,4,1,2,50.0,0,0,0.0,1,2,50.0,2,2,100.0,0,0,0,2,0,0,0,0,0,2
../kbl_data/2023-2024,S43G01N48,부산 KCC,Home,라건아,20,6,8,75.0,2,4,50.0,8,12,66.7,2,2,100.0,4,10,14,0,0,0,0,0,5,1
../kbl_data/2023-2024,S43G01N48,부산 KCC,Home,허웅,8,0,1,0.0,2,11,18.2,2,12,16.7,2,6,33.3,0,3,3,1,0,0,0,0,3,2
../kbl_data/2023-2024,S43G01N48,부산 KCC,Home,이승현,8,2,5,40.0,0,0,0.0,2,5,40.0,4,4,100.0,3,1,4,1,3,0,0,0,2,2
../kbl_data/2023-2024,S43G01N48,부산 KCC,Home,이호현,4,1,4,25.0,0,0,0.0,1,4,25.0,2,2,100.0,2,2,4,3,2,0,0,0,3,2
../kbl_data/2023-2024,S43G01N48,부산 KCC,Home,최준용,30,11,19,57.9,1,4,25.0,12,23,52.2,5,7,71.4,2,10,12,5,0,1,0,1,2,2
../kbl_data/2023-2024,S43G01N48,부산 KCC,Home,이근휘,0,0,0,0.0,0,1,0.0,0,1,0.0,0,0,0.0,0,2,2,0,0,0,0,0,0,1
../kbl_data/2023-2024,S43G01N48,부산 KCC,Home,김동현,0,0,0,0.0,0,0,0.0,0,0,0.0,0,0,0.0,0,0,0,0,0,0,0,0,0,1
../kbl_data/2023-2024,S43G01N48,부산 KCC,Home,송동훈,2,0,0,0.0,0,1,0.0,0,1,0.0,2,2,100.0,0,3,3,2,0,0,0,0,0,4
../kbl_data/2023-2024,S43G01N48,부산 KCC,Home,여준형,0,0,0,0.0,0,0,0.0,0,0,0.0,0,0,0.0,0,0,0,0,0,0,0,0,0,0
../kbl_data/2023-2024,S43G01N48,부산 KCC,Home,캘빈 제프리 에피스톨라,0,0,0,0.0,0,0,0.0,0,0,0.0,0,0,0.0,0,0,0,0,0,0,0,0,0,0
../kbl_data/2023-2024,S43G01N48,부산 KCC,Home,알리제 드숀 존슨,2,1,4,25.0,0,0,0.0,1,4,25.0,0,0,0.0,2,5,7,0,0,0,0,0,3,0
../kbl_data/2023-2024,S43G01N48,고양 소노,Away,김강선,0,0,1,0.0,0,1,0.0,0,2,0.0,0,0,0.0,0,2,2,1,1,0,0,0,0,1
../kbl_data/2023-2024,S43G01N48,고양 소노,Away,함준후,3,0,2,0.0,1,4,25.0,1,6,16.7,0,0,0.0,0,1,1,0,0,0,0,0,0,4
../kbl_data/2023-2024,S43G01N48,고양 소노,Away,최현민,6,0,2,0.0,2,7,28.6,2,9,22.2,0,0,0.0,0,0,0,0,0,0,0,0,0,5
../kbl_data/2023-2024,S43G01N48,고양 소노,Away,김민욱,6,0,0,0.0,2,4,50.0,2,4,50.0,0,0,0.0,1,1,2,0,0,1,0,0,0,2
../kbl_data/2023-2024,S43G01N48,고양 소노,Away,한호빈,8,2,3,66.7,1,8,12.5,3,11,27.3,1,2,50.0,0,2,2,3,3,0,0,0,3,2
../kbl_data/2023-2024,S43G01N48,고양 소노,Away,김지후,3,0,0,0.0,1,7,14.3,1,7,14.3,0,0,0.0,0,2,2,0,1,0,1,0,0,1
../kbl_data/2023-2024,S43G01N48,고양 소노,Away,김진유,2,1,1,100.0,0,0,0.0,1,1,100.0,0,0,0.0,0,0,0,1,0,0,0,0,0,0
../kbl_data/2023-2024,S43G01N48,고양 소노,Away,치나누 오누아쿠,6,2,9,22.2,0,1,0.0,2,10,20.0,2,4,50.0,4,10,14,2,2,0,0,0,3,0
../kbl_data/2023-2024,S43G01N48,고양 소노,Away,이정현,27,9,15,60.0,2,4,50.0,11,19,57.9,3,4,75.0,0,3,3,5,4,0,0,0,1,4
../kbl_data/2023-2024,S43G01N48,고양 소노,Away,백지웅,0,0,0,0.0,0,0,0.0,0,0,0.0,0,0,0.0,2,0,2,1,0,0,0,0,0,1
../kbl_data/2023-2024,S43G01N48,고양 소노,Away,안정욱,0,0,0,0.0,0,0,0.0,0,0,0.0,0,0,0.0,0,0,0,0,1,0,0,0,0,1
../kbl_data/2023-2024,S43G01N48,고양 소노,Away,디욘테 데이비스,8,4,5,80.0,0,2,0.0,4,7,57.1,0,0,0.0,2,2,4,0,0,2,0,2,0,1
../kbl_data/2023-2024,S43G01N49,안양 정관장,Home,정준원,8,4,5,80.0,0,3,0.0,4,8,50.0,0,0,0.0,1,0,1,0,0,0,0,0,1,0
../kbl_data/2023-2024,S43G01N49,안양 정관장,Home,배병준,3,0,5,0.0,1,4,25.0,1,9,11.1,0,0,0.0,0,1,1,2,0,0,0,0,0,0
../kbl_data/2023-2024,S43G01N49,안양 정관장,Home,정효근,6,2,5,40.0,0,2,0.0,2,7,28.6,2,3,66.7,2,0,2,1,1,0,0,0,1,2
../kbl_data/2023-2024,S43G01N49,안양 정관장,Home,이종현,6,3,5,60.0,0,0,0.0,3,5,60.0,0,0,0.0,0,1,1,1,0,0,0,0,0,1
../kbl_data/2023-2024,S43G01N49,안양 정관장,Home,박지훈,13,5,9,55.6,1,4,25.0,6,13,46.2,0,0,0.0,0,5,5,5,2,0,0,0,1,4
../kbl_data/2023-2024,S43G01N49,안양 정관장,Home,최성원,13,1,1,100.0,3,7,42.9,4,8,50.0,2,2,100.0,0,0,0,4,0,0,0,0,3,2
../kbl_data/2023-2024,S43G01N49,안양 정관장,Home,이우정,0,0,0,0.0,0,1,0.0,0,1,0.0,0,0,0.0,0,0,0,1,0,0,0,0,1,1
../kbl_data/2023-2024,S43G01N49,안양 정관장,Home,대릴 먼로,17,5,9,55.6,2,2,100.0,7,11,63.6,1,1,100.0,3,2,5,7,1,0,1,1,0,2
../kbl_data/2023-2024,S43G01N49,안양 정관장,Home,김경원,5,2,4,50.0,0,0,0.0,2,4,50.0,1,2,50.0,3,2,5,2,0,1,0,0,1,0
../kbl_data/2023-2024,S43G01N49,안양 정관장,Home,렌즈 아반도,0,0,1,0.0,0,0,0.0,0,1,0.0,0,0,0.0,0,0,0,0,0,0,0,0,3,0
../kbl_data/2023-2024,S43G01N49,안양 정관장,Home,고찬혁,3,0,0,0.0,0,2,0.0,0,2,0.0,3,5,60.0,0,0,0,0,0,0,0,0,0,1
../kbl_data/2023-2024,S43G01N49,안양 정관장,Home,듀반 맥스웰,3,0,0,0.0,0,0,0.0,0,0,0.0,3,4,75.0,1,2,3,2,2,0,0,0,2,3
../kbl_data/2023-2024,S43G01N49,창원 LG,Away,이관희,14,2,3,66.7,2,4,50.0,4,7,57.1,4,4,100.0,0,1,1,2,1,0,0,0,3,1
../kbl_data/2023-2024,S43G01N49,창원 LG,Away,정희재,5,0,0,0.0,1,4,25.0,1,4,25.0,2,2,100.0,0,2,2,1,0,0,0,0,2,3
../kbl_data/2023-2024,S43G01N49,창원 LG,Away,한상혁,0,0,0,0.0,0,0,0.0,0,0,0.0,0,0,0.0,0,0,0,0,0,0,0,0,0,0
../kbl_data/2023-2024,S43G01N49,창원 LG,Away,이재도,15,6,7,85.7,1,4,25.0,7,11,63.6,0,0,0.0,0,1,1,7,2,0,0,0,2,4
../kbl_data/2023-2024,S43G01N49,창원 LG,Away,정인덕,0,0,0,0.0,0,1,0.0,0,1,0.0,0,0,0.0,0,0,0,0,0,0,0,0,0,0
../kbl_data/2023-2024,S43G01N49,창원 LG,Away,양홍석,19,4,5,80.0,3,7,42.9,7,12,58.3,2,2,100.0,0,5,5,6,0,1,0,0,1,2
../kbl_data/2023-2024,S43G01N49,창원 LG,Away,아셈 마레이,21,10,15,66.7,0,0,0.0,10,15,66.7,1,2,50.0,5,12,17,6,1,0,0,0,0,2
../kbl_data/2023-2024,S43G01N49,창원 LG,Away,이승우,4,2,2,100.0,0,0,0.0,2,2,100.0,0,0,0.0,2,2,4,0,1,0,0,0,1,1
../kbl_data/2023-2024,S43G01N49,창원 LG,Away,저스틴 구탕,12,6,7,85.7,0,0,0.0,6,7,85.7,0,0,0.0,1,5,6,3,2,0,0,4,1,3
../kbl_data/2023-2024,S43G01N49,창원 LG,Away,양준석,5,1,1,100.0,1,1,100.0,2,2,100.0,0,0,0.0,0,1,1,1,1,0,0,0,1,1
../kbl_data/2023-2024,S43G01N49,창원 LG,Away,단테 커닝햄,0,0,0,0.0,0,0,0.0,0,0,0.0,0,0,0.0,0,0,0,0,0,0,0,0,0,0
../kbl_data/2023-2024,S43G01N49,창원 LG,Away,유기상,11,1,3,33.3,3,3,100.0,4,6,66.7,0,0,0.0,0,0,0,0,1,1,0,0,2,4
../kbl_data/2023-2024,S43G01N50,수원 KT,Home,한희원,7,2,2,100.0,1,3,33.3,3,5,60.0,0,0,0.0,1,5,6,0,0,0,0,0,2,3
../kbl_data/2023-2024,S43G01N50,수원 KT,Home,최창진,0,0,0,0.0,0,0,0.0,0,0,0.0,0,0,0.0,0,0,0,2,1,0,0,0,2,0
../kbl_data/2023-2024,S43G01N50,수원 KT,Home,문성곤,0,0,0,0.0,0,3,0.0,0,3,0.0,0,0,0.0,1,0,1,3,1,0,0,0,1,5
../kbl_data/2023-2024,S43G01N50,수원 KT,Home,이현석,0,0,0,0.0,0,0,0.0,0,0,0.0,0,0,0.0,0,0,0,0,0,0,0,0,0,0
../kbl_data/2023-2024,S43G01N50,수원 KT,Home,정성우,7,2,3,66.7,0,3,0.0,2,6,33.3,3,4,75.0,0,1,1,8,4,0,1,0,0,2
../kbl_data/2023-2024,S43G01N50,수원 KT,Home,허훈,26,4,5,80.0,5,8,62.5,9,13,69.2,3,6,50.0,0,2,2,4,3,0,0,0,3,2
../kbl_data/2023-2024,S43G01N50,수원 KT,Home,박찬호,0,0,1,0.0,0,0,0.0,0,1,0.0,0,0,0.0,0,0,0,0,0,0,0,0,0,2
../kbl_data/2023-2024,S43G01N50,수원 KT,Home,이두원,13,6,8,75.0,0,0,0.0,6,8,75.0,1,6,16.7,1,3,4,0,0,1,0,0,2,1
../kbl_data/2023-2024,S43G01N50,수원 KT,Home,숀 데이브 일데폰소,5,0,1,0.0,1,3,33.3,1,4,25.0,2,2,100.0,1,0,1,2,1,0,0,0,0,1
../kbl_data/2023-2024,S43G01N50,수원 KT,Home,문정현,2,1,1,100.0,0,0,0.0,1,1,100.0,0,0,0.0,0,0,0,0,0,0,0,0,0,0
../kbl_data/2023-2024,S43G01N50,수원 KT,Home,마이클 에릭,4,2,4,50.0,0,0,0.0,2,4,50.0,0,0,0.0,0,4,4,0,0,0,0,1,0,1
../kbl_data/2023-2024,S43G01N50,수원 KT,Home,패리스 배스,23,6,11,54.5,3,9,33.3,9,20,45.0,2,2,100.0,1,6,7,3,1,0,0,3,4,1
../kbl_data/2023-2024,S43G01N50,서울 SK,Away,허일영,20,4,4,100.0,4,5,80.0,8,9,88.9,0,0,0.0,2,1,3,2,3,1,0,0,1,2
../kbl_data/2023-2024,S43G01N50,서울 SK,Away,송창용,2,1,2,50.0,0,2,0.0,1,4,25.0,0,0,0.0,1,3,4,2,1,0,0,0,0,1
../kbl_data/2023-2024,S43G01N50,서울 SK,Away,김선형,10,2,3,66.7,2,6,33.3,4,9,44.4,0,0,0.0,2,3,5,11,3,1,0,0,4,4
../kbl_data/2023-2024,S43G01N50,서울 SK,Away,홍경기,0,0,0,0.0,0,0,0.0,0,0,0.0,0,0,0.0,0,0,0,0,0,0,0,0,0,0
../kbl_data/2023-2024,S43G01N50,서울 SK,Away,오세근,20,8,12,66.7,1,3,33.3,9,15,60.0,1,2,50.0,5,6,11,0,1,1,0,0,1,3
../kbl_data/2023-2024,S43G01N50,서울 SK,Away,최부경,6,1,2,50.0,0,1,0.0,1,3,33.3,4,4,100.0,2,1,3,1,0,1,0,0,1,4
../kbl_data/2023-2024,S43G01N50,서울 SK,Away,리온 윌리엄스,0,0,0,0.0,0,0,0.0,0,0,0.0,0,0,0.0,0,0,0,0,0,0,0,0,0,0
../kbl_data/2023-2024,S43G01N50,서울 SK,Away,최원혁,2,1,1,100.0,0,1,0.0,1,2,50.0,0,0,0.0,1,1,2,0,0,0,0,0,0,1
../kbl_data/2023-2024,S43G01N50,서울 SK,Away,안영준,16,2,7,28.6,4,7,57.1,6,14,42.9,0,0,0.0,1,1,2,2,2,1,0,0,1,3
../kbl_data/2023-2024,S43G01N50,서울 SK,Away,자밀 워니,26,10,17,58.8,0,3,0.0,10,20,50.0,6,8,75.0,3,11,14,2,2,0,0,0,4,1
../kbl_data/2023-2024,S43G01N50,서울 SK,Away,김형빈,0,0,0,0.0,0,1,0.0,0,1,0.0,0,0,0.0,0,0,0,0,0,0,0,0,1,0
../kbl_data/2023-2024,S43G01N50,서울 SK,Away,오재현,0,0,1,0.0,0,1,0.0,0,2,0.0,0,0,0.0,0,0,0,0,1,0,0,0,1,2
../kbl_data/2023-2024,S43G01N51,울산 현대모비스,Home,함지훈,5,2,4,50.0,0,1,0.0,2,5,40.0,1,3,33.3,1,2,3,5,1,1,0,0,0,2
../kbl_data/2023-2024,S43G01N51,울산 현대모비스,Home,김현민,0,0,0,0.0,0,1,0.0,0,1,0.0,0,0,0.0,1,1,2,1,1,0,0,0,0,2
../kbl_data/2023-2024,S43G01N51,울산 현대모비스,Home,최진수,0,0,0,0.0,0,0,0.0,0,0,0.0,0,0,0.0,0,0,0,0,0,0,0,0,0,0
../kbl_data/2023-2024,S43G01N51,울산 현대모비스,Home,김현수,0,0,0,0.0,0,0,0.0,0,0,0.0,0,0,0.0,0,0,0,0,0,0,0,0,0,0
../kbl_data/2023-2024,S43G01N51,울산 현대모비스,Home,장재석,2,0,2,0.0,0,0,0.0,0,2,0.0,2,2,100.0,1,3,4,0,0,0,0,0,1,4
../kbl_data/2023-2024,S43G01N51,울산 현대모비스,Home,김지완,4,1,1,100.0,0,2,0.0,1,3,33.3,2,2,100.0,0,1,1,0,0,0,0,0,1,0
../kbl_data/2023-2024,S43G01N51,울산 현대모비스,Home,김국찬,4,2,4,50.0,0,2,0.0,2,6,33.3,0,0,0.0,1,5,6,2,1,0,0,0,1,3
../kbl_data/2023-2024,S43G01N51,울산 현대모비스,Home,이우석,15,2,10,20.0,3,5,60.0,5,15,33.3,2,4,50.0,2,2,4,3,1,0,0,1,1,3
../kbl_data/2023-2024,S43G01N51,울산 현대모비스,Home,신민석,5,1,1,100.0,1,4,25.0,2,5,40.0,0,0,0.0,0,3,3,0,0,0,0,0,0,1
../kbl_data/2023-2024,S43G01N51,울산 현대모비스,Home,게이지 프림,41,13,23,56.5,1,2,50.0,14,25,56.0,12,14,85.7,7,7,14,3,1,1,0,0,2,1
../kbl_data/2023-2024,S43G01N51,울산 현대모비스,Home,김태완,5,1,2,50.0,1,3,33.3,2,5,40.0,0,0,0.0,1,4,5,5,3,0,0,0,3,2
../kbl_data/2023-2024,S43G01N51,울산 현대모비스,Home,케베 알루마,0,0,5,0.0,0,2,0.0,0,7,0.0,0,0,0.0,0,1,1,0,0,0,0,0,0,1
../kbl_data/2023-2024,S43G01N51,대구 한국가스공사,Away,김동량,6,2,5,40.0,0,0,0.0,2,5,40.0,2,2,100.0,3,3,6,1,0,0,0,0,4,4
../kbl_data/2023-2024,S43G01N51,대구 한국가스공사,Away,차바위,2,1,3,33.3,0,2,0.0,1,5,20.0,0,0,0.0,1,1,2,0,0,0,0,0,1,1
../kbl_data/2023-2024,S43G01N51,대구 한국가스공사,Away,박지훈,0,0,0,0.0,0,0,0.0,0,0,0.0,0,0,0.0,0,0,0,0,0,0,0,0,0,1
../kbl_data/2023-2024,S43G01N51,대구 한국가스공사,Away,이원대,2,0,2,0.0,0,1,0.0,0,3,0.0,2,2,100.0,0,2,2,0,1,0,0,0,0,1
../kbl_data/2023-2024,S43G01N51,대구 한국가스공사,Away,이대헌,5,1,3,33.3,1,3,33.3,2,6,33.3,0,0,0.0,1,4,5,0,0,0,0,0,1,4
../kbl_data/2023-2024,S43G01N51,대구 한국가스공사,Away,박봉진,0,0,0,0.0,0,0,0.0,0,0,0.0,0,0,0.0,0,2,2,0,0,0,0,0,0,1
../kbl_data/2023-2024,S43G01N51,대구 한국가스공사,Away,김낙현,12,3,7,42.9,2,4,50.0,5,11,45.5,0,0,0.0,1,2,3,4,0,0,0,0,2,3
../kbl_data/2023-2024,S43G01N51,대구 한국가스공사,Away,앤드류 니콜슨,31,7,15,46.7,4,10,40.0,11,25,44.0,5,6,83.3,0,10,10,0,0,2,0,0,1,3
../kbl_data/2023-2024,S43G01N51,대구 한국가스공사,Away,신승민,8,1,2,50.0,2,4,50.0,3,6,50.0,0,0,0.0,1,6,7,2,0,0,0,0,0,1
../kbl_data/2023-2024,S43G01N51,대구 한국가스공사,Away,샘조세프 벨란겔,12,6,9,66.7,0,1,0.0,6,10,60.0,0,0,0.0,2,3,5,3,2,0,0,0,0,3
../kbl_data/2023-2024,S43G01N51,대구 한국가스공사,Away,앤쏘니 모스,2,1,4,25.0,0,0,0.0,1,4,25.0,0,0,0.0,0,0,0,0,1,0,0,0,1,1
../kbl_data/2023-2024,S43G01N51,대구 한국가스공사,Away,신주영,0,0,0,0.0,0,0,0.0,0,0,0.0,0,0,0.0,0,0,0,0,0,0,0,0,0,1
../kbl_data/2023-2024,S43G01N52,원주 DB,Home,김현호,3,1,1,100.0,0,0,0.0,1,1,100.0,1,1,100.0,0,1,1,3,0,0,0,0,0,1
../kbl_data/2023-2024,S43G01N52,원주 DB,Home,서민수,2,1,2,50.0,0,2,0.0,1,4,25.0,0,0,0.0,0,9,9,0,0,0,0,0,2,5
../kbl_data/2023-2024,S43G01N52,원주 DB,Home,김영현,3,0,0,0.0,1,5,20.0,1,5,20.0,0,0,0.0,0,0,0,0,0,0,0,0,0,3
../kbl_data/2023-2024,S43G01N52,원주 DB,Home,김종규,6,3,3,100.0,0,0,0.0,3,3,100.0,0,0,0.0,1,6,7,0,1,1,0,0,0,4
../kbl_data/2023-2024,S43G01N52,원주 DB,Home,최승욱,20,8,10,80.0,0,0,0.0,8,10,80.0,4,4,100.0,2,2,4,2,6,0,2,0,2,2
../kbl_data/2023-2024,S43G01N52,원주 DB,Home,강상재,11,3,3,100.0,1,4,25.0,4,7,57.1,2,2,100.0,1,4,5,5,3,1,0,0,3,4
../kbl_data/2023-2024,S43G01N52,원주 DB,Home,디드릭 로슨,24,8,10,80.0,1,5,20.0,9,15,60.0,5,6,83.3,3,9,12,2,0,0,0,0,1,3
../kbl_data/2023-2024,S43G01N52,원주 DB,Home,이용우,0,0,1,0.0,0,2,0.0,0,3,0.0,0,0,0.0,1,0,1,1,2,0,0,0,1,0
../kbl_data/2023-2024,S43G01N52,원주 DB,Home,이선 알바노,21,4,8,50.0,3,5,60.0,7,13,53.8,4,5,80.0,1,2,3,12,2,0,0,0,1,2
../kbl_data/2023-2024,S43G01N52,원주 DB,Home,박인웅,11,4,4,100.0,1,3,33.3,5,7,71.4,0,0,0.0,0,0,0,1,0,0,0,0,1,2
../kbl_data/2023-2024,S43G01N52,원주 DB,Home,박승재,2,1,2,50.0,0,0,0.0,1,2,50.0,0,0,0.0,0,0,0,0,0,0,0,0,1,1
../kbl_data/2023-2024,S43G01N52,원주 DB,Home,제프 위디,19,6,10,60.0,2,2,100.0,8,12,66.7,1,1,100.0,1,3,4,0,1,2,0,3,2,1
../kbl_data/2023-2024,S43G01N52,서울 삼성,Away,이정현,4,1,4,25.0,0,5,0.0,1,9,11.1,2,2,100.0,0,2,2,7,2,0,0,0,0,2
../kbl_data/2023-2024,S43G01N52,서울 삼성,Away,김시래,7,0,1,0.0,1,4,25.0,1,5,20.0,4,6,66.7,1,0,1,5,1,0,0,0,0,2
../kbl_data/2023-2024,S43G01N52,서울 삼성,Away,이동엽,2,1,1,100.0,0,0,0.0,1,1,100.0,0,0,0.0,0,1,1,1,0,0,0,0,1,1
../kbl_data/2023-2024,S43G01N52,서울 삼성,Away,김광철,0,0,0,0.0,0,0,0.0,0,0,0.0,0,0,0.0,0,0,0,0,0,0,0,0,1,0
../kbl_data/2023-2024,S43G01N52,서울 삼성,Away,최승욱,20,8,10,80.0,0,0,0.0,8,10,80.0,4,4,100.0,2,2,4,2,6,0,2,0,2,2
../kbl_data/2023-2024,S43G01N52,서울 삼성,Away,윤성원,0,0,1,0.0,0,2,0.0,0,3,0.0,0,0,0.0,0,1,1,1,1,0,0,0,0,2
../kbl_data/2023-2024,S43G01N52,서울 삼성,Away,김진영,0,0,1,0.0,0,2,0.0,0,3,0.0,0,0,0.0,0,2,2,0,0,0,0,0,1,3
../kbl_data/2023-2024,S43G01N52,서울 삼성,Away,조우성,5,1,4,25.0,0,0,0.0,1,4,25.0,3,3,100.0,2,2,4,0,0,0,0,0,1,3
../kbl_data/2023-2024,S43G01N52,서울 삼성,Away,이원석,6,1,3,33.3,1,2,50.0,2,5,40.0,1,1,100.0,1,6,7,1,0,0,0,0,0,4
../kbl_data/2023-2024,S43G01N52,서울 삼성,Away,아반 나바,0,0,1,0.0,0,2,0.0,0,3,0.0,0,0,0.0,0,0,0,1,0,0,0,0,0,2
../kbl_data/2023-2024,S43G01N52,서울 삼성,Away,이스마엘 레인,6,3,7,42.9,0,2,0.0,3,9,33.3,0,2,0.0,4,5,9,0,1,0,0,0,2,0
../kbl_data/2023-2024,S43G01N52,서울 삼성,Away,코피 코번,33,15,29,51.7,0,0,0.0,15,29,51.7,3,8,37.5,5,2,7,0,1,0,0,0,4,0
../kbl_data/2023-2024,S43G01N53,창원 LG,Home,이관희,5,0,0,0.0,1,3,33.3,1,3,33.3,2,2,100.0,0,1,1,0,1,0,0,0,1,0
../kbl_data/2023-2024,S43G01N53,창원 LG,Home,정희재,2,1,1,100.0,0,1,0.0,1,2,50.0,0,0,0.0,0,1,1,2,1,0,0,0,1,2
../kbl_data/2023-2024,S43G01N53,창원 LG,Home,임동섭,0,0,0,0.0,0,0,0.0,0,0,0.0,0,0,0.0,0,0,0,0,0,0,0,0,0,0
../kbl_data/2023-2024,S43G01N53,창원 LG,Home,한상혁,0,0,0,0.0,0,0,0.0,0,0,0.0,0,0,0.0,0,0,0,0,0,0,0,0,0,0
../kbl_data/2023-2024,S43G01N53,창원 LG,Home,이재도,10,1,7,14.3,2,8,25.0,3,15,20.0,2,2,100.0,0,1,1,4,1,0,0,0,1,2
../kbl_data/2023-2024,S43G01N53,창원 LG,Home,정인덕,0,0,0,0.0,0,0,0.0,0,0,0.0,0,0,0.0,0,1,1,2,0,0,0,0,0,1
../kbl_data/2023-2024,S43G01N53,창원 LG,Home,양홍석,12,3,5,60.0,2,8,25.0,5,13,38.5,0,0,0.0,1,4,5,2,2,0,1,0,2,2
../kbl_data/2023-2024,S43G01N53,창원 LG,Home,아셈 마레이,23,9,13,69.2,0,0,0.0,9,13,69.2,5,10,50.0,11,10,21,3,1,2,1,0,1,3
../kbl_data/2023-2024,S43G01N53,창원 LG,Home,이승우,0,0,0,0.0,0,0,0.0,0,0,0.0,0,0,0.0,0,0,0,0,0,0,0,0,0,0
../kbl_data/2023-2024,S43G01N53,창원 LG,Home,저스틴 구탕,12,6,8,75.0,0,1,0.0,6,9,66.7,0,0,0.0,0,4,4,1,1,1,0,1,4,5
../kbl_data/2023-2024,S43G01N53,창원 LG,Home,양준석,0,0,1,0.0,0,0,0.0,0,1,0.0,0,0,0.0,0,0,0,2,0,0,0,0,0,0
../kbl_data/2023-2024,S43G01N53,창원 LG,Home,유기상,13,2,4,50.0,3,5,60.0,5,9,55.6,0,0,0.0,1,0,1,1,1,0,1,0,0,2
../kbl_data/2023-2024,S43G01N53,대구 한국가스공사,Away,김동량,4,2,3,66.7,0,0,0.0,2,3,66.7,0,0,0.0,1,1,2,2,0,0,0,0,1,2
../kbl_data/2023-2024,S43G01N53,대구 한국가스공사,Away,차바위,6,0,0,0.0,2,4,50.0,2,4,50.0,0,0,0.0,1,2,3,1,1,0,0,0,0,1
../kbl_data/2023-2024,S43G01N53,대구 한국가스공사,Away,이원대,0,0,1,0.0,0,1,0.0,0,2,0.0,0,0,0.0,1,0,1,1,0,0,0,0,0,1
../kbl_data/2023-2024,S43G01N53,대구 한국가스공사,Away,이대헌,4,2,6,33.3,0,0,0.0,2,6,33.3,0,0,0.0,0,2,2,0,0,0,0,0,1,3
../kbl_data/2023-2024,S43G01N53,대구 한국가스공사,Away,박봉진,4,2,2,100.0,0,3,0.0,2,5,40.0,0,0,0.0,0,1,1,0,0,0,0,0,0,1
../kbl_data/2023-2024,S43G01N53,대구 한국가스공사,Away,김낙현,7,2,2,100.0,1,1,100.0,3,3,100.0,0,0,0.0,0,0,0,3,1,0,0,0,2,2
../kbl_data/2023-2024,S43G01N53,대구 한국가스공사,Away,앤드류 니콜슨,13,5,8,62.5,1,4,25.0,6,12,50.0,0,2,0.0,0,2,2,2,0,0,0,0,2,4
../kbl_data/2023-2024,S43G01N53,대구 한국가스공사,Away,신승민,10,2,3,66.7,1,1,100.0,3,4,75.0,3,4,75.0,0,0,0,3,1,1,2,0,2,3
../kbl_data/2023-2024,S43G01N53,대구 한국가스공사,Away,샘조세프 벨란겔,4,2,2,100.0,0,3,0.0,2,5,40.0,0,2,0.0,0,4,4,3,0,0,0,0,2,4
../kbl_data/2023-2024,S43G01N53,대구 한국가스공사,Away,안세영,3,0,2,0.0,1,1,100.0,1,3,33.3,0,0,0.0,0,1,1,0,1,0,0,0,0,1
../kbl_data/2023-2024,S43G01N53,대구 한국가스공사,Away,앤쏘니 모스,2,1,4,25.0,0,0,0.0,1,4,25.0,0,0,0.0,1,5,6,0,0,0,0,0,2,1
../kbl_data/2023-2024,S43G01N53,대구 한국가스공사,Away,신주영,5,1,3,33.3,1,1,100.0,2,4,50.0,0,0,0.0,0,1,1,1,1,0,0,0,1,0
../kbl_data/2023-2024,S43G01N54,안양 정관장,Home,정준원,0,0,0,0.0,0,1,0.0,0,1,0.0,0,0,0.0,0,0,0,0,0,0,0,0,0,0
../kbl_data/2023-2024,S43G01N54,안양 정관장,Home,정효근,22,2,5,40.0,5,6,83.3,7,11,63.6,3,5,60.0,2,5,7,3,1,1,0,0,1,4
../kbl_data/2023-2024,S43G01N54,안양 정관장,Home,이종현,7,2,7,28.6,1,2,50.0,3,9,33.3,0,0,0.0,2,7,9,1,2,1,0,0,0,0
../kbl_data/2023-2024,S43G01N54,안양 정관장,Home,김철욱,0,0,0,0.0,0,0,0.0,0,0,0.0,0,0,0.0,0,0,0,0,0,0,0,0,0,0
../kbl_data/2023-2024,S43G01N54,안양 정관장,Home,박지훈,8,4,6,66.7,0,1,0.0,4,7,57.1,0,0,0.0,2,4,6,6,0,0,1,0,2,3
../kbl_data/2023-2024,S43G01N54,안양 정관장,Home,최성원,11,4,7,57.1,1,3,33.3,5,10,50.0,0,0,0.0,0,2,2,6,1,0,0,0,0,1
../kbl_data/2023-2024,S43G01N54,안양 정관장,Home,대릴 먼로,17,4,11,36.4,3,5,60.0,7,16,43.8,0,0,0.0,2,3,5,5,1,0,2,0,2,3
../kbl_data/2023-2024,S43G01N54,안양 정관장,Home,장태빈,0,0,0,0.0,0,0,0.0,0,0,0.0,0,0,0.0,0,0,0,0,0,0,0,0,0,0
../kbl_data/2023-2024,S43G01N54,안양 정관장,Home,김경원,0,0,1,0.0,0,0,0.0,0,1,0.0,0,0,0.0,1,1,2,0,0,0,0,0,2,0
../kbl_data/2023-2024,S43G01N54,안양 정관장,Home,렌즈 아반도,17,6,10,60.0,1,4,25.0,7,14,50.0,2,2,100.0,4,3,7,1,2,1,0,2,3,4
../kbl_data/2023-2024,S43G01N54,안양 정관장,Home,고찬혁,0,0,0,0.0,0,0,0.0,0,0,0.0,0,0,0.0,0,0,0,0,0,0,0,0,0,0
../kbl_data/2023-2024,S43G01N54,안양 정관장,Home,듀반 맥스웰,2,1,5,20.0,0,0,0.0,1,5,20.0,0,0,0.0,1,1,2,0,0,0,0,0,0,2
../kbl_data/2023-2024,S43G01N54,부산 KCC,Away,정창영,7,1,1,100.0,1,4,25.0,2,5,40.0,2,2,100.0,1,1,2,4,1,0,0,0,2,1
../kbl_data/2023-2024,S43G01N54,부산 KCC,Away,라건아,14,4,7,57.1,1,2,50.0,5,9,55.6,3,4,75.0,2,7,9,0,0,3,0,0,2,1
../kbl_data/2023-2024,S43G01N54,부산 KCC,Away,허웅,23,2,5,40.0,6,11,54.5,8,16,50.0,1,1,100.0,0,1,1,3,0,0,0,0,3,1
../kbl_data/2023-2024,S43G01N54,부산 KCC,Away,이승현,2,1,4,25.0,0,0,0.0,1,4,25.0,0,0,0.0,0,3,3,2,2,0,0,0,0,4
../kbl_data/2023-2024,S43G01N54,부산 KCC,Away,최준용,10,4,6,66.7,0,4,0.0,4,10,40.0,2,3,66.7,0,1,1,4,1,0,0,0,4,4
../kbl_data/2023-2024,S43G01N54,부산 KCC,Away,이진욱,0,0,1,0.0,0,0,0.0,0,1,0.0,0,0,0.0,0,0,0,0,1,0,0,0,0,0
../kbl_data/2023-2024,S43G01N54,부산 KCC,Away,이근휘,2,1,3,33.3,0,3,0.0,1,6,16.7,0,0,0.0,2,2,4,1,0,0,0,0,0,0
../kbl_data/2023-2024,S43G01N54,부산 KCC,Away,김동현,0,0,0,0.0,0,0,0.0,0,0,0.0,0,0,0.0,0,0,0,0,0,0,0,0,0,0
../kbl_data/2023-2024,S43G01N54,부산 KCC,Away,송동훈,5,1,1,100.0,1,3,33.3,2,4,50.0,0,0,0.0,1,1,2,1,1,0,1,0,0,2
../kbl_data/2023-2024,S43G01N54,부산 KCC,Away,여준형,0,0,0,0.0,0,0,0.0,0,0,0.0,0,0,0.0,0,0,0,0,0,0,0,0,0,0
../kbl_data/2023-2024,S43G01N54,부산 KCC,Away,캘빈 제프리 에피스톨라,0,0,0,0.0,0,0,0.0,0,0,0.0,0,0,0.0,0,0,0,0,0,0,0,0,0,0
../kbl_data/2023-2024,S43G01N54,부산 KCC,Away,알리제 드숀 존슨,11,4,7,57.1,0,3,0.0,4,10,40.0,3,5,60.0,5,6,11,1,0,1,0,0,1,4
../kbl_data/2023-2024,S43G01N55,고양 소노,Home,김강선,20,2,3,66.7,5,10,50.0,7,13,53.8,1,2,50.0,1,0,1,0,3,0,2,0,0,4
../kbl_data/2023-2024,S43G01N55,고양 소노,Home,함준후,0,0,0,0.0,0,0,0.0,0,0,0.0,0,0,0.0,0,0,0,0,0,0,0,0,0,0
../kbl_data/2023-2024,S43G01N55,고양 소노,Home,최현민,2,1,1,100.0,0,2,0.0,1,3,33.3,0,0,0.0,0,0,0,3,0,0,0,0,0,3
../kbl_data/2023-2024,S43G01N55,고양 소노,Home,김민욱,13,2,2,100.0,3,8,37.5,5,10,50.0,0,0,0.0,2,0,2,0,0,0,0,0,2,3
../kbl_data/2023-2024,S43G01N55,고양 소노,Home,한호빈,4,0,1,0.0,1,6,16.7,1,7,14.3,1,2,50.0,0,2,2,7,2,0,0,0,3,3
../kbl_data/2023-2024,S43G01N55,고양 소노,Home,김진유,0,0,0,0.0,0,0,0.0,0,0,0.0,0,0,0.0,5,1,6,0,3,0,0,0,0,3
../kbl_data/2023-2024,S43G01N55,고양 소노,Home,치나누 오누아쿠,22,7,14,50.0,2,3,66.7,9,17,52.9,2,4,50.0,5,7,12,6,2,1,0,2,3,3
../kbl_data/2023-2024,S43G01N55,고양 소노,Home,이정현,30,2,8,25.0,6,11,54.5,8,19,42.1,8,9,88.9,1,2,3,6,2,0,1,0,2,3
../kbl_data/2023-2024,S43G01N55,고양 소노,Home,백지웅,0,0,0,0.0,0,0,0.0,0,0,0.0,0,0,0.0,0,0,0,0,0,0,0,0,0,0
../kbl_data/2023-2024,S43G01N55,고양 소노,Home,안정욱,0,0,0,0.0,0,0,0.0,0,0,0.0,0,0,0.0,0,0,0,0,0,0,0,0,0,0
../kbl_data/2023-2024,S43G01N55,고양 소노,Home,조쉬 토랄바,0,0,0,0.0,0,0,0.0,0,0,0.0,0,0,0.0,0,0,0,0,0,0,0,0,0,1
../kbl_data/2023-2024,S43G01N55,고양 소노,Home,디욘테 데이비스,0,0,0,0.0,0,0,0.0,0,0,0.0,0,0,0.0,0,1,1,0,0,0,0,0,0,0
../kbl_data/2023-2024,S43G01N55,원주 DB,Away,김현호,0,0,0,0.0,0,0,0.0,0,0,0.0,0,0,0.0,0,0,0,0,0,0,0,0,1,0
../kbl_data/2023-2024,S43G01N55,원주 DB,Away,서민수,0,0,0,0.0,0,0,0.0,0,0,0.0,0,0,0.0,0,0,0,0,0,0,0,0,0,0
../kbl_data/2023-2024,S43G01N55,원주 DB,Away,김영현,5,1,1,100.0,1,3,33.3,2,4,50.0,0,0,0.0,0,1,1,1,0,0,0,0,0,1
../kbl_data/2023-2024,S43G01N55,원주 DB,Away,김종규,16,7,9,77.8,0,0,0.0,7,9,77.8,2,3,66.7,3,5,8,2,1,1,1,3,1,3
../kbl_data/2023-2024,S43G01N55,원주 DB,Away,최승욱,0,0,1,0.0,0,0,0.0,0,1,0.0,0,0,0.0,0,0,0,1,0,0,0,0,1,3
../kbl_data/2023-2024,S43G01N55,원주 DB,Away,강상재,17,3,4,75.0,3,4,75.0,6,8,75.0,2,2,100.0,2,0,2,0,0,0,0,0,5,4
../kbl_data/2023-2024,S43G01N55,원주 DB,Away,디드릭 로슨,29,6,9,66.7,3,6,50.0,9,15,60.0,8,8,100.0,1,13,14,6,1,0,0,0,5,3
../kbl_data/2023-2024,S43G01N55,원주 DB,Away,이용우,0,0,0,0.0,0,0,0.0,0,0,0.0,0,0,0.0,0,0,0,0,0,0,0,0,0,0
../kbl_data/2023-2024,S43G01N55,원주 DB,Away,이선 알바노,13,3,8,37.5,1,2,50.0,4,10,40.0,4,4,100.0,3,2,5,11,2,0,0,0,4,3
../kbl_data/2023-2024,S43G01N55,원주 DB,Away,박인웅,11,1,1,100.0,3,3,100.0,4,4,100.0,0,0,0.0,0,1,1,0,2,0,0,0,0,1
../kbl_data/2023-2024,S43G01N55,원주 DB,Away,박승재,6,3,3,100.0,0,2,0.0,3,5,60.0,0,0,0.0,0,0,0,1,0,0,0,0,0,0
../kbl_data/2023-2024,S43G01N55,원주 DB,Away,제프 위디,2,0,1,0.0,0,0,0.0,0,1,0.0,2,2,100.0,1,0,1,0,0,0,0,0,0,0
../kbl_data/2023-2024,S43G01N56,서울 SK,Home,허일영,8,1,2,50.0,2,4,50.0,3,6,50.0,0,0,0.0,0,2,2,1,0,0,0,0,0,1
../kbl_data/2023-2024,S43G01N56,서울 SK,Home,송창용,0,0,0,0.0,0,1,0.0,0,1,0.0,0,0,0.0,1,2,3,0,1,0,1,0,0,0
../kbl_data/2023-2024,S43G01N56,서울 SK,Home,김선형,8,4,10,40.0,0,3,0.0,4,13,30.8,0,0,0.0,1,1,2,7,2,1,0,0,2,1
../kbl_data/2023-2024,S43G01N56,서울 SK,Home,홍경기,0,0,0,0.0,0,0,0.0,0,0,0.0,0,0,0.0,0,0,0,0,0,0,0,0,0,0
../kbl_data/2023-2024,S43G01N56,서울 SK,Home,오세근,15,7,12,58.3,0,3,0.0,7,15,46.7,1,1,100.0,4,4,8,2,1,1,0,0,2,2
../kbl_data/2023-2024,S43G01N56,서울 SK,Home,최부경,8,4,6,66.7,0,0,0.0,4,6,66.7,0,0,0.0,0,1,1,0,0,0,0,0,0,4
../kbl_data/2023-2024,S43G01N56,서울 SK,Home,리온 윌리엄스,0,0,0,0.0,0,0,0.0,0,0,0.0,0,0,0.0,0,0,0,0,0,0,0,0,0,0
../kbl_data/2023-2024,S43G01N56,서울 SK,Home,최원혁,6,0,0,0.0,2,2,100.0,2,2,100.0,0,0,0.0,1,1,2,0,0,0,0,0,0,4
../kbl_data/2023-2024,S43G01N56,서울 SK,Home,안영준,2,1,1,100.0,0,3,0.0,1,4,25.0,0,0,0.0,0,0,0,0,0,0,0,0,1,4
../kbl_data/2023-2024,S43G01N56,서울 SK,Home,자밀 워니,31,15,27,55.6,0,1,0.0,15,28,53.6,1,2,50.0,6,10,16,7,2,3,1,3,1,2
../kbl_data/2023-2024,S43G01N56,서울 SK,Home,김형빈,0,0,0,0.0,0,0,0.0,0,0,0.0,0,0,0.0,0,0,0,0,0,0,0,0,0,0
../kbl_data/2023-2024,S43G01N56,서울 SK,Home,오재현,4,1,2,50.0,0,0,0.0,1,2,50.0,2,2,100.0,2,0,2,4,2,0,0,0,1,2
../kbl_data/2023-2024,S43G01N56,서울 삼성,Away,이정현,21,3,5,60.0,5,10,50.0,8,15,53.3,0,0,0.0,1,6,7,5,0,0,0,0,2,1
../kbl_data/2023-2024,S43G01N56,서울 삼성,Away,김시래,10,2,3,66.7,2,5,40.0,4,8,50.0,0,0,0.0,2,3,5,1,1,0,0,0,0,5
../kbl_data/2023-2024,S43G01N56,서울 삼성,Away,이동엽,9,2,2,100.0,1,3,33.3,3,5,60.0,2,2,100.0,1,0,1,1,0,0,0,0,0,0
../kbl_data/2023-2024,S43G01N56,서울 삼성,Away,김광철,0,0,0,0.0,0,0,0.0,0,0,0.0,0,0,0.0,0,0,0,0,0,0,0,0,0,0
../kbl_data/2023-2024,S43G01N56,서울 삼성,Away,최승욱,4,0,4,0.0,1,2,50.0,1,6,16.7,1,2,50.0,3,3,6,3,0,1,1,0,1,1
../kbl_data/2023-2024,S43G01N56,서울 삼성,Away,윤성원,0,0,0,0.0,0,0,0.0,0,0,0.0,0,0,0.0,0,0,0,0,0,0,0,0,0,0
../kbl_data/2023-2024,S43G01N56,서울 삼성,Away,김진영,0,0,0,0.0,0,0,0.0,0,0,0.0,0,0,0.0,0,0,0,0,0,0,0,0,0,0
../kbl_data/2023-2024,S43G01N56,서울 삼성,Away,조우성,2,1,2,50.0,0,0,0.0,1,2,50.0,0,1,0.0,1,2,3,0,0,0,0,0,0,3
../kbl_data/2023-2024,S43G01N56,서울 삼성,Away,이원석,10,2,8,25.0,0,3,0.0,2,11,18.2,6,6,100.0,2,1,3,3,1,2,1,0,2,3
../kbl_data/2023-2024,S43G01N56,서울 삼성,Away,아반 나바,2,1,1,100.0,0,0,0.0,1,1,100.0,0,0,0.0,0,0,0,0,0,0,0,0,1,0
../kbl_data/2023-2024,S43G01N56,서울 삼성,Away,이스마엘 레인,1,0,2,0.0,0,0,0.0,0,2,0.0,1,2,50.0,0,1,1,0,0,0,0,0,0,0
../kbl_data/2023-2024,S43G01N56,서울 삼성,Away,코피 코번,16,7,14,50.0,0,0,0.0,7,14,50.0,2,6,33.3,5,8,13,4,0,0,0,1,5,2
../kbl_data/2023-2024,S43G01N57,수원 KT,Home,한희원,8,1,7,14.3,2,8,25.0,3,15,20.0,0,0,0.0,2,1,3,0,0,0,1,0,1,2
../kbl_data/2023-2024,S43G01N57,수원 KT,Home,최창진,4,2,2,100.0,0,1,0.0,2,3,66.7,0,0,0.0,0,1,1,0,1,1,0,0,1,0
../kbl_data/2023-2024,S43G01N57,수원 KT,Home,문성곤,2,1,1,100.0,0,2,0.0,1,3,33.3,0,0,0.0,1,0,1,1,0,0,0,0,1,4
../kbl_data/2023-2024,S43G01N57,수원 KT,Home,이현석,0,0,0,0.0,0,0,0.0,0,0,0.0,0,0,0.0,0,0,0,0,0,0,0,0,0,1
../kbl_data/2023-2024,S43G01N57,수원 KT,Home,정성우,0,0,2,0.0,0,2,0.0,0,4,0.0,0,0,0.0,0,0,0,5,2,0,1,0,1,5
../kbl_data/2023-2024,S43G01N57,수원 KT,Home,허훈,4,2,5,40.0,0,3,0.0,2,8,25.0,0,0,0.0,0,0,0,5,1,0,0,0,1,0
../kbl_data/2023-2024,S43G01N57,수원 KT,Home,박준영,2,1,4,25.0,0,0,0.0,1,4,25.0,0,0,0.0,0,0,0,0,1,0,0,0,0,0
../kbl_data/2023-2024,S43G01N57,수원 KT,Home,이두원,8,4,13,30.8,0,0,0.0,4,13,30.8,0,0,0.0,6,2,8,0,1,0,0,1,1,3
../kbl_data/2023-2024,S43G01N57,수원 KT,Home,숀 데이브 일데폰소,9,3,4,75.0,1,4,25.0,4,8,50.0,0,0,0.0,1,2,3,5,0,0,0,0,2,0
../kbl_data/2023-2024,S43G01N57,수원 KT,Home,문정현,0,0,0,0.0,0,2,0.0,0,2,0.0,0,0,0.0,0,0,0,0,0,0,0,0,0,0
../kbl_data/2023-2024,S43G01N57,수원 KT,Home,마이클 에릭,10,5,6,83.3,0,0,0.0,5,6,83.3,0,0,0.0,2,2,4,1,1,1,0,3,1,0
../kbl_data/2023-2024,S43G01N57,수원 KT,Home,패리스 배스,24,5,12,41.7,4,6,66.7,9,18,50.0,2,2,100.0,3,6,9,1,0,1,0,3,2,4
../kbl_data/2023-2024,S43G01N57,원주 DB,Away,김현호,0,0,0,0.0,0,0,0.0,0,0,0.0,0,0,0.0,0,0,0,1,0,0,0,0,1,0
../kbl_data/2023-2024,S43G01N57,원주 DB,Away,서민수,0,0,2,0.0,0,2,0.0,0,4,0.0,0,0,0.0,2,1,3,0,0,0,0,0,1,3
../kbl_data/2023-2024,S43G01N57,원주 DB,Away,김영현,0,0,0,0.0,0,1,0.0,0,1,0.0,0,0,0.0,0,2,2,0,0,0,0,0,0,2
../kbl_data/2023-2024,S43G01N57,원주 DB,Away,김종규,16,5,8,62.5,0,0,0.0,5,8,62.5,6,6,100.0,2,4,6,1,1,2,0,1,3,4
../kbl_data/2023-2024,S43G01N57,원주 DB,Away,최승욱,4,1,2,50.0,0,2,0.0,1,4,25.0,2,2,100.0,2,1,3,2,1,2,0,0,1,1
../kbl_data/2023-2024,S43G01N57,원주 DB,Away,강상재,16,5,6,83.3,2,4,50.0,7,10,70.0,0,0,0.0,3,8,11,3,0,0,0,0,2,0
../kbl_data/2023-2024,S43G01N57,원주 DB,Away,디드릭 로슨,27,7,13,53.8,2,4,50.0,9,17,52.9,7,7,100.0,2,6,8,2,1,3,0,1,2,0
../kbl_data/2023-2024,S43G01N57,원주 DB,Away,이용우,2,1,1,100.0,0,1,0.0,1,2,50.0,0,0,0.0,1,0,1,0,0,0,0,0,0,0
../kbl_data/2023-2024,S43G01N57,원주 DB,Away,이선 알바노,8,3,5,60.0,0,3,0.0,3,8,37.5,2,2,100.0,0,1,1,7,2,0,0,0,0,1
../kbl_data/2023-2024,S43G01N57,원주 DB,Away,박인웅,2,1,2,50.0,0,1,0.0,1,3,33.3,0,0,0.0,2,1,3,2,0,0,0,0,1,0
../kbl_data/2023-2024,S43G01N57,원주 DB,Away,박승재,5,1,4,25.0,1,2,50.0,2,6,33.3,0,0,0.0,0,1,1,1,1,0,0,0,1,0
../kbl_data/2023-2024,S43G01N57,원주 DB,Away,제프 위디,7,2,4,50.0,0,1,0.0,2,5,40.0,3,4,75.0,1,7,8,0,3,2,0,1,3,0
../kbl_data/2023-2024,S43G01N58,대구 한국가스공사,Home,김동량,1,0,0,0.0,0,0,0.0,0,0,0.0,1,4,25.0,0,0,0,0,0,0,0,0,0,0
../kbl_data/2023-2024,S43G01N58,대구 한국가스공사,Home,차바위,5,1,1,100.0,1,1,100.0,2,2,100.0,0,0,0.0,2,0,2,1,1,0,0,0,1,0
../kbl_data/2023-2024,S43G01N58,대구 한국가스공사,Home,박지훈,54,20,34,58.8,4,8,50.0,24,42,57.1,2,2,100.0,4,8,12,4,0,0,0,0,2,4
../kbl_data/2023-2024,S43G01N58,대구 한국가스공사,Home,이대헌,23,9,12,75.0,1,1,100.0,10,13,76.9,2,4,50.0,1,4,5,6,2,0,1,0,1,2
../kbl_data/2023-2024,S43G01N58,대구 한국가스공사,Home,박봉진,3,0,0,0.0,1,4,25.0,1,4,25.0,0,0,0.0,1,2,3,0,1,0,0,0,0,5
../kbl_data/2023-2024,S43G01N58,대구 한국가스공사,Home,김낙현,2,1,1,100.0,0,0,0.0,1,1,100.0,0,0,0.0,0,0,0,4,0,0,0,0,0,1
../kbl_data/2023-2024,S43G01N58,대구 한국가스공사,Home,양준우,0,0,0,0.0,0,0,0.0,0,0,0.0,0,0,0.0,0,0,0,1,0,0,0,0,0,0
../kbl_data/2023-2024,S43G01N58,대구 한국가스공사,Home,앤드류 니콜슨,27,9,13,69.2,3,7,42.9,12,20,60.0,0,1,0.0,2,4,6,1,1,0,0,1,0,2
../kbl_data/2023-2024,S43G01N58,대구 한국가스공사,Home,신승민,14,2,3,66.7,3,7,42.9,5,10,50.0,1,2,50.0,1,3,4,4,1,0,1,0,1,4
../kbl_data/2023-2024,S43G01N58,대구 한국가스공사,Home,샘조세프 벨란겔,11,4,8,50.0,1,3,33.3,5,11,45.5,0,0,0.0,0,3,3,6,0,0,1,0,0,4
../kbl_data/2023-2024,S43G01N58,대구 한국가스공사,Home,앤쏘니 모스,5,1,5,20.0,0,0,0.0,1,5,20.0,3,4,75.0,0,0,0,0,0,0,0,0,1,1
../kbl_data/2023-2024,S43G01N58,대구 한국가스공사,Home,신주영,0,0,0,0.0,0,0,0.0,0,0,0.0,0,0,0.0,0,1,1,0,0,0,0,0,1,0
../kbl_data/2023-2024,S43G01N58,안양 정관장,Away,정준원,3,0,1,0.0,1,2,50.0,1,3,33.3,0,0,0.0,0,0,0,0,0,0,0,0,0,1
../kbl_data/2023-2024,S43G01N58,안양 정관장,Away,정효근,5,1,2,50.0,1,5,20.0,2,7,28.6,0,0,0.0,0,6,6,3,0,0,0,0,3,4
../kbl_data/2023-2024,S43G01N58,안양 정관장,Away,이종현,18,5,5,100.0,0,1,0.0,5,6,83.3,8,8,100.0,1,4,5,1,1,0,0,0,1,3
../kbl_data/2023-2024,S43G01N58,안양 정관장,Away,김철욱,0,0,0,0.0,0,0,0.0,0,0,0.0,0,0,0.0,0,0,0,0,0,0,0,0,0,0
../kbl_data/2023-2024,S43G01N58,안양 정관장,Away,박지훈,54,20,34,58.8,4,8,50.0,24,42,57.1,2,2,100.0,4,8,12,4,0,0,0,0,2,4
../kbl_data/2023-2024,S43G01N58,안양 정관장,Away,최성원,20,1,2,50.0,6,10,60.0,7,12,58.3,0,0,0.0,0,0,0,10,0,0,0,0,2,2
../kbl_data/2023-2024,S43G01N58,안양 정관장,Away,대릴 먼로,10,1,4,25.0,2,4,50.0,3,8,37.5,2,2,100.0,1,8,9,7,0,0,0,0,2,3
../kbl_data/2023-2024,S43G01N58,안양 정관장,Away,장태빈,0,0,0,0.0,0,0,0.0,0,0,0.0,0,0,0.0,0,0,0,0,0,0,0,0,0,0
../kbl_data/2023-2024,S43G01N58,안양 정관장,Away,김경원,4,2,2,100.0,0,0,0.0,2,2,100.0,0,0,0.0,1,1,2,1,0,0,0,0,1,2
../kbl_data/2023-2024,S43G01N58,안양 정관장,Away,렌즈 아반도,9,3,4,75.0,1,1,100.0,4,5,80.0,0,1,0.0,0,1,1,1,1,2,0,1,1,2
../kbl_data/2023-2024,S43G01N58,안양 정관장,Away,고찬혁,0,0,0,0.0,0,0,0.0,0,0,0.0,0,0,0.0,0,0,0,0,0,0,0,0,0,0
../kbl_data/2023-2024,S43G01N58,안양 정관장,Away,듀반 맥스웰,4,2,2,100.0,0,0,0.0,2,2,100.0,0,2,0.0,1,0,1,2,0,2,0,0,0,2
../kbl_data/2023-2024,S43G01N59,창원 LG,Home,이관희,17,1,3,33.3,5,6,83.3,6,9,66.7,0,0,0.0,0,1,1,0,0,0,0,0,0,1
../kbl_data/2023-2024,S43G01N59,창원 LG,Home,정희재,6,0,0,0.0,2,3,66.7,2,3,66.7,0,0,0.0,1,1,2,2,0,0,0,0,0,3
../kbl_data/2023-2024,S43G01N59,창원 LG,Home,임동섭,3,0,0,0.0,0,2,0.0,0,2,0.0,3,3,100.0,0,0,0,0,0,0,0,0,0,1
../kbl_data/2023-2024,S43G01N59,창원 LG,Home,이재도,3,0,1,0.0,0,2,0.0,0,3,0.0,3,3,100.0,1,1,2,5,0,0,0,0,2,0
../kbl_data/2023-2024,S43G01N59,창원 LG,Home,정인덕,6,0,0,0.0,2,2,100.0,2,2,100.0,0,0,0.0,0,0,0,2,0,0,0,0,0,2
../kbl_data/2023-2024,S43G01N59,창원 LG,Home,양홍석,6,3,7,42.9,0,3,0.0,3,10,30.0,0,0,0.0,3,2,5,5,2,0,0,0,3,3
../kbl_data/2023-2024,S43G01N59,창원 LG,Home,윤원상,2,1,2,50.0,0,1,0.0,1,3,33.3,0,0,0.0,0,3,3,0,0,0,0,0,0,3
../kbl_data/2023-2024,S43G01N59,창원 LG,Home,아셈 마레이,21,9,13,69.2,0,0,0.0,9,13,69.2,3,4,75.0,4,8,12,6,0,0,0,0,0,2
../kbl_data/2023-2024,S43G01N59,창원 LG,Home,저스틴 구탕,12,2,7,28.6,2,2,100.0,4,9,44.4,2,2,100.0,3,5,8,1,0,0,0,0,2,1
../kbl_data/2023-2024,S43G01N59,창원 LG,Home,양준석,9,3,5,60.0,1,1,100.0,4,6,66.7,0,0,0.0,0,0,0,2,1,0,0,0,2,1
../kbl_data/2023-2024,S43G01N59,창원 LG,Home,단테 커닝햄,6,2,8,25.0,0,0,0.0,2,8,25.0,2,2,100.0,1,3,4,0,3,0,0,1,2,2
../kbl_data/2023-2024,S43G01N59,창원 LG,Home,유기상,6,0,1,0.0,2,5,40.0,2,6,33.3,0,0,0.0,1,1,2,0,1,0,0,0,0,0
../kbl_data/2023-2024,S43G01N59,울산 현대모비스,Away,함지훈,7,2,6,33.3,1,2,50.0,3,8,37.5,0,0,0.0,3,2,5,2,0,0,0,0,1,0
../kbl_data/2023-2024,S43G01N59,울산 현대모비스,Away,김현민,4,2,2,100.0,0,0,0.0,2,2,100.0,0,0,0.0,0,1,1,0,0,0,0,0,1,2
../kbl_data/2023-2024,S43G01N59,울산 현대모비스,Away,최진수,1,0,1,0.0,0,1,0.0,0,2,0.0,1,2,50.0,0,0,0,0,2,1,0,0,0,1
../kbl_data/2023-2024,S43G01N59,울산 현대모비스,Away,김현수,7,2,3,66.7,1,2,50.0,3,5,60.0,0,0,0.0,1,1,2,0,0,0,1,0,0,0
../kbl_data/2023-2024,S43G01N59,울산 현대모비스,Away,장재석,12,6,11,54.5,0,0,0.0,6,11,54.5,0,1,0.0,0,0,0,1,0,0,0,1,0,3
../kbl_data/2023-2024,S43G01N59,울산 현대모비스,Away,김지완,5,1,1,100.0,1,1,100.0,2,2,100.0,0,0,0.0,0,1,1,3,0,0,0,0,2,3
../kbl_data/2023-2024,S43G01N59,울산 현대모비스,Away,김국찬,5,1,5,20.0,0,3,0.0,1,8,12.5,3,3,100.0,0,2,2,0,2,0,0,0,2,3
../kbl_data/2023-2024,S43G01N59,울산 현대모비스,Away,이우석,9,3,4,75.0,1,2,50.0,4,6,66.7,0,0,0.0,1,1,2,2,0,0,0,0,0,1
../kbl_data/2023-2024,S43G01N59,울산 현대모비스,Away,신민석,0,0,0,0.0,0,0,0.0,0,0,0.0,0,0,0.0,0,0,0,0,0,0,0,0,0,1
../kbl_data/2023-2024,S43G01N59,울산 현대모비스,Away,게이지 프림,9,3,6,50.0,0,0,0.0,3,6,50.0,3,4,75.0,1,4,5,0,0,1,0,0,2,2
../kbl_data/2023-2024,S43G01N59,울산 현대모비스,Away,김태완,5,1,2,50.0,1,1,100.0,2,3,66.7,0,0,0.0,0,0,0,1,0,0,0,0,3,1
../kbl_data/2023-2024,S43G01N59,울산 현대모비스,Away,케베 알루마,12,2,4,50.0,1,6,16.7,3,10,30.0,5,6,83.3,1,9,10,5,1,1,0,0,3,1
../kbl_data/2023-2024,S43G01N60,서울 삼성,Home,이정현,9,3,5,60.0,0,4,0.0,3,9,33.3,3,6,50.0,0,4,4,8,2,0,0,0,2,4
../kbl_data/2023-2024,S43G01N60,서울 삼성,Home,김승원,0,0,0,0.0,0,0,0.0,0,0,0.0,0,0,0.0,0,3,3,2,0,0,0,0,0,1
../kbl_data/2023-2024,S43G01N60,서울 삼성,Home,김시래,15,3,5,60.0,1,3,33.3,4,8,50.0,6,6,100.0,0,5,5,6,1,0,1,0,3,3
../kbl_data/2023-2024,S43G01N60,서울 삼성,Home,이동엽,2,1,3,33.3,0,3,0.0,1,6,16.7,0,0,0.0,0,1,1,1,0,0,0,0,3,1
../kbl_data/2023-2024,S43G01N60,서울 삼성,Home,김광철,3,0,0,0.0,1,1,100.0,1,1,100.0,0,0,0.0,0,0,0,0,0,0,0,0,1,1
../kbl_data/2023-2024,S43G01N60,서울 삼성,Home,최승욱,6,3,3,100.0,0,0,0.0,3,3,100.0,0,0,0.0,1,8,9,2,1,2,0,0,0,2
../kbl_data/2023-2024,S43G01N60,서울 삼성,Home,윤성원,0,0,0,0.0,0,0,0.0,0,0,0.0,0,0,0.0,0,0,0,0,0,0,0,0,0,0
../kbl_data/2023-2024,S43G01N60,서울 삼성,Home,김진영,0,0,0,0.0,0,0,0.0,0,0,0.0,0,0,0.0,0,0,0,0,0,0,0,0,0,0
../kbl_data/2023-2024,S43G01N60,서울 삼성,Home,이원석,9,3,7,42.9,0,1,0.0,3,8,37.5,3,6,50.0,3,5,8,1,0,0,1,0,2,2
../kbl_data/2023-2024,S43G01N60,서울 삼성,Home,아반 나바,4,2,3,66.7,0,3,0.0,2,6,33.3,0,1,0.0,1,0,1,1,1,0,0,0,0,1
../kbl_data/2023-2024,S43G01N60,서울 삼성,Home,이스마엘 레인,19,9,15,60.0,0,0,0.0,9,15,60.0,1,2,50.0,3,4,7,0,0,0,0,2,1,2
../kbl_data/2023-2024,S43G01N60,서울 삼성,Home,코피 코번,17,8,14,57.1,0,0,0.0,8,14,57.1,1,2,50.0,5,6,11,0,0,0,0,0,3,3
../kbl_data/2023-2024,S43G01N60,대구 한국가스공사,Away,차바위,0,0,0,0.0,0,2,0.0,0,2,0.0,0,0,0.0,2,1,3,0,1,1,0,0,3,3
../kbl_data/2023-2024,S43G01N60,대구 한국가스공사,Away,박지훈,0,0,1,0.0,0,0,0.0,0,1,0.0,0,0,0.0,0,0,0,1,1,0,0,0,0,0
../kbl_data/2023-2024,S43G01N60,대구 한국가스공사,Away,조상열,5,0,0,0.0,1,3,33.3,1,3,33.3,2,2,100.0,1,1,2,1,0,0,0,0,0,0
../kbl_data/2023-2024,S43G01N60,대구 한국가스공사,Away,이대헌,27,11,16,68.8,1,2,50.0,12,18,66.7,2,4,50.0,2,2,4,0,2,0,0,0,1,2
../kbl_data/2023-2024,S43G01N60,대구 한국가스공사,Away,김낙현,0,0,2,0.0,0,1,0.0,0,3,0.0,0,0,0.0,0,0,0,0,0,0,0,0,0,1
../kbl_data/2023-2024,S43G01N60,대구 한국가스공사,Away,양재혁,0,0,2,0.0,0,0,0.0,0,2,0.0,0,0,0.0,1,1,2,0,3,0,1,0,0,2
../kbl_data/2023-2024,S43G01N60,대구 한국가스공사,Away,양준우,1,0,1,0.0,0,0,0.0,0,1,0.0,1,2,50.0,0,1,1,1,0,0,0,0,1,2
../kbl_data/2023-2024,S43G01N60,대구 한국가스공사,Away,앤드류 니콜슨,4,2,6,33.3,0,3,0.0,2,9,22.2,0,0,0.0,1,1,2,0,0,1,0,0,0,5
../kbl_data/2023-2024,S43G01N60,대구 한국가스공사,Away,신승민,2,1,6,16.7,0,3,0.0,1,9,11.1,0,0,0.0,1,6,7,0,2,0,0,0,1,3
../kbl_data/2023-2024,S43G01N60,대구 한국가스공사,Away,샘조세프 벨란겔,18,5,10,50.0,1,6,16.7,6,16,37.5,5,6,83.3,0,4,4,3,2,0,1,0,1,2
../kbl_data/2023-2024,S43G01N60,대구 한국가스공사,Away,앤쏘니 모스,0,0,2,0.0,0,0,0.0,0,2,0.0,0,0,0.0,1,6,7,1,1,0,0,0,2,5
../kbl_data/2023-2024,S43G01N60,대구 한국가스공사,Away,신주영,6,3,5,60.0,0,1,0.0,3,6,50.0,0,0,0.0,1,2,3,0,0,0,0,0,1,4
../kbl_data/2023-2024,S43G01N61,안양 정관장,Home,정준원,8,3,3,100.0,0,1,0.0,3,4,75.0,2,2,100.0,1,1,2,0,0,0,0,0,0,3
../kbl_data/2023-2024,S43G01N61,안양 정관장,Home,정효근,11,1,4,25.0,2,5,40.0,3,9,33.3,3,6,50.0,3,3,6,0,0,0,0,0,1,1
../kbl_data/2023-2024,S43G01N61,안양 정관장,Home,이종현,7,1,3,33.3,1,1,100.0,2,4,50.0,2,2,100.0,0,5,5,0,0,1,0,0,1,1
../kbl_data/2023-2024,S43G01N61,안양 정관장,Home,김철욱,0,0,1,0.0,0,0,0.0,0,1,0.0,0,0,0.0,0,0,0,0,0,0,0,0,0,0
../kbl_data/2023-2024,S43G01N61,안양 정관장,Home,박지훈,8,1,3,33.3,2,3,66.7,3,6,50.0,0,0,0.0,1,3,4,2,0,0,1,0,4,1
../kbl_data/2023-2024,S43G01N61,안양 정관장,Home,최성원,7,2,4,50.0,1,7,14.3,3,11,27.3,0,2,0.0,0,0,0,8,3,0,1,0,2,2
../kbl_data/2023-2024,S43G01N61,안양 정관장,Home,대릴 먼로,18,5,7,71.4,2,3,66.7,7,10,70.0,2,2,100.0,3,4,7,5,2,0,0,0,1,1
../kbl_data/2023-2024,S43G01N61,안양 정관장,Home,장태빈,4,2,2,100.0,0,1,0.0,2,3,66.7,0,0,0.0,0,1,1,1,1,0,0,0,0,2
../kbl_data/2023-2024,S43G01N61,안양 정관장,Home,김경원,3,1,2,50.0,0,1,0.0,1,3,33.3,1,2,50.0,2,0,2,0,0,2,0,0,0,0
../kbl_data/2023-2024,S43G01N61,안양 정관장,Home,렌즈 아반도,13,5,11,45.5,0,3,0.0,5,14,35.7,3,4,75.0,4,1,5,0,1,0,0,0,0,1
../kbl_data/2023-2024,S43G01N61,안양 정관장,Home,고찬혁,6,0,1,0.0,1,3,33.3,1,4,25.0,3,3,100.0,0,0,0,0,0,0,1,0,0,2
../kbl_data/2023-2024,S43G01N61,안양 정관장,Home,나성호,0,0,0,0.0,0,0,0.0,0,0,0.0,0,0,0.0,0,0,0,0,0,0,0,0,0,0
../kbl_data/2023-2024,S43G01N61,수원 KT,Away,한희원,14,1,2,50.0,4,7,57.1,5,9,55.6,0,0,0.0,0,4,4,2,2,0,0,0,1,2
../kbl_data/2023-2024,S43G01N61,수원 KT,Away,최창진,2,1,1,100.0,0,1,0.0,1,2,50.0,0,0,0.0,1,2,3,7,0,0,0,0,0,1
../kbl_data/2023-2024,S43G01N61,수원 KT,Away,문성곤,2,1,1,100.0,0,3,0.0,1,4,25.0,0,0,0.0,4,4,8,6,0,1,0,0,2,4
../kbl_data/2023-2024,S43G01N61,수원 KT,Away,이현석,0,0,0,0.0,0,0,0.0,0,0,0.0,0,0,0.0,0,1,1,0,0,0,0,0,0,0
../kbl_data/2023-2024,S43G01N61,수원 KT,Away,정성우,5,0,1,0.0,1,1,100.0,1,2,50.0,2,2,100.0,2,1,3,3,1,0,0,0,0,1
../kbl_data/2023-2024,S43G01N61,수원 KT,Away,최성모,2,1,1,100.0,0,0,0.0,1,1,100.0,0,0,0.0,0,0,0,0,0,0,0,0,0,1
../kbl_data/2023-2024,S43G01N61,수원 KT,Away,허훈,19,2,3,66.7,5,11,45.5,7,14,50.0,0,0,0.0,0,1,1,4,0,0,0,0,2,2
../kbl_data/2023-2024,S43G01N61,수원 KT,Away,이두원,8,4,6,66.7,0,0,0.0,4,6,66.7,0,0,0.0,1,2,3,0,0,1,0,0,0,3
../kbl_data/2023-2024,S43G01N61,수원 KT,Away,숀 데이브 일데폰소,7,3,3,100.0,0,3,0.0,3,6,50.0,1,2,50.0,0,1,1,1,0,0,0,0,1,1
../kbl_data/2023-2024,S43G01N61,수원 KT,Away,문정현,3,0,1,0.0,1,2,50.0,1,3,33.3,0,0,0.0,1,3,4,3,0,0,0,0,1,1
../kbl_data/2023-2024,S43G01N61,수원 KT,Away,마이클 에릭,15,7,8,87.5,0,0,0.0,7,8,87.5,1,1,100.0,1,2,3,0,0,0,0,2,1,3
../kbl_data/2023-2024,S43G01N61,수원 KT,Away,패리스 배스,17,7,12,58.3,1,4,25.0,8,16,50.0,0,1,0.0,1,7,8,1,2,1,0,2,4,3
../kbl_data/2023-2024,S43G01N62,서울 SK,Home,허일영,2,1,3,33.3,0,2,0.0,1,5,20.0,0,0,0.0,0,1,1,0,0,0,0,0,2,1
../kbl_data/2023-2024,S43G01N62,서울 SK,Home,송창용,0,0,0,0.0,0,0,0.0,0,0,0.0,0,0,0.0,0,0,0,0,0,0,0,0,0,0
../kbl_data/2023-2024,S43G01N62,서울 SK,Home,김선형,4,1,3,33.3,0,5,0.0,1,8,12.5,2,2,100.0,1,0,1,2,0,0,0,0,1,2
../kbl_data/2023-2024,S43G01N62,서울 SK,Home,홍경기,0,0,0,0.0,0,0,0.0,0,0,0.0,0,0,0.0,0,0,0,0,0,0,0,0,0,0
../kbl_data/2023-2024,S43G01N62,서울 SK,Home,오세근,8,2,3,66.7,1,3,33.3,3,6,50.0,1,2,50.0,1,6,7,2,1,0,0,0,3,3
../kbl_data/2023-2024,S43G01N62,서울 SK,Home,최부경,4,2,4,50.0,0,0,0.0,2,4,50.0,0,0,0.0,3,3,6,0,0,0,1,0,0,5
../kbl_data/2023-2024,S43G01N62,서울 SK,Home,리온 윌리엄스,0,0,0,0.0,0,0,0.0,0,0,0.0,0,0,0.0,0,0,0,0,0,0,0,0,0,0
../kbl_data/2023-2024,S43G01N62,서울 SK,Home,최원혁,8,0,2,0.0,2,3,66.7,2,5,40.0,2,2,100.0,2,3,5,3,1,0,0,0,0,3
../kbl_data/2023-2024,S43G01N62,서울 SK,Home,안영준,21,8,11,72.7,0,2,0.0,8,13,61.5,5,6,83.3,0,5,5,3,4,0,0,0,5,3
../kbl_data/2023-2024,S43G01N62,서울 SK,Home,자밀 워니,32,13,25,52.0,1,2,50.0,14,27,51.9,3,5,60.0,7,13,20,6,0,1,0,0,1,2
../kbl_data/2023-2024,S43G01N62,서울 SK,Home,김형빈,0,0,0,0.0,0,0,0.0,0,0,0.0,0,0,0.0,0,0,0,0,0,0,0,0,0,0
../kbl_data/2023-2024,S43G01N62,서울 SK,Home,오재현,7,2,4,50.0,1,3,33.3,3,7,42.9,0,0,0.0,0,2,2,2,0,0,0,0,0,4
../kbl_data/2023-2024,S43G01N62,원주 DB,Away,김현호,0,0,0,0.0,0,0,0.0,0,0,0.0,0,0,0.0,0,0,0,0,0,0,0,0,0,1
../kbl_data/2023-2024,S43G01N62,원주 DB,Away,서민수,0,0,0,0.0,0,0,0.0,0,0,0.0,0,0,0.0,0,0,0,0,0,0,0,0,0,2
../kbl_data/2023-2024,S43G01N62,원주 DB,Away,김영현,0,0,0,0.0,0,0,0.0,0,0,0.0,0,0,0.0,0,0,0,0,0,0,0,0,1,1
../kbl_data/2023-2024,S43G01N62,원주 DB,Away,김종규,13,4,6,66.7,0,0,0.0,4,6,66.7,5,6,83.3,2,5,7,0,0,0,0,1,0,2
../kbl_data/2023-2024,S43G01N62,원주 DB,Away,최승욱,2,1,1,100.0,0,2,0.0,1,3,33.3,0,0,0.0,0,0,0,1,4,0,0,0,1,1
../kbl_data/2023-2024,S43G01N62,원주 DB,Away,강상재,11,3,9,33.3,1,6,16.7,4,15,26.7,2,3,66.7,0,4,4,2,0,1,0,0,0,1
../kbl_data/2023-2024,S43G01N62,원주 DB,Away,디드릭 로슨,22,7,14,50.0,2,12,16.7,9,26,34.6,2,4,50.0,6,7,13,11,1,0,0,0,1,2
../kbl_data/2023-2024,S43G01N62,원주 DB,Away,이용우,0,0,0,0.0,0,0,0.0,0,0,0.0,0,0,0.0,0,0,0,0,0,0,0,0,0,0
../kbl_data/2023-2024,S43G01N62,원주 DB,Away,이선 알바노,21,4,8,50.0,3,6,50.0,7,14,50.0,4,5,80.0,1,2,3,6,0,0,0,0,2,4
../kbl_data/2023-2024,S43G01N62,원주 DB,Away,박인웅,11,5,7,71.4,0,4,0.0,5,11,45.5,1,2,50.0,2,4,6,0,2,0,0,0,1,1
../kbl_data/2023-2024,S43G01N62,원주 DB,Away,박승재,0,0,0,0.0,0,0,0.0,0,0,0.0,0,0,0.0,0,0,0,0,0,0,0,0,0,0
../kbl_data/2023-2024,S43G01N62,원주 DB,Away,제프 위디,0,0,0,0.0,0,0,0.0,0,0,0.0,0,0,0.0,0,2,2,0,0,1,0,0,1,2
../kbl_data/2023-2024,S43G01N63,창원 LG,Home,이관희,9,2,5,40.0,1,7,14.3,3,12,25.0,2,2,100.0,0,3,3,0,0,0,0,0,0,2
../kbl_data/2023-2024,S43G01N63,창원 LG,Home,정희재,0,0,0,0.0,0,2,0.0,0,2,0.0,0,0,0.0,0,2,2,0,0,0,0,0,0,1
../kbl_data/2023-2024,S43G01N63,창원 LG,Home,임동섭,3,0,0,0.0,1,1,100.0,1,1,100.0,0,0,0.0,0,2,2,0,0,0,0,0,0,1
../kbl_data/2023-2024,S43G01N63,창원 LG,Home,한상혁,4,2,2,100.0,0,0,0.0,2,2,100.0,0,0,0.0,0,1,1,1,0,0,0,0,0,0
../kbl_data/2023-2024,S43G01N63,창원 LG,Home,이재도,5,1,3,33.3,0,0,0.0,1,3,33.3,3,4,75.0,3,3,6,3,1,1,0,0,3,2
../kbl_data/2023-2024,S43G01N63,창원 LG,Home,정인덕,5,0,1,0.0,1,2,50.0,1,3,33.3,2,2,100.0,0,1,1,0,0,1,0,0,0,0
../kbl_data/2023-2024,S43G01N63,창원 LG,Home,양홍석,19,6,8,75.0,2,4,50.0,8,12,66.7,1,1,100.0,3,7,10,5,0,0,0,0,1,2
../kbl_data/2023-2024,S43G01N63,창원 LG,Home,윤원상,2,0,0,0.0,0,2,0.0,0,2,0.0,2,2,100.0,0,1,1,0,0,0,0,0,0,1
../kbl_data/2023-2024,S43G01N63,창원 LG,Home,아셈 마레이,15,5,13,38.5,0,0,0.0,5,13,38.5,5,8,62.5,5,7,12,4,5,0,0,0,3,1
../kbl_data/2023-2024,S43G01N63,창원 LG,Home,저스틴 구탕,9,4,9,44.4,0,1,0.0,4,10,40.0,1,2,50.0,3,4,7,1,1,0,0,0,2,4
../kbl_data/2023-2024,S43G01N63,창원 LG,Home,양준석,2,1,2,50.0,0,1,0.0,1,3,33.3,0,0,0.0,0,1,1,1,2,0,0,0,1,2
../kbl_data/2023-2024,S43G01N63,창원 LG,Home,유기상,7,2,3,66.7,1,2,50.0,3,5,60.0,0,0,0.0,1,2,3,0,0,1,0,0,0,4
../kbl_data/2023-2024,S43G01N63,고양 소노,Away,김강선,0,0,0,0.0,0,1,0.0,0,1,0.0,0,0,0.0,0,0,0,0,0,0,0,0,0,1
../kbl_data/2023-2024,S43G01N63,고양 소노,Away,함준후,0,0,2,0.0,0,1,0.0,0,3,0.0,0,0,0.0,0,0,0,0,0,0,0,0,1,3
../kbl_data/2023-2024,S43G01N63,고양 소노,Away,최현민,7,0,1,0.0,2,4,50.0,2,5,40.0,1,2,50.0,1,2,3,0,0,0,0,0,0,1
../kbl_data/2023-2024,S43G01N63,고양 소노,Away,김민욱,0,0,0,0.0,0,0,0.0,0,0,0.0,0,0,0.0,0,0,0,0,0,0,0,0,0,0
../kbl_data/2023-2024,S43G01N63,고양 소노,Away,한호빈,6,0,2,0.0,2,6,33.3,2,8,25.0,0,0,0.0,0,2,2,2,2,0,0,0,0,1
../kbl_data/2023-2024,S43G01N63,고양 소노,Away,김진유,0,0,0,0.0,0,3,0.0,0,3,0.0,0,0,0.0,5,4,9,1,1,0,0,0,0,3
../kbl_data/2023-2024,S43G01N63,고양 소노,Away,치나누 오누아쿠,20,9,14,64.3,0,4,0.0,9,18,50.0,2,4,50.0,4,8,12,1,0,0,0,1,3,3
../kbl_data/2023-2024,S43G01N63,고양 소노,Away,이정현,11,1,6,16.7,0,5,0.0,1,11,9.1,9,10,90.0,0,2,2,3,2,0,1,0,3,4
../kbl_data/2023-2024,S43G01N63,고양 소노,Away,백지웅,3,0,1,0.0,1,6,16.7,1,7,14.3,0,0,0.0,1,1,2,0,1,0,0,0,2,3
../kbl_data/2023-2024,S43G01N63,고양 소노,Away,안정욱,0,0,0,0.0,0,1,0.0,0,1,0.0,0,0,0.0,0,0,0,0,0,0,0,0,0,1
../kbl_data/2023-2024,S43G01N63,고양 소노,Away,민기남,0,0,0,0.0,0,2,0.0,0,2,0.0,0,0,0.0,0,0,0,0,0,0,1,0,1,0
../kbl_data/2023-2024,S43G01N63,고양 소노,Away,디욘테 데이비스,2,1,3,33.3,0,3,0.0,1,6,16.7,0,0,0.0,0,2,2,0,0,1,0,0,0,1
../kbl_data/2023-2024,S43G01N64,서울 삼성,Home,이정현,2,1,3,33.3,0,2,0.0,1,5,20.0,0,0,0.0,0,1,1,0,0,0,0,0,0,0
../kbl_data/2023-2024,S43G01N64,서울 삼성,Home,김승원,0,0,0,0.0,0,0,0.0,0,0,0.0,0,0,0.0,0,1,1,0,0,0,0,0,0,2
../kbl_data/2023-2024,S43G01N64,서울 삼성,Home,김시래,10,2,2,100.0,2,4,50.0,4,6,66.7,0,0,0.0,0,1,1,2,2,0,1,0,4,2
../kbl_data/2023-2024,S43G01N64,서울 삼성,Home,이동엽,2,1,5,20.0,0,2,0.0,1,7,14.3,0,0,0.0,0,1,1,2,0,0,0,0,1,3
../kbl_data/2023-2024,S43G01N64,서울 삼성,Home,최승욱,13,3,4,75.0,2,4,50.0,5,8,62.5,1,3,33.3,1,1,2,0,1,0,0,0,1,1
../kbl_data/2023-2024,S43G01N64,서울 삼성,Home,윤성원,4,2,3,66.7,0,1,0.0,2,4,50.0,0,0,0.0,2,2,4,0,0,0,0,0,0,1
../kbl_data/2023-2024,S43G01N64,서울 삼성,Home,김진영,0,0,1,0.0,0,0,0.0,0,1,0.0,0,0,0.0,0,0,0,0,0,0,0,0,0,0
../kbl_data/2023-2024,S43G01N64,서울 삼성,Home,김무성,1,0,2,0.0,0,0,0.0,0,2,0.0,1,2,50.0,0,0,0,0,0,0,0,0,0,2
../kbl_data/2023-2024,S43G01N64,서울 삼성,Home,이원석,9,3,6,50.0,1,6,16.7,4,12,33.3,0,0,0.0,3,3,6,2,2,0,0,0,3,1
../kbl_data/2023-2024,S43G01N64,서울 삼성,Home,아반 나바,7,3,8,37.5,0,1,0.0,3,9,33.3,1,2,50.0,0,0,0,2,1,0,0,0,2,0
../kbl_data/2023-2024,S43G01N64,서울 삼성,Home,이스마엘 레인,8,4,6,66.7,0,0,0.0,4,6,66.7,0,0,0.0,5,6,11,0,1,1,0,1,0,2
../kbl_data/2023-2024,S43G01N64,서울 삼성,Home,코피 코번,10,5,10,50.0,0,0,0.0,5,10,50.0,0,2,0.0,3,3,6,2,0,1,0,0,1,1
../kbl_data/2023-2024,S43G01N64,울산 현대모비스,Away,함지훈,11,4,5,80.0,0,0,0.0,4,5,80.0,3,4,75.0,2,2,4,5,1,1,0,0,0,0
../kbl_data/2023-2024,S43G01N64,울산 현대모비스,Away,김현민,0,0,0,0.0,0,0,0.0,0,0,0.0,0,0,0.0,0,0,0,0,0,0,0,0,0,0
../kbl_data/2023-2024,S43G01N64,울산 현대모비스,Away,최진수,11,3,5,60.0,1,2,50.0,4,7,57.1,2,2,100.0,1,2,3,1,1,1,0,0,0,2
../kbl_data/2023-2024,S43G01N64,울산 현대모비스,Away,김현수,0,0,0,0.0,0,0,0.0,0,0,0.0,0,0,0.0,0,0,0,0,0,0,0,0,0,0
../kbl_data/2023-2024,S43G01N64,울산 현대모비스,Away,장재석,0,0,1,0.0,0,0,0.0,0,1,0.0,0,0,0.0,0,2,2,0,0,0,0,0,1,2
../kbl_data/2023-2024,S43G01N64,울산 현대모비스,Away,김지완,4,2,3,66.7,0,3,0.0,2,6,33.3,0,0,0.0,0,5,5,4,0,0,0,0,1,2
../kbl_data/2023-2024,S43G01N64,울산 현대모비스,Away,김국찬,2,1,2,50.0,0,0,0.0,1,2,50.0,0,0,0.0,1,0,1,2,1,0,0,0,0,2
../kbl_data/2023-2024,S43G01N64,울산 현대모비스,Away,박준은,0,0,0,0.0,0,2,0.0,0,2,0.0,0,0,0.0,0,0,0,0,0,0,0,0,1,1
../kbl_data/2023-2024,S43G01N64,울산 현대모비스,Away,이우석,10,5,10,50.0,0,1,0.0,5,11,45.5,0,0,0.0,0,6,6,4,2,1,0,0,2,1
../kbl_data/2023-2024,S43G01N64,울산 현대모비스,Away,게이지 프림,20,8,13,61.5,1,2,50.0,9,15,60.0,1,1,100.0,3,2,5,1,0,1,0,1,2,1
../kbl_data/2023-2024,S43G01N64,울산 현대모비스,Away,김태완,4,0,2,0.0,1,2,50.0,1,4,25.0,1,1,100.0,1,3,4,1,1,0,0,0,2,2
../kbl_data/2023-2024,S43G01N64,울산 현대모비스,Away,케베 알루마,18,4,8,50.0,2,4,50.0,6,12,50.0,4,6,66.7,3,3,6,0,0,1,0,1,1,2
../kbl_data/2023-2024,S43G01N65,부산 KCC,Home,정창영,8,3,6,50.0,0,3,0.0,3,9,33.3,2,2,100.0,1,3,4,1,0,0,0,0,3,3
../kbl_data/2023-2024,S43G01N65,부산 KCC,Home,라건아,19,5,10,50.0,1,1,100.0,6,11,54.5,6,6,100.0,1,7,8,3,0,0,0,0,1,0
../kbl_data/2023-2024,S43G01N65,부산 KCC,Home,허웅,11,2,4,50.0,1,5,20.0,3,9,33.3,4,4,100.0,0,0,0,1,0,0,0,0,0,0
../kbl_data/2023-2024,S43G01N65,부산 KCC,Home,이승현,2,1,3,33.3,0,0,0.0,1,3,33.3,0,0,0.0,0,2,2,3,1,1,0,0,0,1
../kbl_data/2023-2024,S43G01N65,부산 KCC,Home,이호현,10,2,3,66.7,2,5,40.0,4,8,50.0,0,0,0.0,1,1,2,0,0,0,0,0,0,3
../kbl_data/2023-2024,S43G01N65,부산 KCC,Home,송교창,3,0,1,0.0,1,2,50.0,1,3,33.3,0,0,0.0,2,1,3,1,0,0,0,0,1,1
../kbl_data/2023-2024,S43G01N65,부산 KCC,Home,최준용,11,2,5,40.0,2,3,66.7,4,8,50.0,1,3,33.3,1,4,5,2,1,1,0,0,2,3
../kbl_data/2023-2024,S43G01N65,부산 KCC,Home,이진욱,3,0,0,0.0,1,2,50.0,1,2,50.0,0,0,0.0,0,0,0,1,0,0,0,0,0,1
../kbl_data/2023-2024,S43G01N65,부산 KCC,Home,이근휘,0,0,1,0.0,0,1,0.0,0,2,0.0,0,0,0.0,0,0,0,0,0,0,0,0,1,0
../kbl_data/2023-2024,S43G01N65,부산 KCC,Home,김동현,0,0,0,0.0,0,0,0.0,0,0,0.0,0,0,0.0,0,0,0,0,0,0,0,0,0,0
../kbl_data/2023-2024,S43G01N65,부산 KCC,Home,송동훈,2,0,0,0.0,0,0,0.0,0,0,0.0,2,2,100.0,1,0,1,0,0,0,1,0,0,1
../kbl_data/2023-2024,S43G01N65,부산 KCC,Home,알리제 드숀 존슨,12,5,6,83.3,0,1,0.0,5,7,71.4,2,4,50.0,2,3,5,2,1,0,0,0,1,2
../kbl_data/2023-2024,S43G01N65,대구 한국가스공사,Away,차바위,7,2,2,100.0,1,1,100.0,3,3,100.0,0,0,0.0,1,1,2,3,0,0,0,0,0,3
../kbl_data/2023-2024,S43G01N65,대구 한국가스공사,Away,박지훈,12,3,3,100.0,2,2,100.0,5,5,100.0,0,0,0.0,0,3,3,2,2,0,0,0,1,5
../kbl_data/2023-2024,S43G01N65,대구 한국가스공사,Away,조상열,1,0,1,0.0,0,1,0.0,0,2,0.0,1,1,100.0,1,0,1,0,0,0,0,0,0,0
../kbl_data/2023-2024,S43G01N65,대구 한국가스공사,Away,이대헌,19,9,13,69.2,0,2,0.0,9,15,60.0,1,2,50.0,0,1,1,1,0,1,0,0,1,2
../kbl_data/2023-2024,S43G01N65,대구 한국가스공사,Away,양재혁,0,0,0,0.0,0,0,0.0,0,0,0.0,0,0,0.0,0,0,0,0,0,0,0,0,0,0
../kbl_data/2023-2024,S43G01N65,대구 한국가스공사,Away,양준우,0,0,0,0.0,0,3,0.0,0,3,0.0,0,0,0.0,0,1,1,2,1,0,1,0,0,2
../kbl_data/2023-2024,S43G01N65,대구 한국가스공사,Away,앤드류 니콜슨,25,8,12,66.7,3,6,50.0,11,18,61.1,0,0,0.0,0,11,11,1,0,0,0,0,3,4
../kbl_data/2023-2024,S43G01N65,대구 한국가스공사,Away,신승민,0,0,4,0.0,0,0,0.0,0,4,0.0,0,0,0.0,0,2,2,0,0,0,0,0,1,1
../kbl_data/2023-2024,S43G01N65,대구 한국가스공사,Away,샘조세프 벨란겔,30,5,7,71.4,5,9,55.6,10,16,62.5,5,5,100.0,1,3,4,6,1,0,1,0,0,3
../kbl_data/2023-2024,S43G01N65,대구 한국가스공사,Away,안세영,0,0,1,0.0,0,0,0.0,0,1,0.0,0,0,0.0,0,0,0,0,0,0,0,0,0,0
../kbl_data/2023-2024,S43G01N65,대구 한국가스공사,Away,앤쏘니 모스,2,1,2,50.0,0,0,0.0,1,2,50.0,0,0,0.0,1,4,5,1,0,0,0,0,1,3
../kbl_data/2023-2024,S43G01N65,대구 한국가스공사,Away,신주영,0,0,0,0.0,0,0,0.0,0,0,0.0,0,0,0.0,0,0,0,0,0,0,0,0,0,0
../kbl_data/2023-2024,S43G01N66,수원 KT,Home,한희원,10,0,1,0.0,2,6,33.3,2,7,28.6,4,4,100.0,1,0,1,2,1,0,1,0,0,2
../kbl_data/2023-2024,S43G01N66,수원 KT,Home,최창진,5,2,2,100.0,0,0,0.0,2,2,100.0,1,2,50.0,2,1,3,1,1,0,0,0,0,1
../kbl_data/2023-2024,S43G01N66,수원 KT,Home,문성곤,6,0,0,0.0,2,4,50.0,2,4,50.0,0,0,0.0,0,3,3,0,1,0,0,0,2,5
../kbl_data/2023-2024,S43G01N66,수원 KT,Home,이현석,0,0,0,0.0,0,1,0.0,0,1,0.0,0,0,0.0,0,0,0,0,0,0,0,0,0,0
../kbl_data/2023-2024,S43G01N66,수원 KT,Home,정성우,1,0,1,0.0,0,1,0.0,0,2,0.0,1,2,50.0,1,0,1,2,0,0,0,0,1,4
../kbl_data/2023-2024,S43G01N66,수원 KT,Home,허훈,23,3,5,60.0,4,8,50.0,7,13,53.8,5,6,83.3,1,1,2,5,1,1,1,0,3,1
../kbl_data/2023-2024,S43G01N66,수원 KT,Home,김준환,0,0,1,0.0,0,3,0.0,0,4,0.0,0,0,0.0,0,0,0,0,3,0,0,0,0,0
../kbl_data/2023-2024,S43G01N66,수원 KT,Home,이두원,6,2,6,33.3,0,0,0.0,2,6,33.3,2,2,100.0,2,1,3,1,0,0,0,1,0,3
../kbl_data/2023-2024,S43G01N66,수원 KT,Home,숀 데이브 일데폰소,5,1,1,100.0,1,1,100.0,2,2,100.0,0,0,0.0,0,1,1,0,0,0,0,0,0,1
../kbl_data/2023-2024,S43G01N66,수원 KT,Home,문정현,1,0,0,0.0,0,0,0.0,0,0,0.0,1,2,50.0,0,1,1,0,0,0,0,0,0,1
../kbl_data/2023-2024,S43G01N66,수원 KT,Home,마이클 에릭,8,4,7,57.1,0,0,0.0,4,7,57.1,0,0,0.0,2,2,4,1,0,2,0,1,1,3
../kbl_data/2023-2024,S43G01N66,수원 KT,Home,패리스 배스,23,7,11,63.6,2,5,40.0,9,16,56.2,3,5,60.0,2,5,7,3,0,1,0,1,1,5
../kbl_data/2023-2024,S43G01N66,서울 삼성,Away,이정현,19,3,6,50.0,3,7,42.9,6,13,46.2,4,4,100.0,1,3,4,3,0,0,0,0,1,5
../kbl_data/2023-2024,S43G01N66,서울 삼성,Away,김승원,2,1,1,100.0,0,0,0.0,1,1,100.0,0,0,0.0,2,0,2,1,1,0,0,0,0,2
../kbl_data/2023-2024,S43G01N66,서울 삼성,Away,김시래,4,1,1,100.0,0,4,0.0,1,5,20.0,2,2,100.0,0,5,5,4,0,0,0,0,3,2
../kbl_data/2023-2024,S43G01N66,서울 삼성,Away,이동엽,5,0,1,0.0,1,3,33.3,1,4,25.0,2,2,100.0,2,1,3,2,1,0,0,0,2,4
../kbl_data/2023-2024,S43G01N66,서울 삼성,Away,최승욱,7,0,0,0.0,1,2,50.0,1,2,50.0,4,4,100.0,2,2,4,0,1,0,1,0,2,4
../kbl_data/2023-2024,S43G01N66,서울 삼성,Away,윤성원,0,0,0,0.0,0,0,0.0,0,0,0.0,0,0,0.0,0,0,0,0,0,0,0,0,0,0
../kbl_data/2023-2024,S43G01N66,서울 삼성,Away,김진영,0,0,0,0.0,0,0,0.0,0,0,0.0,0,0,0.0,0,0,0,0,0,0,0,0,0,0
../kbl_data/2023-2024,S43G01N66,서울 삼성,Away,김무성,0,0,1,0.0,0,0,0.0,0,1,0.0,0,0,0.0,0,0,0,0,0,0,0,0,1,1
../kbl_data/2023-2024,S43G01N66,서울 삼성,Away,이원석,6,2,7,28.6,0,1,0.0,2,8,25.0,2,4,50.0,1,7,8,2,0,1,0,0,1,2
../kbl_data/2023-2024,S43G01N66,서울 삼성,Away,아반 나바,7,1,1,100.0,1,4,25.0,2,5,40.0,2,2,100.0,0,1,1,0,0,0,0,0,2,2
../kbl_data/2023-2024,S43G01N66,서울 삼성,Away,이스마엘 레인,7,2,2,100.0,1,1,100.0,3,3,100.0,0,0,0.0,1,3,4,0,1,0,0,2,0,0
../kbl_data/2023-2024,S43G01N66,서울 삼성,Away,코피 코번,26,9,19,47.4,0,0,0.0,9,19,47.4,8,8,100.0,5,3,8,1,1,2,0,1,2,2
../kbl_data/2023-2024,S43G01N67,안양 정관장,Home,정준원,8,1,2,50.0,2,2,100.0,3,4,75.0,0,0,0.0,0,1,1,0,0,0,0,0,0,0
../kbl_data/2023-2024,S43G01N67,안양 정관장,Home,정효근,12,3,4,75.0,0,4,0.0,3,8,37.5,6,6,100.0,0,2,2,1,1,0,1,0,0,3
../kbl_data/2023-2024,S43G01N67,안양 정관장,Home,이종현,5,2,5,40.0,0,2,0.0,2,7,28.6,1,1,100.0,0,2,2,0,1,0,0,0,0,2
../kbl_data/2023-2024,S43G01N67,안양 정관장,Home,김철욱,1,0,1,0.0,0,1,0.0,0,2,0.0,1,2,50.0,1,0,1,0,1,0,0,0,0,0
../kbl_data/2023-2024,S43G01N67,안양 정관장,Home,박지훈,16,5,7,71.4,2,5,40.0,7,12,58.3,0,2,0.0,2,3,5,6,2,0,1,0,1,3
../kbl_data/2023-2024,S43G01N67,안양 정관장,Home,최성원,9,0,5,0.0,3,6,50.0,3,11,27.3,0,0,0.0,0,0,0,2,2,0,0,0,1,1
../kbl_data/2023-2024,S43G01N67,안양 정관장,Home,대릴 먼로,10,2,9,22.2,2,4,50.0,4,13,30.8,0,0,0.0,1,4,5,3,0,0,0,0,1,1
../kbl_data/2023-2024,S43G01N67,안양 정관장,Home,장태빈,2,1,1,100.0,0,1,0.0,1,2,50.0,0,0,0.0,0,0,0,1,0,0,0,0,0,4
../kbl_data/2023-2024,S43G01N67,안양 정관장,Home,김경원,10,5,5,100.0,0,0,0.0,5,5,100.0,0,0,0.0,4,1,5,1,0,0,0,0,0,2
../kbl_data/2023-2024,S43G01N67,안양 정관장,Home,렌즈 아반도,4,1,1,100.0,0,2,0.0,1,3,33.3,2,2,100.0,0,3,3,3,1,0,0,0,2,2
../kbl_data/2023-2024,S43G01N67,안양 정관장,Home,고찬혁,3,0,1,0.0,1,4,25.0,1,5,20.0,0,0,0.0,0,0,0,0,0,0,0,0,0,0
../kbl_data/2023-2024,S43G01N67,안양 정관장,Home,표승빈,0,0,0,0.0,0,1,0.0,0,1,0.0,0,0,0.0,0,0,0,0,0,0,0,0,0,0
../kbl_data/2023-2024,S43G01N67,원주 DB,Away,김현호,0,0,0,0.0,0,0,0.0,0,0,0.0,0,0,0.0,0,0,0,0,0,0,0,0,1,0
../kbl_data/2023-2024,S43G01N67,원주 DB,Away,서민수,0,0,0,0.0,0,0,0.0,0,0,0.0,0,0,0.0,0,1,1,0,0,0,0,0,0,1
../kbl_data/2023-2024,S43G01N67,원주 DB,Away,김영현,12,0,1,0.0,4,5,80.0,4,6,66.7,0,0,0.0,0,5,5,0,0,0,0,0,0,2
../kbl_data/2023-2024,S43G01N67,원주 DB,Away,김종규,14,5,6,83.3,0,1,0.0,5,7,71.4,4,4,100.0,0,3,3,2,1,2,0,0,0,2
../kbl_data/2023-2024,S43G01N67,원주 DB,Away,최승욱,7,1,2,50.0,1,1,100.0,2,3,66.7,2,2,100.0,3,0,3,2,3,0,0,0,2,3
../kbl_data/2023-2024,S43G01N67,원주 DB,Away,강상재,10,2,6,33.3,2,5,40.0,4,11,36.4,0,0,0.0,1,7,8,6,1,0,0,0,1,4
../kbl_data/2023-2024,S43G01N67,원주 DB,Away,디드릭 로슨,15,7,11,63.6,0,1,0.0,7,12,58.3,1,1,100.0,3,5,8,6,0,2,0,0,2,0
../kbl_data/2023-2024,S43G01N67,원주 DB,Away,이용우,12,2,2,100.0,2,2,100.0,4,4,100.0,2,2,100.0,0,4,4,1,0,0,0,0,1,4
../kbl_data/2023-2024,S43G01N67,원주 DB,Away,이선 알바노,11,5,7,71.4,0,3,0.0,5,10,50.0,1,1,100.0,0,0,0,8,0,1,0,0,4,2
../kbl_data/2023-2024,S43G01N67,원주 DB,Away,박인웅,4,2,4,50.0,0,0,0.0,2,4,50.0,0,0,0.0,0,4,4,0,0,0,0,0,0,1
../kbl_data/2023-2024,S43G01N67,원주 DB,Away,박승재,0,0,0,0.0,0,0,0.0,0,0,0.0,0,0,0.0,0,0,0,0,0,0,0,0,0,1
../kbl_data/2023-2024,S43G01N67,원주 DB,Away,제프 위디,12,6,7,85.7,0,0,0.0,6,7,85.7,0,0,0.0,0,3,3,1,0,2,0,3,2,1
../kbl_data/2023-2024,S43G01N68,고양 소노,Home,함준후,6,0,0,0.0,2,3,66.7,2,3,66.7,0,0,0.0,0,0,0,1,0,1,0,0,0,3
../kbl_data/2023-2024,S43G01N68,고양 소노,Home,최현민,0,0,0,0.0,0,0,0.0,0,0,0.0,0,0,0.0,0,0,0,0,0,0,0,0,0,0
../kbl_data/2023-2024,S43G01N68,고양 소노,Home,김민욱,11,1,1,100.0,3,9,33.3,4,10,40.0,0,2,0.0,1,6,7,0,0,1,0,0,0,3
../kbl_data/2023-2024,S43G01N68,고양 소노,Home,한호빈,0,0,0,0.0,0,0,0.0,0,0,0.0,0,0,0.0,0,0,0,0,0,0,0,0,1,2
../kbl_data/2023-2024,S43G01N68,고양 소노,Home,전성현,18,2,6,33.3,4,11,36.4,6,17,35.3,2,2,100.0,0,4,4,3,0,0,0,0,1,1
../kbl_data/2023-2024,S43G01N68,고양 소노,Home,김진유,0,0,0,0.0,0,0,0.0,0,0,0.0,0,0,0.0,1,1,2,0,0,0,1,0,0,5
../kbl_data/2023-2024,S43G01N68,고양 소노,Home,치나누 오누아쿠,17,7,14,50.0,0,0,0.0,7,14,50.0,3,3,100.0,3,11,14,8,1,0,0,0,2,2
../kbl_data/2023-2024,S43G01N68,고양 소노,Home,이정현,25,3,7,42.9,5,6,83.3,8,13,61.5,4,4,100.0,0,2,2,6,1,0,3,0,2,1
../kbl_data/2023-2024,S43G01N68,고양 소노,Home,안정욱,0,0,0,0.0,0,0,0.0,0,0,0.0,0,0,0.0,0,0,0,0,0,0,0,0,0,0
../kbl_data/2023-2024,S43G01N68,고양 소노,Home,박종하,0,0,0,0.0,0,1,0.0,0,1,0.0,0,0,0.0,0,0,0,0,0,0,0,0,0,0
../kbl_data/2023-2024,S43G01N68,고양 소노,Home,조쉬 토랄바,4,2,4,50.0,0,4,0.0,2,8,25.0,0,0,0.0,0,1,1,3,1,0,0,0,0,5
../kbl_data/2023-2024,S43G01N68,고양 소노,Home,디욘테 데이비스,3,1,2,50.0,0,0,0.0,1,2,50.0,1,1,100.0,1,2,3,0,0,0,0,0,0,0
../kbl_data/2023-2024,S43G01N68,서울 SK,Away,허일영,7,1,2,50.0,1,1,100.0,2,3,66.7,2,2,100.0,2,0,2,1,0,0,0,0,0,0
../kbl_data/2023-2024,S43G01N68,서울 SK,Away,송창용,0,0,0,0.0,0,0,0.0,0,0,0.0,0,0,0.0,0,0,0,0,0,0,0,0,0,0
../kbl_data/2023-2024,S43G01N68,서울 SK,Away,김선형,4,2,3,66.7,0,3,0.0,2,6,33.3,0,0,0.0,0,0,0,3,1,1,0,0,1,5
../kbl_data/2023-2024,S43G01N68,서울 SK,Away,홍경기,0,0,0,0.0,0,0,0.0,0,0,0.0,0,0,0.0,0,0,0,0,0,0,0,0,0,0
../kbl_data/2023-2024,S43G01N68,서울 SK,Away,오세근,1,0,1,0.0,0,1,0.0,0,2,0.0,1,2,50.0,0,4,4,0,0,0,0,0,0,2
../kbl_data/2023-2024,S43G01N68,서울 SK,Away,최부경,2,1,4,25.0,0,0,0.0,1,4,25.0,0,0,0.0,4,2,6,1,0,0,0,0,1,4
../kbl_data/2023-2024,S43G01N68,서울 SK,Away,리온 윌리엄스,8,1,3,33.3,1,1,100.0,2,4,50.0,3,4,75.0,0,2,2,0,0,1,0,0,0,0
../kbl_data/2023-2024,S43G01N68,서울 SK,Away,최원혁,6,1,2,50.0,1,4,25.0,2,6,33.3,1,2,50.0,4,3,7,7,2,0,0,0,0,4
../kbl_data/2023-2024,S43G01N68,서울 SK,Away,안영준,16,3,6,50.0,2,6,33.3,5,12,41.7,4,5,80.0,0,7,7,0,0,1,0,0,2,1
../kbl_data/2023-2024,S43G01N68,서울 SK,Away,자밀 워니,22,9,18,50.0,1,5,20.0,10,23,43.5,1,1,100.0,0,6,6,4,0,1,0,1,2,2
../kbl_data/2023-2024,S43G01N68,서울 SK,Away,김형빈,0,0,0,0.0,0,0,0.0,0,0,0.0,0,0,0.0,0,0,0,0,0,0,0,0,0,0
../kbl_data/2023-2024,S43G01N68,서울 SK,Away,오재현,11,3,5,60.0,1,4,25.0,4,9,44.4,2,4,50.0,3,2,5,3,1,0,0,0,3,2
../kbl_data/2023-2024,S43G01N69,부산 KCC,Home,정창영,6,0,1,0.0,0,0,0.0,0,1,0.0,6,6,100.0,0,6,6,2,1,0,0,0,2,0
../kbl_data/2023-2024,S43G01N69,부산 KCC,Home,라건아,6,3,7,42.9,0,0,0.0,3,7,42.9,0,0,0.0,2,8,10,0,1,0,0,1,1,2
../kbl_data/2023-2024,S43G01N69,부산 KCC,Home,허웅,21,7,10,70.0,1,2,50.0,8,12,66.7,4,5,80.0,0,1,1,1,1,0,0,0,2,2
../kbl_data/2023-2024,S43G01N69,부산 KCC,Home,이승현,0,0,2,0.0,0,0,0.0,0,2,0.0,0,0,0.0,0,0,0,0,0,0,0,0,1,1
../kbl_data/2023-2024,S43G01N69,부산 KCC,Home,이호현,10,1,2,50.0,2,7,28.6,3,9,33.3,2,2,100.0,0,2,2,2,2,0,1,0,2,2
../kbl_data/2023-2024,S43G01N69,부산 KCC,Home,송교창,9,2,3,66.7,1,1,100.0,3,4,75.0,2,3,66.7,0,3,3,2,1,0,0,0,2,2
../kbl_data/2023-2024,S43G01N69,부산 KCC,Home,최준용,17,7,13,53.8,1,5,20.0,8,18,44.4,0,1,0.0,2,5,7,4,1,0,2,0,2,2
../kbl_data/2023-2024,S43G01N69,부산 KCC,Home,이진욱,0,0,0,0.0,0,0,0.0,0,0,0.0,0,0,0.0,0,0,0,0,0,0,0,0,0,0
../kbl_data/2023-2024,S43G01N69,부산 KCC,Home,이근휘,3,0,0,0.0,1,1,100.0,1,1,100.0,0,0,0.0,0,0,0,0,0,0,0,0,0,1
../kbl_data/2023-2024,S43G01N69,부산 KCC,Home,김동현,0,0,0,0.0,0,0,0.0,0,0,0.0,0,0,0.0,0,0,0,0,0,0,0,0,0,0
../kbl_data/2023-2024,S43G01N69,부산 KCC,Home,송동훈,0,0,0,0.0,0,0,0.0,0,0,0.0,0,0,0.0,0,0,0,0,0,0,0,0,0,0
../kbl_data/2023-2024,S43G01N69,부산 KCC,Home,알리제 드숀 존슨,19,8,12,66.7,0,0,0.0,8,12,66.7,3,4,75.0,4,4,8,6,0,0,0,1,2,4
../kbl_data/2023-2024,S43G01N69,울산 현대모비스,Away,함지훈,0,0,0,0.0,0,0,0.0,0,0,0.0,0,0,0.0,2,3,5,6,1,1,0,0,0,0
../kbl_data/2023-2024,S43G01N69,울산 현대모비스,Away,김현민,0,0,0,0.0,0,0,0.0,0,0,0.0,0,0,0.0,1,0,1,1,0,0,0,0,0,0
../kbl_data/2023-2024,S43G01N69,울산 현대모비스,Away,최진수,4,2,3,66.7,0,4,0.0,2,7,28.6,0,0,0.0,1,7,8,2,1,0,0,0,0,5
../kbl_data/2023-2024,S43G01N69,울산 현대모비스,Away,김현수,2,1,2,50.0,0,3,0.0,1,5,20.0,0,0,0.0,1,0,1,2,1,0,0,0,0,2
../kbl_data/2023-2024,S43G01N69,울산 현대모비스,Away,장재석,6,3,4,75.0,0,0,0.0,3,4,75.0,0,0,0.0,2,2,4,1,1,0,0,0,1,2
../kbl_data/2023-2024,S43G01N69,울산 현대모비스,Away,김지완,17,4,6,66.7,3,7,42.9,7,13,53.8,0,0,0.0,1,2,3,1,2,0,1,0,1,2
../kbl_data/2023-2024,S43G01N69,울산 현대모비스,Away,김국찬,0,0,2,0.0,0,2,0.0,0,4,0.0,0,0,0.0,1,1,2,1,1,0,0,0,2,2
../kbl_data/2023-2024,S43G01N69,울산 현대모비스,Away,박준은,6,0,0,0.0,2,2,100.0,2,2,100.0,0,0,0.0,1,0,1,1,0,0,0,0,1,1
../kbl_data/2023-2024,S43G01N69,울산 현대모비스,Away,이우석,6,3,8,37.5,0,1,0.0,3,9,33.3,0,0,0.0,0,1,1,3,0,0,0,0,4,4
../kbl_data/2023-2024,S43G01N69,울산 현대모비스,Away,게이지 프림,22,8,10,80.0,0,3,0.0,8,13,61.5,6,6,100.0,0,5,5,1,2,0,0,0,3,2
../kbl_data/2023-2024,S43G01N69,울산 현대모비스,Away,김태완,2,1,3,33.3,0,0,0.0,1,3,33.3,0,0,0.0,1,0,1,0,0,0,0,0,2,2
../kbl_data/2023-2024,S43G01N69,울산 현대모비스,Away,케베 알루마,19,7,9,77.8,1,6,16.7,8,15,53.3,2,4,50.0,1,5,6,2,1,1,0,1,1,3
../kbl_data/2023-2024,S43G01N70,수원 KT,Home,한희원,6,0,2,0.0,2,7,28.6,2,9,22.2,0,0,0.0,2,3,5,1,1,0,0,0,0,1
../kbl_data/2023-2024,S43G01N70,수원 KT,Home,최창진,2,0,1,0.0,0,0,0.0,0,1,0.0,2,2,100.0,2,0,2,2,2,0,0,0,1,2
../kbl_data/2023-2024,S43G01N70,수원 KT,Home,문성곤,12,0,0,0.0,4,7,57.1,4,7,57.1,0,2,0.0,0,0,0,1,4,1,0,0,4,2
../kbl_data/2023-2024,S43G01N70,수원 KT,Home,이현석,0,0,0,0.0,0,0,0.0,0,0,0.0,0,0,0.0,0,0,0,0,0,0,0,0,0,0
../kbl_data/2023-2024,S43G01N70,수원 KT,Home,정성우,10,1,2,50.0,2,6,33.3,3,8,37.5,2,3,66.7,0,5,5,4,0,0,0,0,2,2
../kbl_data/2023-2024,S43G01N70,수원 KT,Home,허훈,17,4,10,40.0,3,4,75.0,7,14,50.0,0,0,0.0,2,2,4,3,1,0,0,0,3,2
../kbl_data/2023-2024,S43G01N70,수원 KT,Home,김준환,4,2,2,100.0,0,1,0.0,2,3,66.7,0,0,0.0,0,0,0,0,0,0,0,0,0,1
../kbl_data/2023-2024,S43G01N70,수원 KT,Home,이두원,10,4,4,100.0,0,0,0.0,4,4,100.0,2,3,66.7,3,0,3,1,0,2,0,0,2,4
../kbl_data/2023-2024,S43G01N70,수원 KT,Home,숀 데이브 일데폰소,0,0,2,0.0,0,1,0.0,0,3,0.0,0,0,0.0,0,0,0,0,0,0,0,0,0,0
../kbl_data/2023-2024,S43G01N70,수원 KT,Home,문정현,2,0,0,0.0,0,1,0.0,0,1,0.0,2,2,100.0,0,1,1,0,0,0,0,0,0,1
../kbl_data/2023-2024,S43G01N70,수원 KT,Home,마이클 에릭,4,2,3,66.7,0,0,0.0,2,3,66.7,0,0,0.0,1,1,2,1,0,1,0,0,0,1
../kbl_data/2023-2024,S43G01N70,수원 KT,Home,패리스 배스,26,7,11,63.6,3,6,50.0,10,17,58.8,3,4,75.0,3,11,14,7,2,1,0,1,1,4
../kbl_data/2023-2024,S43G01N70,창원 LG,Away,이관희,20,2,4,50.0,5,11,45.5,7,15,46.7,1,3,33.3,1,3,4,1,0,0,0,0,0,1
../kbl_data/2023-2024,S43G01N70,창원 LG,Away,정희재,0,0,0,0.0,0,1,0.0,0,1,0.0,0,0,0.0,1,0,1,0,0,0,0,0,0,3
../kbl_data/2023-2024,S43G01N70,창원 LG,Away,임동섭,0,0,0,0.0,0,0,0.0,0,0,0.0,0,0,0.0,0,0,0,0,0,0,0,0,0,0
../kbl_data/2023-2024,S43G01N70,창원 LG,Away,이재도,13,4,8,50.0,1,3,33.3,5,11,45.5,2,2,100.0,1,2,3,5,1,0,0,0,2,2
../kbl_data/2023-2024,S43G01N70,창원 LG,Away,정인덕,0,0,1,0.0,0,0,0.0,0,1,0.0,0,0,0.0,1,0,1,0,0,0,0,0,0,0
../kbl_data/2023-2024,S43G01N70,창원 LG,Away,양홍석,19,0,2,0.0,5,10,50.0,5,12,41.7,4,4,100.0,4,1,5,5,1,0,1,0,2,2
../kbl_data/2023-2024,S43G01N70,창원 LG,Away,박정현,0,0,0,0.0,0,0,0.0,0,0,0.0,0,0,0.0,0,0,0,0,0,0,0,0,0,0
../kbl_data/2023-2024,S43G01N70,창원 LG,Away,윤원상,0,0,0,0.0,0,0,0.0,0,0,0.0,0,0,0.0,0,0,0,0,0,0,0,0,1,0
../kbl_data/2023-2024,S43G01N70,창원 LG,Away,아셈 마레이,20,8,13,61.5,0,0,0.0,8,13,61.5,4,6,66.7,7,13,20,6,1,0,0,0,2,3
../kbl_data/2023-2024,S43G01N70,창원 LG,Away,저스틴 구탕,13,6,6,100.0,0,1,0.0,6,7,85.7,1,3,33.3,2,3,5,4,0,0,0,0,5,2
../kbl_data/2023-2024,S43G01N70,창원 LG,Away,양준석,0,0,0,0.0,0,0,0.0,0,0,0.0,0,0,0.0,0,0,0,1,1,0,0,0,0,0
../kbl_data/2023-2024,S43G01N70,창원 LG,Away,유기상,3,0,6,0.0,1,5,20.0,1,11,9.1,0,0,0.0,1,2,3,0,0,0,2,0,2,3
../kbl_data/2023-2024,S43G01N71,고양 소노,Home,최현민,2,1,1,100.0,0,0,0.0,1,1,100.0,0,0,0.0,0,0,0,0,0,0,0,0,0,0
../kbl_data/2023-2024,S43G01N71,고양 소노,Home,김민욱,12,0,1,0.0,4,6,66.7,4,7,57.1,0,0,0.0,1,3,4,2,0,0,0,0,1,3
../kbl_data/2023-2024,S43G01N71,고양 소노,Home,한호빈,9,3,3,100.0,1,4,25.0,4,7,57.1,0,2,0.0,1,2,3,1,0,0,0,0,1,2
../kbl_data/2023-2024,S43G01N71,고양 소노,Home,전성현,8,1,3,33.3,2,5,40.0,3,8,37.5,0,0,0.0,0,0,0,1,0,0,0,0,1,2
../kbl_data/2023-2024,S43G01N71,고양 소노,Home,김진유,0,0,0,0.0,0,0,0.0,0,0,0.0,0,0,0.0,0,0,0,0,1,0,0,0,0,1
../kbl_data/2023-2024,S43G01N71,고양 소노,Home,치나누 오누아쿠,18,9,13,69.2,0,2,0.0,9,15,60.0,0,0,0.0,0,7,7,7,1,0,0,2,1,4
../kbl_data/2023-2024,S43G01N71,고양 소노,Home,이정현,26,5,7,71.4,3,7,42.9,8,14,57.1,7,7,100.0,2,3,5,10,3,0,0,0,2,1
../kbl_data/2023-2024,S43G01N71,고양 소노,Home,백지웅,0,0,0,0.0,0,0,0.0,0,0,0.0,0,0,0.0,0,0,0,0,0,0,0,0,0,1
../kbl_data/2023-2024,S43G01N71,고양 소노,Home,안정욱,0,0,0,0.0,0,0,0.0,0,0,0.0,0,0,0.0,0,0,0,0,0,0,0,0,0,0
../kbl_data/2023-2024,S43G01N71,고양 소노,Home,박종하,0,0,0,0.0,0,1,0.0,0,1,0.0,0,0,0.0,0,0,0,0,0,0,0,0,0,0
../kbl_data/2023-2024,S43G01N71,고양 소노,Home,조쉬 토랄바,5,1,4,25.0,1,5,20.0,2,9,22.2,0,0,0.0,1,1,2,0,0,0,0,0,0,1
../kbl_data/2023-2024,S43G01N71,고양 소노,Home,디욘테 데이비스,6,2,3,66.7,0,0,0.0,2,3,66.7,2,2,100.0,0,3,3,0,0,2,0,1,0,0
../kbl_data/2023-2024,S43G01N71,안양 정관장,Away,정준원,0,0,2,0.0,0,0,0.0,0,2,0.0,0,0,0.0,1,1,2,0,0,0,0,0,1,1
../kbl_data/2023-2024,S43G01N71,안양 정관장,Away,정효근,13,5,6,83.3,1,4,25.0,6,10,60.0,0,0,0.0,2,5,7,4,0,0,0,0,1,5
../kbl_data/2023-2024,S43G01N71,안양 정관장,Away,이종현,9,3,4,75.0,1,2,50.0,4,6,66.7,0,0,0.0,0,1,1,0,1,0,0,0,2,0
../kbl_data/2023-2024,S43G01N71,안양 정관장,Away,박지훈,19,5,7,71.4,3,6,50.0,8,13,61.5,0,0,0.0,2,3,5,3,1,0,0,0,0,3
../kbl_data/2023-2024,S43G01N71,안양 정관장,Away,최성원,18,3,8,37.5,3,6,50.0,6,14,42.9,3,3,100.0,1,1,2,8,1,0,0,0,4,3
../kbl_data/2023-2024,S43G01N71,안양 정관장,Away,이우정,0,0,0,0.0,0,0,0.0,0,0,0.0,0,0,0.0,0,0,0,0,0,0,0,0,0,0
../kbl_data/2023-2024,S43G01N71,안양 정관장,Away,대릴 먼로,3,0,1,0.0,1,3,33.3,1,4,25.0,0,0,0.0,1,6,7,1,1,0,0,0,2,2
../kbl_data/2023-2024,S43G01N71,안양 정관장,Away,장태빈,0,0,0,0.0,0,0,0.0,0,0,0.0,0,0,0.0,0,0,0,0,0,0,0,0,0,0
../kbl_data/2023-2024,S43G01N71,안양 정관장,Away,김경원,12,3,3,100.0,1,1,100.0,4,4,100.0,3,3,100.0,1,1,2,0,0,0,0,0,0,0
../kbl_data/2023-2024,S43G01N71,안양 정관장,Away,오마리 스펠맨,3,0,3,0.0,1,4,25.0,1,7,14.3,0,2,0.0,0,4,4,1,0,1,0,0,0,1
../kbl_data/2023-2024,S43G01N71,안양 정관장,Away,렌즈 아반도,5,1,2,50.0,1,2,50.0,2,4,50.0,0,0,0.0,1,4,5,0,0,0,0,0,2,0
../kbl_data/2023-2024,S43G01N71,안양 정관장,Away,고찬혁,0,0,0,0.0,0,1,0.0,0,1,0.0,0,0,0.0,0,0,0,0,0,0,0,0,0,2
../kbl_data/2023-2024,S43G01N72,부산 KCC,Home,정창영,0,0,1,0.0,0,0,0.0,0,1,0.0,0,0,0.0,0,0,0,1,0,0,0,0,2,0
../kbl_data/2023-2024,S43G01N72,부산 KCC,Home,라건아,5,2,2,100.0,0,1,0.0,2,3,66.7,1,1,100.0,0,3,3,0,0,0,0,0,1,2
../kbl_data/2023-2024,S43G01N72,부산 KCC,Home,허웅,14,2,6,33.3,3,8,37.5,5,14,35.7,1,1,100.0,0,3,3,1,1,0,0,0,2,2
../kbl_data/2023-2024,S43G01N72,부산 KCC,Home,이승현,3,0,1,0.0,0,0,0.0,0,1,0.0,3,4,75.0,3,2,5,1,2,0,0,0,3,1
../kbl_data/2023-2024,S43G01N72,부산 KCC,Home,이호현,11,2,3,66.7,1,2,50.0,3,5,60.0,4,4,100.0,0,2,2,3,2,0,1,0,1,3
../kbl_data/2023-2024,S43G01N72,부산 KCC,Home,송교창,7,2,7,28.6,1,3,33.3,3,10,30.0,0,0,0.0,1,4,5,2,0,0,0,0,1,0
../kbl_data/2023-2024,S43G01N72,부산 KCC,Home,최준용,6,2,4,50.0,0,6,0.0,2,10,20.0,2,4,50.0,0,1,1,2,1,1,0,0,1,3
../kbl_data/2023-2024,S43G01N72,부산 KCC,Home,이진욱,0,0,0,0.0,0,0,0.0,0,0,0.0,0,0,0.0,0,0,0,0,0,0,0,0,0,0
../kbl_data/2023-2024,S43G01N72,부산 KCC,Home,이근휘,0,0,1,0.0,0,0,0.0,0,1,0.0,0,0,0.0,0,0,0,0,0,0,0,0,0,1
../kbl_data/2023-2024,S43G01N72,부산 KCC,Home,김동현,2,0,0,0.0,0,0,0.0,0,0,0.0,2,2,100.0,0,0,0,0,1,0,0,0,0,0
../kbl_data/2023-2024,S43G01N72,부산 KCC,Home,송동훈,0,0,1,0.0,0,0,0.0,0,1,0.0,0,0,0.0,0,0,0,1,0,0,0,0,0,2
../kbl_data/2023-2024,S43G01N72,부산 KCC,Home,알리제 드숀 존슨,23,10,14,71.4,1,4,25.0,11,18,61.1,0,2,0.0,4,9,13,3,0,0,0,3,4,2
../kbl_data/2023-2024,S43G01N72,수원 KT,Away,한희원,2,1,2,50.0,0,3,0.0,1,5,20.0,0,0,0.0,3,4,7,1,0,0,0,0,4,1
../kbl_data/2023-2024,S43G01N72,수원 KT,Away,최창진,2,1,2,50.0,0,1,0.0,1,3,33.3,0,0,0.0,1,2,3,3,1,0,0,0,0,3
../kbl_data/2023-2024,S43G01N72,수원 KT,Away,문성곤,12,3,4,75.0,2,5,40.0,5,9,55.6,0,0,0.0,1,2,3,0,3,0,0,0,0,4
../kbl_data/2023-2024,S43G01N72,수원 KT,Away,이현석,0,0,0,0.0,0,0,0.0,0,0,0.0,0,0,0.0,0,0,0,0,0,0,0,0,0,0
../kbl_data/2023-2024,S43G01N72,수원 KT,Away,정성우,2,1,2,50.0,0,2,0.0,1,4,25.0,0,0,0.0,0,0,0,5,2,0,0,0,3,2
../kbl_data/2023-2024,S43G01N72,수원 KT,Away,허훈,19,5,9,55.6,3,9,33.3,8,18,44.4,0,4,0.0,1,3,4,6,2,0,0,0,2,3
../kbl_data/2023-2024,S43G01N72,수원 KT,Away,박찬호,0,0,0,0.0,0,0,0.0,0,0,0.0,0,0,0.0,0,0,0,0,0,0,0,0,0,0
../kbl_data/2023-2024,S43G01N72,수원 KT,Away,김준환,2,1,2,50.0,0,0,0.0,1,2,50.0,0,0,0.0,1,0,1,0,0,0,0,0,0,1
../kbl_data/2023-2024,S43G01N72,수원 KT,Away,이두원,8,4,5,80.0,0,0,0.0,4,5,80.0,0,1,0.0,0,2,2,2,1,0,0,0,1,2
../kbl_data/2023-2024,S43G01N72,수원 KT,Away,숀 데이브 일데폰소,0,0,0,0.0,0,1,0.0,0,1,0.0,0,0,0.0,0,0,0,2,0,0,0,0,1,1
../kbl_data/2023-2024,S43G01N72,수원 KT,Away,문정현,5,1,2,50.0,1,3,33.3,2,5,40.0,0,0,0.0,5,4,9,2,1,0,0,0,2,4
../kbl_data/2023-2024,S43G01N72,수원 KT,Away,패리스 배스,33,10,14,71.4,3,10,30.0,13,24,54.2,4,5,80.0,5,13,18,4,3,2,0,4,2,2
../kbl_data/2023-2024,S43G01N73,서울 SK,Home,허일영,5,0,0,0.0,0,0,0.0,0,0,0.0,5,6,83.3,1,1,2,0,0,0,0,0,0,4
../kbl_data/2023-2024,S43G01N73,서울 SK,Home,송창용,0,0,1,0.0,0,0,0.0,0,1,0.0,0,0,0.0,0,1,1,0,0,0,0,0,0,0
../kbl_data/2023-2024,S43G01N73,서울 SK,Home,김선형,19,5,10,50.0,1,2,50.0,6,12,50.0,6,8,75.0,1,1,2,4,1,0,0,0,1,2
../kbl_data/2023-2024,S43G01N73,서울 SK,Home,홍경기,0,0,0,0.0,0,0,0.0,0,0,0.0,0,0,0.0,0,0,0,0,0,0,0,0,0,0
../kbl_data/2023-2024,S43G01N73,서울 SK,Home,오세근,21,5,6,83.3,2,3,66.7,7,9,77.8,5,5,100.0,1,0,1,0,1,0,0,0,0,2
../kbl_data/2023-2024,S43G01N73,서울 SK,Home,최부경,0,0,1,0.0,0,0,0.0,0,1,0.0,0,0,0.0,1,1,2,0,0,0,0,0,0,0
../kbl_data/2023-2024,S43G01N73,서울 SK,Home,리온 윌리엄스,0,0,0,0.0,0,1,0.0,0,1,0.0,0,0,0.0,0,3,3,1,0,0,0,0,0,0
../kbl_data/2023-2024,S43G01N73,서울 SK,Home,최원혁,0,0,1,0.0,0,1,0.0,0,2,0.0,0,0,0.0,0,1,1,1,2,1,0,0,0,4
../kbl_data/2023-2024,S43G01N73,서울 SK,Home,안영준,0,0,4,0.0,0,3,0.0,0,7,0.0,0,0,0.0,0,3,3,5,0,0,0,0,2,2
../kbl_data/2023-2024,S43G01N73,서울 SK,Home,자밀 워니,16,8,13,61.5,0,2,0.0,8,15,53.3,0,0,0.0,1,6,7,5,2,0,0,1,3,1
../kbl_data/2023-2024,S43G01N73,서울 SK,Home,김형빈,2,1,1,100.0,0,0,0.0,1,1,100.0,0,0,0.0,0,1,1,0,0,0,0,0,0,0
../kbl_data/2023-2024,S43G01N73,서울 SK,Home,오재현,10,1,4,25.0,2,4,50.0,3,8,37.5,2,2,100.0,0,2,2,1,0,0,0,0,0,2
../kbl_data/2023-2024,S43G01N73,창원 LG,Away,이관희,0,0,1,0.0,0,1,0.0,0,2,0.0,0,0,0.0,0,0,0,0,0,0,0,0,0,0
../kbl_data/2023-2024,S43G01N73,창원 LG,Away,정희재,12,0,1,0.0,4,5,80.0,4,6,66.7,0,0,0.0,1,2,3,1,0,0,0,0,0,1
../kbl_data/2023-2024,S43G01N73,창원 LG,Away,임동섭,0,0,0,0.0,0,1,0.0,0,1,0.0,0,0,0.0,1,1,2,0,0,0,0,0,1,0
../kbl_data/2023-2024,S43G01N73,창원 LG,Away,이재도,25,2,6,33.3,7,8,87.5,9,14,64.3,0,0,0.0,0,2,2,6,1,0,0,0,0,4
../kbl_data/2023-2024,S43G01N73,창원 LG,Away,정인덕,7,2,2,100.0,1,4,25.0,3,6,50.0,0,0,0.0,1,1,2,0,1,0,0,0,0,1
../kbl_data/2023-2024,S43G01N73,창원 LG,Away,양홍석,9,0,5,0.0,2,6,33.3,2,11,18.2,3,5,60.0,5,5,10,4,0,2,0,0,1,3
../kbl_data/2023-2024,S43G01N73,창원 LG,Away,박정현,2,1,3,33.3,0,0,0.0,1,3,33.3,0,0,0.0,0,0,0,1,0,0,0,0,0,2
../kbl_data/2023-2024,S43G01N73,창원 LG,Away,윤원상,0,0,1,0.0,0,1,0.0,0,2,0.0,0,0,0.0,0,0,0,0,1,0,0,0,0,0
../kbl_data/2023-2024,S43G01N73,창원 LG,Away,아셈 마레이,15,7,14,50.0,0,0,0.0,7,14,50.0,1,1,100.0,11,12,23,7,1,1,0,0,4,2
../kbl_data/2023-2024,S43G01N73,창원 LG,Away,저스틴 구탕,6,2,3,66.7,0,0,0.0,2,3,66.7,2,2,100.0,0,1,1,2,1,0,0,0,1,2
../kbl_data/2023-2024,S43G01N73,창원 LG,Away,양준석,2,1,5,20.0,0,1,0.0,1,6,16.7,0,0,0.0,0,1,1,1,0,0,0,0,1,2
../kbl_data/2023-2024,S43G01N73,창원 LG,Away,유기상,9,0,2,0.0,3,5,60.0,3,7,42.9,0,0,0.0,1,1,2,0,0,0,0,0,0,3
../kbl_data/2023-2024,S43G01N74,안양 정관장,Home,정준원,0,0,3,0.0,0,1,0.0,0,4,0.0,0,0,0.0,1,1,2,0,0,0,0,0,0,0
../kbl_data/2023-2024,S43G01N74,안양 정관장,Home,정효근,4,1,1,100.0,0,0,0.0,1,1,100.0,2,2,100.0,1,0,1,1,0,0,0,0,1,0
../kbl_data/2023-2024,S43G01N74,안양 정관장,Home,이종현,13,5,5,100.0,0,2,0.0,5,7,71.4,3,3,100.0,3,4,7,1,0,0,0,0,1,2
../kbl_data/2023-2024,S43G01N74,안양 정관장,Home,박지훈,8,4,6,66.7,0,0,0.0,4,6,66.7,0,2,0.0,0,2,2,4,3,0,0,0,2,3
../kbl_data/2023-2024,S43G01N74,안양 정관장,Home,최성원,16,3,5,60.0,2,6,33.3,5,11,45.5,4,4,100.0,0,0,0,2,0,0,0,0,2,1
../kbl_data/2023-2024,S43G01N74,안양 정관장,Home,이우정,0,0,0,0.0,0,0,0.0,0,0,0.0,0,0,0.0,0,0,0,0,0,0,0,0,0,0
../kbl_data/2023-2024,S43G01N74,안양 정관장,Home,대릴 먼로,2,1,4,25.0,0,1,0.0,1,5,20.0,0,0,0.0,0,1,1,2,0,0,0,0,0,2
../kbl_data/2023-2024,S43G01N74,안양 정관장,Home,장태빈,2,1,2,50.0,0,0,0.0,1,2,50.0,0,0,0.0,0,2,2,0,0,0,0,0,0,1
../kbl_data/2023-2024,S43G01N74,안양 정관장,Home,김경원,12,6,6,100.0,0,1,0.0,6,7,85.7,0,0,0.0,2,0,2,0,1,3,0,0,0,3
../kbl_data/2023-2024,S43G01N74,안양 정관장,Home,오마리 스펠맨,12,5,8,62.5,0,4,0.0,5,12,41.7,2,4,50.0,2,0,2,2,0,0,0,3,0,2
../kbl_data/2023-2024,S43G01N74,안양 정관장,Home,렌즈 아반도,8,3,6,50.0,0,2,0.0,3,8,37.5,2,2,100.0,1,5,6,2,0,0,0,0,3,1
../kbl_data/2023-2024,S43G01N74,안양 정관장,Home,고찬혁,0,0,0,0.0,0,0,0.0,0,0,0.0,0,0,0.0,0,0,0,0,0,0,0,0,0,0
../kbl_data/2023-2024,S43G01N74,울산 현대모비스,Away,함지훈,14,5,7,71.4,0,1,0.0,5,8,62.5,4,4,100.0,1,3,4,1,0,0,0,0,0,3
../kbl_data/2023-2024,S43G01N74,울산 현대모비스,Away,김현민,0,0,0,0.0,0,0,0.0,0,0,0.0,0,0,0.0,0,0,0,0,0,0,0,0,0,0
../kbl_data/2023-2024,S43G01N74,울산 현대모비스,Away,최진수,0,0,0,0.0,0,0,0.0,0,0,0.0,0,0,0.0,0,1,1,0,0,0,0,0,0,0
../kbl_data/2023-2024,S43G01N74,울산 현대모비스,Away,김현수,7,2,2,100.0,1,3,33.3,3,5,60.0,0,0,0.0,0,0,0,3,1,0,0,0,0,0
../kbl_data/2023-2024,S43G01N74,울산 현대모비스,Away,장재석,9,4,6,66.7,0,0,0.0,4,6,66.7,1,2,50.0,2,1,3,0,1,0,0,0,0,3
../kbl_data/2023-2024,S43G01N74,울산 현대모비스,Away,김지완,12,3,4,75.0,2,4,50.0,5,8,62.5,0,0,0.0,0,1,1,8,1,0,0,0,0,3
../kbl_data/2023-2024,S43G01N74,울산 현대모비스,Away,김국찬,14,1,2,50.0,3,3,100.0,4,5,80.0,3,3,100.0,1,2,3,1,0,0,0,0,1,3
../kbl_data/2023-2024,S43G01N74,울산 현대모비스,Away,박준은,2,1,1,100.0,0,1,0.0,1,2,50.0,0,0,0.0,0,1,1,0,0,0,0,0,0,1
../kbl_data/2023-2024,S43G01N74,울산 현대모비스,Away,이우석,12,6,9,66.7,0,0,0.0,6,9,66.7,0,0,0.0,2,7,9,4,2,0,0,0,1,0
../kbl_data/2023-2024,S43G01N74,울산 현대모비스,Away,게이지 프림,25,9,17,52.9,1,1,100.0,10,18,55.6,4,5,80.0,6,5,11,5,4,0,0,0,1,2
../kbl_data/2023-2024,S43G01N74,울산 현대모비스,Away,김태완,4,2,6,33.3,0,0,0.0,2,6,33.3,0,0,0.0,1,1,2,2,0,0,0,0,2,4
../kbl_data/2023-2024,S43G01N74,울산 현대모비스,Away,케베 알루마,9,3,4,75.0,1,3,33.3,4,7,57.1,0,0,0.0,2,2,4,2,0,0,0,2,0,1
../kbl_data/2023-2024,S43G01N75,서울 삼성,Home,이정현,72,16,26,61.5,6,16,37.5,22,42,52.4,22,24,91.7,4,4,8,16,6,0,0,0,2,6
../kbl_data/2023-2024,S43G01N75,서울 삼성,Home,김승원,3,0,0,0.0,0,0,0.0,0,0,0.0,3,4,75.0,1,4,5,1,0,0,0,0,1,0
../kbl_data/2023-2024,S43G01N75,서울 삼성,Home,김시래,4,2,5,40.0,0,4,0.0,2,9,22.2,0,0,0.0,0,1,1,4,0,0,0,0,0,3
../kbl_data/2023-2024,S43G01N75,서울 삼성,Home,이동엽,5,0,3,0.0,1,2,50.0,1,5,20.0,2,2,100.0,0,5,5,1,0,0,0,0,0,3
../kbl_data/2023-2024,S43G01N75,서울 삼성,Home,최승욱,4,0,1,0.0,1,2,50.0,1,3,33.3,1,2,50.0,0,1,1,1,1,0,0,0,2,3
../kbl_data/2023-2024,S43G01N75,서울 삼성,Home,윤성원,5,1,2,50.0,1,2,50.0,2,4,50.0,0,0,0.0,0,2,2,0,0,0,0,0,0,2
../kbl_data/2023-2024,S43G01N75,서울 삼성,Home,김무성,0,0,0,0.0,0,0,0.0,0,0,0.0,0,2,0.0,0,0,0,1,0,0,0,0,0,1
../kbl_data/2023-2024,S43G01N75,서울 삼성,Home,박민우,2,0,0,0.0,0,0,0.0,0,0,0.0,2,2,100.0,1,1,2,0,0,0,0,0,0,1
../kbl_data/2023-2024,S43G01N75,서울 삼성,Home,신동혁,2,1,1,100.0,0,3,0.0,1,4,25.0,0,0,0.0,0,2,2,1,2,1,0,0,1,3
../kbl_data/2023-2024,S43G01N75,서울 삼성,Home,아반 나바,2,1,3,33.3,0,1,0.0,1,4,25.0,0,0,0.0,0,1,1,0,0,0,0,0,0,0
../kbl_data/2023-2024,S43G01N75,서울 삼성,Home,이스마엘 레인,12,6,9,66.7,0,1,0.0,6,10,60.0,0,0,0.0,1,2,3,0,0,0,0,1,0,2
../kbl_data/2023-2024,S43G01N75,서울 삼성,Home,코피 코번,11,5,11,45.5,0,0,0.0,5,11,45.5,1,2,50.0,2,8,10,0,1,0,0,0,5,1
../kbl_data/2023-2024,S43G01N75,고양 소노,Away,최현민,6,0,0,0.0,2,3,66.7,2,3,66.7,0,0,0.0,0,3,3,1,1,0,0,0,0,3
../kbl_data/2023-2024,S43G01N75,고양 소노,Away,김민욱,3,0,1,0.0,1,1,100.0,1,2,50.0,0,0,0.0,1,0,1,0,0,0,0,0,1,0
../kbl_data/2023-2024,S43G01N75,고양 소노,Away,한호빈,12,2,3,66.7,2,8,25.0,4,11,36.4,2,2,100.0,0,2,2,3,0,0,0,0,1,2
../kbl_data/2023-2024,S43G01N75,고양 소노,Away,전성현,16,2,4,50.0,4,10,40.0,6,14,42.9,0,0,0.0,0,4,4,2,0,0,0,0,2,2
../kbl_data/2023-2024,S43G01N75,고양 소노,Away,김지후,0,0,0,0.0,0,1,0.0,0,1,0.0,0,0,0.0,0,0,0,0,0,0,0,0,0,0
../kbl_data/2023-2024,S43G01N75,고양 소노,Away,김진유,0,0,0,0.0,0,1,0.0,0,1,0.0,0,0,0.0,3,2,5,1,1,0,0,0,1,5
../kbl_data/2023-2024,S43G01N75,고양 소노,Away,치나누 오누아쿠,17,7,13,53.8,0,1,0.0,7,14,50.0,3,5,60.0,2,8,10,3,1,0,1,0,3,3
../kbl_data/2023-2024,S43G01N75,고양 소노,Away,이정현,72,16,26,61.5,6,16,37.5,22,42,52.4,22,24,91.7,4,4,8,16,6,0,0,0,2,6
../kbl_data/2023-2024,S43G01N75,고양 소노,Away,백지웅,0,0,0,0.0,0,0,0.0,0,0,0.0,0,0,0.0,0,0,0,0,0,0,0,0,0,1
../kbl_data/2023-2024,S43G01N75,고양 소노,Away,조재우,0,0,0,0.0,0,0,0.0,0,0,0.0,0,0,0.0,0,0,0,0,0,0,0,0,0,0
../kbl_data/2023-2024,S43G01N75,고양 소노,Away,조쉬 토랄바,0,0,0,0.0,0,2,0.0,0,2,0.0,0,0,0.0,0,2,2,1,0,0,0,0,0,1
../kbl_data/2023-2024,S43G01N75,고양 소노,Away,디욘테 데이비스,2,1,4,25.0,0,2,0.0,1,6,16.7,0,0,0.0,3,7,10,0,0,2,0,0,1,1
../kbl_data/2023-2024,S43G01N76,원주 DB,Home,김현호,0,0,0,0.0,0,0,0.0,0,0,0.0,0,0,0.0,0,0,0,0,0,0,0,0,0,0
../kbl_data/2023-2024,S43G01N76,원주 DB,Home,서민수,1,0,0,0.0,0,0,0.0,0,0,0.0,1,2,50.0,0,0,0,0,1,0,0,0,0,0
../kbl_data/2023-2024,S43G01N76,원주 DB,Home,김영현,0,0,0,0.0,0,1,0.0,0,1,0.0,0,0,0.0,0,0,0,0,1,0,0,0,0,2
../kbl_data/2023-2024,S43G01N76,원주 DB,Home,김종규,9,2,5,40.0,1,2,50.0,3,7,42.9,2,3,66.7,0,3,3,0,0,1,0,0,0,3
../kbl_data/2023-2024,S43G01N76,원주 DB,Home,최승욱,4,2,6,33.3,0,3,0.0,2,9,22.2,0,0,0.0,0,0,0,0,0,0,0,0,1,3
../kbl_data/2023-2024,S43G01N76,원주 DB,Home,강상재,22,8,9,88.9,1,3,33.3,9,12,75.0,3,5,60.0,3,2,5,2,1,0,0,0,1,0
../kbl_data/2023-2024,S43G01N76,원주 DB,Home,디드릭 로슨,12,3,8,37.5,1,6,16.7,4,14,28.6,3,4,75.0,1,12,13,6,2,0,0,0,2,2
../kbl_data/2023-2024,S43G01N76,원주 DB,Home,이용우,3,0,0,0.0,1,2,50.0,1,2,50.0,0,0,0.0,1,0,1,0,0,0,1,0,2,3
../kbl_data/2023-2024,S43G01N76,원주 DB,Home,이선 알바노,14,7,13,53.8,0,1,0.0,7,14,50.0,0,0,0.0,0,1,1,9,1,0,0,0,2,3
../kbl_data/2023-2024,S43G01N76,원주 DB,Home,박인웅,2,1,2,50.0,0,1,0.0,1,3,33.3,0,0,0.0,1,2,3,0,1,0,0,0,0,1
../kbl_data/2023-2024,S43G01N76,원주 DB,Home,박승재,2,1,1,100.0,0,1,0.0,1,2,50.0,0,0,0.0,0,0,0,0,0,0,0,0,0,0
../kbl_data/2023-2024,S43G01N76,원주 DB,Home,제프 위디,1,0,2,0.0,0,1,0.0,0,3,0.0,1,2,50.0,0,1,1,0,0,1,0,0,0,0
../kbl_data/2023-2024,S43G01N76,창원 LG,Away,이관희,6,1,3,33.3,1,2,50.0,2,5,40.0,1,2,50.0,0,0,0,0,0,0,0,0,0,0
../kbl_data/2023-2024,S43G01N76,창원 LG,Away,정희재,13,2,3,66.7,3,6,50.0,5,9,55.6,0,0,0.0,1,1,2,0,0,0,0,0,0,4
../kbl_data/2023-2024,S43G01N76,창원 LG,Away,임동섭,0,0,0,0.0,0,0,0.0,0,0,0.0,0,0,0.0,0,0,0,0,0,0,0,0,0,1
../kbl_data/2023-2024,S43G01N76,창원 LG,Away,이재도,16,6,9,66.7,1,4,25.0,7,13,53.8,1,2,50.0,0,5,5,4,0,0,0,0,1,2
../kbl_data/2023-2024,S43G01N76,창원 LG,Away,정인덕,2,1,1,100.0,0,0,0.0,1,1,100.0,0,0,0.0,0,0,0,0,0,0,0,0,0,0
../kbl_data/2023-2024,S43G01N76,창원 LG,Away,양홍석,15,4,7,57.1,2,7,28.6,6,14,42.9,1,1,100.0,2,2,4,5,1,0,0,0,3,4
../kbl_data/2023-2024,S43G01N76,창원 LG,Away,박정현,6,1,2,50.0,1,2,50.0,2,4,50.0,1,2,50.0,2,3,5,1,0,0,0,0,0,0
../kbl_data/2023-2024,S43G01N76,창원 LG,Away,윤원상,3,0,0,0.0,1,1,100.0,1,1,100.0,0,0,0.0,0,1,1,0,0,0,0,0,0,0
../kbl_data/2023-2024,S43G01N76,창원 LG,Away,아셈 마레이,17,7,9,77.8,0,0,0.0,7,9,77.8,3,5,60.0,7,17,24,5,3,1,0,0,3,3
../kbl_data/2023-2024,S43G01N76,창원 LG,Away,저스틴 구탕,2,1,3,33.3,0,0,0.0,1,3,33.3,0,0,0.0,0,3,3,3,0,0,0,0,1,1
../kbl_data/2023-2024,S43G01N76,창원 LG,Away,양준석,2,1,1,100.0,0,1,0.0,1,2,50.0,0,0,0.0,0,0,0,1,0,0,0,0,2,2
../kbl_data/2023-2024,S43G01N76,창원 LG,Away,유기상,9,2,4,50.0,1,6,16.7,3,10,30.0,2,2,100.0,0,1,1,1,1,0,0,0,1,3
../kbl_data/2023-2024,S43G01N77,서울 SK,Home,허일영,8,2,2,100.0,0,2,0.0,2,4,50.0,4,4,100.0,1,3,4,0,1,0,0,0,0,2
../kbl_data/2023-2024,S43G01N77,서울 SK,Home,송창용,0,0,0,0.0,0,0,0.0,0,0,0.0,0,0,0.0,0,0,0,0,0,0,0,0,0,0
../kbl_data/2023-2024,S43G01N77,서울 SK,Home,김선형,4,2,6,33.3,0,1,0.0,2,7,28.6,0,0,0.0,0,2,2,3,2,0,0,0,4,2
../kbl_data/2023-2024,S43G01N77,서울 SK,Home,홍경기,0,0,0,0.0,0,0,0.0,0,0,0.0,0,0,0.0,0,0,0,0,0,0,0,0,0,0
../kbl_data/2023-2024,S43G01N77,서울 SK,Home,오세근,8,2,5,40.0,0,3,0.0,2,8,25.0,4,4,100.0,1,5,6,3,1,0,0,0,0,3
../kbl_data/2023-2024,S43G01N77,서울 SK,Home,최부경,4,2,2,100.0,0,0,0.0,2,2,100.0,0,0,0.0,1,1,2,1,1,0,0,0,0,5
../kbl_data/2023-2024,S43G01N77,서울 SK,Home,리온 윌리엄스,0,0,1,0.0,0,0,0.0,0,1,0.0,0,0,0.0,0,1,1,0,0,0,0,0,0,0
../kbl_data/2023-2024,S43G01N77,서울 SK,Home,최원혁,0,0,1,0.0,0,1,0.0,0,2,0.0,0,0,0.0,0,1,1,1,0,0,0,0,1,1
../kbl_data/2023-2024,S43G01N77,서울 SK,Home,안영준,14,2,5,40.0,2,9,22.2,4,14,28.6,4,4,100.0,1,5,6,1,2,0,0,0,0,2
../kbl_data/2023-2024,S43G01N77,서울 SK,Home,자밀 워니,23,11,29,37.9,0,2,0.0,11,31,35.5,1,4,25.0,5,10,15,0,0,0,0,0,1,3
../kbl_data/2023-2024,S43G01N77,서울 SK,Home,김형빈,0,0,0,0.0,0,0,0.0,0,0,0.0,0,0,0.0,0,0,0,0,0,0,0,0,0,0
../kbl_data/2023-2024,S43G01N77,서울 SK,Home,오재현,11,4,4,100.0,1,2,50.0,5,6,83.3,0,0,0.0,0,2,2,1,2,0,1,0,0,1
../kbl_data/2023-2024,S43G01N77,부산 KCC,Away,정창영,0,0,0,0.0,0,0,0.0,0,0,0.0,0,0,0.0,0,0,0,0,0,0,0,0,0,0
../kbl_data/2023-2024,S43G01N77,부산 KCC,Away,라건아,17,7,10,70.0,0,1,0.0,7,11,63.6,3,4,75.0,3,5,8,2,1,1,0,0,0,2
../kbl_data/2023-2024,S43G01N77,부산 KCC,Away,허웅,10,1,3,33.3,2,7,28.6,3,10,30.0,2,2,100.0,0,5,5,5,0,0,0,0,2,5
../kbl_data/2023-2024,S43G01N77,부산 KCC,Away,이승현,6,3,4,75.0,0,0,0.0,3,4,75.0,0,0,0.0,1,3,4,0,0,0,0,0,1,1
../kbl_data/2023-2024,S43G01N77,부산 KCC,Away,이호현,6,2,4,50.0,0,3,0.0,2,7,28.6,2,2,100.0,1,2,3,2,1,0,0,0,2,3
../kbl_data/2023-2024,S43G01N77,부산 KCC,Away,송교창,6,3,5,60.0,0,1,0.0,3,6,50.0,0,0,0.0,1,1,2,2,0,0,0,0,1,2
../kbl_data/2023-2024,S43G01N77,부산 KCC,Away,최준용,14,4,9,44.4,1,9,11.1,5,18,27.8,3,4,75.0,2,13,15,4,0,3,0,1,3,3
../kbl_data/2023-2024,S43G01N77,부산 KCC,Away,곽정훈,0,0,0,0.0,0,0,0.0,0,0,0.0,0,0,0.0,0,0,0,0,0,0,0,0,0,0
../kbl_data/2023-2024,S43G01N77,부산 KCC,Away,이근휘,5,1,1,100.0,1,3,33.3,2,4,50.0,0,0,0.0,0,0,0,0,0,0,0,0,0,1
../kbl_data/2023-2024,S43G01N77,부산 KCC,Away,김동현,0,0,0,0.0,0,0,0.0,0,0,0.0,0,0,0.0,0,0,0,0,0,0,0,0,0,0
../kbl_data/2023-2024,S43G01N77,부산 KCC,Away,송동훈,0,0,0,0.0,0,0,0.0,0,0,0.0,0,0,0.0,0,0,0,0,0,0,0,0,0,0
../kbl_data/2023-2024,S43G01N77,부산 KCC,Away,알리제 드숀 존슨,10,3,5,60.0,0,1,0.0,3,6,50.0,4,5,80.0,1,7,8,2,2,0,0,0,2,1
../kbl_data/2023-2024,S43G01N78,대구 한국가스공사,Home,김동량,0,0,0,0.0,0,0,0.0,0,0,0.0,0,0,0.0,0,0,0,0,1,0,0,0,0,0
../kbl_data/2023-2024,S43G01N78,대구 한국가스공사,Home,차바위,6,0,0,0.0,2,3,66.7,2,3,66.7,0,0,0.0,0,2,2,0,0,1,0,0,3,3
../kbl_data/2023-2024,S43G01N78,대구 한국가스공사,Home,박지훈,9,0,0,0.0,2,4,50.0,2,4,50.0,3,4,75.0,0,3,3,2,1,0,0,0,1,1
../kbl_data/2023-2024,S43G01N78,대구 한국가스공사,Home,조상열,5,1,1,100.0,1,2,50.0,2,3,66.7,0,0,0.0,1,0,1,0,0,0,0,0,1,0
../kbl_data/2023-2024,S43G01N78,대구 한국가스공사,Home,이원대,2,1,1,100.0,0,1,0.0,1,2,50.0,0,0,0.0,0,1,1,3,0,0,0,0,0,1
../kbl_data/2023-2024,S43G01N78,대구 한국가스공사,Home,이대헌,12,5,10,50.0,0,1,0.0,5,11,45.5,2,2,100.0,0,3,3,3,0,0,0,0,1,1
../kbl_data/2023-2024,S43G01N78,대구 한국가스공사,Home,양재혁,0,0,0,0.0,0,0,0.0,0,0,0.0,0,0,0.0,1,0,1,0,0,0,0,0,0,1
../kbl_data/2023-2024,S43G01N78,대구 한국가스공사,Home,앤드류 니콜슨,9,3,5,60.0,1,6,16.7,4,11,36.4,0,0,0.0,1,5,6,0,0,0,0,0,3,0
../kbl_data/2023-2024,S43G01N78,대구 한국가스공사,Home,신승민,0,0,1,0.0,0,2,0.0,0,3,0.0,0,0,0.0,0,4,4,1,0,1,0,0,1,3
../kbl_data/2023-2024,S43G01N78,대구 한국가스공사,Home,샘조세프 벨란겔,10,1,2,50.0,2,3,66.7,3,5,60.0,2,2,100.0,0,1,1,4,0,0,0,0,5,3
../kbl_data/2023-2024,S43G01N78,대구 한국가스공사,Home,안세영,16,3,5,60.0,3,3,100.0,6,8,75.0,1,1,100.0,0,1,1,0,1,0,0,0,1,2
../kbl_data/2023-2024,S43G01N78,대구 한국가스공사,Home,듀반 맥스웰,12,5,5,100.0,0,1,0.0,5,6,83.3,2,4,50.0,1,5,6,1,0,2,1,0,2,3
../kbl_data/2023-2024,S43G01N78,수원 KT,Away,한희원,3,0,0,0.0,1,2,50.0,1,2,50.0,0,0,0.0,0,1,1,3,1,2,0,0,0,2
../kbl_data/2023-2024,S43G01N78,수원 KT,Away,최창진,7,2,2,100.0,1,1,100.0,3,3,100.0,0,1,0.0,1,1,2,4,0,0,0,0,1,3
../kbl_data/2023-2024,S43G01N78,수원 KT,Away,문성곤,0,0,0,0.0,0,2,0.0,0,2,0.0,0,0,0.0,0,1,1,0,6,0,0,0,1,4
../kbl_data/2023-2024,S43G01N78,수원 KT,Away,이현석,0,0,2,0.0,0,2,0.0,0,4,0.0,0,0,0.0,0,1,1,0,0,1,0,0,1,1
../kbl_data/2023-2024,S43G01N78,수원 KT,Away,정성우,10,0,0,0.0,3,5,60.0,3,5,60.0,1,2,50.0,0,1,1,4,0,0,0,0,0,1
../kbl_data/2023-2024,S43G01N78,수원 KT,Away,허훈,7,2,4,50.0,1,6,16.7,3,10,30.0,0,0,0.0,1,0,1,5,1,0,0,0,0,2
../kbl_data/2023-2024,S43G01N78,수원 KT,Away,박찬호,0,0,0,0.0,0,0,0.0,0,0,0.0,0,0,0.0,0,0,0,0,0,0,0,0,0,0
../kbl_data/2023-2024,S43G01N78,수원 KT,Away,김준환,4,2,3,66.7,0,1,0.0,2,4,50.0,0,0,0.0,0,0,0,0,0,0,0,0,0,0
../kbl_data/2023-2024,S43G01N78,수원 KT,Away,이두원,12,6,10,60.0,0,0,0.0,6,10,60.0,0,0,0.0,3,3,6,1,0,0,0,1,0,2
../kbl_data/2023-2024,S43G01N78,수원 KT,Away,숀 데이브 일데폰소,12,2,3,66.7,2,6,33.3,4,9,44.4,2,2,100.0,1,2,3,3,2,0,0,0,0,0
../kbl_data/2023-2024,S43G01N78,수원 KT,Away,문정현,13,3,3,100.0,2,3,66.7,5,6,83.3,1,1,100.0,3,1,4,2,0,0,0,0,3,2
../kbl_data/2023-2024,S43G01N78,수원 KT,Away,패리스 배스,31,7,10,70.0,5,9,55.6,12,19,63.2,2,3,66.7,1,9,10,4,4,1,0,2,2,3
../kbl_data/2023-2024,S43G01N79,울산 현대모비스,Home,함지훈,15,6,7,85.7,0,1,0.0,6,8,75.0,3,5,60.0,3,5,8,5,0,0,0,0,0,1
../kbl_data/2023-2024,S43G01N79,울산 현대모비스,Home,김현민,0,0,0,0.0,0,0,0.0,0,0,0.0,0,0,0.0,0,0,0,0,0,0,0,0,0,0
../kbl_data/2023-2024,S43G01N79,울산 현대모비스,Home,최진수,0,0,0,0.0,0,0,0.0,0,0,0.0,0,0,0.0,0,0,0,0,0,0,0,0,0,0
../kbl_data/2023-2024,S43G01N79,울산 현대모비스,Home,김현수,0,0,0,0.0,0,0,0.0,0,0,0.0,0,0,0.0,0,0,0,0,0,0,0,0,0,1
../kbl_data/2023-2024,S43G01N79,울산 현대모비스,Home,장재석,0,0,1,0.0,0,0,0.0,0,1,0.0,0,0,0.0,2,0,2,1,0,0,0,0,1,1
../kbl_data/2023-2024,S43G01N79,울산 현대모비스,Home,김지완,5,1,1,100.0,1,7,14.3,2,8,25.0,0,0,0.0,0,3,3,7,0,0,0,0,1,3
../kbl_data/2023-2024,S43G01N79,울산 현대모비스,Home,김국찬,17,1,2,50.0,5,9,55.6,6,11,54.5,0,2,0.0,2,2,4,1,1,0,2,0,1,4
../kbl_data/2023-2024,S43G01N79,울산 현대모비스,Home,박준은,0,0,0,0.0,0,0,0.0,0,0,0.0,0,0,0.0,0,0,0,0,0,0,0,0,0,0
../kbl_data/2023-2024,S43G01N79,울산 현대모비스,Home,이우석,11,4,8,50.0,1,2,50.0,5,10,50.0,0,0,0.0,2,7,9,1,3,0,0,0,3,2
../kbl_data/2023-2024,S43G01N79,울산 현대모비스,Home,게이지 프림,13,4,20,20.0,0,0,0.0,4,20,20.0,5,6,83.3,0,5,5,4,2,0,0,0,1,2
../kbl_data/2023-2024,S43G01N79,울산 현대모비스,Home,김태완,0,0,0,0.0,0,0,0.0,0,0,0.0,0,0,0.0,0,0,0,0,0,0,0,0,1,2
../kbl_data/2023-2024,S43G01N79,울산 현대모비스,Home,케베 알루마,5,1,3,33.3,1,1,100.0,2,4,50.0,0,0,0.0,1,3,4,0,0,1,0,0,3,4
../kbl_data/2023-2024,S43G01N79,고양 소노,Away,최현민,3,0,1,0.0,1,4,25.0,1,5,20.0,0,0,0.0,1,3,4,2,0,0,0,0,0,4
../kbl_data/2023-2024,S43G01N79,고양 소노,Away,김민욱,5,1,1,100.0,1,3,33.3,2,4,50.0,0,0,0.0,3,1,4,0,0,0,2,0,0,1
../kbl_data/2023-2024,S43G01N79,고양 소노,Away,한호빈,9,2,6,33.3,1,4,25.0,3,10,30.0,2,2,100.0,1,3,4,3,0,0,0,0,0,1
../kbl_data/2023-2024,S43G01N79,고양 소노,Away,전성현,6,0,4,0.0,2,6,33.3,2,10,20.0,0,0,0.0,0,0,0,0,0,0,0,0,1,2
../kbl_data/2023-2024,S43G01N79,고양 소노,Away,김지후,0,0,0,0.0,0,0,0.0,0,0,0.0,0,0,0.0,0,0,0,0,0,0,0,0,0,0
../kbl_data/2023-2024,S43G01N79,고양 소노,Away,김진유,2,1,3,33.3,0,1,0.0,1,4,25.0,0,0,0.0,1,3,4,0,1,0,1,0,0,2
../kbl_data/2023-2024,S43G01N79,고양 소노,Away,치나누 오누아쿠,22,7,11,63.6,2,3,66.7,9,14,64.3,2,2,100.0,4,10,14,2,2,2,0,0,5,4
../kbl_data/2023-2024,S43G01N79,고양 소노,Away,이정현,16,5,10,50.0,2,10,20.0,7,20,35.0,0,0,0.0,0,6,6,4,2,0,0,0,4,3
../kbl_data/2023-2024,S43G01N79,고양 소노,Away,백지웅,3,0,0,0.0,1,3,33.3,1,3,33.3,0,0,0.0,1,0,1,2,0,0,0,0,0,0
../kbl_data/2023-2024,S43G01N79,고양 소노,Away,조재우,0,0,0,0.0,0,0,0.0,0,0,0.0,0,0,0.0,0,0,0,0,0,0,0,0,0,0
../kbl_data/2023-2024,S43G01N79,고양 소노,Away,조쉬 토랄바,0,0,0,0.0,0,0,0.0,0,0,0.0,0,0,0.0,0,0,0,0,0,0,0,0,0,0
../kbl_data/2023-2024,S43G01N79,고양 소노,Away,디욘테 데이비스,5,0,0,0.0,0,0,0.0,0,0,0.0,5,6,83.3,0,0,0,0,0,0,0,0,0,0
../kbl_data/2023-2024,S43G01N80,서울 SK,Home,허일영,4,2,5,40.0,0,1,0.0,2,6,33.3,0,0,0.0,0,0,0,0,0,0,0,0,1,1
../kbl_data/2023-2024,S43G01N80,서울 SK,Home,송창용,0,0,0,0.0,0,0,0.0,0,0,0.0,0,0,0.0,0,0,0,0,0,0,0,0,0,0
../kbl_data/2023-2024,S43G01N80,서울 SK,Home,김선형,10,1,3,33.3,2,3,66.7,3,6,50.0,2,2,100.0,0,3,3,10,3,0,0,0,0,1
../kbl_data/2023-2024,S43G01N80,서울 SK,Home,홍경기,0,0,0,0.0,0,0,0.0,0,0,0.0,0,0,0.0,0,0,0,0,0,0,0,0,0,0
../kbl_data/2023-2024,S43G01N80,서울 SK,Home,오세근,7,1,4,25.0,1,1,100.0,2,5,40.0,2,2,100.0,2,2,4,0,1,0,0,0,0,1
../kbl_data/2023-2024,S43G01N80,서울 SK,Home,최부경,7,3,8,37.5,0,0,0.0,3,8,37.5,1,1,100.0,0,3,3,1,2,0,0,0,0,1
../kbl_data/2023-2024,S43G01N80,서울 SK,Home,리온 윌리엄스,0,0,0,0.0,0,0,0.0,0,0,0.0,0,0,0.0,0,0,0,0,0,0,0,0,0,0
../kbl_data/2023-2024,S43G01N80,서울 SK,Home,최원혁,5,1,1,100.0,1,4,25.0,2,5,40.0,0,0,0.0,0,2,2,4,2,0,1,0,0,3
../kbl_data/2023-2024,S43G01N80,서울 SK,Home,안영준,20,1,3,33.3,6,8,75.0,7,11,63.6,0,0,0.0,2,8,10,2,0,0,0,0,4,1
../kbl_data/2023-2024,S43G01N80,서울 SK,Home,자밀 워니,26,10,12,83.3,1,4,25.0,11,16,68.8,3,6,50.0,1,8,9,5,2,3,0,1,0,1
../kbl_data/2023-2024,S43G01N80,서울 SK,Home,김형빈,0,0,0,0.0,0,0,0.0,0,0,0.0,0,0,0.0,0,0,0,0,0,0,0,0,0,0
../kbl_data/2023-2024,S43G01N80,서울 SK,Home,오재현,6,0,2,0.0,2,8,25.0,2,10,20.0,0,0,0.0,0,1,1,1,2,0,0,0,3,1
../kbl_data/2023-2024,S43G01N80,안양 정관장,Away,정준원,5,1,1,100.0,1,2,50.0,2,3,66.7,0,0,0.0,0,0,0,0,0,0,0,0,1,1
../kbl_data/2023-2024,S43G01N80,안양 정관장,Away,정효근,3,0,2,0.0,1,3,33.3,1,5,20.0,0,0,0.0,0,4,4,3,0,1,0,0,4,3
../kbl_data/2023-2024,S43G01N80,안양 정관장,Away,이종현,2,1,3,33.3,0,0,0.0,1,3,33.3,0,0,0.0,0,0,0,0,0,0,0,0,1,1
../kbl_data/2023-2024,S43G01N80,안양 정관장,Away,김철욱,0,0,0,0.0,0,0,0.0,0,0,0.0,0,0,0.0,0,0,0,0,0,0,0,0,0,0
../kbl_data/2023-2024,S43G01N80,안양 정관장,Away,박지훈,13,5,6,83.3,1,3,33.3,6,9,66.7,0,1,0.0,1,1,2,4,2,0,0,0,4,4
../kbl_data/2023-2024,S43G01N80,안양 정관장,Away,최성원,10,2,5,40.0,2,3,66.7,4,8,50.0,0,0,0.0,0,1,1,3,0,0,0,0,2,1
../kbl_data/2023-2024,S43G01N80,안양 정관장,Away,대릴 먼로,5,1,2,50.0,1,2,50.0,2,4,50.0,0,0,0.0,2,2,4,3,0,0,0,0,0,1
../kbl_data/2023-2024,S43G01N80,안양 정관장,Away,장태빈,0,0,0,0.0,0,0,0.0,0,0,0.0,0,0,0.0,0,0,0,0,0,0,0,0,0,0
../kbl_data/2023-2024,S43G01N80,안양 정관장,Away,김경원,12,6,7,85.7,0,0,0.0,6,7,85.7,0,0,0.0,2,7,9,1,3,1,0,1,1,1
../kbl_data/2023-2024,S43G01N80,안양 정관장,Away,오마리 스펠맨,13,2,6,33.3,3,8,37.5,5,14,35.7,0,0,0.0,1,8,9,1,0,0,0,0,2,1
../kbl_data/2023-2024,S43G01N80,안양 정관장,Away,렌즈 아반도,8,1,8,12.5,1,3,33.3,2,11,18.2,3,4,75.0,1,5,6,1,1,0,0,0,3,3
../kbl_data/2023-2024,S43G01N80,안양 정관장,Away,고찬혁,0,0,0,0.0,0,0,0.0,0,0,0.0,0,0,0.0,0,0,0,0,0,0,0,0,0,0
../kbl_data/2023-2024,S43G01N81,부산 KCC,Home,정창영,6,2,3,66.7,0,2,0.0,2,5,40.0,2,2,100.0,1,1,2,4,0,1,0,0,3,1
../kbl_data/2023-2024,S43G01N81,부산 KCC,Home,라건아,4,2,4,50.0,0,2,0.0,2,6,33.3,0,0,0.0,1,1,2,0,0,0,0,0,0,1
../kbl_data/2023-2024,S43G01N81,부산 KCC,Home,허웅,7,2,7,28.6,1,5,20.0,3,12,25.0,0,0,0.0,2,2,4,0,0,0,1,0,0,3
../kbl_data/2023-2024,S43G01N81,부산 KCC,Home,이승현,6,3,5,60.0,0,0,0.0,3,5,60.0,0,0,0.0,1,1,2,0,1,0,0,0,0,2
../kbl_data/2023-2024,S43G01N81,부산 KCC,Home,이호현,5,1,1,100.0,1,3,33.3,2,4,50.0,0,0,0.0,0,4,4,0,1,0,0,0,1,2
../kbl_data/2023-2024,S43G01N81,부산 KCC,Home,송교창,13,5,8,62.5,0,0,0.0,5,8,62.5,3,4,75.0,1,4,5,2,0,1,0,0,0,4
../kbl_data/2023-2024,S43G01N81,부산 KCC,Home,최준용,18,3,9,33.3,1,3,33.3,4,12,33.3,9,11,81.8,3,2,5,2,0,1,0,0,2,1
../kbl_data/2023-2024,S43G01N81,부산 KCC,Home,곽정훈,0,0,0,0.0,0,0,0.0,0,0,0.0,0,0,0.0,0,0,0,0,0,0,0,0,0,0
../kbl_data/2023-2024,S43G01N81,부산 KCC,Home,이근휘,3,0,1,0.0,1,1,100.0,1,2,50.0,0,0,0.0,0,1,1,0,0,1,0,0,0,1
../kbl_data/2023-2024,S43G01N81,부산 KCC,Home,김동현,0,0,0,0.0,0,0,0.0,0,0,0.0,0,0,0.0,0,0,0,0,0,0,0,0,0,0
../kbl_data/2023-2024,S43G01N81,부산 KCC,Home,송동훈,0,0,0,0.0,0,0,0.0,0,0,0.0,0,0,0.0,0,2,2,1,0,0,1,0,0,0
../kbl_data/2023-2024,S43G01N81,부산 KCC,Home,알리제 드숀 존슨,15,6,14,42.9,0,1,0.0,6,15,40.0,3,5,60.0,3,10,13,5,3,0,1,0,2,4
../kbl_data/2023-2024,S43G01N81,서울 삼성,Away,이정현,2,1,5,20.0,0,5,0.0,1,10,10.0,0,0,0.0,0,4,4,3,1,0,0,0,3,1
../kbl_data/2023-2024,S43G01N81,서울 삼성,Away,김승원,0,0,0,0.0,0,0,0.0,0,0,0.0,0,0,0.0,0,1,1,0,0,0,0,0,1,4
../kbl_data/2023-2024,S43G01N81,서울 삼성,Away,김시래,5,0,1,0.0,1,5,20.0,1,6,16.7,2,2,100.0,1,0,1,6,1,0,0,0,1,1
../kbl_data/2023-2024,S43G01N81,서울 삼성,Away,이동엽,2,1,4,25.0,0,2,0.0,1,6,16.7,0,0,0.0,2,3,5,4,1,0,0,0,1,1
../kbl_data/2023-2024,S43G01N81,서울 삼성,Away,최승욱,3,1,2,50.0,0,1,0.0,1,3,33.3,1,3,33.3,0,1,1,2,1,0,0,0,0,2
../kbl_data/2023-2024,S43G01N81,서울 삼성,Away,윤성원,3,0,2,0.0,1,5,20.0,1,7,14.3,0,0,0.0,1,1,2,0,0,0,0,0,0,3
../kbl_data/2023-2024,S43G01N81,서울 삼성,Away,김무성,0,0,0,0.0,0,0,0.0,0,0,0.0,0,0,0.0,0,0,0,0,0,0,0,0,0,0
../kbl_data/2023-2024,S43G01N81,서울 삼성,Away,박민우,9,0,0,0.0,3,5,60.0,3,5,60.0,0,0,0.0,0,1,1,0,0,0,0,0,1,3
../kbl_data/2023-2024,S43G01N81,서울 삼성,Away,신동혁,12,0,3,0.0,4,8,50.0,4,11,36.4,0,0,0.0,1,7,8,2,0,1,0,0,0,2
../kbl_data/2023-2024,S43G01N81,서울 삼성,Away,아반 나바,6,0,0,0.0,2,2,100.0,2,2,100.0,0,0,0.0,0,0,0,0,0,0,0,0,1,2
../kbl_data/2023-2024,S43G01N81,서울 삼성,Away,이스마엘 레인,11,5,8,62.5,0,1,0.0,5,9,55.6,1,2,50.0,1,4,5,1,1,0,0,1,1,1
../kbl_data/2023-2024,S43G01N81,서울 삼성,Away,코피 코번,21,8,11,72.7,0,0,0.0,8,11,72.7,5,7,71.4,5,4,9,2,1,0,0,0,2,3
../kbl_data/2023-2024,S43G01N82,원주 DB,Home,김현호,3,0,0,0.0,1,1,100.0,1,1,100.0,0,0,0.0,0,1,1,0,0,0,0,0,1,0
../kbl_data/2023-2024,S43G01N82,원주 DB,Home,서민수,0,0,1,0.0,0,3,0.0,0,4,0.0,0,0,0.0,0,3,3,1,0,0,0,0,0,4
../kbl_data/2023-2024,S43G01N82,원주 DB,Home,김영현,8,1,2,50.0,2,2,100.0,3,4,75.0,0,0,0.0,0,3,3,1,1,0,0,0,0,2
../kbl_data/2023-2024,S43G01N82,원주 DB,Home,김종규,8,4,5,80.0,0,0,0.0,4,5,80.0,0,0,0.0,1,3,4,0,0,1,0,1,1,1
../kbl_data/2023-2024,S43G01N82,원주 DB,Home,최승욱,4,2,3,66.7,0,0,0.0,2,3,66.7,0,0,0.0,0,0,0,0,0,0,0,0,0,1
../kbl_data/2023-2024,S43G01N82,원주 DB,Home,강상재,18,4,5,80.0,3,4,75.0,7,9,77.8,1,2,50.0,3,3,6,4,3,0,0,0,2,1
../kbl_data/2023-2024,S43G01N82,원주 DB,Home,디드릭 로슨,17,5,13,38.5,2,5,40.0,7,18,38.9,1,1,100.0,3,4,7,4,1,2,0,0,2,1
../kbl_data/2023-2024,S43G01N82,원주 DB,Home,이용우,0,0,0,0.0,0,0,0.0,0,0,0.0,0,0,0.0,0,0,0,0,0,0,0,0,0,0
../kbl_data/2023-2024,S43G01N82,원주 DB,Home,이선 알바노,15,4,7,57.1,1,1,100.0,5,8,62.5,4,4,100.0,0,4,4,7,2,0,0,0,3,4
../kbl_data/2023-2024,S43G01N82,원주 DB,Home,박인웅,5,1,1,100.0,1,3,33.3,2,4,50.0,0,0,0.0,1,0,1,0,0,0,0,0,0,0
../kbl_data/2023-2024,S43G01N82,원주 DB,Home,박승재,8,1,2,50.0,2,3,66.7,3,5,60.0,0,0,0.0,0,0,0,4,1,0,1,0,3,4
../kbl_data/2023-2024,S43G01N82,원주 DB,Home,제프 위디,2,1,4,25.0,0,0,0.0,1,4,25.0,0,0,0.0,0,4,4,1,1,0,0,0,2,2
../kbl_data/2023-2024,S43G01N82,대구 한국가스공사,Away,김동량,2,1,1,100.0,0,0,0.0,1,1,100.0,0,0,0.0,1,0,1,0,0,0,0,0,0,1
../kbl_data/2023-2024,S43G01N82,대구 한국가스공사,Away,차바위,0,0,0,0.0,0,1,0.0,0,1,0.0,0,0,0.0,1,0,1,0,0,0,0,0,0,0
../kbl_data/2023-2024,S43G01N82,대구 한국가스공사,Away,박지훈,3,0,1,0.0,1,2,50.0,1,3,33.3,0,0,0.0,0,1,1,1,1,0,0,0,1,0
../kbl_data/2023-2024,S43G01N82,대구 한국가스공사,Away,조상열,5,0,0,0.0,1,3,33.3,1,3,33.3,2,2,100.0,0,0,0,1,0,0,1,0,0,3
../kbl_data/2023-2024,S43G01N82,대구 한국가스공사,Away,이대헌,4,2,6,33.3,0,0,0.0,2,6,33.3,0,0,0.0,1,3,4,1,1,0,0,0,0,0
../kbl_data/2023-2024,S43G01N82,대구 한국가스공사,Away,양재혁,0,0,0,0.0,0,2,0.0,0,2,0.0,0,0,0.0,0,1,1,0,0,0,0,0,0,0
../kbl_data/2023-2024,S43G01N82,대구 한국가스공사,Away,양준우,5,0,1,0.0,1,2,50.0,1,3,33.3,2,2,100.0,1,1,2,2,0,0,1,0,1,0
../kbl_data/2023-2024,S43G01N82,대구 한국가스공사,Away,앤드류 니콜슨,17,6,15,40.0,1,5,20.0,7,20,35.0,2,2,100.0,1,6,7,0,0,1,0,2,0,2
../kbl_data/2023-2024,S43G01N82,대구 한국가스공사,Away,신승민,7,2,4,50.0,1,4,25.0,3,8,37.5,0,0,0.0,4,4,8,1,0,0,0,0,3,5
../kbl_data/2023-2024,S43G01N82,대구 한국가스공사,Away,샘조세프 벨란겔,20,4,6,66.7,3,7,42.9,7,13,53.8,3,4,75.0,0,3,3,3,2,0,0,0,3,4
../kbl_data/2023-2024,S43G01N82,대구 한국가스공사,Away,안세영,0,0,1,0.0,0,1,0.0,0,2,0.0,0,0,0.0,0,0,0,0,2,0,0,0,1,3
../kbl_data/2023-2024,S43G01N82,대구 한국가스공사,Away,듀반 맥스웰,11,5,14,35.7,0,0,0.0,5,14,35.7,1,2,50.0,6,1,7,0,0,2,0,1,1,1
../kbl_data/2023-2024,S43G01N83,수원 KT,Home,한희원,3,0,2,0.0,1,4,25.0,1,6,16.7,0,0,0.0,1,1,2,2,0,0,0,0,0,1
../kbl_data/2023-2024,S43G01N83,수원 KT,Home,최창진,0,0,1,0.0,0,0,0.0,0,1,0.0,0,0,0.0,0,2,2,2,0,0,1,0,1,2
../kbl_data/2023-2024,S43G01N83,수원 KT,Home,문성곤,2,1,1,100.0,0,4,0.0,1,5,20.0,0,0,0.0,5,0,5,3,3,0,0,0,0,4
../kbl_data/2023-2024,S43G01N83,수원 KT,Home,이현석,0,0,0,0.0,0,0,0.0,0,0,0.0,0,0,0.0,0,0,0,0,0,0,0,0,0,0
../kbl_data/2023-2024,S43G01N83,수원 KT,Home,정성우,5,2,3,66.7,0,3,0.0,2,6,33.3,1,1,100.0,1,1,2,8,0,0,0,0,0,3
../kbl_data/2023-2024,S43G01N83,수원 KT,Home,허훈,22,7,12,58.3,1,9,11.1,8,21,38.1,5,5,100.0,1,3,4,3,1,1,0,0,0,2
../kbl_data/2023-2024,S43G01N83,수원 KT,Home,하윤기,24,9,12,75.0,0,0,0.0,9,12,75.0,6,8,75.0,3,4,7,0,0,0,0,0,0,2
../kbl_data/2023-2024,S43G01N83,수원 KT,Home,이두원,8,4,4,100.0,0,0,0.0,4,4,100.0,0,0,0.0,0,0,0,0,1,0,0,1,1,2
../kbl_data/2023-2024,S43G01N83,수원 KT,Home,숀 데이브 일데폰소,0,0,0,0.0,0,0,0.0,0,0,0.0,0,0,0.0,0,0,0,0,0,0,0,0,0,0
../kbl_data/2023-2024,S43G01N83,수원 KT,Home,문정현,0,0,0,0.0,0,0,0.0,0,0,0.0,0,0,0.0,0,0,0,0,0,0,0,0,0,0
../kbl_data/2023-2024,S43G01N83,수원 KT,Home,마이클 에릭,0,0,0,0.0,0,0,0.0,0,0,0.0,0,0,0.0,0,1,1,0,0,0,0,0,0,0
../kbl_data/2023-2024,S43G01N83,수원 KT,Home,패리스 배스,22,4,9,44.4,4,11,36.4,8,20,40.0,2,4,50.0,4,4,8,3,1,1,0,0,3,3
../kbl_data/2023-2024,S43G01N83,고양 소노,Away,함준후,0,0,0,0.0,0,0,0.0,0,0,0.0,0,0,0.0,0,0,0,1,0,0,0,0,0,1
../kbl_data/2023-2024,S43G01N83,고양 소노,Away,최현민,3,0,3,0.0,1,2,50.0,1,5,20.0,0,0,0.0,3,2,5,0,1,0,0,0,2,5
../kbl_data/2023-2024,S43G01N83,고양 소노,Away,김민욱,3,1,1,100.0,0,4,0.0,1,5,20.0,1,1,100.0,1,1,2,0,0,0,0,0,1,2
../kbl_data/2023-2024,S43G01N83,고양 소노,Away,한호빈,10,2,3,66.7,2,7,28.6,4,10,40.0,0,0,0.0,0,3,3,6,1,0,1,0,1,3
../kbl_data/2023-2024,S43G01N83,고양 소노,Away,전성현,22,1,1,100.0,6,11,54.5,7,12,58.3,2,2,100.0,0,2,2,0,0,0,0,0,0,0
../kbl_data/2023-2024,S43G01N83,고양 소노,Away,김지후,0,0,1,0.0,0,0,0.0,0,1,0.0,0,0,0.0,1,0,1,0,0,0,0,0,0,0
../kbl_data/2023-2024,S43G01N83,고양 소노,Away,김진유,4,2,2,100.0,0,0,0.0,2,2,100.0,0,0,0.0,1,2,3,1,0,0,0,0,0,0
../kbl_data/2023-2024,S43G01N83,고양 소노,Away,치나누 오누아쿠,27,11,15,73.3,0,2,0.0,11,17,64.7,5,6,83.3,5,7,12,8,0,2,0,1,8,2
../kbl_data/2023-2024,S43G01N83,고양 소노,Away,이정현,12,1,3,33.3,3,7,42.9,4,10,40.0,1,2,50.0,0,4,4,3,1,0,0,0,4,4
../kbl_data/2023-2024,S43G01N83,고양 소노,Away,백지웅,0,0,0,0.0,0,0,0.0,0,0,0.0,0,0,0.0,0,0,0,0,0,0,0,0,0,0
../kbl_data/2023-2024,S43G01N83,고양 소노,Away,조재우,0,0,0,0.0,0,0,0.0,0,0,0.0,0,0,0.0,1,0,1,0,0,0,0,0,1,3
../kbl_data/2023-2024,S43G01N83,고양 소노,Away,디욘테 데이비스,0,0,0,0.0,0,0,0.0,0,0,0.0,0,0,0.0,0,0,0,0,0,0,0,0,0,0
../kbl_data/2023-2024,S43G01N84,서울 삼성,Home,이정현,13,0,2,0.0,4,7,57.1,4,9,44.4,1,2,50.0,0,5,5,3,2,0,0,0,0,1
../kbl_data/2023-2024,S43G01N84,서울 삼성,Home,김승원,0,0,1,0.0,0,0,0.0,0,1,0.0,0,0,0.0,0,0,0,0,0,0,0,0,0,0
../kbl_data/2023-2024,S43G01N84,서울 삼성,Home,김시래,10,1,3,33.3,2,5,40.0,3,8,37.5,2,2,100.0,1,2,3,2,0,0,0,0,2,3
../kbl_data/2023-2024,S43G01N84,서울 삼성,Home,이동엽,0,0,1,0.0,0,0,0.0,0,1,0.0,0,0,0.0,1,1,2,1,0,0,0,0,1,2
../kbl_data/2023-2024,S43G01N84,서울 삼성,Home,최승욱,2,1,2,50.0,0,1,0.0,1,3,33.3,0,0,0.0,1,2,3,0,1,0,1,0,1,0
../kbl_data/2023-2024,S43G01N84,서울 삼성,Home,윤성원,2,1,1,100.0,0,2,0.0,1,3,33.3,0,0,0.0,0,0,0,0,0,0,0,0,1,2
../kbl_data/2023-2024,S43G01N84,서울 삼성,Home,박민우,0,0,1,0.0,0,2,0.0,0,3,0.0,0,0,0.0,0,0,0,0,0,0,0,0,0,1
../kbl_data/2023-2024,S43G01N84,서울 삼성,Home,이원석,4,2,2,100.0,0,4,0.0,2,6,33.3,0,1,0.0,2,6,8,2,1,1,0,0,1,3
../kbl_data/2023-2024,S43G01N84,서울 삼성,Home,신동혁,10,0,4,0.0,3,4,75.0,3,8,37.5,1,4,25.0,2,1,3,2,0,1,0,0,0,2
../kbl_data/2023-2024,S43G01N84,서울 삼성,Home,아반 나바,18,6,10,60.0,2,3,66.7,8,13,61.5,0,0,0.0,0,1,1,4,1,0,0,0,0,2
../kbl_data/2023-2024,S43G01N84,서울 삼성,Home,이스마엘 레인,0,0,0,0.0,0,1,0.0,0,1,0.0,0,0,0.0,0,0,0,1,0,0,0,0,0,0
../kbl_data/2023-2024,S43G01N84,서울 삼성,Home,코피 코번,23,11,19,57.9,0,0,0.0,11,19,57.9,1,2,50.0,3,5,8,0,1,2,0,2,3,1
../kbl_data/2023-2024,S43G01N84,창원 LG,Away,이관희,14,7,13,53.8,0,2,0.0,7,15,46.7,0,0,0.0,1,1,2,1,0,0,0,0,0,2
../kbl_data/2023-2024,S43G01N84,창원 LG,Away,정희재,0,0,0,0.0,0,2,0.0,0,2,0.0,0,0,0.0,0,2,2,1,0,0,0,0,0,3
../kbl_data/2023-2024,S43G01N84,창원 LG,Away,임동섭,2,1,1,100.0,0,0,0.0,1,1,100.0,0,0,0.0,1,0,1,0,0,0,0,0,0,1
../kbl_data/2023-2024,S43G01N84,창원 LG,Away,이재도,21,6,8,75.0,3,3,100.0,9,11,81.8,0,0,0.0,1,1,2,3,0,0,0,0,0,0
../kbl_data/2023-2024,S43G01N84,창원 LG,Away,정인덕,2,1,1,100.0,0,1,0.0,1,2,50.0,0,0,0.0,0,0,0,0,0,0,0,0,0,0
../kbl_data/2023-2024,S43G01N84,창원 LG,Away,양홍석,22,9,11,81.8,1,3,33.3,10,14,71.4,1,3,33.3,3,5,8,3,1,1,0,0,1,2
../kbl_data/2023-2024,S43G01N84,창원 LG,Away,박정현,0,0,1,0.0,0,1,0.0,0,2,0.0,0,0,0.0,0,2,2,0,0,0,0,0,0,0
../kbl_data/2023-2024,S43G01N84,창원 LG,Away,윤원상,0,0,1,0.0,0,3,0.0,0,4,0.0,0,0,0.0,0,0,0,0,1,0,0,0,0,0
../kbl_data/2023-2024,S43G01N84,창원 LG,Away,아셈 마레이,12,5,10,50.0,0,0,0.0,5,10,50.0,2,2,100.0,1,9,10,8,2,0,0,1,3,4
../kbl_data/2023-2024,S43G01N84,창원 LG,Away,저스틴 구탕,6,3,4,75.0,0,0,0.0,3,4,75.0,0,0,0.0,1,3,4,4,1,0,0,1,2,0
../kbl_data/2023-2024,S43G01N84,창원 LG,Away,양준석,7,3,4,75.0,0,0,0.0,3,4,75.0,1,1,100.0,0,2,2,2,1,0,0,0,1,2
../kbl_data/2023-2024,S43G01N84,창원 LG,Away,유기상,9,0,1,0.0,2,4,50.0,2,5,40.0,3,3,100.0,1,3,4,0,0,1,0,0,1,4
../kbl_data/2023-2024,S43G01N86,울산 현대모비스,Home,함지훈,4,2,3,66.7,0,0,0.0,2,3,66.7,0,0,0.0,2,1,3,1,0,0,0,0,1,1
../kbl_data/2023-2024,S43G01N86,울산 현대모비스,Home,최진수,0,0,0,0.0,0,0,0.0,0,0,0.0,0,0,0.0,0,0,0,0,0,0,0,0,0,0
../kbl_data/2023-2024,S43G01N86,울산 현대모비스,Home,김현수,0,0,0,0.0,0,0,0.0,0,0,0.0,0,0,0.0,0,0,0,0,0,0,0,0,0,0
../kbl_data/2023-2024,S43G01N86,울산 현대모비스,Home,장재석,1,0,0,0.0,0,0,0.0,0,0,0.0,1,2,50.0,0,1,1,0,1,0,0,0,0,0
../kbl_data/2023-2024,S43G01N86,울산 현대모비스,Home,김지완,9,0,2,0.0,3,4,75.0,3,6,50.0,0,0,0.0,1,1,2,5,0,0,0,0,3,2
../kbl_data/2023-2024,S43G01N86,울산 현대모비스,Home,김준일,0,0,1,0.0,0,0,0.0,0,1,0.0,0,0,0.0,1,5,6,2,0,0,0,0,2,3
../kbl_data/2023-2024,S43G01N86,울산 현대모비스,Home,김국찬,4,0,1,0.0,1,1,100.0,1,2,50.0,1,2,50.0,1,1,2,0,0,0,0,0,3,2
../kbl_data/2023-2024,S43G01N86,울산 현대모비스,Home,이우석,7,2,7,28.6,1,9,11.1,3,16,18.8,0,0,0.0,1,3,4,2,1,0,0,0,0,4
../kbl_data/2023-2024,S43G01N86,울산 현대모비스,Home,게이지 프림,8,4,5,80.0,0,0,0.0,4,5,80.0,0,0,0.0,1,4,5,0,0,0,0,0,1,1
../kbl_data/2023-2024,S43G01N86,울산 현대모비스,Home,김태완,0,0,0,0.0,0,0,0.0,0,0,0.0,0,0,0.0,0,0,0,0,0,0,0,0,0,1
../kbl_data/2023-2024,S43G01N86,울산 현대모비스,Home,박무빈,9,4,7,57.1,0,5,0.0,4,12,33.3,1,2,50.0,0,2,2,1,1,0,1,0,1,4
../kbl_data/2023-2024,S43G01N86,울산 현대모비스,Home,케베 알루마,33,4,8,50.0,6,12,50.0,10,20,50.0,7,9,77.8,1,9,10,2,2,0,0,0,1,1
../kbl_data/2023-2024,S43G01N86,서울 SK,Away,양우섭,0,0,0,0.0,0,0,0.0,0,0,0.0,0,0,0.0,0,0,0,0,0,0,0,0,0,0
../kbl_data/2023-2024,S43G01N86,서울 SK,Away,허일영,0,0,0,0.0,0,0,0.0,0,0,0.0,0,0,0.0,0,0,0,0,0,0,0,0,0,1
../kbl_data/2023-2024,S43G01N86,서울 SK,Away,송창용,2,1,1,100.0,0,1,0.0,1,2,50.0,0,0,0.0,1,1,2,0,0,0,0,0,0,0
../kbl_data/2023-2024,S43G01N86,서울 SK,Away,김선형,14,3,5,60.0,2,3,66.7,5,8,62.5,2,4,50.0,0,4,4,4,0,0,0,0,0,1
../kbl_data/2023-2024,S43G01N86,서울 SK,Away,오세근,4,2,3,66.7,0,2,0.0,2,5,40.0,0,0,0.0,0,2,2,0,0,0,0,0,0,3
../kbl_data/2023-2024,S43G01N86,서울 SK,Away,최부경,4,1,3,33.3,0,0,0.0,1,3,33.3,2,2,100.0,1,4,5,2,2,0,0,0,0,2
../kbl_data/2023-2024,S43G01N86,서울 SK,Away,리온 윌리엄스,2,1,1,100.0,0,0,0.0,1,1,100.0,0,0,0.0,0,1,1,0,0,0,0,0,1,2
../kbl_data/2023-2024,S43G01N86,서울 SK,Away,최원혁,0,0,0,0.0,0,1,0.0,0,1,0.0,0,0,0.0,0,0,0,3,0,0,0,0,0,4
../kbl_data/2023-2024,S43G01N86,서울 SK,Away,안영준,16,2,5,40.0,2,4,50.0,4,9,44.4,6,8,75.0,0,5,5,4,3,0,0,0,3,1
../kbl_data/2023-2024,S43G01N86,서울 SK,Away,자밀 워니,24,10,19,52.6,0,1,0.0,10,20,50.0,4,6,66.7,1,5,6,3,1,1,0,2,3,3
../kbl_data/2023-2024,S43G01N86,서울 SK,Away,오재현,10,1,3,33.3,2,5,40.0,3,8,37.5,2,2,100.0,0,1,1,2,0,0,0,0,1,3
../kbl_data/2023-2024,S43G01N86,서울 SK,Away,고메즈 딜 리아노,2,1,2,50.0,0,1,0.0,1,3,33.3,0,0,0.0,0,0,0,0,0,1,0,0,0,0
../kbl_data/2023-2024,S43G01N87,고양 소노,Home,김강선,0,0,1,0.0,0,5,0.0,0,6,0.0,0,0,0.0,0,2,2,1,1,0,0,0,0,0
../kbl_data/2023-2024,S43G01N87,고양 소노,Home,함준후,0,0,1,0.0,0,0,0.0,0,1,0.0,0,0,0.0,0,0,0,0,0,0,0,0,0,0
../kbl_data/2023-2024,S43G01N87,고양 소노,Home,최현민,11,1,2,50.0,3,10,30.0,4,12,33.3,0,0,0.0,1,3,4,1,2,0,0,0,1,3
../kbl_data/2023-2024,S43G01N87,고양 소노,Home,김민욱,2,1,3,33.3,0,1,0.0,1,4,25.0,0,0,0.0,0,0,0,0,0,0,0,0,0,1
../kbl_data/2023-2024,S43G01N87,고양 소노,Home,한호빈,12,1,2,50.0,3,6,50.0,4,8,50.0,1,2,50.0,2,3,5,4,1,0,0,0,1,3
../kbl_data/2023-2024,S43G01N87,고양 소노,Home,전성현,3,0,1,0.0,1,4,25.0,1,5,20.0,0,0,0.0,0,0,0,4,0,0,0,0,2,3
../kbl_data/2023-2024,S43G01N87,고양 소노,Home,김진유,0,0,0,0.0,0,1,0.0,0,1,0.0,0,0,0.0,0,0,0,0,0,0,0,0,0,0
../kbl_data/2023-2024,S43G01N87,고양 소노,Home,치나누 오누아쿠,17,6,8,75.0,1,2,50.0,7,10,70.0,2,3,66.7,2,8,10,1,1,0,0,2,3,1
../kbl_data/2023-2024,S43G01N87,고양 소노,Home,이정현,20,3,5,60.0,4,9,44.4,7,14,50.0,2,2,100.0,1,2,3,7,2,0,0,0,0,2
../kbl_data/2023-2024,S43G01N87,고양 소노,Home,조은후,0,0,1,0.0,0,0,0.0,0,1,0.0,0,0,0.0,0,0,0,2,1,0,0,0,0,2
../kbl_data/2023-2024,S43G01N87,고양 소노,Home,안정욱,0,0,0,0.0,0,1,0.0,0,1,0.0,0,0,0.0,0,0,0,0,0,0,0,0,0,1
../kbl_data/2023-2024,S43G01N87,고양 소노,Home,디욘테 데이비스,9,3,4,75.0,1,1,100.0,4,5,80.0,0,0,0.0,2,3,5,0,1,1,0,2,1,1
../kbl_data/2023-2024,S43G01N87,대구 한국가스공사,Away,김동량,6,3,3,100.0,0,0,0.0,3,3,100.0,0,0,0.0,2,3,5,0,0,0,0,0,0,3
../kbl_data/2023-2024,S43G01N87,대구 한국가스공사,Away,차바위,11,0,2,0.0,3,4,75.0,3,6,50.0,2,2,100.0,1,1,2,2,0,0,0,0,0,4
../kbl_data/2023-2024,S43G01N87,대구 한국가스공사,Away,박지훈,8,3,3,100.0,0,1,0.0,3,4,75.0,2,3,66.7,1,3,4,2,0,0,0,0,1,1
../kbl_data/2023-2024,S43G01N87,대구 한국가스공사,Away,조상열,0,0,0,0.0,0,0,0.0,0,0,0.0,0,0,0.0,0,1,1,0,0,0,0,0,0,1
../kbl_data/2023-2024,S43G01N87,대구 한국가스공사,Away,박봉진,0,0,0,0.0,0,0,0.0,0,0,0.0,0,0,0.0,0,0,0,0,0,0,0,0,0,0
../kbl_data/2023-2024,S43G01N87,대구 한국가스공사,Away,김낙현,12,3,5,60.0,2,8,25.0,5,13,38.5,0,0,0.0,0,3,3,2,2,0,0,0,2,3
../kbl_data/2023-2024,S43G01N87,대구 한국가스공사,Away,양재혁,2,1,1,100.0,0,1,0.0,1,2,50.0,0,0,0.0,0,0,0,0,1,0,0,0,0,0
../kbl_data/2023-2024,S43G01N87,대구 한국가스공사,Away,양준우,0,0,0,0.0,0,0,0.0,0,0,0.0,0,0,0.0,0,0,0,0,0,0,0,0,0,0
../kbl_data/2023-2024,S43G01N87,대구 한국가스공사,Away,앤드류 니콜슨,10,3,5,60.0,1,6,16.7,4,11,36.4,1,2,50.0,0,7,7,1,1,1,0,1,2,0
../kbl_data/2023-2024,S43G01N87,대구 한국가스공사,Away,신승민,0,0,1,0.0,0,2,0.0,0,3,0.0,0,0,0.0,1,3,4,3,0,1,2,0,2,2
../kbl_data/2023-2024,S43G01N87,대구 한국가스공사,Away,샘조세프 벨란겔,20,4,5,80.0,4,5,80.0,8,10,80.0,0,0,0.0,0,3,3,5,0,0,0,0,0,3
../kbl_data/2023-2024,S43G01N87,대구 한국가스공사,Away,듀반 맥스웰,11,5,5,100.0,0,1,0.0,5,6,83.3,1,2,50.0,1,4,5,0,0,1,0,0,4,3
../kbl_data/2023-2024,S43G01N88,원주 DB,Home,김현호,0,0,0,0.0,0,0,0.0,0,0,0.0,0,0,0.0,0,0,0,0,0,0,0,0,0,0
../kbl_data/2023-2024,S43G01N88,원주 DB,Home,서민수,2,1,1,100.0,0,2,0.0,1,3,33.3,0,0,0.0,0,1,1,0,0,0,0,0,0,2
../kbl_data/2023-2024,S43G01N88,원주 DB,Home,김영현,4,2,3,66.7,0,1,0.0,2,4,50.0,0,0,0.0,1,3,4,1,2,0,0,0,0,3
../kbl_data/2023-2024,S43G01N88,원주 DB,Home,김종규,17,8,10,80.0,0,0,0.0,8,10,80.0,1,1,100.0,4,4,8,2,2,0,0,3,1,2
../kbl_data/2023-2024,S43G01N88,원주 DB,Home,최승욱,8,4,14,28.6,0,0,0.0,4,14,28.6,0,0,0.0,6,6,12,2,6,2,0,0,6,4
../kbl_data/2023-2024,S43G01N88,원주 DB,Home,강상재,2,0,4,0.0,0,3,0.0,0,7,0.0,2,2,100.0,1,2,3,5,2,0,0,0,5,1
../kbl_data/2023-2024,S43G01N88,원주 DB,Home,디드릭 로슨,25,5,10,50.0,4,9,44.4,9,19,47.4,3,3,100.0,0,6,6,4,1,2,0,0,0,4
../kbl_data/2023-2024,S43G01N88,원주 DB,Home,이용우,3,0,1,0.0,1,1,100.0,1,2,50.0,0,0,0.0,0,0,0,1,0,0,0,0,0,0
../kbl_data/2023-2024,S43G01N88,원주 DB,Home,이선 알바노,17,5,12,41.7,1,2,50.0,6,14,42.9,4,4,100.0,2,1,3,6,3,0,0,0,0,2
../kbl_data/2023-2024,S43G01N88,원주 DB,Home,박인웅,5,2,3,66.7,0,0,0.0,2,3,66.7,1,1,100.0,0,0,0,0,0,0,0,0,0,1
../kbl_data/2023-2024,S43G01N88,원주 DB,Home,박승재,7,2,2,100.0,1,1,100.0,3,3,100.0,0,1,0.0,0,1,1,0,0,0,0,0,2,2
../kbl_data/2023-2024,S43G01N88,원주 DB,Home,제프 위디,9,3,5,60.0,1,2,50.0,4,7,57.1,0,1,0.0,1,7,8,0,1,0,0,0,2,2
../kbl_data/2023-2024,S43G01N88,서울 삼성,Away,이정현,11,0,3,0.0,3,6,50.0,3,9,33.3,2,2,100.0,0,4,4,2,0,0,0,0,0,1
../kbl_data/2023-2024,S43G01N88,서울 삼성,Away,김승원,2,1,3,33.3,0,0,0.0,1,3,33.3,0,0,0.0,1,2,3,1,0,0,0,0,0,2
../kbl_data/2023-2024,S43G01N88,서울 삼성,Away,김시래,0,0,2,0.0,0,2,0.0,0,4,0.0,0,0,0.0,1,1,2,1,1,0,0,0,3,1
../kbl_data/2023-2024,S43G01N88,서울 삼성,Away,이동엽,4,2,3,66.7,0,1,0.0,2,4,50.0,0,0,0.0,1,2,3,3,2,0,0,0,1,3
../kbl_data/2023-2024,S43G01N88,서울 삼성,Away,김광철,0,0,0,0.0,0,0,0.0,0,0,0.0,0,0,0.0,0,0,0,0,0,0,0,0,0,0
../kbl_data/2023-2024,S43G01N88,서울 삼성,Away,최승욱,8,4,14,28.6,0,0,0.0,4,14,28.6,0,0,0.0,6,6,12,2,6,2,0,0,6,4
../kbl_data/2023-2024,S43G01N88,서울 삼성,Away,윤성원,3,0,0,0.0,1,3,33.3,1,3,33.3,0,0,0.0,0,1,1,0,0,0,0,0,0,1
../kbl_data/2023-2024,S43G01N88,서울 삼성,Away,이원석,7,3,4,75.0,0,3,0.0,3,7,42.9,1,1,100.0,3,5,8,1,0,0,0,0,2,1
../kbl_data/2023-2024,S43G01N88,서울 삼성,Away,신동혁,3,1,2,50.0,0,3,0.0,1,5,20.0,1,2,50.0,1,2,3,2,0,0,0,0,3,4
../kbl_data/2023-2024,S43G01N88,서울 삼성,Away,아반 나바,7,2,5,40.0,1,3,33.3,3,8,37.5,0,0,0.0,1,1,2,1,1,0,1,0,3,2
../kbl_data/2023-2024,S43G01N88,서울 삼성,Away,이스마엘 레인,4,2,5,40.0,0,2,0.0,2,7,28.6,0,0,0.0,2,2,4,3,1,0,0,0,0,1
../kbl_data/2023-2024,S43G01N88,서울 삼성,Away,코피 코번,22,9,15,60.0,0,0,0.0,9,15,60.0,4,7,57.1,2,7,9,1,0,0,0,2,4,2
../kbl_data/2023-2024,S43G01N89,울산 현대모비스,Home,함지훈,9,4,4,100.0,0,0,0.0,4,4,100.0,1,1,100.0,2,2,4,4,0,0,0,0,0,3
../kbl_data/2023-2024,S43G01N89,울산 현대모비스,Home,최진수,4,1,4,25.0,0,1,0.0,1,5,20.0,2,2,100.0,1,3,4,0,1,0,0,0,0,2
../kbl_data/2023-2024,S43G01N89,울산 현대모비스,Home,김현수,3,0,0,0.0,1,1,100.0,1,1,100.0,0,0,0.0,0,0,0,0,0,0,0,0,0,1
../kbl_data/2023-2024,S43G01N89,울산 현대모비스,Home,장재석,12,6,8,75.0,0,0,0.0,6,8,75.0,0,2,0.0,1,0,1,1,1,1,0,0,0,2
../kbl_data/2023-2024,S43G01N89,울산 현대모비스,Home,김지완,3,1,3,33.3,0,2,0.0,1,5,20.0,1,2,50.0,1,0,1,5,0,0,0,0,1,2
../kbl_data/2023-2024,S43G01N89,울산 현대모비스,Home,김준일,0,0,2,0.0,0,0,0.0,0,2,0.0,0,0,0.0,1,1,2,0,0,0,0,0,1,0
../kbl_data/2023-2024,S43G01N89,울산 현대모비스,Home,김국찬,11,1,1,100.0,3,6,50.0,4,7,57.1,0,0,0.0,1,2,3,4,1,0,0,0,0,2
../kbl_data/2023-2024,S43G01N89,울산 현대모비스,Home,이우석,7,2,5,40.0,1,2,50.0,3,7,42.9,0,0,0.0,2,4,6,1,0,0,0,0,3,3
../kbl_data/2023-2024,S43G01N89,울산 현대모비스,Home,게이지 프림,17,6,10,60.0,0,1,0.0,6,11,54.5,5,6,83.3,2,6,8,0,0,1,0,0,2,0
../kbl_data/2023-2024,S43G01N89,울산 현대모비스,Home,김태완,1,0,0,0.0,0,0,0.0,0,0,0.0,1,2,50.0,0,0,0,0,0,0,0,0,1,0
../kbl_data/2023-2024,S43G01N89,울산 현대모비스,Home,박무빈,5,1,3,33.3,1,2,50.0,2,5,40.0,0,0,0.0,0,3,3,6,0,0,1,0,2,2
../kbl_data/2023-2024,S43G01N89,울산 현대모비스,Home,케베 알루마,21,5,8,62.5,3,6,50.0,8,14,57.1,2,2,100.0,2,2,4,1,1,1,0,0,1,3
../kbl_data/2023-2024,S43G01N89,안양 정관장,Away,정준원,5,1,3,33.3,1,2,50.0,2,5,40.0,0,0,0.0,0,0,0,0,0,0,0,0,1,3
../kbl_data/2023-2024,S43G01N89,안양 정관장,Away,정효근,3,0,1,0.0,1,1,100.0,1,2,50.0,0,2,0.0,0,0,0,0,0,0,0,0,0,1
../kbl_data/2023-2024,S43G01N89,안양 정관장,Away,이종현,2,1,1,100.0,0,0,0.0,1,1,100.0,0,0,0.0,0,0,0,0,0,0,0,0,0,1
../kbl_data/2023-2024,S43G01N89,안양 정관장,Away,김철욱,10,2,2,100.0,2,4,50.0,4,6,66.7,0,2,0.0,0,3,3,0,0,0,1,0,0,4
../kbl_data/2023-2024,S43G01N89,안양 정관장,Away,박지훈,12,6,7,85.7,0,4,0.0,6,11,54.5,0,0,0.0,2,0,2,5,0,1,0,0,3,1
../kbl_data/2023-2024,S43G01N89,안양 정관장,Away,최성원,2,1,3,33.3,0,2,0.0,1,5,20.0,0,0,0.0,2,0,2,2,0,0,0,0,0,1
../kbl_data/2023-2024,S43G01N89,안양 정관장,Away,이우정,0,0,0,0.0,0,1,0.0,0,1,0.0,0,0,0.0,0,0,0,1,1,0,0,0,0,2
../kbl_data/2023-2024,S43G01N89,안양 정관장,Away,대릴 먼로,2,0,2,0.0,0,1,0.0,0,3,0.0,2,4,50.0,0,2,2,2,1,0,0,0,3,1
../kbl_data/2023-2024,S43G01N89,안양 정관장,Away,김경원,8,4,6,66.7,0,1,0.0,4,7,57.1,0,0,0.0,0,1,1,0,1,0,0,0,0,2
../kbl_data/2023-2024,S43G01N89,안양 정관장,Away,오마리 스펠맨,10,3,8,37.5,1,4,25.0,4,12,33.3,1,2,50.0,4,5,9,4,0,1,0,0,1,1
../kbl_data/2023-2024,S43G01N89,안양 정관장,Away,렌즈 아반도,17,5,6,83.3,0,1,0.0,5,7,71.4,7,8,87.5,2,5,7,1,1,1,0,0,1,2
../kbl_data/2023-2024,S43G01N89,안양 정관장,Away,고찬혁,7,2,4,50.0,1,2,50.0,3,6,50.0,0,0,0.0,1,2,3,0,2,1,0,0,0,2
../kbl_data/2023-2024,S43G01N90,창원 LG,Home,이관희,15,3,6,50.0,3,8,37.5,6,14,42.9,0,0,0.0,0,2,2,1,0,0,0,0,2,2
../kbl_data/2023-2024,S43G01N90,창원 LG,Home,정희재,3,0,0,0.0,1,4,25.0,1,4,25.0,0,0,0.0,0,1,1,2,1,0,0,0,0,3
../kbl_data/2023-2024,S43G01N90,창원 LG,Home,임동섭,0,0,0,0.0,0,0,0.0,0,0,0.0,0,0,0.0,0,0,0,0,0,0,0,0,0,0
../kbl_data/2023-2024,S43G01N90,창원 LG,Home,이재도,16,4,5,80.0,1,2,50.0,5,7,71.4,5,6,83.3,1,4,5,3,0,0,0,0,4,3
../kbl_data/2023-2024,S43G01N90,창원 LG,Home,정인덕,0,0,0,0.0,0,0,0.0,0,0,0.0,0,0,0.0,0,0,0,0,0,0,0,0,0,0
../kbl_data/2023-2024,S43G01N90,창원 LG,Home,양홍석,10,3,6,50.0,1,6,16.7,4,12,33.3,1,2,50.0,1,5,6,0,1,0,0,0,0,2
../kbl_data/2023-2024,S43G01N90,창원 LG,Home,박정현,0,0,0,0.0,0,1,0.0,0,1,0.0,0,0,0.0,0,0,0,0,0,0,0,0,1,2
../kbl_data/2023-2024,S43G01N90,창원 LG,Home,윤원상,0,0,0,0.0,0,0,0.0,0,0,0.0,0,0,0.0,0,0,0,0,0,0,0,0,0,0
../kbl_data/2023-2024,S43G01N90,창원 LG,Home,아셈 마레이,21,9,10,90.0,0,0,0.0,9,10,90.0,3,9,33.3,6,12,18,2,3,1,0,1,1,5
../kbl_data/2023-2024,S43G01N90,창원 LG,Home,저스틴 구탕,9,1,3,33.3,2,2,100.0,3,5,60.0,1,2,50.0,0,5,5,1,0,0,0,0,4,0
../kbl_data/2023-2024,S43G01N90,창원 LG,Home,양준석,2,0,1,0.0,0,0,0.0,0,1,0.0,2,2,100.0,0,1,1,3,0,0,0,0,2,3
../kbl_data/2023-2024,S43G01N90,창원 LG,Home,유기상,8,1,3,33.3,2,5,40.0,3,8,37.5,0,0,0.0,0,2,2,0,1,0,0,0,1,2
../kbl_data/2023-2024,S43G01N90,수원 KT,Away,한희원,8,2,3,66.7,0,4,0.0,2,7,28.6,4,4,100.0,1,6,7,0,3,0,0,0,0,2
../kbl_data/2023-2024,S43G01N90,수원 KT,Away,최창진,5,1,3,33.3,1,1,100.0,2,4,50.0,0,0,0.0,2,1,3,0,1,0,0,0,0,1
../kbl_data/2023-2024,S43G01N90,수원 KT,Away,문성곤,2,1,2,50.0,0,3,0.0,1,5,20.0,0,0,0.0,1,0,1,0,2,0,0,0,2,4
../kbl_data/2023-2024,S43G01N90,수원 KT,Away,이현석,0,0,0,0.0,0,0,0.0,0,0,0.0,0,0,0.0,0,0,0,0,0,0,0,0,0,0
../kbl_data/2023-2024,S43G01N90,수원 KT,Away,정성우,7,2,4,50.0,1,6,16.7,3,10,30.0,0,0,0.0,0,2,2,3,0,0,0,0,1,3
../kbl_data/2023-2024,S43G01N90,수원 KT,Away,허훈,18,5,9,55.6,1,5,20.0,6,14,42.9,5,5,100.0,0,3,3,5,0,0,1,0,1,4
../kbl_data/2023-2024,S43G01N90,수원 KT,Away,하윤기,0,0,5,0.0,0,0,0.0,0,5,0.0,0,0,0.0,2,3,5,2,0,0,0,0,1,3
../kbl_data/2023-2024,S43G01N90,수원 KT,Away,이두원,4,1,3,33.3,0,0,0.0,1,3,33.3,2,2,100.0,0,1,1,0,0,1,0,0,0,2
../kbl_data/2023-2024,S43G01N90,수원 KT,Away,숀 데이브 일데폰소,4,2,2,100.0,0,0,0.0,2,2,100.0,0,0,0.0,0,0,0,0,0,0,0,0,1,0
../kbl_data/2023-2024,S43G01N90,수원 KT,Away,문정현,0,0,2,0.0,0,0,0.0,0,2,0.0,0,0,0.0,1,1,2,0,2,0,0,0,0,1
../kbl_data/2023-2024,S43G01N90,수원 KT,Away,마이클 에릭,7,3,5,60.0,0,0,0.0,3,5,60.0,1,2,50.0,0,0,0,0,0,0,0,2,1,0
../kbl_data/2023-2024,S43G01N90,수원 KT,Away,패리스 배스,21,5,11,45.5,2,5,40.0,7,16,43.8,5,5,100.0,2,7,9,0,1,0,0,0,3,3
../kbl_data/2023-2024,S43G01N91,고양 소노,Home,김강선,11,1,1,100.0,3,10,30.0,4,11,36.4,0,0,0.0,1,1,2,5,1,0,0,0,1,3
../kbl_data/2023-2024,S43G01N91,고양 소노,Home,함준후,2,1,1,100.0,0,1,0.0,1,2,50.0,0,0,0.0,1,1,2,0,0,0,0,0,0,0
../kbl_data/2023-2024,S43G01N91,고양 소노,Home,한호빈,15,3,3,100.0,3,6,50.0,6,9,66.7,0,0,0.0,0,3,3,7,0,0,0,0,1,2
../kbl_data/2023-2024,S43G01N91,고양 소노,Home,전성현,16,2,2,100.0,4,8,50.0,6,10,60.0,0,0,0.0,0,2,2,0,0,0,0,0,1,2
../kbl_data/2023-2024,S43G01N91,고양 소노,Home,김진유,0,0,0,0.0,0,0,0.0,0,0,0.0,0,0,0.0,1,0,1,1,1,0,0,0,0,4
../kbl_data/2023-2024,S43G01N91,고양 소노,Home,김진용,0,0,0,0.0,0,0,0.0,0,0,0.0,0,0,0.0,0,0,0,0,0,0,0,0,0,0
../kbl_data/2023-2024,S43G01N91,고양 소노,Home,치나누 오누아쿠,15,5,10,50.0,0,2,0.0,5,12,41.7,5,7,71.4,3,6,9,8,2,1,0,0,5,4
../kbl_data/2023-2024,S43G01N91,고양 소노,Home,이정현,15,6,10,60.0,1,4,25.0,7,14,50.0,0,0,0.0,1,5,6,0,1,0,0,0,0,2
../kbl_data/2023-2024,S43G01N91,고양 소노,Home,백지웅,0,0,0,0.0,0,1,0.0,0,1,0.0,0,0,0.0,0,0,0,0,0,0,1,0,0,0
../kbl_data/2023-2024,S43G01N91,고양 소노,Home,안정욱,0,0,1,0.0,0,1,0.0,0,2,0.0,0,0,0.0,0,0,0,0,0,0,0,0,0,0
../kbl_data/2023-2024,S43G01N91,고양 소노,Home,민기남,0,0,0,0.0,0,1,0.0,0,1,0.0,0,0,0.0,1,0,1,0,0,0,0,0,0,0
../kbl_data/2023-2024,S43G01N91,고양 소노,Home,디욘테 데이비스,2,1,2,50.0,0,0,0.0,1,2,50.0,0,0,0.0,2,0,2,0,0,2,0,0,1,0
../kbl_data/2023-2024,S43G01N91,대구 한국가스공사,Away,김동량,2,1,3,33.3,0,0,0.0,1,3,33.3,0,0,0.0,1,1,2,1,1,0,0,0,1,0
../kbl_data/2023-2024,S43G01N91,대구 한국가스공사,Away,차바위,14,1,1,100.0,4,5,80.0,5,6,83.3,0,0,0.0,1,3,4,0,1,0,0,0,0,4
../kbl_data/2023-2024,S43G01N91,대구 한국가스공사,Away,박지훈,2,0,2,0.0,0,0,0.0,0,2,0.0,2,2,100.0,1,2,3,1,0,0,0,0,0,2
../kbl_data/2023-2024,S43G01N91,대구 한국가스공사,Away,조상열,0,0,0,0.0,0,1,0.0,0,1,0.0,0,0,0.0,0,1,1,1,0,0,0,0,1,2
../kbl_data/2023-2024,S43G01N91,대구 한국가스공사,Away,박봉진,0,0,0,0.0,0,0,0.0,0,0,0.0,0,0,0.0,0,0,0,0,0,0,0,0,0,0
../kbl_data/2023-2024,S43G01N91,대구 한국가스공사,Away,김낙현,18,6,6,100.0,2,7,28.6,8,13,61.5,0,0,0.0,0,3,3,5,2,0,0,0,1,1
../kbl_data/2023-2024,S43G01N91,대구 한국가스공사,Away,양재혁,3,0,1,0.0,1,1,100.0,1,2,50.0,0,0,0.0,2,1,3,1,0,0,0,0,1,0
../kbl_data/2023-2024,S43G01N91,대구 한국가스공사,Away,양준우,0,0,0,0.0,0,1,0.0,0,1,0.0,0,0,0.0,0,1,1,0,0,0,0,0,0,0
../kbl_data/2023-2024,S43G01N91,대구 한국가스공사,Away,앤드류 니콜슨,15,3,9,33.3,3,5,60.0,6,14,42.9,0,0,0.0,3,4,7,0,0,0,1,0,2,2
../kbl_data/2023-2024,S43G01N91,대구 한국가스공사,Away,신승민,7,3,6,50.0,0,1,0.0,3,7,42.9,1,1,100.0,0,0,0,1,0,0,0,0,1,1
../kbl_data/2023-2024,S43G01N91,대구 한국가스공사,Away,샘조세프 벨란겔,10,1,2,50.0,2,3,66.7,3,5,60.0,2,2,100.0,0,3,3,4,1,0,0,0,1,4
../kbl_data/2023-2024,S43G01N91,대구 한국가스공사,Away,듀반 맥스웰,13,5,6,83.3,1,3,33.3,6,9,66.7,0,0,0.0,1,1,2,4,0,3,0,3,1,2
../kbl_data/2023-2024,S43G01N92,원주 DB,Home,김현호,0,0,0,0.0,0,0,0.0,0,0,0.0,0,0,0.0,0,0,0,0,0,0,0,0,0,0
../kbl_data/2023-2024,S43G01N92,원주 DB,Home,서민수,5,1,1,100.0,1,2,50.0,2,3,66.7,0,2,0.0,0,1,1,1,0,0,0,0,0,2
../kbl_data/2023-2024,S43G01N92,원주 DB,Home,김영현,3,0,2,0.0,1,3,33.3,1,5,20.0,0,0,0.0,2,1,3,1,3,0,0,0,1,2
../kbl_data/2023-2024,S43G01N92,원주 DB,Home,김종규,10,4,7,57.1,0,0,0.0,4,7,57.1,2,3,66.7,4,3,7,1,0,0,0,1,0,2
../kbl_data/2023-2024,S43G01N92,원주 DB,Home,최승욱,0,0,0,0.0,0,2,0.0,0,2,0.0,0,2,0.0,0,1,1,0,0,0,0,0,1,1
../kbl_data/2023-2024,S43G01N92,원주 DB,Home,강상재,12,1,3,33.3,3,4,75.0,4,7,57.1,1,2,50.0,2,4,6,9,0,0,0,0,4,4
../kbl_data/2023-2024,S43G01N92,원주 DB,Home,디드릭 로슨,28,7,10,70.0,3,8,37.5,10,18,55.6,5,8,62.5,0,11,11,0,0,0,0,0,2,3
../kbl_data/2023-2024,S43G01N92,원주 DB,Home,이용우,0,0,0,0.0,0,0,0.0,0,0,0.0,0,0,0.0,0,0,0,0,0,0,0,0,0,0
../kbl_data/2023-2024,S43G01N92,원주 DB,Home,이선 알바노,15,5,9,55.6,1,3,33.3,6,12,50.0,2,4,50.0,0,2,2,6,4,0,0,0,1,2
../kbl_data/2023-2024,S43G01N92,원주 DB,Home,박인웅,7,2,3,66.7,1,2,50.0,3,5,60.0,0,0,0.0,0,2,2,1,1,0,0,0,1,3
../kbl_data/2023-2024,S43G01N92,원주 DB,Home,박승재,0,0,0,0.0,0,0,0.0,0,0,0.0,0,0,0.0,0,0,0,0,0,0,0,0,0,0
../kbl_data/2023-2024,S43G01N92,원주 DB,Home,제프 위디,8,4,9,44.4,0,0,0.0,4,9,44.4,0,0,0.0,3,4,7,0,0,1,0,1,2,0
../kbl_data/2023-2024,S43G01N92,안양 정관장,Away,정준원,0,0,0,0.0,0,0,0.0,0,0,0.0,0,0,0.0,0,0,0,0,0,0,0,0,0,0
../kbl_data/2023-2024,S43G01N92,안양 정관장,Away,정효근,10,2,6,33.3,2,5,40.0,4,11,36.4,0,0,0.0,1,5,6,2,0,0,0,0,1,3
../kbl_data/2023-2024,S43G01N92,안양 정관장,Away,이종현,6,3,4,75.0,0,1,0.0,3,5,60.0,0,0,0.0,0,1,1,2,1,0,0,0,1,1
../kbl_data/2023-2024,S43G01N92,안양 정관장,Away,김철욱,0,0,0,0.0,0,0,0.0,0,0,0.0,0,0,0.0,0,0,0,0,0,0,0,0,0,0
../kbl_data/2023-2024,S43G01N92,안양 정관장,Away,박지훈,11,2,8,25.0,1,3,33.3,3,11,27.3,4,5,80.0,2,1,3,6,2,0,0,0,1,4
../kbl_data/2023-2024,S43G01N92,안양 정관장,Away,최성원,17,3,5,60.0,3,6,50.0,6,11,54.5,2,2,100.0,1,3,4,3,1,0,0,0,3,1
../kbl_data/2023-2024,S43G01N92,안양 정관장,Away,이우정,0,0,0,0.0,0,1,0.0,0,1,0.0,0,0,0.0,0,0,0,0,0,0,0,0,0,0
../kbl_data/2023-2024,S43G01N92,안양 정관장,Away,대릴 먼로,16,5,8,62.5,2,5,40.0,7,13,53.8,0,0,0.0,3,6,9,7,1,0,0,0,1,4
../kbl_data/2023-2024,S43G01N92,안양 정관장,Away,김경원,7,3,6,50.0,0,0,0.0,3,6,50.0,1,3,33.3,6,2,8,1,1,1,0,0,2,5
../kbl_data/2023-2024,S43G01N92,안양 정관장,Away,오마리 스펠맨,2,1,4,25.0,0,2,0.0,1,6,16.7,0,0,0.0,0,3,3,0,0,0,0,0,0,0
../kbl_data/2023-2024,S43G01N92,안양 정관장,Away,렌즈 아반도,8,2,4,50.0,1,7,14.3,3,11,27.3,1,2,50.0,3,2,5,0,2,5,0,1,1,4
../kbl_data/2023-2024,S43G01N92,안양 정관장,Away,고찬혁,6,0,0,0.0,2,3,66.7,2,3,66.7,0,0,0.0,0,0,0,0,0,0,0,0,0,2
../kbl_data/2023-2024,S43G01N93,울산 현대모비스,Home,함지훈,18,7,8,87.5,0,0,0.0,7,8,87.5,4,5,80.0,4,0,4,6,0,0,0,0,1,2
../kbl_data/2023-2024,S43G01N93,울산 현대모비스,Home,최진수,2,1,1,100.0,0,0,0.0,1,1,100.0,0,0,0.0,0,0,0,0,0,0,0,0,0,0
../kbl_data/2023-2024,S43G01N93,울산 현대모비스,Home,김현수,0,0,0,0.0,0,0,0.0,0,0,0.0,0,0,0.0,0,1,1,1,0,0,0,0,0,2
../kbl_data/2023-2024,S43G01N93,울산 현대모비스,Home,장재석,0,0,0,0.0,0,0,0.0,0,0,0.0,0,0,0.0,0,0,0,0,0,0,0,0,0,0
../kbl_data/2023-2024,S43G01N93,울산 현대모비스,Home,김지완,0,0,0,0.0,0,1,0.0,0,1,0.0,0,0,0.0,0,2,2,0,1,0,0,0,0,1
../kbl_data/2023-2024,S43G01N93,울산 현대모비스,Home,김준일,1,0,0,0.0,0,0,0.0,0,0,0.0,1,2,50.0,1,1,2,1,0,0,0,0,0,1
../kbl_data/2023-2024,S43G01N93,울산 현대모비스,Home,김국찬,8,1,1,100.0,2,6,33.3,3,7,42.9,0,2,0.0,0,4,4,2,0,0,0,0,1,3
../kbl_data/2023-2024,S43G01N93,울산 현대모비스,Home,이우석,10,3,11,27.3,1,1,100.0,4,12,33.3,1,1,100.0,0,3,3,5,1,0,0,0,1,3
../kbl_data/2023-2024,S43G01N93,울산 현대모비스,Home,게이지 프림,19,8,10,80.0,0,2,0.0,8,12,66.7,3,4,75.0,0,5,5,1,1,1,0,0,1,5
../kbl_data/2023-2024,S43G01N93,울산 현대모비스,Home,김태완,0,0,0,0.0,0,1,0.0,0,1,0.0,0,0,0.0,0,0,0,0,0,0,0,0,0,0
../kbl_data/2023-2024,S43G01N93,울산 현대모비스,Home,박무빈,19,6,8,75.0,2,6,33.3,8,14,57.1,1,4,25.0,1,3,4,4,0,0,0,0,4,3
../kbl_data/2023-2024,S43G01N93,울산 현대모비스,Home,케베 알루마,3,1,5,20.0,0,0,0.0,1,5,20.0,1,2,50.0,0,2,2,0,1,1,0,0,2,0
../kbl_data/2023-2024,S43G01N93,창원 LG,Away,이관희,6,3,7,42.9,0,4,0.0,3,11,27.3,0,0,0.0,1,0,1,1,1,0,0,0,1,1
../kbl_data/2023-2024,S43G01N93,창원 LG,Away,정희재,0,0,0,0.0,0,1,0.0,0,1,0.0,0,0,0.0,0,1,1,1,0,0,0,0,0,2
../kbl_data/2023-2024,S43G01N93,창원 LG,Away,임동섭,0,0,0,0.0,0,0,0.0,0,0,0.0,0,0,0.0,0,0,0,0,0,0,0,0,0,0
../kbl_data/2023-2024,S43G01N93,창원 LG,Away,이재도,15,6,12,50.0,1,4,25.0,7,16,43.8,0,0,0.0,1,1,2,2,0,0,0,0,1,2
../kbl_data/2023-2024,S43G01N93,창원 LG,Away,정인덕,5,1,2,50.0,1,2,50.0,2,4,50.0,0,0,0.0,1,0,1,0,0,0,0,0,1,2
../kbl_data/2023-2024,S43G01N93,창원 LG,Away,양홍석,19,4,8,50.0,3,6,50.0,7,14,50.0,2,3,66.7,3,6,9,3,2,0,0,0,1,4
../kbl_data/2023-2024,S43G01N93,창원 LG,Away,박정현,0,0,1,0.0,0,0,0.0,0,1,0.0,0,0,0.0,0,1,1,0,0,0,0,0,0,0
../kbl_data/2023-2024,S43G01N93,창원 LG,Away,윤원상,0,0,0,0.0,0,0,0.0,0,0,0.0,0,0,0.0,0,0,0,0,0,0,0,0,0,0
../kbl_data/2023-2024,S43G01N93,창원 LG,Away,아셈 마레이,22,10,16,62.5,0,0,0.0,10,16,62.5,2,7,28.6,11,11,22,3,3,1,1,0,2,3
../kbl_data/2023-2024,S43G01N93,창원 LG,Away,저스틴 구탕,4,2,3,66.7,0,0,0.0,2,3,66.7,0,0,0.0,0,0,0,0,1,0,0,0,0,0
../kbl_data/2023-2024,S43G01N93,창원 LG,Away,양준석,11,4,5,80.0,1,2,50.0,5,7,71.4,0,0,0.0,0,2,2,2,0,0,0,0,1,4
../kbl_data/2023-2024,S43G01N93,창원 LG,Away,유기상,6,0,1,0.0,1,4,25.0,1,5,20.0,3,5,60.0,1,2,3,0,0,1,0,0,0,1
../kbl_data/2023-2024,S43G01N94,수원 KT,Home,한희원,20,4,5,80.0,4,11,36.4,8,16,50.0,0,0,0.0,3,3,6,1,1,0,0,0,3,1
../kbl_data/2023-2024,S43G01N94,수원 KT,Home,최창진,2,1,1,100.0,0,0,0.0,1,1,100.0,0,0,0.0,2,1,3,2,0,0,1,0,0,5
../kbl_data/2023-2024,S43G01N94,수원 KT,Home,문성곤,6,2,3,66.7,0,3,0.0,2,6,33.3,2,2,100.0,3,2,5,2,4,0,0,0,2,4
../kbl_data/2023-2024,S43G01N94,수원 KT,Home,이현석,0,0,0,0.0,0,0,0.0,0,0,0.0,0,0,0.0,0,0,0,0,0,0,0,0,0,0
../kbl_data/2023-2024,S43G01N94,수원 KT,Home,정성우,10,2,4,50.0,0,4,0.0,2,8,25.0,6,6,100.0,1,0,1,5,1,0,0,0,0,4
../kbl_data/2023-2024,S43G01N94,수원 KT,Home,허훈,10,2,4,50.0,2,6,33.3,4,10,40.0,0,0,0.0,1,3,4,3,1,0,0,0,1,1
../kbl_data/2023-2024,S43G01N94,수원 KT,Home,김준환,7,2,4,50.0,1,6,16.7,3,10,30.0,0,0,0.0,0,0,0,1,0,0,0,0,0,2
../kbl_data/2023-2024,S43G01N94,수원 KT,Home,하윤기,0,0,5,0.0,0,0,0.0,0,5,0.0,0,0,0.0,0,1,1,0,0,0,0,0,1,1
../kbl_data/2023-2024,S43G01N94,수원 KT,Home,이두원,4,2,4,50.0,0,0,0.0,2,4,50.0,0,0,0.0,1,0,1,0,0,0,0,0,1,3
../kbl_data/2023-2024,S43G01N94,수원 KT,Home,문정현,0,0,0,0.0,0,0,0.0,0,0,0.0,0,0,0.0,0,0,0,0,0,0,0,0,0,2
../kbl_data/2023-2024,S43G01N94,수원 KT,Home,마이클 에릭,4,1,1,100.0,0,0,0.0,1,1,100.0,2,2,100.0,1,2,3,3,0,0,0,0,0,1
../kbl_data/2023-2024,S43G01N94,수원 KT,Home,패리스 배스,31,7,12,58.3,5,8,62.5,12,20,60.0,2,4,50.0,3,4,7,3,0,1,0,1,1,2
../kbl_data/2023-2024,S43G01N94,서울 삼성,Away,이정현,10,2,2,100.0,0,2,0.0,2,4,50.0,6,6,100.0,0,4,4,4,1,0,0,0,2,1
../kbl_data/2023-2024,S43G01N94,서울 삼성,Away,홍경기,13,2,5,40.0,3,6,50.0,5,11,45.5,0,0,0.0,0,1,1,2,0,0,0,0,0,3
../kbl_data/2023-2024,S43G01N94,서울 삼성,Away,김승원,0,0,0,0.0,0,0,0.0,0,0,0.0,0,0,0.0,1,0,1,0,0,0,0,0,1,2
../kbl_data/2023-2024,S43G01N94,서울 삼성,Away,김시래,5,1,3,33.3,0,0,0.0,1,3,33.3,3,3,100.0,0,2,2,1,0,0,0,0,1,4
../kbl_data/2023-2024,S43G01N94,서울 삼성,Away,이동엽,10,2,3,66.7,1,3,33.3,3,6,50.0,3,4,75.0,2,1,3,1,1,0,0,0,0,1
../kbl_data/2023-2024,S43G01N94,서울 삼성,Away,최승욱,4,1,2,50.0,0,1,0.0,1,3,33.3,2,2,100.0,0,2,2,0,0,1,1,0,2,2
../kbl_data/2023-2024,S43G01N94,서울 삼성,Away,윤성원,7,2,2,100.0,1,4,25.0,3,6,50.0,0,0,0.0,1,2,3,1,0,0,0,0,1,1
../kbl_data/2023-2024,S43G01N94,서울 삼성,Away,이원석,12,4,8,50.0,0,1,0.0,4,9,44.4,4,6,66.7,2,2,4,4,0,1,0,1,2,3
../kbl_data/2023-2024,S43G01N94,서울 삼성,Away,신동혁,2,0,0,0.0,0,4,0.0,0,4,0.0,2,2,100.0,0,2,2,0,0,0,0,0,0,2
../kbl_data/2023-2024,S43G01N94,서울 삼성,Away,아반 나바,0,0,1,0.0,0,0,0.0,0,1,0.0,0,0,0.0,1,1,2,1,0,0,0,0,2,1
../kbl_data/2023-2024,S43G01N94,서울 삼성,Away,이스마엘 레인,0,0,2,0.0,0,2,0.0,0,4,0.0,0,0,0.0,0,0,0,1,1,0,0,0,1,0
../kbl_data/2023-2024,S43G01N94,서울 삼성,Away,코피 코번,36,17,21,81.0,0,0,0.0,17,21,81.0,2,2,100.0,10,10,20,4,2,2,0,0,2,2
../kbl_data/2023-2024,S43G01N95,원주 DB,Home,김현호,0,0,0,0.0,0,0,0.0,0,0,0.0,0,0,0.0,0,0,0,0,0,0,0,0,0,0
../kbl_data/2023-2024,S43G01N95,원주 DB,Home,서민수,5,1,2,50.0,1,5,20.0,2,7,28.6,0,0,0.0,0,0,0,0,0,1,0,0,0,2
../kbl_data/2023-2024,S43G01N95,원주 DB,Home,두경민,8,1,2,50.0,2,2,100.0,3,4,75.0,0,0,0.0,1,1,2,2,0,0,0,0,1,0
../kbl_data/2023-2024,S43G01N95,원주 DB,Home,김영현,6,0,1,0.0,2,4,50.0,2,5,40.0,0,0,0.0,1,1,2,2,0,0,0,0,0,3
../kbl_data/2023-2024,S43G01N95,원주 DB,Home,최승욱,0,0,0,0.0,0,1,0.0,0,1,0.0,0,0,0.0,0,0,0,1,1,0,0,0,0,0
../kbl_data/2023-2024,S43G01N95,원주 DB,Home,강상재,13,2,6,33.3,3,5,60.0,5,11,45.5,0,0,0.0,1,11,12,0,2,0,0,0,0,2
../kbl_data/2023-2024,S43G01N95,원주 DB,Home,이윤수,0,0,0,0.0,0,0,0.0,0,0,0.0,0,0,0.0,0,0,0,0,0,0,0,0,0,0
../kbl_data/2023-2024,S43G01N95,원주 DB,Home,디드릭 로슨,28,4,7,57.1,5,14,35.7,9,21,42.9,5,6,83.3,0,7,7,8,3,0,0,0,3,2
../kbl_data/2023-2024,S43G01N95,원주 DB,Home,이선 알바노,19,5,11,45.5,3,5,60.0,8,16,50.0,0,0,0.0,2,3,5,4,1,0,0,0,3,2
../kbl_data/2023-2024,S43G01N95,원주 DB,Home,박인웅,10,3,3,100.0,1,2,50.0,4,5,80.0,1,2,50.0,2,1,3,1,0,0,0,0,0,2
../kbl_data/2023-2024,S43G01N95,원주 DB,Home,박승재,2,1,1,100.0,0,0,0.0,1,1,100.0,0,0,0.0,0,0,0,0,0,0,0,0,1,1
../kbl_data/2023-2024,S43G01N95,원주 DB,Home,제프 위디,0,0,0,0.0,0,0,0.0,0,0,0.0,0,0,0.0,0,0,0,0,0,0,0,0,0,0
../kbl_data/2023-2024,S43G01N95,서울 SK,Away,양우섭,0,0,0,0.0,0,0,0.0,0,0,0.0,0,0,0.0,0,0,0,0,0,0,0,0,0,0
../kbl_data/2023-2024,S43G01N95,서울 SK,Away,송창용,2,1,2,50.0,0,2,0.0,1,4,25.0,0,0,0.0,0,0,0,0,1,0,0,0,0,0
../kbl_data/2023-2024,S43G01N95,서울 SK,Away,김선형,11,4,6,66.7,1,5,20.0,5,11,45.5,0,0,0.0,1,1,2,2,0,0,0,0,1,2
../kbl_data/2023-2024,S43G01N95,서울 SK,Away,오세근,9,3,5,60.0,1,2,50.0,4,7,57.1,0,0,0.0,1,1,2,2,0,0,0,0,1,2
../kbl_data/2023-2024,S43G01N95,서울 SK,Away,최부경,2,1,4,25.0,0,0,0.0,1,4,25.0,0,0,0.0,1,4,5,1,0,0,0,0,0,1
../kbl_data/2023-2024,S43G01N95,서울 SK,Away,리온 윌리엄스,0,0,0,0.0,0,0,0.0,0,0,0.0,0,0,0.0,0,0,0,0,0,0,0,0,0,0
../kbl_data/2023-2024,S43G01N95,서울 SK,Away,최원혁,11,1,1,100.0,3,4,75.0,4,5,80.0,0,0,0.0,1,3,4,1,1,0,0,0,1,3
../kbl_data/2023-2024,S43G01N95,서울 SK,Away,안영준,8,3,5,60.0,0,3,0.0,3,8,37.5,2,2,100.0,1,5,6,2,1,3,0,1,2,3
../kbl_data/2023-2024,S43G01N95,서울 SK,Away,자밀 워니,18,7,14,50.0,1,2,50.0,8,16,50.0,1,2,50.0,5,8,13,5,1,2,0,0,1,2
../kbl_data/2023-2024,S43G01N95,서울 SK,Away,오재현,12,3,7,42.9,2,4,50.0,5,11,45.5,0,0,0.0,1,2,3,1,1,0,0,0,0,1
../kbl_data/2023-2024,S43G01N95,서울 SK,Away,김건우,0,0,0,0.0,0,0,0.0,0,0,0.0,0,0,0.0,0,0,0,0,0,0,0,0,0,0
../kbl_data/2023-2024,S43G01N95,서울 SK,Away,고메즈 딜 리아노,9,3,4,75.0,1,2,50.0,4,6,66.7,0,0,0.0,0,2,2,1,1,0,0,0,3,1
../kbl_data/2023-2024,S43G01N96,부산 KCC,Home,정창영,10,2,4,50.0,1,5,20.0,3,9,33.3,3,4,75.0,0,3,3,1,2,0,0,0,0,1
../kbl_data/2023-2024,S43G01N96,부산 KCC,Home,라건아,21,10,12,83.3,0,1,0.0,10,13,76.9,1,3,33.3,5,16,21,5,0,4,0,2,2,2
../kbl_data/2023-2024,S43G01N96,부산 KCC,Home,허웅,16,0,3,0.0,5,7,71.4,5,10,50.0,1,1,100.0,0,0,0,4,0,0,0,0,3,3
../kbl_data/2023-2024,S43G01N96,부산 KCC,Home,이승현,2,0,3,0.0,0,0,0.0,0,3,0.0,2,2,100.0,0,1,1,1,0,0,0,0,0,2
../kbl_data/2023-2024,S43G01N96,부산 KCC,Home,이호현,9,3,4,75.0,1,5,20.0,4,9,44.4,0,0,0.0,0,2,2,1,0,0,0,0,0,3
../kbl_data/2023-2024,S43G01N96,부산 KCC,Home,송교창,10,4,8,50.0,0,1,0.0,4,9,44.4,2,2,100.0,1,2,3,3,0,0,0,0,1,2
../kbl_data/2023-2024,S43G01N96,부산 KCC,Home,최준용,15,4,7,57.1,0,3,0.0,4,10,40.0,7,11,63.6,4,8,12,4,0,0,0,0,1,4
../kbl_data/2023-2024,S43G01N96,부산 KCC,Home,곽정훈,0,0,0,0.0,0,0,0.0,0,0,0.0,0,0,0.0,0,0,0,0,0,0,0,0,0,0
../kbl_data/2023-2024,S43G01N96,부산 KCC,Home,이근휘,0,0,0,0.0,0,0,0.0,0,0,0.0,0,0,0.0,0,0,0,0,0,0,0,0,0,1
../kbl_data/2023-2024,S43G01N96,부산 KCC,Home,김동현,0,0,0,0.0,0,0,0.0,0,0,0.0,0,0,0.0,0,0,0,0,0,0,0,0,0,0
../kbl_data/2023-2024,S43G01N96,부산 KCC,Home,송동훈,0,0,2,0.0,0,2,0.0,0,4,0.0,0,0,0.0,0,0,0,0,0,0,0,0,0,0
../kbl_data/2023-2024,S43G01N96,부산 KCC,Home,알리제 드숀 존슨,10,3,6,50.0,0,1,0.0,3,7,42.9,4,5,80.0,0,8,8,3,0,0,0,0,2,2
../kbl_data/2023-2024,S43G01N96,대구 한국가스공사,Away,김동량,3,1,4,25.0,0,0,0.0,1,4,25.0,1,1,100.0,1,3,4,1,0,0,0,0,0,1
../kbl_data/2023-2024,S43G01N96,대구 한국가스공사,Away,차바위,0,0,0,0.0,0,0,0.0,0,0,0.0,0,0,0.0,3,4,7,1,0,0,0,0,0,5
../kbl_data/2023-2024,S43G01N96,대구 한국가스공사,Away,박지훈,2,1,4,25.0,0,0,0.0,1,4,25.0,0,0,0.0,2,0,2,0,2,0,0,0,0,5
../kbl_data/2023-2024,S43G01N96,대구 한국가스공사,Away,조상열,2,1,1,100.0,0,2,0.0,1,3,33.3,0,0,0.0,2,0,2,0,0,0,0,0,0,0
../kbl_data/2023-2024,S43G01N96,대구 한국가스공사,Away,박봉진,0,0,0,0.0,0,1,0.0,0,1,0.0,0,0,0.0,1,0,1,0,0,0,0,0,0,1
../kbl_data/2023-2024,S43G01N96,대구 한국가스공사,Away,김낙현,19,2,7,28.6,5,13,38.5,7,20,35.0,0,0,0.0,0,3,3,3,0,0,0,0,2,2
../kbl_data/2023-2024,S43G01N96,대구 한국가스공사,Away,양재혁,11,1,1,100.0,3,3,100.0,4,4,100.0,0,0,0.0,0,2,2,0,1,0,0,0,0,5
../kbl_data/2023-2024,S43G01N96,대구 한국가스공사,Away,양준우,0,0,0,0.0,0,0,0.0,0,0,0.0,0,0,0.0,0,0,0,0,0,0,0,0,0,0
../kbl_data/2023-2024,S43G01N96,대구 한국가스공사,Away,앤드류 니콜슨,20,6,12,50.0,2,8,25.0,8,20,40.0,2,2,100.0,2,11,13,0,1,2,0,1,2,3
../kbl_data/2023-2024,S43G01N96,대구 한국가스공사,Away,신승민,2,1,3,33.3,0,3,0.0,1,6,16.7,0,0,0.0,1,1,2,0,1,0,0,0,2,1
../kbl_data/2023-2024,S43G01N96,대구 한국가스공사,Away,샘조세프 벨란겔,14,5,11,45.5,1,6,16.7,6,17,35.3,1,2,50.0,1,1,2,4,2,0,1,0,0,2
../kbl_data/2023-2024,S43G01N96,대구 한국가스공사,Away,듀반 맥스웰,15,7,14,50.0,0,0,0.0,7,14,50.0,1,2,50.0,2,6,8,1,0,0,0,0,1,2
../kbl_data/2023-2024,S43G01N97,대구 한국가스공사,Home,김동량,2,1,1,100.0,0,0,0.0,1,1,100.0,0,0,0.0,0,0,0,0,1,0,0,0,0,1
../kbl_data/2023-2024,S43G01N97,대구 한국가스공사,Home,차바위,3,0,2,0.0,1,2,50.0,1,4,25.0,0,0,0.0,0,1,1,0,0,2,0,0,0,1
../kbl_data/2023-2024,S43G01N97,대구 한국가스공사,Home,박지훈,5,1,3,33.3,1,3,33.3,2,6,33.3,0,0,0.0,1,2,3,1,1,0,0,0,0,2
../kbl_data/2023-2024,S43G01N97,대구 한국가스공사,Home,조상열,0,0,0,0.0,0,0,0.0,0,0,0.0,0,0,0.0,0,0,0,0,2,0,0,0,0,1
../kbl_data/2023-2024,S43G01N97,대구 한국가스공사,Home,이대헌,9,2,5,40.0,1,2,50.0,3,7,42.9,2,4,50.0,0,2,2,1,2,0,0,0,1,1
../kbl_data/2023-2024,S43G01N97,대구 한국가스공사,Home,김낙현,2,1,3,33.3,0,1,0.0,1,4,25.0,0,0,0.0,0,2,2,3,1,0,0,0,4,2
../kbl_data/2023-2024,S43G01N97,대구 한국가스공사,Home,양재혁,0,0,0,0.0,0,2,0.0,0,2,0.0,0,0,0.0,4,1,5,0,1,0,0,0,0,4
../kbl_data/2023-2024,S43G01N97,대구 한국가스공사,Home,양준우,2,0,0,0.0,0,1,0.0,0,1,0.0,2,2,100.0,0,1,1,0,0,0,0,0,0,0
../kbl_data/2023-2024,S43G01N97,대구 한국가스공사,Home,앤드류 니콜슨,18,9,12,75.0,0,3,0.0,9,15,60.0,0,0,0.0,0,12,12,2,0,0,0,0,0,2
../kbl_data/2023-2024,S43G01N97,대구 한국가스공사,Home,신승민,7,2,3,66.7,1,4,25.0,3,7,42.9,0,0,0.0,0,0,0,1,2,0,0,0,1,2
../kbl_data/2023-2024,S43G01N97,대구 한국가스공사,Home,샘조세프 벨란겔,15,2,5,40.0,3,6,50.0,5,11,45.5,2,2,100.0,1,1,2,5,1,0,1,0,3,1
../kbl_data/2023-2024,S43G01N97,대구 한국가스공사,Home,듀반 맥스웰,6,3,8,37.5,0,0,0.0,3,8,37.5,0,0,0.0,1,1,2,0,0,1,0,1,3,1
../kbl_data/2023-2024,S43G01N97,서울 SK,Away,양우섭,0,0,0,0.0,0,0,0.0,0,0,0.0,0,0,0.0,0,0,0,0,0,0,0,0,0,0
../kbl_data/2023-2024,S43G01N97,서울 SK,Away,송창용,0,0,0,0.0,0,0,0.0,0,0,0.0,0,0,0.0,0,0,0,0,0,0,0,0,1,0
../kbl_data/2023-2024,S43G01N97,서울 SK,Away,김선형,9,4,5,80.0,0,1,0.0,4,6,66.7,1,4,25.0,1,0,1,1,3,1,0,0,2,0
../kbl_data/2023-2024,S43G01N97,서울 SK,Away,오세근,2,1,3,33.3,0,1,0.0,1,4,25.0,0,0,0.0,1,4,5,2,1,1,0,0,0,2
../kbl_data/2023-2024,S43G01N97,서울 SK,Away,최부경,7,2,2,100.0,0,0,0.0,2,2,100.0,3,3,100.0,1,3,4,0,0,0,0,0,1,2
../kbl_data/2023-2024,S43G01N97,서울 SK,Away,리온 윌리엄스,4,2,2,100.0,0,1,0.0,2,3,66.7,0,0,0.0,1,1,2,0,0,0,0,0,0,0
../kbl_data/2023-2024,S43G01N97,서울 SK,Away,최원혁,0,0,1,0.0,0,2,0.0,0,3,0.0,0,0,0.0,1,3,4,7,2,0,0,0,3,4
../kbl_data/2023-2024,S43G01N97,서울 SK,Away,안영준,17,1,4,25.0,5,10,50.0,6,14,42.9,0,0,0.0,1,7,8,2,0,1,0,0,0,1
../kbl_data/2023-2024,S43G01N97,서울 SK,Away,자밀 워니,18,7,17,41.2,1,1,100.0,8,18,44.4,1,2,50.0,4,7,11,5,2,1,0,0,3,0
../kbl_data/2023-2024,S43G01N97,서울 SK,Away,오재현,12,4,4,100.0,1,4,25.0,5,8,62.5,1,1,100.0,0,2,2,2,1,0,0,0,2,2
../kbl_data/2023-2024,S43G01N97,서울 SK,Away,김건우,0,0,0,0.0,0,0,0.0,0,0,0.0,0,0,0.0,0,0,0,0,0,0,0,0,0,0
../kbl_data/2023-2024,S43G01N97,서울 SK,Away,고메즈 딜 리아노,12,3,5,60.0,2,4,50.0,5,9,55.6,0,0,0.0,1,1,2,2,0,0,0,0,3,3
../kbl_data/2023-2024,S43G01N98,수원 KT,Home,한희원,12,0,0,0.0,3,10,30.0,3,10,30.0,3,4,75.0,0,2,2,3,1,1,0,0,0,2
../kbl_data/2023-2024,S43G01N98,수원 KT,Home,최창진,0,0,0,0.0,0,2,0.0,0,2,0.0,0,0,0.0,1,1,2,2,0,0,0,0,2,0
../kbl_data/2023-2024,S43G01N98,수원 KT,Home,문성곤,8,1,1,100.0,2,7,28.6,3,8,37.5,0,0,0.0,1,7,8,5,8,0,1,0,1,2
../kbl_data/2023-2024,S43G01N98,수원 KT,Home,이현석,0,0,0,0.0,0,0,0.0,0,0,0.0,0,0,0.0,0,0,0,0,0,1,0,0,0,0
../kbl_data/2023-2024,S43G01N98,수원 KT,Home,정성우,7,2,5,40.0,1,3,33.3,3,8,37.5,0,0,0.0,1,2,3,3,2,0,0,0,0,4
../kbl_data/2023-2024,S43G01N98,수원 KT,Home,김준환,4,2,2,100.0,0,2,0.0,2,4,50.0,0,1,0.0,0,2,2,1,2,0,0,0,0,2
../kbl_data/2023-2024,S43G01N98,수원 KT,Home,하윤기,9,4,9,44.4,0,0,0.0,4,9,44.4,1,1,100.0,2,3,5,3,0,0,0,1,1,3
../kbl_data/2023-2024,S43G01N98,수원 KT,Home,이두원,6,1,2,50.0,0,0,0.0,1,2,50.0,4,4,100.0,0,0,0,0,0,0,1,0,2,4
../kbl_data/2023-2024,S43G01N98,수원 KT,Home,숀 데이브 일데폰소,4,1,3,33.3,0,0,0.0,1,3,33.3,2,2,100.0,0,0,0,1,0,0,0,0,0,0
../kbl_data/2023-2024,S43G01N98,수원 KT,Home,문정현,4,0,0,0.0,1,1,100.0,1,1,100.0,1,2,50.0,0,1,1,0,0,0,0,0,0,0
../kbl_data/2023-2024,S43G01N98,수원 KT,Home,마이클 에릭,0,0,0,0.0,0,0,0.0,0,0,0.0,0,0,0.0,0,1,1,0,0,0,0,0,0,0
../kbl_data/2023-2024,S43G01N98,수원 KT,Home,패리스 배스,28,5,8,62.5,5,15,33.3,10,23,43.5,3,3,100.0,1,4,5,3,3,1,0,0,4,3
../kbl_data/2023-2024,S43G01N98,고양 소노,Away,김강선,16,1,1,100.0,4,10,40.0,5,11,45.5,2,2,100.0,2,2,4,0,0,0,1,0,2,3
../kbl_data/2023-2024,S43G01N98,고양 소노,Away,함준후,2,1,1,100.0,0,2,0.0,1,3,33.3,0,0,0.0,0,0,0,0,0,0,0,0,1,3
../kbl_data/2023-2024,S43G01N98,고양 소노,Away,김민욱,14,0,1,0.0,4,10,40.0,4,11,36.4,2,2,100.0,1,5,6,3,2,1,0,0,3,3
../kbl_data/2023-2024,S43G01N98,고양 소노,Away,한호빈,5,1,4,25.0,1,4,25.0,2,8,25.0,0,0,0.0,2,4,6,3,2,0,0,0,3,2
../kbl_data/2023-2024,S43G01N98,고양 소노,Away,전성현,10,1,4,25.0,2,7,28.6,3,11,27.3,2,2,100.0,1,1,2,0,0,0,0,0,4,1
../kbl_data/2023-2024,S43G01N98,고양 소노,Away,김진유,0,0,1,0.0,0,0,0.0,0,1,0.0,0,0,0.0,0,3,3,2,0,0,0,0,1,0
../kbl_data/2023-2024,S43G01N98,고양 소노,Away,김진용,0,0,0,0.0,0,0,0.0,0,0,0.0,0,0,0.0,0,0,0,0,0,0,0,0,0,0
../kbl_data/2023-2024,S43G01N98,고양 소노,Away,치나누 오누아쿠,9,1,2,50.0,0,0,0.0,1,2,50.0,7,8,87.5,2,9,11,4,0,2,1,0,4,5
../kbl_data/2023-2024,S43G01N98,고양 소노,Away,조은후,0,0,0,0.0,0,0,0.0,0,0,0.0,0,0,0.0,0,0,0,0,0,0,0,0,1,1
../kbl_data/2023-2024,S43G01N98,고양 소노,Away,안정욱,2,1,1,100.0,0,0,0.0,1,1,100.0,0,0,0.0,0,0,0,0,0,0,1,0,0,1
../kbl_data/2023-2024,S43G01N98,고양 소노,Away,민기남,6,0,0,0.0,2,4,50.0,2,4,50.0,0,0,0.0,0,0,0,0,1,0,0,0,3,1
../kbl_data/2023-2024,S43G01N98,고양 소노,Away,디욘테 데이비스,0,0,1,0.0,0,1,0.0,0,2,0.0,0,0,0.0,0,4,4,0,1,0,0,0,2,2
../kbl_data/2023-2024,S43G01N99,부산 KCC,Home,정창영,0,0,1,0.0,0,1,0.0,0,2,0.0,0,0,0.0,0,0,0,0,0,0,0,0,0,2
../kbl_data/2023-2024,S43G01N99,부산 KCC,Home,라건아,17,6,11,54.5,1,1,100.0,7,12,58.3,2,2,100.0,5,3,8,1,0,0,0,0,0,0
../kbl_data/2023-2024,S43G01N99,부산 KCC,Home,허웅,9,1,5,20.0,1,6,16.7,2,11,18.2,4,4,100.0,0,2,2,4,0,0,0,0,1,4
../kbl_data/2023-2024,S43G01N99,부산 KCC,Home,이승현,2,0,5,0.0,0,0,0.0,0,5,0.0,2,2,100.0,2,1,3,0,0,0,0,0,0,1
../kbl_data/2023-2024,S43G01N99,부산 KCC,Home,이호현,5,1,2,50.0,1,3,33.3,2,5,40.0,0,0,0.0,2,4,6,4,0,0,1,0,2,3
../kbl_data/2023-2024,S43G01N99,부산 KCC,Home,송교창,22,6,8,75.0,2,4,50.0,8,12,66.7,4,4,100.0,2,5,7,4,1,0,0,0,0,2
../kbl_data/2023-2024,S43G01N99,부산 KCC,Home,최준용,19,6,10,60.0,2,8,25.0,8,18,44.4,1,2,50.0,2,4,6,6,1,2,0,0,3,3
../kbl_data/2023-2024,S43G01N99,부산 KCC,Home,곽정훈,0,0,0,0.0,0,0,0.0,0,0,0.0,0,0,0.0,0,0,0,0,0,0,0,0,0,0
../kbl_data/2023-2024,S43G01N99,부산 KCC,Home,이근휘,5,1,1,100.0,1,1,100.0,2,2,100.0,0,0,0.0,0,1,1,0,0,0,0,0,1,2
../kbl_data/2023-2024,S43G01N99,부산 KCC,Home,김동현,0,0,0,0.0,0,0,0.0,0,0,0.0,0,0,0.0,0,0,0,0,0,0,0,0,0,0
../kbl_data/2023-2024,S43G01N99,부산 KCC,Home,송동훈,0,0,0,0.0,0,0,0.0,0,0,0.0,0,0,0.0,0,0,0,0,0,0,0,0,0,0
../kbl_data/2023-2024,S43G01N99,부산 KCC,Home,알리제 드숀 존슨,15,6,15,40.0,0,0,0.0,6,15,40.0,3,3,100.0,5,9,14,1,1,0,0,2,1,1
../kbl_data/2023-2024,S43G01N99,원주 DB,Away,서민수,2,1,1,100.0,0,2,0.0,1,3,33.3,0,0,0.0,0,0,0,1,0,0,0,0,0,1
../kbl_data/2023-2024,S43G01N99,원주 DB,Away,두경민,5,1,3,33.3,1,3,33.3,2,6,33.3,0,0,0.0,1,0,1,2,1,0,0,0,1,1
../kbl_data/2023-2024,S43G01N99,원주 DB,Away,김영현,8,0,1,0.0,2,2,100.0,2,3,66.7,2,2,100.0,0,2,2,1,2,0,0,0,1,2
../kbl_data/2023-2024,S43G01N99,원주 DB,Away,김종규,18,8,11,72.7,0,2,0.0,8,13,61.5,2,2,100.0,0,5,5,1,0,1,0,0,1,3
../kbl_data/2023-2024,S43G01N99,원주 DB,Away,최승욱,4,1,1,100.0,0,1,0.0,1,2,50.0,2,2,100.0,0,1,1,0,0,0,0,0,0,1
../kbl_data/2023-2024,S43G01N99,원주 DB,Away,강상재,7,2,4,50.0,1,4,25.0,3,8,37.5,0,0,0.0,0,0,0,2,0,0,0,0,0,1
../kbl_data/2023-2024,S43G01N99,원주 DB,Away,유현준,0,0,0,0.0,0,0,0.0,0,0,0.0,0,0,0.0,0,0,0,2,0,0,0,0,0,0
../kbl_data/2023-2024,S43G01N99,원주 DB,Away,디드릭 로슨,16,5,10,50.0,0,5,0.0,5,15,33.3,6,6,100.0,2,10,12,3,0,1,0,0,2,4
../kbl_data/2023-2024,S43G01N99,원주 DB,Away,이선 알바노,19,4,9,44.4,1,2,50.0,5,11,45.5,8,8,100.0,0,6,6,6,1,0,0,0,0,4
../kbl_data/2023-2024,S43G01N99,원주 DB,Away,박인웅,3,0,0,0.0,1,1,100.0,1,1,100.0,0,0,0.0,0,0,0,0,0,0,0,0,0,0
../kbl_data/2023-2024,S43G01N99,원주 DB,Away,박승재,0,0,0,0.0,0,0,0.0,0,0,0.0,0,0,0.0,0,0,0,0,0,0,0,0,0,0
../kbl_data/2023-2024,S43G01N99,원주 DB,Away,제프 위디,6,3,3,100.0,0,0,0.0,3,3,100.0,0,0,0.0,1,0,1,0,0,0,0,0,0,0
../kbl_data/2023-2024,S43G01N100,안양 정관장,Home,정준원,0,0,1,0.0,0,1,0.0,0,2,0.0,0,0,0.0,0,0,0,0,0,0,0,0,0,2
../kbl_data/2023-2024,S43G01N100,안양 정관장,Home,배병준,18,5,10,50.0,2,4,50.0,7,14,50.0,2,2,100.0,1,4,5,2,0,0,0,0,1,2
../kbl_data/2023-2024,S43G01N100,안양 정관장,Home,정효근,12,2,7,28.6,2,6,33.3,4,13,30.8,2,2,100.0,2,2,4,2,0,0,0,0,1,0
../kbl_data/2023-2024,S43G01N100,안양 정관장,Home,이종현,6,3,3,100.0,0,0,0.0,3,3,100.0,0,0,0.0,1,0,1,0,0,0,0,0,0,2
../kbl_data/2023-2024,S43G01N100,안양 정관장,Home,김철욱,11,1,2,50.0,3,4,75.0,4,6,66.7,0,0,0.0,2,2,4,2,1,0,0,0,1,5
../kbl_data/2023-2024,S43G01N100,안양 정관장,Home,박지훈,5,1,4,25.0,1,2,50.0,2,6,33.3,0,0,0.0,0,4,4,5,2,0,1,0,4,2
../kbl_data/2023-2024,S43G01N100,안양 정관장,Home,이우정,0,0,0,0.0,0,0,0.0,0,0,0.0,0,0,0.0,0,0,0,0,0,0,0,0,0,0
../kbl_data/2023-2024,S43G01N100,안양 정관장,Home,대릴 먼로,15,5,7,71.4,1,5,20.0,6,12,50.0,2,2,100.0,4,12,16,6,0,2,0,0,0,4
../kbl_data/2023-2024,S43G01N100,안양 정관장,Home,장태빈,0,0,1,0.0,0,0,0.0,0,1,0.0,0,0,0.0,0,0,0,1,0,0,0,0,0,1
../kbl_data/2023-2024,S43G01N100,안양 정관장,Home,김경원,10,3,3,100.0,1,1,100.0,4,4,100.0,1,1,100.0,1,2,3,0,0,0,0,0,0,3
../kbl_data/2023-2024,S43G01N100,안양 정관장,Home,렌즈 아반도,7,2,4,50.0,0,0,0.0,2,4,50.0,3,4,75.0,1,1,2,1,0,0,0,1,2,1
../kbl_data/2023-2024,S43G01N100,안양 정관장,Home,고찬혁,0,0,0,0.0,0,0,0.0,0,0,0.0,0,0,0.0,0,0,0,0,0,0,0,0,0,0
../kbl_data/2023-2024,S43G01N100,서울 삼성,Away,이정현,0,0,1,0.0,0,3,0.0,0,4,0.0,0,0,0.0,0,1,1,0,0,0,0,0,0,1
../kbl_data/2023-2024,S43G01N100,서울 삼성,Away,홍경기,2,1,2,50.0,0,1,0.0,1,3,33.3,0,0,0.0,0,0,0,1,0,0,0,0,0,0
../kbl_data/2023-2024,S43G01N100,서울 삼성,Away,김승원,0,0,0,0.0,0,0,0.0,0,0,0.0,0,0,0.0,0,1,1,0,0,1,0,0,0,1
../kbl_data/2023-2024,S43G01N100,서울 삼성,Away,김시래,3,1,4,25.0,0,0,0.0,1,4,25.0,1,1,100.0,0,0,0,6,1,0,0,0,2,3
../kbl_data/2023-2024,S43G01N100,서울 삼성,Away,이동엽,0,0,1,0.0,0,2,0.0,0,3,0.0,0,0,0.0,0,2,2,2,1,0,0,0,1,1
../kbl_data/2023-2024,S43G01N100,서울 삼성,Away,최승욱,4,2,3,66.7,0,1,0.0,2,4,50.0,0,0,0.0,0,0,0,0,0,0,0,0,0,0
../kbl_data/2023-2024,S43G01N100,서울 삼성,Away,윤성원,0,0,0,0.0,0,2,0.0,0,2,0.0,0,0,0.0,0,1,1,1,0,0,0,0,0,4
../kbl_data/2023-2024,S43G01N100,서울 삼성,Away,이원석,23,8,12,66.7,1,4,25.0,9,16,56.2,4,7,57.1,4,5,9,1,2,0,1,0,3,3
../kbl_data/2023-2024,S43G01N100,서울 삼성,Away,신동혁,10,3,4,75.0,1,5,20.0,4,9,44.4,1,1,100.0,0,5,5,2,0,0,0,0,0,4
../kbl_data/2023-2024,S43G01N100,서울 삼성,Away,아반 나바,2,1,1,100.0,0,2,0.0,1,3,33.3,0,0,0.0,0,1,1,1,0,0,0,0,0,0
../kbl_data/2023-2024,S43G01N100,서울 삼성,Away,이스마엘 레인,10,2,2,100.0,1,1,100.0,3,3,100.0,3,3,100.0,1,0,1,0,0,0,0,0,1,0
../kbl_data/2023-2024,S43G01N100,서울 삼성,Away,코피 코번,21,8,15,53.3,0,0,0.0,8,15,53.3,5,9,55.6,8,6,14,6,1,1,0,0,1,0
../kbl_data/2023-2024,S43G01N101,대구 한국가스공사,Home,차바위,9,2,3,66.7,1,2,50.0,3,5,60.0,2,3,66.7,0,4,4,1,0,0,0,0,4,2
../kbl_data/2023-2024,S43G01N101,대구 한국가스공사,Home,박지훈,0,0,1,0.0,0,0,0.0,0,1,0.0,0,0,0.0,0,0,0,0,0,0,0,0,0,0
../kbl_data/2023-2024,S43G01N101,대구 한국가스공사,Home,조상열,0,0,0,0.0,0,1,0.0,0,1,0.0,0,0,0.0,0,0,0,0,0,0,0,0,1,1
../kbl_data/2023-2024,S43G01N101,대구 한국가스공사,Home,이대헌,14,5,6,83.3,1,1,100.0,6,7,85.7,1,2,50.0,0,2,2,0,0,0,2,0,3,4
../kbl_data/2023-2024,S43G01N101,대구 한국가스공사,Home,양재혁,0,0,1,0.0,0,0,0.0,0,1,0.0,0,0,0.0,0,2,2,0,0,0,0,0,0,0
../kbl_data/2023-2024,S43G01N101,대구 한국가스공사,Home,양준우,0,0,1,0.0,0,1,0.0,0,2,0.0,0,2,0.0,0,0,0,0,0,0,0,0,0,1
../kbl_data/2023-2024,S43G01N101,대구 한국가스공사,Home,앤드류 니콜슨,26,8,12,66.7,2,5,40.0,10,17,58.8,4,4,100.0,0,8,8,1,1,1,0,2,0,1
../kbl_data/2023-2024,S43G01N101,대구 한국가스공사,Home,신승민,10,5,7,71.4,0,2,0.0,5,9,55.6,0,0,0.0,3,5,8,2,0,0,1,0,1,4
../kbl_data/2023-2024,S43G01N101,대구 한국가스공사,Home,샘조세프 벨란겔,23,2,4,50.0,6,10,60.0,8,14,57.1,1,2,50.0,0,3,3,3,2,0,1,0,2,3
../kbl_data/2023-2024,S43G01N101,대구 한국가스공사,Home,안세영,0,0,1,0.0,0,0,0.0,0,1,0.0,0,0,0.0,0,1,1,1,1,0,0,0,0,0
../kbl_data/2023-2024,S43G01N101,대구 한국가스공사,Home,신주영,2,1,1,100.0,0,0,0.0,1,1,100.0,0,0,0.0,1,0,1,0,0,0,0,0,0,0
../kbl_data/2023-2024,S43G01N101,대구 한국가스공사,Home,듀반 맥스웰,4,2,6,33.3,0,0,0.0,2,6,33.3,0,0,0.0,2,1,3,3,2,0,1,1,0,4
../kbl_data/2023-2024,S43G01N101,창원 LG,Away,이관희,3,0,4,0.0,1,3,33.3,1,7,14.3,0,0,0.0,0,2,2,1,0,0,0,0,1,1
../kbl_data/2023-2024,S43G01N101,창원 LG,Away,정희재,7,0,0,0.0,1,1,100.0,1,1,100.0,4,4,100.0,0,2,2,0,0,0,0,0,0,4
../kbl_data/2023-2024,S43G01N101,창원 LG,Away,임동섭,3,0,0,0.0,1,1,100.0,1,1,100.0,0,0,0.0,0,0,0,0,1,0,0,0,1,0
../kbl_data/2023-2024,S43G01N101,창원 LG,Away,이재도,9,1,3,33.3,1,6,16.7,2,9,22.2,4,4,100.0,1,1,2,3,0,0,0,0,3,1
../kbl_data/2023-2024,S43G01N101,창원 LG,Away,정인덕,0,0,0,0.0,0,0,0.0,0,0,0.0,0,0,0.0,1,0,1,0,0,0,0,0,0,0
../kbl_data/2023-2024,S43G01N101,창원 LG,Away,양홍석,7,2,5,40.0,1,4,25.0,3,9,33.3,0,0,0.0,0,7,7,1,1,0,0,0,1,1
../kbl_data/2023-2024,S43G01N101,창원 LG,Away,박정현,0,0,0,0.0,0,0,0.0,0,0,0.0,0,0,0.0,0,0,0,0,0,0,0,0,1,2
../kbl_data/2023-2024,S43G01N101,창원 LG,Away,아셈 마레이,14,3,10,30.0,1,1,100.0,4,11,36.4,5,6,83.3,8,9,17,4,4,1,0,0,1,3
../kbl_data/2023-2024,S43G01N101,창원 LG,Away,저스틴 구탕,14,4,8,50.0,2,2,100.0,6,10,60.0,0,0,0.0,1,2,3,2,0,0,0,0,1,1
../kbl_data/2023-2024,S43G01N101,창원 LG,Away,양준석,5,1,2,50.0,1,3,33.3,2,5,40.0,0,0,0.0,0,0,0,0,0,0,0,0,1,3
../kbl_data/2023-2024,S43G01N101,창원 LG,Away,유기상,5,1,1,100.0,1,4,25.0,2,5,40.0,0,0,0.0,0,0,0,0,0,0,0,0,1,2
../kbl_data/2023-2024,S43G01N101,창원 LG,Away,후안 텔로,2,1,3,33.3,0,1,0.0,1,4,25.0,0,0,0.0,0,2,2,0,0,0,0,0,3,3
../kbl_data/2023-2024,S43G01N102,서울 SK,Home,양우섭,0,0,0,0.0,0,0,0.0,0,0,0.0,0,0,0.0,0,0,0,0,0,0,0,0,0,0
../kbl_data/2023-2024,S43G01N102,서울 SK,Home,송창용,2,1,1,100.0,0,0,0.0,1,1,100.0,0,0,0.0,0,0,0,0,0,0,0,0,1,0
../kbl_data/2023-2024,S43G01N102,서울 SK,Home,김선형,5,1,5,20.0,1,1,100.0,2,6,33.3,0,0,0.0,0,1,1,5,2,0,0,0,1,1
../kbl_data/2023-2024,S43G01N102,서울 SK,Home,오세근,14,4,7,57.1,2,5,40.0,6,12,50.0,0,0,0.0,2,4,6,0,0,0,0,0,1,2
../kbl_data/2023-2024,S43G01N102,서울 SK,Home,최부경,2,1,1,100.0,0,0,0.0,1,1,100.0,0,0,0.0,0,3,3,0,0,0,0,0,2,4
../kbl_data/2023-2024,S43G01N102,서울 SK,Home,리온 윌리엄스,0,0,2,0.0,0,0,0.0,0,2,0.0,0,0,0.0,2,1,3,0,0,0,0,0,0,0
../kbl_data/2023-2024,S43G01N102,서울 SK,Home,최원혁,11,2,2,100.0,2,6,33.3,4,8,50.0,1,2,50.0,4,4,8,6,3,0,0,0,1,1
../kbl_data/2023-2024,S43G01N102,서울 SK,Home,안영준,7,2,9,22.2,1,5,20.0,3,14,21.4,0,1,0.0,3,3,6,2,0,1,0,0,4,1
../kbl_data/2023-2024,S43G01N102,서울 SK,Home,자밀 워니,40,15,24,62.5,3,6,50.0,18,30,60.0,1,3,33.3,6,8,14,8,1,1,0,0,0,1
../kbl_data/2023-2024,S43G01N102,서울 SK,Home,오재현,4,2,3,66.7,0,3,0.0,2,6,33.3,0,0,0.0,0,2,2,1,2,0,0,0,2,5
../kbl_data/2023-2024,S43G01N102,서울 SK,Home,김건우,0,0,0,0.0,0,0,0.0,0,0,0.0,0,0,0.0,0,0,0,0,0,0,0,0,0,0
../kbl_data/2023-2024,S43G01N102,서울 SK,Home,고메즈 딜 리아노,0,0,1,0.0,0,0,0.0,0,1,0.0,0,0,0.0,0,0,0,1,1,0,0,0,0,2
../kbl_data/2023-2024,S43G01N102,울산 현대모비스,Away,함지훈,2,1,2,50.0,0,0,0.0,1,2,50.0,0,0,0.0,0,2,2,4,1,0,0,0,0,1
../kbl_data/2023-2024,S43G01N102,울산 현대모비스,Away,최진수,1,0,0,0.0,0,0,0.0,0,0,0.0,1,2,50.0,0,0,0,2,1,0,0,0,0,2
../kbl_data/2023-2024,S43G01N102,울산 현대모비스,Away,김현수,0,0,0,0.0,0,0,0.0,0,0,0.0,0,0,0.0,0,0,0,0,0,0,0,0,0,0
../kbl_data/2023-2024,S43G01N102,울산 현대모비스,Away,장재석,10,4,6,66.7,0,0,0.0,4,6,66.7,2,3,66.7,0,6,6,0,0,3,0,0,1,1
../kbl_data/2023-2024,S43G01N102,울산 현대모비스,Away,김지완,7,2,3,66.7,1,2,50.0,3,5,60.0,0,0,0.0,0,1,1,2,0,0,0,0,2,2
../kbl_data/2023-2024,S43G01N102,울산 현대모비스,Away,김준일,4,1,4,25.0,0,0,0.0,1,4,25.0,2,2,100.0,0,3,3,0,1,1,0,0,1,2
../kbl_data/2023-2024,S43G01N102,울산 현대모비스,Away,김국찬,5,1,3,33.3,1,1,100.0,2,4,50.0,0,0,0.0,0,0,0,1,3,0,0,0,1,0
../kbl_data/2023-2024,S43G01N102,울산 현대모비스,Away,이우석,14,4,8,50.0,2,7,28.6,6,15,40.0,0,0,0.0,0,1,1,3,1,0,0,0,0,0
../kbl_data/2023-2024,S43G01N102,울산 현대모비스,Away,게이지 프림,14,6,9,66.7,0,1,0.0,6,10,60.0,2,3,66.7,1,5,6,5,0,0,0,0,0,3
../kbl_data/2023-2024,S43G01N102,울산 현대모비스,Away,김태완,3,0,1,0.0,1,2,50.0,1,3,33.3,0,0,0.0,2,0,2,0,0,0,0,0,1,1
../kbl_data/2023-2024,S43G01N102,울산 현대모비스,Away,박무빈,14,3,7,42.9,1,3,33.3,4,10,40.0,5,5,100.0,1,0,1,4,1,0,0,0,3,2
../kbl_data/2023-2024,S43G01N102,울산 현대모비스,Away,케베 알루마,3,0,0,0.0,1,2,50.0,1,2,50.0,0,0,0.0,0,2,2,0,1,0,0,0,2,0
../kbl_data/2023-2024,S43G01N103,원주 DB,Home,서민수,0,0,0,0.0,0,0,0.0,0,0,0.0,0,0,0.0,0,0,0,0,0,0,0,0,0,0
../kbl_data/2023-2024,S43G01N103,원주 DB,Home,두경민,9,0,0,0.0,0,4,0.0,0,4,0.0,9,9,100.0,0,2,2,1,1,0,0,0,1,0
../kbl_data/2023-2024,S43G01N103,원주 DB,Home,김영현,0,0,0,0.0,0,0,0.0,0,0,0.0,0,0,0.0,0,0,0,0,0,0,0,0,0,1
../kbl_data/2023-2024,S43G01N103,원주 DB,Home,김종규,10,3,6,50.0,0,0,0.0,3,6,50.0,4,4,100.0,4,3,7,2,1,0,0,0,2,5
../kbl_data/2023-2024,S43G01N103,원주 DB,Home,최승욱,4,1,2,50.0,0,2,0.0,1,4,25.0,2,2,100.0,0,3,3,0,0,0,0,0,1,2
../kbl_data/2023-2024,S43G01N103,원주 DB,Home,강상재,9,3,5,60.0,1,6,16.7,4,11,36.4,0,0,0.0,0,3,3,4,0,0,0,0,2,2
../kbl_data/2023-2024,S43G01N103,원주 DB,Home,유현준,0,0,0,0.0,0,0,0.0,0,0,0.0,0,0,0.0,0,0,0,0,0,0,0,0,0,0
../kbl_data/2023-2024,S43G01N103,원주 DB,Home,디드릭 로슨,24,6,11,54.5,3,7,42.9,9,18,50.0,3,5,60.0,2,11,13,4,0,0,0,0,1,0
../kbl_data/2023-2024,S43G01N103,원주 DB,Home,이선 알바노,21,4,10,40.0,4,6,66.7,8,16,50.0,1,2,50.0,0,2,2,5,3,0,1,0,3,2
../kbl_data/2023-2024,S43G01N103,원주 DB,Home,박인웅,3,0,1,0.0,1,3,33.3,1,4,25.0,0,0,0.0,0,0,0,0,0,0,0,0,0,5
../kbl_data/2023-2024,S43G01N103,원주 DB,Home,박승재,0,0,0,0.0,0,0,0.0,0,0,0.0,0,0,0.0,0,0,0,0,0,0,0,0,0,0
../kbl_data/2023-2024,S43G01N103,원주 DB,Home,제프 위디,2,1,2,50.0,0,1,0.0,1,3,33.3,0,0,0.0,1,2,3,0,0,2,0,1,1,1
../kbl_data/2023-2024,S43G01N103,수원 KT,Away,한희원,11,2,3,66.7,2,7,28.6,4,10,40.0,1,3,33.3,0,8,8,1,0,0,0,0,1,5
../kbl_data/2023-2024,S43G01N103,수원 KT,Away,최창진,0,0,0,0.0,0,0,0.0,0,0,0.0,0,0,0.0,1,2,3,1,1,0,0,0,1,3
../kbl_data/2023-2024,S43G01N103,수원 KT,Away,문성곤,4,2,4,50.0,0,6,0.0,2,10,20.0,0,0,0.0,4,4,8,4,2,0,0,0,0,4
../kbl_data/2023-2024,S43G01N103,수원 KT,Away,이현석,0,0,0,0.0,0,0,0.0,0,0,0.0,0,0,0.0,0,0,0,0,0,0,0,0,0,0
../kbl_data/2023-2024,S43G01N103,수원 KT,Away,정성우,17,2,6,33.3,4,9,44.4,6,15,40.0,1,3,33.3,2,2,4,7,3,0,0,0,2,3
../kbl_data/2023-2024,S43G01N103,수원 KT,Away,김준환,2,0,0,0.0,0,0,0.0,0,0,0.0,2,2,100.0,0,0,0,0,0,0,0,0,0,0
../kbl_data/2023-2024,S43G01N103,수원 KT,Away,하윤기,10,4,11,36.4,0,0,0.0,4,11,36.4,2,4,50.0,5,4,9,1,1,1,0,0,2,2
../kbl_data/2023-2024,S43G01N103,수원 KT,Away,이두원,0,0,1,0.0,0,0,0.0,0,1,0.0,0,0,0.0,1,1,2,0,0,0,0,0,2,0
../kbl_data/2023-2024,S43G01N103,수원 KT,Away,숀 데이브 일데폰소,3,0,1,0.0,1,1,100.0,1,2,50.0,0,0,0.0,0,1,1,1,0,0,0,0,1,1
../kbl_data/2023-2024,S43G01N103,수원 KT,Away,문정현,0,0,0,0.0,0,1,0.0,0,1,0.0,0,0,0.0,0,0,0,0,0,0,0,0,0,1
../kbl_data/2023-2024,S43G01N103,수원 KT,Away,마이클 에릭,0,0,0,0.0,0,0,0.0,0,0,0.0,0,0,0.0,0,0,0,0,0,0,0,0,0,0
../kbl_data/2023-2024,S43G01N103,수원 KT,Away,패리스 배스,43,8,14,57.1,7,12,58.3,15,26,57.7,6,8,75.0,3,6,9,2,1,0,0,1,2,3
../kbl_data/2023-2024,S43G01N104,창원 LG,Home,이관희,3,0,3,0.0,1,4,25.0,1,7,14.3,0,0,0.0,0,0,0,1,0,0,0,0,0,3
../kbl_data/2023-2024,S43G01N104,창원 LG,Home,정희재,11,2,3,66.7,1,3,33.3,3,6,50.0,4,4,100.0,2,0,2,0,0,0,0,0,0,1
../kbl_data/2023-2024,S43G01N104,창원 LG,Home,임동섭,3,0,0,0.0,1,4,25.0,1,4,25.0,0,0,0.0,0,0,0,0,0,1,0,0,0,3
../kbl_data/2023-2024,S43G01N104,창원 LG,Home,이재도,10,2,4,50.0,2,2,100.0,4,6,66.7,0,0,0.0,0,1,1,0,0,0,0,0,0,0
../kbl_data/2023-2024,S43G01N104,창원 LG,Home,정인덕,0,0,0,0.0,0,0,0.0,0,0,0.0,0,0,0.0,0,0,0,0,0,0,0,0,0,0
../kbl_data/2023-2024,S43G01N104,창원 LG,Home,양홍석,26,7,14,50.0,3,6,50.0,10,20,50.0,3,4,75.0,2,7,9,7,2,1,0,0,1,2
../kbl_data/2023-2024,S43G01N104,창원 LG,Home,박정현,0,0,0,0.0,0,0,0.0,0,0,0.0,0,0,0.0,0,0,0,0,0,0,0,0,0,0
../kbl_data/2023-2024,S43G01N104,창원 LG,Home,아셈 마레이,22,8,16,50.0,0,0,0.0,8,16,50.0,6,7,85.7,8,8,16,3,0,0,0,1,1,4
../kbl_data/2023-2024,S43G01N104,창원 LG,Home,저스틴 구탕,5,1,1,100.0,1,1,100.0,2,2,100.0,0,0,0.0,0,3,3,5,1,0,0,0,2,4
../kbl_data/2023-2024,S43G01N104,창원 LG,Home,양준석,0,0,4,0.0,0,0,0.0,0,4,0.0,0,0,0.0,2,3,5,6,0,1,0,0,0,2
../kbl_data/2023-2024,S43G01N104,창원 LG,Home,유기상,11,1,2,50.0,3,7,42.9,4,9,44.4,0,0,0.0,0,3,3,1,0,2,0,0,0,3
../kbl_data/2023-2024,S43G01N104,창원 LG,Home,후안 텔로,2,1,4,25.0,0,1,0.0,1,5,20.0,0,0,0.0,0,3,3,1,3,0,0,0,1,1
../kbl_data/2023-2024,S43G01N104,서울 삼성,Away,이정현,11,0,0,0.0,3,7,42.9,3,7,42.9,2,3,66.7,0,3,3,1,0,0,0,0,1,0
../kbl_data/2023-2024,S43G01N104,서울 삼성,Away,홍경기,0,0,1,0.0,0,1,0.0,0,2,0.0,0,0,0.0,1,1,2,1,0,0,0,0,0,0
../kbl_data/2023-2024,S43G01N104,서울 삼성,Away,김승원,0,0,0,0.0,0,0,0.0,0,0,0.0,0,0,0.0,0,0,0,0,0,0,0,0,0,0
../kbl_data/2023-2024,S43G01N104,서울 삼성,Away,김시래,7,2,6,33.3,0,4,0.0,2,10,20.0,3,4,75.0,1,2,3,5,2,0,0,0,3,5
../kbl_data/2023-2024,S43G01N104,서울 삼성,Away,이동엽,5,1,4,25.0,0,2,0.0,1,6,16.7,3,5,60.0,2,2,4,1,0,0,0,0,1,2
../kbl_data/2023-2024,S43G01N104,서울 삼성,Away,최승욱,11,4,9,44.4,1,1,100.0,5,10,50.0,0,0,0.0,5,4,9,0,0,0,0,0,0,2
../kbl_data/2023-2024,S43G01N104,서울 삼성,Away,윤성원,0,0,0,0.0,0,1,0.0,0,1,0.0,0,0,0.0,0,0,0,0,0,0,0,0,0,2
../kbl_data/2023-2024,S43G01N104,서울 삼성,Away,이원석,8,2,7,28.6,0,1,0.0,2,8,25.0,4,6,66.7,2,5,7,1,0,1,0,1,1,3
../kbl_data/2023-2024,S43G01N104,서울 삼성,Away,신동혁,3,1,2,50.0,0,0,0.0,1,2,50.0,1,1,100.0,0,2,2,1,0,0,0,0,0,2
../kbl_data/2023-2024,S43G01N104,서울 삼성,Away,아반 나바,2,1,1,100.0,0,1,0.0,1,2,50.0,0,0,0.0,0,0,0,0,0,0,0,0,1,0
../kbl_data/2023-2024,S43G01N104,서울 삼성,Away,이스마엘 레인,2,1,4,25.0,0,1,0.0,1,5,20.0,0,0,0.0,1,4,5,1,0,0,0,1,2,1
../kbl_data/2023-2024,S43G01N104,서울 삼성,Away,코피 코번,26,13,22,59.1,0,0,0.0,13,22,59.1,0,4,0.0,3,6,9,1,0,2,0,2,1,2
../kbl_data/2023-2024,S43G01N105,부산 KCC,Home,정창영,2,1,1,100.0,0,1,0.0,1,2,50.0,0,0,0.0,0,0,0,1,0,0,0,0,0,1
../kbl_data/2023-2024,S43G01N105,부산 KCC,Home,라건아,10,5,9,55.6,0,2,0.0,5,11,45.5,0,0,0.0,5,5,10,0,0,1,0,0,2,3
../kbl_data/2023-2024,S43G01N105,부산 KCC,Home,허웅,11,4,5,80.0,0,6,0.0,4,11,36.4,3,5,60.0,0,2,2,4,1,0,0,0,2,1
../kbl_data/2023-2024,S43G01N105,부산 KCC,Home,이승현,3,0,2,0.0,1,1,100.0,1,3,33.3,0,0,0.0,1,1,2,2,0,0,1,0,0,3
../kbl_data/2023-2024,S43G01N105,부산 KCC,Home,이호현,2,0,1,0.0,0,2,0.0,0,3,0.0,2,2,100.0,1,3,4,1,0,0,0,0,1,1
../kbl_data/2023-2024,S43G01N105,부산 KCC,Home,송교창,15,5,11,45.5,0,3,0.0,5,14,35.7,5,6,83.3,4,1,5,4,1,1,0,1,1,2
../kbl_data/2023-2024,S43G01N105,부산 KCC,Home,최준용,7,2,9,22.2,1,2,50.0,3,11,27.3,0,1,0.0,2,6,8,2,1,0,0,0,3,0
../kbl_data/2023-2024,S43G01N105,부산 KCC,Home,곽정훈,0,0,0,0.0,0,0,0.0,0,0,0.0,0,0,0.0,0,0,0,0,0,0,0,0,0,0
../kbl_data/2023-2024,S43G01N105,부산 KCC,Home,이근휘,1,0,0,0.0,0,0,0.0,0,0,0.0,1,2,50.0,1,1,2,0,0,0,0,0,0,0
../kbl_data/2023-2024,S43G01N105,부산 KCC,Home,김동현,0,0,0,0.0,0,0,0.0,0,0,0.0,0,0,0.0,0,0,0,0,0,0,0,0,0,0
../kbl_data/2023-2024,S43G01N105,부산 KCC,Home,송동훈,0,0,1,0.0,0,1,0.0,0,2,0.0,0,0,0.0,0,1,1,2,1,0,0,0,1,3
../kbl_data/2023-2024,S43G01N105,부산 KCC,Home,알리제 드숀 존슨,18,8,11,72.7,0,4,0.0,8,15,53.3,2,2,100.0,4,11,15,2,1,0,0,0,4,1
../kbl_data/2023-2024,S43G01N105,고양 소노,Away,김강선,7,2,4,50.0,1,4,25.0,3,8,37.5,0,0,0.0,0,3,3,0,2,0,0,0,1,4
../kbl_data/2023-2024,S43G01N105,고양 소노,Away,김민욱,15,3,4,75.0,3,7,42.9,6,11,54.5,0,0,0.0,1,8,9,4,2,1,0,0,1,4
../kbl_data/2023-2024,S43G01N105,고양 소노,Away,한호빈,7,2,5,40.0,1,5,20.0,3,10,30.0,0,0,0.0,1,2,3,5,1,0,0,0,2,2
../kbl_data/2023-2024,S43G01N105,고양 소노,Away,전성현,2,1,3,33.3,0,7,0.0,1,10,10.0,0,3,0.0,0,0,0,0,1,0,0,0,1,4
../kbl_data/2023-2024,S43G01N105,고양 소노,Away,김진유,2,1,3,33.3,0,0,0.0,1,3,33.3,0,0,0.0,4,1,5,0,1,0,0,0,0,0
../kbl_data/2023-2024,S43G01N105,고양 소노,Away,김진용,0,0,0,0.0,0,0,0.0,0,0,0.0,0,0,0.0,0,0,0,0,0,0,0,0,0,0
../kbl_data/2023-2024,S43G01N105,고양 소노,Away,치나누 오누아쿠,12,5,14,35.7,0,0,0.0,5,14,35.7,2,4,50.0,3,8,11,3,0,1,0,0,6,2
../kbl_data/2023-2024,S43G01N105,고양 소노,Away,백지웅,0,0,0,0.0,0,2,0.0,0,2,0.0,0,0,0.0,0,1,1,1,1,0,0,0,0,2
../kbl_data/2023-2024,S43G01N105,고양 소노,Away,안정욱,0,0,0,0.0,0,0,0.0,0,0,0.0,0,0,0.0,0,0,0,0,0,0,0,0,0,0
../kbl_data/2023-2024,S43G01N105,고양 소노,Away,박종하,8,1,3,33.3,2,3,66.7,3,6,50.0,0,0,0.0,1,0,1,0,0,0,0,0,0,1
../kbl_data/2023-2024,S43G01N105,고양 소노,Away,민기남,0,0,2,0.0,0,1,0.0,0,3,0.0,0,0,0.0,0,0,0,2,0,0,1,0,0,2
../kbl_data/2023-2024,S43G01N105,고양 소노,Away,디욘테 데이비스,8,4,5,80.0,0,1,0.0,4,6,66.7,0,0,0.0,2,2,4,1,1,1,0,0,0,0
../kbl_data/2023-2024,S43G01N106,안양 정관장,Home,정준원,9,0,1,0.0,2,2,100.0,2,3,66.7,3,4,75.0,2,0,2,0,1,0,0,0,0,1
../kbl_data/2023-2024,S43G01N106,안양 정관장,Home,배병준,5,1,2,50.0,1,7,14.3,2,9,22.2,0,0,0.0,0,4,4,0,0,0,0,0,2,2
../kbl_data/2023-2024,S43G01N106,안양 정관장,Home,정효근,19,4,8,50.0,3,6,50.0,7,14,50.0,2,4,50.0,4,5,9,3,0,1,0,1,2,4
../kbl_data/2023-2024,S43G01N106,안양 정관장,Home,이종현,10,3,5,60.0,1,1,100.0,4,6,66.7,1,1,100.0,2,2,4,2,1,0,0,0,3,1
../kbl_data/2023-2024,S43G01N106,안양 정관장,Home,김철욱,0,0,1,0.0,0,3,0.0,0,4,0.0,0,0,0.0,1,1,2,1,0,0,0,0,0,3
../kbl_data/2023-2024,S43G01N106,안양 정관장,Home,박지훈,50,10,16,62.5,6,18,33.3,16,34,47.1,12,14,85.7,2,4,6,22,6,0,0,0,8,12
../kbl_data/2023-2024,S43G01N106,안양 정관장,Home,이우정,0,0,0,0.0,0,0,0.0,0,0,0.0,0,0,0.0,0,0,0,0,0,0,0,0,0,0
../kbl_data/2023-2024,S43G01N106,안양 정관장,Home,대릴 먼로,10,1,1,100.0,2,4,50.0,3,5,60.0,2,2,100.0,1,4,5,3,1,0,0,0,1,3
../kbl_data/2023-2024,S43G01N106,안양 정관장,Home,장태빈,6,1,2,50.0,1,2,50.0,2,4,50.0,1,2,50.0,0,0,0,0,1,0,0,0,0,2
../kbl_data/2023-2024,S43G01N106,안양 정관장,Home,김경원,5,2,3,66.7,0,0,0.0,2,3,66.7,1,2,50.0,0,2,2,0,0,0,0,0,0,1
../kbl_data/2023-2024,S43G01N106,안양 정관장,Home,고찬혁,0,0,0,0.0,0,1,0.0,0,1,0.0,0,0,0.0,0,0,0,0,0,0,0,0,0,0
../kbl_data/2023-2024,S43G01N106,안양 정관장,Home,나성호,0,0,0,0.0,0,0,0.0,0,0,0.0,0,0,0.0,0,0,0,0,0,0,0,0,0,2
../kbl_data/2023-2024,S43G01N106,대구 한국가스공사,Away,김동량,2,1,2,50.0,0,0,0.0,1,2,50.0,0,0,0.0,0,1,1,0,0,0,0,0,0,2
../kbl_data/2023-2024,S43G01N106,대구 한국가스공사,Away,차바위,4,2,2,100.0,0,1,0.0,2,3,66.7,0,0,0.0,2,2,4,3,1,0,0,0,1,3
../kbl_data/2023-2024,S43G01N106,대구 한국가스공사,Away,박지훈,50,10,16,62.5,6,18,33.3,16,34,47.1,12,14,85.7,2,4,6,22,6,0,0,0,8,12
../kbl_data/2023-2024,S43G01N106,대구 한국가스공사,Away,조상열,0,0,0,0.0,0,0,0.0,0,0,0.0,0,0,0.0,0,0,0,0,0,0,0,0,0,1
../kbl_data/2023-2024,S43G01N106,대구 한국가스공사,Away,이대헌,21,6,10,60.0,3,4,75.0,9,14,64.3,0,2,0.0,6,3,9,3,1,0,0,0,0,4
../kbl_data/2023-2024,S43G01N106,대구 한국가스공사,Away,김낙현,13,5,5,100.0,0,2,0.0,5,7,71.4,3,3,100.0,1,1,2,2,0,0,0,0,2,2
../kbl_data/2023-2024,S43G01N106,대구 한국가스공사,Away,양재혁,0,0,0,0.0,0,1,0.0,0,1,0.0,0,0,0.0,1,1,2,0,0,0,0,0,1,1
../kbl_data/2023-2024,S43G01N106,대구 한국가스공사,Away,앤드류 니콜슨,21,8,14,57.1,1,3,33.3,9,17,52.9,2,3,66.7,3,7,10,1,1,2,0,2,0,0
../kbl_data/2023-2024,S43G01N106,대구 한국가스공사,Away,신승민,4,2,2,100.0,0,4,0.0,2,6,33.3,0,0,0.0,0,3,3,1,3,1,0,0,2,1
../kbl_data/2023-2024,S43G01N106,대구 한국가스공사,Away,샘조세프 벨란겔,9,3,6,50.0,1,4,25.0,4,10,40.0,0,1,0.0,0,1,1,6,3,0,0,0,1,3
../kbl_data/2023-2024,S43G01N106,대구 한국가스공사,Away,안세영,0,0,0,0.0,0,0,0.0,0,0,0.0,0,0,0.0,0,0,0,0,1,0,0,0,0,3
../kbl_data/2023-2024,S43G01N106,대구 한국가스공사,Away,듀반 맥스웰,8,3,4,75.0,0,0,0.0,3,4,75.0,2,3,66.7,0,3,3,1,0,0,0,1,2,0
../kbl_data/2023-2024,S43G01N107,수원 KT,Home,한희원,6,0,0,0.0,2,6,33.3,2,6,33.3,0,0,0.0,0,0,0,2,0,0,0,0,0,3
../kbl_data/2023-2024,S43G01N107,수원 KT,Home,최창진,1,0,1,0.0,0,0,0.0,0,1,0.0,1,2,50.0,0,2,2,4,1,0,0,0,1,2
../kbl_data/2023-2024,S43G01N107,수원 KT,Home,문성곤,5,1,2,50.0,1,4,25.0,2,6,33.3,0,0,0.0,1,0,1,1,1,0,0,0,1,2
../kbl_data/2023-2024,S43G01N107,수원 KT,Home,이현석,0,0,0,0.0,0,0,0.0,0,0,0.0,0,0,0.0,0,0,0,0,0,0,0,0,0,0
../kbl_data/2023-2024,S43G01N107,수원 KT,Home,정성우,7,1,2,50.0,1,5,20.0,2,7,28.6,2,2,100.0,0,2,2,3,0,0,0,0,3,1
../kbl_data/2023-2024,S43G01N107,수원 KT,Home,김준환,5,1,2,50.0,1,1,100.0,2,3,66.7,0,0,0.0,0,0,0,0,0,0,0,0,0,0
../kbl_data/2023-2024,S43G01N107,수원 KT,Home,하윤기,11,4,12,33.3,0,0,0.0,4,12,33.3,3,4,75.0,4,5,9,4,0,0,0,1,2,2
../kbl_data/2023-2024,S43G01N107,수원 KT,Home,이두원,0,0,0,0.0,0,0,0.0,0,0,0.0,0,0,0.0,0,0,0,0,0,0,0,0,0,0
../kbl_data/2023-2024,S43G01N107,수원 KT,Home,숀 데이브 일데폰소,14,1,3,33.3,3,7,42.9,4,10,40.0,3,4,75.0,2,2,4,1,1,0,0,0,2,0
../kbl_data/2023-2024,S43G01N107,수원 KT,Home,문정현,3,0,2,0.0,0,0,0.0,0,2,0.0,3,4,75.0,2,2,4,0,1,0,0,0,0,1
../kbl_data/2023-2024,S43G01N107,수원 KT,Home,마이클 에릭,7,3,5,60.0,0,0,0.0,3,5,60.0,1,3,33.3,3,5,8,3,0,0,0,1,0,3
../kbl_data/2023-2024,S43G01N107,수원 KT,Home,패리스 배스,12,3,5,60.0,2,10,20.0,5,15,33.3,0,0,0.0,1,8,9,0,0,0,0,1,1,2
../kbl_data/2023-2024,S43G01N107,서울 SK,Away,양우섭,0,0,0,0.0,0,0,0.0,0,0,0.0,0,0,0.0,0,0,0,0,0,0,0,0,0,0
../kbl_data/2023-2024,S43G01N107,서울 SK,Away,송창용,0,0,0,0.0,0,2,0.0,0,2,0.0,0,0,0.0,0,0,0,0,0,0,0,0,1,0
../kbl_data/2023-2024,S43G01N107,서울 SK,Away,김선형,12,4,5,80.0,1,3,33.3,5,8,62.5,1,2,50.0,0,2,2,1,1,0,0,0,1,4
../kbl_data/2023-2024,S43G01N107,서울 SK,Away,오세근,11,4,4,100.0,1,3,33.3,5,7,71.4,0,0,0.0,1,5,6,0,0,0,0,0,0,3
../kbl_data/2023-2024,S43G01N107,서울 SK,Away,최부경,2,1,4,25.0,0,0,0.0,1,4,25.0,0,0,0.0,0,2,2,2,2,0,0,0,0,1
../kbl_data/2023-2024,S43G01N107,서울 SK,Away,리온 윌리엄스,2,1,1,100.0,0,0,0.0,1,1,100.0,0,0,0.0,0,0,0,0,0,0,0,0,0,1
../kbl_data/2023-2024,S43G01N107,서울 SK,Away,최원혁,2,1,1,100.0,0,1,0.0,1,2,50.0,0,0,0.0,1,0,1,4,2,0,0,0,1,3
../kbl_data/2023-2024,S43G01N107,서울 SK,Away,안영준,12,4,9,44.4,0,4,0.0,4,13,30.8,4,7,57.1,0,7,7,5,1,0,0,0,2,3
../kbl_data/2023-2024,S43G01N107,서울 SK,Away,자밀 워니,29,7,13,53.8,3,4,75.0,10,17,58.8,6,10,60.0,4,6,10,3,1,3,0,1,0,2
../kbl_data/2023-2024,S43G01N107,서울 SK,Away,오재현,13,1,3,33.3,3,4,75.0,4,7,57.1,2,2,100.0,0,4,4,5,1,0,0,0,0,3
../kbl_data/2023-2024,S43G01N107,서울 SK,Away,김건우,0,0,0,0.0,0,0,0.0,0,0,0.0,0,0,0.0,0,0,0,0,0,0,0,0,0,0
../kbl_data/2023-2024,S43G01N107,서울 SK,Away,고메즈 딜 리아노,2,1,1,100.0,0,0,0.0,1,1,100.0,0,0,0.0,0,0,0,1,0,0,0,0,0,1
../kbl_data/2023-2024,S43G01N108,울산 현대모비스,Home,함지훈,9,4,10,40.0,0,0,0.0,4,10,40.0,1,2,50.0,1,2,3,8,2,2,0,0,2,2
../kbl_data/2023-2024,S43G01N108,울산 현대모비스,Home,최진수,0,0,0,0.0,0,0,0.0,0,0,0.0,0,0,0.0,0,0,0,0,0,0,0,0,0,0
../kbl_data/2023-2024,S43G01N108,울산 현대모비스,Home,김현수,0,0,0,0.0,0,0,0.0,0,0,0.0,0,0,0.0,0,0,0,0,0,0,0,0,0,0
../kbl_data/2023-2024,S43G01N108,울산 현대모비스,Home,장재석,0,0,0,0.0,0,0,0.0,0,0,0.0,0,0,0.0,0,0,0,0,0,0,0,0,0,1
../kbl_data/2023-2024,S43G01N108,울산 현대모비스,Home,김지완,6,0,1,0.0,2,2,100.0,2,3,66.7,0,0,0.0,1,2,3,2,0,0,0,0,0,1
../kbl_data/2023-2024,S43G01N108,울산 현대모비스,Home,김준일,0,0,1,0.0,0,0,0.0,0,1,0.0,0,0,0.0,0,1,1,0,1,0,0,0,0,2
../kbl_data/2023-2024,S43G01N108,울산 현대모비스,Home,김국찬,3,0,0,0.0,0,5,0.0,0,5,0.0,3,3,100.0,0,3,3,0,0,0,0,0,3,4
../kbl_data/2023-2024,S43G01N108,울산 현대모비스,Home,박준은,0,0,2,0.0,0,2,0.0,0,4,0.0,0,0,0.0,0,1,1,0,0,0,0,0,0,2
../kbl_data/2023-2024,S43G01N108,울산 현대모비스,Home,이우석,10,4,8,50.0,0,0,0.0,4,8,50.0,2,4,50.0,1,9,10,4,0,0,0,0,0,4
../kbl_data/2023-2024,S43G01N108,울산 현대모비스,Home,게이지 프림,32,13,21,61.9,0,2,0.0,13,23,56.5,6,8,75.0,4,5,9,4,1,1,1,0,5,3
../kbl_data/2023-2024,S43G01N108,울산 현대모비스,Home,김태완,0,0,0,0.0,0,0,0.0,0,0,0.0,0,0,0.0,0,0,0,0,0,0,0,0,0,0
../kbl_data/2023-2024,S43G01N108,울산 현대모비스,Home,박무빈,21,6,11,54.5,1,4,25.0,7,15,46.7,6,8,75.0,3,3,6,6,2,0,0,0,1,4
../kbl_data/2023-2024,S43G01N108,부산 KCC,Away,정창영,0,0,1,0.0,0,2,0.0,0,3,0.0,0,0,0.0,1,1,2,1,0,0,0,0,0,1
../kbl_data/2023-2024,S43G01N108,부산 KCC,Away,라건아,10,4,8,50.0,0,0,0.0,4,8,50.0,2,3,66.7,2,3,5,0,0,1,0,0,2,1
../kbl_data/2023-2024,S43G01N108,부산 KCC,Away,허웅,15,1,2,50.0,4,7,57.1,5,9,55.6,1,2,50.0,0,1,1,4,0,0,0,0,2,3
../kbl_data/2023-2024,S43G01N108,부산 KCC,Away,이승현,2,1,4,25.0,0,0,0.0,1,4,25.0,0,0,0.0,1,0,1,1,0,0,0,0,0,0
../kbl_data/2023-2024,S43G01N108,부산 KCC,Away,이호현,0,0,2,0.0,0,1,0.0,0,3,0.0,0,0,0.0,0,0,0,0,0,0,0,0,2,2
../kbl_data/2023-2024,S43G01N108,부산 KCC,Away,송교창,10,3,8,37.5,0,1,0.0,3,9,33.3,4,4,100.0,0,9,9,0,0,0,0,0,2,5
../kbl_data/2023-2024,S43G01N108,부산 KCC,Away,최준용,6,2,6,33.3,0,3,0.0,2,9,22.2,2,4,50.0,2,2,4,5,1,2,0,0,1,5
../kbl_data/2023-2024,S43G01N108,부산 KCC,Away,곽정훈,0,0,0,0.0,0,0,0.0,0,0,0.0,0,0,0.0,0,0,0,0,0,0,0,0,0,0
../kbl_data/2023-2024,S43G01N108,부산 KCC,Away,이근휘,20,1,1,100.0,5,6,83.3,6,7,85.7,3,3,100.0,0,0,0,4,0,0,0,0,0,1
../kbl_data/2023-2024,S43G01N108,부산 KCC,Away,김동현,0,0,0,0.0,0,0,0.0,0,0,0.0,0,0,0.0,0,0,0,0,0,0,0,0,0,0
../kbl_data/2023-2024,S43G01N108,부산 KCC,Away,송동훈,3,0,0,0.0,1,2,50.0,1,2,50.0,0,0,0.0,1,0,1,2,0,0,0,0,0,1
../kbl_data/2023-2024,S43G01N108,부산 KCC,Away,알리제 드숀 존슨,18,8,12,66.7,0,2,0.0,8,14,57.1,2,6,33.3,5,7,12,9,3,0,2,0,2,4
../kbl_data/2023-2024,S43G01N109,대구 한국가스공사,Home,김동량,0,0,0,0.0,0,0,0.0,0,0,0.0,0,0,0.0,0,0,0,0,0,0,0,0,0,0
../kbl_data/2023-2024,S43G01N109,대구 한국가스공사,Home,박지훈,5,1,3,33.3,1,1,100.0,2,4,50.0,0,3,0.0,0,1,1,0,0,0,0,0,1,4
../kbl_data/2023-2024,S43G01N109,대구 한국가스공사,Home,조상열,0,0,0,0.0,0,2,0.0,0,2,0.0,0,0,0.0,0,0,0,0,0,0,0,0,0,1
../kbl_data/2023-2024,S43G01N109,대구 한국가스공사,Home,이대헌,5,2,6,33.3,0,2,0.0,2,8,25.0,1,4,25.0,1,3,4,1,1,0,1,0,1,1
../kbl_data/2023-2024,S43G01N109,대구 한국가스공사,Home,김낙현,0,0,1,0.0,0,2,0.0,0,3,0.0,0,0,0.0,0,2,2,3,0,0,0,0,1,1
../kbl_data/2023-2024,S43G01N109,대구 한국가스공사,Home,양재혁,2,1,1,100.0,0,3,0.0,1,4,25.0,0,0,0.0,0,0,0,1,2,0,0,0,0,4
../kbl_data/2023-2024,S43G01N109,대구 한국가스공사,Home,앤드류 니콜슨,22,7,11,63.6,2,5,40.0,9,16,56.2,2,2,100.0,0,5,5,1,1,0,0,1,1,0
../kbl_data/2023-2024,S43G01N109,대구 한국가스공사,Home,신승민,12,3,4,75.0,2,4,50.0,5,8,62.5,0,0,0.0,1,4,5,0,1,0,1,0,2,2
../kbl_data/2023-2024,S43G01N109,대구 한국가스공사,Home,샘조세프 벨란겔,10,4,6,66.7,0,2,0.0,4,8,50.0,2,2,100.0,0,1,1,3,0,0,0,0,3,3
../kbl_data/2023-2024,S43G01N109,대구 한국가스공사,Home,안세영,2,1,1,100.0,0,2,0.0,1,3,33.3,0,0,0.0,0,0,0,0,1,0,1,0,0,5
../kbl_data/2023-2024,S43G01N109,대구 한국가스공사,Home,신주영,2,1,3,33.3,0,0,0.0,1,3,33.3,0,0,0.0,0,0,0,1,0,0,0,0,0,1
../kbl_data/2023-2024,S43G01N109,대구 한국가스공사,Home,듀반 맥스웰,12,5,7,71.4,0,1,0.0,5,8,62.5,2,2,100.0,1,3,4,0,2,3,0,1,0,0
../kbl_data/2023-2024,S43G01N109,원주 DB,Away,김현호,1,0,0,0.0,0,0,0.0,0,0,0.0,1,2,50.0,0,0,0,1,0,0,0,0,1,0
../kbl_data/2023-2024,S43G01N109,원주 DB,Away,서민수,2,1,2,50.0,0,2,0.0,1,4,25.0,0,0,0.0,1,1,2,0,0,0,0,0,0,3
../kbl_data/2023-2024,S43G01N109,원주 DB,Away,두경민,0,0,0,0.0,0,0,0.0,0,0,0.0,0,0,0.0,0,0,0,0,0,0,0,0,2,1
../kbl_data/2023-2024,S43G01N109,원주 DB,Away,김종규,11,5,10,50.0,0,0,0.0,5,10,50.0,1,1,100.0,3,5,8,2,0,0,0,1,1,4
../kbl_data/2023-2024,S43G01N109,원주 DB,Away,최승욱,5,1,3,33.3,1,3,33.3,2,6,33.3,0,0,0.0,2,0,2,1,1,0,0,0,1,4
../kbl_data/2023-2024,S43G01N109,원주 DB,Away,강상재,23,8,8,100.0,1,5,20.0,9,13,69.2,4,5,80.0,4,7,11,6,1,0,0,0,4,2
../kbl_data/2023-2024,S43G01N109,원주 DB,Away,디드릭 로슨,21,7,10,70.0,1,5,20.0,8,15,53.3,4,5,80.0,1,7,8,4,1,1,0,0,2,1
../kbl_data/2023-2024,S43G01N109,원주 DB,Away,이선 알바노,7,1,2,50.0,1,3,33.3,2,5,40.0,2,2,100.0,0,1,1,4,1,0,0,0,1,1
../kbl_data/2023-2024,S43G01N109,원주 DB,Away,박인웅,3,0,0,0.0,1,3,33.3,1,3,33.3,0,0,0.0,2,2,4,0,0,0,0,0,0,3
../kbl_data/2023-2024,S43G01N109,원주 DB,Away,박승재,4,2,6,33.3,0,2,0.0,2,8,25.0,0,0,0.0,3,0,3,0,1,0,0,0,1,1
../kbl_data/2023-2024,S43G01N109,원주 DB,Away,최승빈,0,0,0,0.0,0,0,0.0,0,0,0.0,0,0,0.0,0,0,0,0,0,0,0,0,0,0
../kbl_data/2023-2024,S43G01N109,원주 DB,Away,제프 위디,8,3,7,42.9,0,2,0.0,3,9,33.3,2,2,100.0,2,8,10,1,2,0,0,1,1,1
../kbl_data/2023-2024,S43G01N110,고양 소노,Home,김강선,6,2,3,66.7,0,5,0.0,2,8,25.0,2,2,100.0,0,4,4,3,1,1,1,0,4,3
../kbl_data/2023-2024,S43G01N110,고양 소노,Home,최현민,4,2,2,100.0,0,2,0.0,2,4,50.0,0,0,0.0,0,3,3,1,0,0,0,0,0,1
../kbl_data/2023-2024,S43G01N110,고양 소노,Home,김민욱,2,1,1,100.0,0,0,0.0,1,1,100.0,0,1,0.0,0,0,0,2,0,0,0,0,0,2
../kbl_data/2023-2024,S43G01N110,고양 소노,Home,한호빈,9,2,3,66.7,1,3,33.3,3,6,50.0,2,2,100.0,0,1,1,4,1,0,0,0,5,3
../kbl_data/2023-2024,S43G01N110,고양 소노,Home,전성현,18,0,2,0.0,5,12,41.7,5,14,35.7,3,4,75.0,2,3,5,0,1,0,0,0,0,0
../kbl_data/2023-2024,S43G01N110,고양 소노,Home,김진유,0,0,0,0.0,0,0,0.0,0,0,0.0,0,0,0.0,0,1,1,0,1,0,0,0,0,1
../kbl_data/2023-2024,S43G01N110,고양 소노,Home,치나누 오누아쿠,20,9,14,64.3,0,0,0.0,9,14,64.3,2,3,66.7,4,8,12,4,0,2,0,1,5,2
../kbl_data/2023-2024,S43G01N110,고양 소노,Home,조은후,3,0,1,0.0,1,2,50.0,1,3,33.3,0,0,0.0,0,1,1,0,0,0,0,0,0,0
../kbl_data/2023-2024,S43G01N110,고양 소노,Home,백지웅,2,1,1,100.0,0,0,0.0,1,1,100.0,0,0,0.0,0,0,0,0,1,0,0,0,0,0
../kbl_data/2023-2024,S43G01N110,고양 소노,Home,조재우,4,1,1,100.0,0,0,0.0,1,1,100.0,2,2,100.0,0,1,1,0,0,1,0,0,0,1
../kbl_data/2023-2024,S43G01N110,고양 소노,Home,박종하,0,0,0,0.0,0,2,0.0,0,2,0.0,0,0,0.0,0,0,0,0,0,0,0,0,0,1
../kbl_data/2023-2024,S43G01N110,고양 소노,Home,디욘테 데이비스,2,1,2,50.0,0,1,0.0,1,3,33.3,0,0,0.0,1,4,5,0,0,2,0,0,2,1
../kbl_data/2023-2024,S43G01N110,서울 SK,Away,양우섭,0,0,0,0.0,0,0,0.0,0,0,0.0,0,0,0.0,0,0,0,0,0,0,0,0,0,0
../kbl_data/2023-2024,S43G01N110,서울 SK,Away,송창용,0,0,0,0.0,0,1,0.0,0,1,0.0,0,0,0.0,0,1,1,0,0,0,0,0,0,1
../kbl_data/2023-2024,S43G01N110,서울 SK,Away,김선형,17,4,4,100.0,3,6,50.0,7,10,70.0,0,0,0.0,0,0,0,4,1,0,0,0,1,0
../kbl_data/2023-2024,S43G01N110,서울 SK,Away,오세근,5,1,6,16.7,1,4,25.0,2,10,20.0,0,0,0.0,0,3,3,1,0,0,0,0,0,1
../kbl_data/2023-2024,S43G01N110,서울 SK,Away,최부경,10,5,6,83.3,0,0,0.0,5,6,83.3,0,0,0.0,1,4,5,1,0,0,0,0,1,1
../kbl_data/2023-2024,S43G01N110,서울 SK,Away,리온 윌리엄스,2,0,1,0.0,0,1,0.0,0,2,0.0,2,2,100.0,1,1,2,1,0,0,0,0,0,0
../kbl_data/2023-2024,S43G01N110,서울 SK,Away,최원혁,3,0,0,0.0,1,3,33.3,1,3,33.3,0,0,0.0,4,2,6,4,1,0,0,0,1,5
../kbl_data/2023-2024,S43G01N110,서울 SK,Away,안영준,21,4,6,66.7,4,8,50.0,8,14,57.1,1,2,50.0,1,2,3,2,2,0,0,0,1,3
../kbl_data/2023-2024,S43G01N110,서울 SK,Away,자밀 워니,12,4,10,40.0,1,2,50.0,5,12,41.7,1,1,100.0,1,6,7,2,2,0,0,0,3,2
../kbl_data/2023-2024,S43G01N110,서울 SK,Away,오재현,10,4,5,80.0,0,4,0.0,4,9,44.4,2,2,100.0,0,2,2,2,4,0,0,0,0,3
../kbl_data/2023-2024,S43G01N110,서울 SK,Away,김건우,0,0,0,0.0,0,0,0.0,0,0,0.0,0,0,0.0,0,1,1,0,0,0,0,0,1,0
../kbl_data/2023-2024,S43G01N110,서울 SK,Away,고메즈 딜 리아노,0,0,1,0.0,0,0,0.0,0,1,0.0,0,0,0.0,1,0,1,0,0,0,0,0,0,0
../kbl_data/2023-2024,S43G01N111,울산 현대모비스,Home,함지훈,10,2,5,40.0,1,1,100.0,3,6,50.0,3,3,100.0,3,0,3,6,1,1,0,0,0,1
../kbl_data/2023-2024,S43G01N111,울산 현대모비스,Home,최진수,4,1,4,25.0,0,1,0.0,1,5,20.0,2,4,50.0,0,0,0,0,0,0,0,0,1,3
../kbl_data/2023-2024,S43G01N111,울산 현대모비스,Home,김현수,0,0,0,0.0,0,0,0.0,0,0,0.0,0,0,0.0,0,0,0,1,0,0,0,0,0,0
../kbl_data/2023-2024,S43G01N111,울산 현대모비스,Home,장재석,4,2,3,66.7,0,0,0.0,2,3,66.7,0,0,0.0,0,2,2,2,0,0,0,0,0,2
../kbl_data/2023-2024,S43G01N111,울산 현대모비스,Home,김지완,0,0,0,0.0,0,2,0.0,0,2,0.0,0,0,0.0,0,1,1,2,0,0,0,0,1,2
../kbl_data/2023-2024,S43G01N111,울산 현대모비스,Home,김준일,0,0,1,0.0,0,0,0.0,0,1,0.0,0,0,0.0,0,0,0,0,0,0,0,0,0,2
../kbl_data/2023-2024,S43G01N111,울산 현대모비스,Home,김국찬,3,0,0,0.0,1,1,100.0,1,1,100.0,0,0,0.0,0,1,1,2,2,0,0,0,4,1
../kbl_data/2023-2024,S43G01N111,울산 현대모비스,Home,이우석,16,4,4,100.0,2,5,40.0,6,9,66.7,2,3,66.7,1,5,6,4,4,1,0,0,2,2
../kbl_data/2023-2024,S43G01N111,울산 현대모비스,Home,게이지 프림,24,9,15,60.0,0,0,0.0,9,15,60.0,6,6,100.0,5,7,12,2,2,2,0,0,2,2
../kbl_data/2023-2024,S43G01N111,울산 현대모비스,Home,김태완,0,0,1,0.0,0,0,0.0,0,1,0.0,0,0,0.0,0,0,0,0,0,0,0,0,0,0
../kbl_data/2023-2024,S43G01N111,울산 현대모비스,Home,박무빈,8,3,4,75.0,0,2,0.0,3,6,50.0,2,3,66.7,0,5,5,6,1,0,0,0,6,4
../kbl_data/2023-2024,S43G01N111,울산 현대모비스,Home,케베 알루마,25,4,5,80.0,5,7,71.4,9,12,75.0,2,2,100.0,1,7,8,0,0,0,0,2,2,3
../kbl_data/2023-2024,S43G01N111,수원 KT,Away,한희원,8,1,2,50.0,2,6,33.3,3,8,37.5,0,0,0.0,0,2,2,1,2,1,1,0,3,3
../kbl_data/2023-2024,S43G01N111,수원 KT,Away,최창진,0,0,0,0.0,0,0,0.0,0,0,0.0,0,0,0.0,0,0,0,0,0,0,0,0,0,0
../kbl_data/2023-2024,S43G01N111,수원 KT,Away,문성곤,0,0,0,0.0,0,2,0.0,0,2,0.0,0,0,0.0,0,1,1,3,0,0,0,0,2,3
../kbl_data/2023-2024,S43G01N111,수원 KT,Away,이현석,3,0,0,0.0,1,2,50.0,1,2,50.0,0,0,0.0,0,0,0,1,2,0,0,0,0,0
../kbl_data/2023-2024,S43G01N111,수원 KT,Away,정성우,2,0,2,0.0,0,3,0.0,0,5,0.0,2,4,50.0,2,1,3,7,3,0,0,0,1,4
../kbl_data/2023-2024,S43G01N111,수원 KT,Away,최성모,3,0,0,0.0,1,1,100.0,1,1,100.0,0,0,0.0,0,0,0,1,0,0,0,0,0,1
../kbl_data/2023-2024,S43G01N111,수원 KT,Away,하윤기,25,10,18,55.6,0,0,0.0,10,18,55.6,5,5,100.0,3,3,6,1,1,0,0,2,3,1
../kbl_data/2023-2024,S43G01N111,수원 KT,Away,이두원,4,2,3,66.7,0,0,0.0,2,3,66.7,0,0,0.0,0,0,0,0,0,0,1,0,0,1
../kbl_data/2023-2024,S43G01N111,수원 KT,Away,숀 데이브 일데폰소,0,0,2,0.0,0,1,0.0,0,3,0.0,0,0,0.0,0,1,1,0,0,0,0,0,0,0
../kbl_data/2023-2024,S43G01N111,수원 KT,Away,문정현,2,1,2,50.0,0,2,0.0,1,4,25.0,0,1,0.0,0,0,0,0,0,0,0,0,0,1
../kbl_data/2023-2024,S43G01N111,수원 KT,Away,마이클 에릭,0,0,1,0.0,0,0,0.0,0,1,0.0,0,0,0.0,0,1,1,0,0,1,0,0,0,1
../kbl_data/2023-2024,S43G01N111,수원 KT,Away,패리스 배스,27,12,20,60.0,0,4,0.0,12,24,50.0,3,4,75.0,5,8,13,3,5,1,0,3,7,4
../kbl_data/2023-2024,S43G01N112,안양 정관장,Home,정준원,2,1,1,100.0,0,0,0.0,1,1,100.0,0,0,0.0,0,0,0,1,0,0,0,0,0,0
../kbl_data/2023-2024,S43G01N112,안양 정관장,Home,배병준,0,0,1,0.0,0,2,0.0,0,3,0.0,0,0,0.0,1,0,1,0,0,0,0,0,2,1
../kbl_data/2023-2024,S43G01N112,안양 정관장,Home,정효근,7,1,3,33.3,1,5,20.0,2,8,25.0,2,4,50.0,1,4,5,4,0,0,0,0,2,3
../kbl_data/2023-2024,S43G01N112,안양 정관장,Home,이종현,11,2,7,28.6,1,1,100.0,3,8,37.5,4,4,100.0,4,1,5,3,0,1,0,0,0,0
../kbl_data/2023-2024,S43G01N112,안양 정관장,Home,김철욱,0,0,0,0.0,0,0,0.0,0,0,0.0,0,0,0.0,0,3,3,0,0,0,0,0,0,0
../kbl_data/2023-2024,S43G01N112,안양 정관장,Home,박지훈,9,3,7,42.9,1,3,33.3,4,10,40.0,0,0,0.0,2,3,5,7,0,0,0,0,2,3
../kbl_data/2023-2024,S43G01N112,안양 정관장,Home,이우정,3,0,1,0.0,1,1,100.0,1,2,50.0,0,0,0.0,0,0,0,1,0,0,0,0,1,1
../kbl_data/2023-2024,S43G01N112,안양 정관장,Home,장태빈,0,0,0,0.0,0,0,0.0,0,0,0.0,0,0,0.0,0,0,0,0,0,0,0,0,1,0
../kbl_data/2023-2024,S43G01N112,안양 정관장,Home,김경원,0,0,0,0.0,0,0,0.0,0,0,0.0,0,0,0.0,0,0,0,0,1,0,0,0,0,0
../kbl_data/2023-2024,S43G01N112,안양 정관장,Home,렌즈 아반도,10,3,5,60.0,1,4,25.0,4,9,44.4,1,1,100.0,1,2,3,2,0,2,0,1,1,3
../kbl_data/2023-2024,S43G01N112,안양 정관장,Home,고찬혁,2,1,2,50.0,0,0,0.0,1,2,50.0,0,2,0.0,0,1,1,0,0,0,0,0,1,1
../kbl_data/2023-2024,S43G01N112,안양 정관장,Home,로버트 카터,31,11,18,61.1,2,6,33.3,13,24,54.2,3,4,75.0,3,6,9,1,4,2,0,0,3,2
../kbl_data/2023-2024,S43G01N112,부산 KCC,Away,정창영,5,1,2,50.0,1,2,50.0,2,4,50.0,0,0,0.0,0,0,0,1,1,0,0,0,1,2
../kbl_data/2023-2024,S43G01N112,부산 KCC,Away,라건아,23,10,13,76.9,0,0,0.0,10,13,76.9,3,3,100.0,2,6,8,0,1,0,0,1,0,2
../kbl_data/2023-2024,S43G01N112,부산 KCC,Away,허웅,12,0,2,0.0,4,5,80.0,4,7,57.1,0,0,0.0,0,0,0,5,0,0,0,0,0,3
../kbl_data/2023-2024,S43G01N112,부산 KCC,Away,이승현,8,1,2,50.0,2,3,66.7,3,5,60.0,0,0,0.0,1,1,2,5,0,0,0,0,2,2
../kbl_data/2023-2024,S43G01N112,부산 KCC,Away,이호현,7,2,2,100.0,1,1,100.0,3,3,100.0,0,2,0.0,2,0,2,1,0,0,0,0,0,3
../kbl_data/2023-2024,S43G01N112,부산 KCC,Away,송교창,8,4,4,100.0,0,5,0.0,4,9,44.4,0,0,0.0,0,2,2,5,1,0,0,0,2,1
../kbl_data/2023-2024,S43G01N112,부산 KCC,Away,최준용,5,2,3,66.7,0,4,0.0,2,7,28.6,1,1,100.0,0,10,10,3,1,1,0,0,1,1
../kbl_data/2023-2024,S43G01N112,부산 KCC,Away,곽정훈,5,1,2,50.0,1,3,33.3,2,5,40.0,0,0,0.0,0,0,0,0,0,0,1,0,0,0
../kbl_data/2023-2024,S43G01N112,부산 KCC,Away,이근휘,9,0,0,0.0,3,6,50.0,3,6,50.0,0,0,0.0,2,2,4,1,2,0,0,0,0,0
../kbl_data/2023-2024,S43G01N112,부산 KCC,Away,김동현,5,1,2,50.0,1,3,33.3,2,5,40.0,0,0,0.0,0,0,0,0,0,0,0,0,0,1
../kbl_data/2023-2024,S43G01N112,부산 KCC,Away,송동훈,4,2,2,100.0,0,0,0.0,2,2,100.0,0,0,0.0,1,0,1,0,0,0,0,0,0,0
../kbl_data/2023-2024,S43G01N112,부산 KCC,Away,알리제 드숀 존슨,13,6,9,66.7,0,0,0.0,6,9,66.7,1,1,100.0,3,5,8,6,0,0,0,1,2,4
../kbl_data/2023-2024,S43G01N113,창원 LG,Home,이관희,6,0,2,0.0,2,3,66.7,2,5,40.0,0,0,0.0,0,0,0,0,0,0,0,0,2,0
../kbl_data/2023-2024,S43G01N113,창원 LG,Home,정희재,5,1,1,100.0,1,3,33.3,2,4,50.0,0,0,0.0,3,2,5,1,1,0,0,0,1,2
../kbl_data/2023-2024,S43G01N113,창원 LG,Home,임동섭,3,0,0,0.0,1,1,100.0,1,1,100.0,0,0,0.0,1,0,1,0,1,0,0,0,0,0
../kbl_data/2023-2024,S43G01N113,창원 LG,Home,이재도,12,3,5,60.0,1,4,25.0,4,9,44.4,3,4,75.0,0,3,3,3,1,0,0,0,5,4
../kbl_data/2023-2024,S43G01N113,창원 LG,Home,정인덕,0,0,0,0.0,0,0,0.0,0,0,0.0,0,0,0.0,0,0,0,0,0,1,0,0,0,1
../kbl_data/2023-2024,S43G01N113,창원 LG,Home,양홍석,9,3,5,60.0,0,6,0.0,3,11,27.3,3,4,75.0,0,8,8,5,1,0,0,0,4,2
../kbl_data/2023-2024,S43G01N113,창원 LG,Home,박정현,0,0,0,0.0,0,0,0.0,0,0,0.0,0,0,0.0,0,0,0,0,0,0,0,0,0,0
../kbl_data/2023-2024,S43G01N113,창원 LG,Home,아셈 마레이,11,2,4,50.0,0,0,0.0,2,4,50.0,7,9,77.8,3,13,16,3,2,0,0,0,7,2
../kbl_data/2023-2024,S43G01N113,창원 LG,Home,저스틴 구탕,3,0,1,0.0,1,1,100.0,1,2,50.0,0,0,0.0,0,1,1,0,0,0,0,0,3,1
../kbl_data/2023-2024,S43G01N113,창원 LG,Home,양준석,2,1,3,33.3,0,0,0.0,1,3,33.3,0,0,0.0,0,0,0,0,0,0,0,0,0,1
../kbl_data/2023-2024,S43G01N113,창원 LG,Home,유기상,11,0,3,0.0,2,7,28.6,2,10,20.0,5,7,71.4,2,2,4,1,0,0,0,0,2,3
../kbl_data/2023-2024,S43G01N113,창원 LG,Home,후안 텔로,0,0,0,0.0,0,0,0.0,0,0,0.0,0,0,0.0,0,0,0,0,0,0,0,0,0,0
../kbl_data/2023-2024,S43G01N113,서울 SK,Away,양우섭,0,0,0,0.0,0,0,0.0,0,0,0.0,0,0,0.0,0,0,0,0,0,0,0,0,0,0
../kbl_data/2023-2024,S43G01N113,서울 SK,Away,송창용,4,2,2,100.0,0,0,0.0,2,2,100.0,0,0,0.0,0,0,0,0,0,0,0,0,1,3
../kbl_data/2023-2024,S43G01N113,서울 SK,Away,김선형,12,3,8,37.5,1,5,20.0,4,13,30.8,3,4,75.0,0,2,2,6,5,0,0,0,4,3
../kbl_data/2023-2024,S43G01N113,서울 SK,Away,오세근,11,5,10,50.0,0,0,0.0,5,10,50.0,1,2,50.0,4,7,11,0,1,1,0,0,0,3
../kbl_data/2023-2024,S43G01N113,서울 SK,Away,리온 윌리엄스,0,0,0,0.0,0,0,0.0,0,0,0.0,0,0,0.0,0,0,0,0,0,0,0,0,0,0
../kbl_data/2023-2024,S43G01N113,서울 SK,Away,최원혁,8,1,2,50.0,2,3,66.7,3,5,60.0,0,0,0.0,2,4,6,2,4,0,0,0,1,5
../kbl_data/2023-2024,S43G01N113,서울 SK,Away,안영준,9,1,4,25.0,1,4,25.0,2,8,25.0,4,6,66.7,4,2,6,1,6,0,0,0,0,2
../kbl_data/2023-2024,S43G01N113,서울 SK,Away,자밀 워니,20,10,24,41.7,0,5,0.0,10,29,34.5,0,0,0.0,1,3,4,2,1,0,0,1,1,2
../kbl_data/2023-2024,S43G01N113,서울 SK,Away,김형빈,0,0,0,0.0,0,0,0.0,0,0,0.0,0,0,0.0,0,0,0,0,0,0,0,0,0,0
../kbl_data/2023-2024,S43G01N113,서울 SK,Away,오재현,0,0,0,0.0,0,3,0.0,0,3,0.0,0,0,0.0,0,3,3,0,0,0,0,0,2,3
../kbl_data/2023-2024,S43G01N113,서울 SK,Away,김건우,0,0,0,0.0,0,0,0.0,0,0,0.0,0,0,0.0,0,0,0,0,0,0,0,0,0,0
../kbl_data/2023-2024,S43G01N113,서울 SK,Away,고메즈 딜 리아노,0,0,0,0.0,0,0,0.0,0,0,0.0,0,0,0.0,0,0,0,0,0,0,0,0,0,0
../kbl_data/2023-2024,S43G01N114,고양 소노,Home,김강선,2,1,1,100.0,0,3,0.0,1,4,25.0,0,0,0.0,0,1,1,0,1,0,0,0,0,3
../kbl_data/2023-2024,S43G01N114,고양 소노,Home,함준후,3,0,1,0.0,1,1,100.0,1,2,50.0,0,0,0.0,1,0,1,0,0,0,0,0,1,1
../kbl_data/2023-2024,S43G01N114,고양 소노,Home,최현민,0,0,3,0.0,0,2,0.0,0,5,0.0,0,2,0.0,1,2,3,1,0,0,0,0,0,1
../kbl_data/2023-2024,S43G01N114,고양 소노,Home,김민욱,7,2,2,100.0,1,7,14.3,3,9,33.3,0,0,0.0,3,3,6,2,0,0,2,0,4,3
../kbl_data/2023-2024,S43G01N114,고양 소노,Home,한호빈,5,1,2,50.0,1,5,20.0,2,7,28.6,0,0,0.0,0,0,0,3,4,0,0,0,1,2
../kbl_data/2023-2024,S43G01N114,고양 소노,Home,전성현,0,0,1,0.0,0,4,0.0,0,5,0.0,0,0,0.0,0,1,1,0,1,0,0,0,1,0
../kbl_data/2023-2024,S43G01N114,고양 소노,Home,김진유,5,1,1,100.0,1,3,33.3,2,4,50.0,0,0,0.0,4,2,6,1,1,1,2,0,1,0
../kbl_data/2023-2024,S43G01N114,고양 소노,Home,치나누 오누아쿠,4,2,5,40.0,0,2,0.0,2,7,28.6,0,1,0.0,3,3,6,5,1,0,0,0,5,2
../kbl_data/2023-2024,S43G01N114,고양 소노,Home,백지웅,9,0,0,0.0,3,10,30.0,3,10,30.0,0,0,0.0,0,0,0,0,0,0,0,0,3,0
../kbl_data/2023-2024,S43G01N114,고양 소노,Home,조재우,2,1,2,50.0,0,0,0.0,1,2,50.0,0,0,0.0,1,0,1,0,0,0,0,0,0,0
../kbl_data/2023-2024,S43G01N114,고양 소노,Home,디욘테 데이비스,8,4,5,80.0,0,2,0.0,4,7,57.1,0,0,0.0,2,5,7,1,0,1,0,1,2,1
../kbl_data/2023-2024,S43G01N114,고양 소노,Home,알렉스 카바노,13,4,11,36.4,1,1,100.0,5,12,41.7,2,2,100.0,1,3,4,1,0,0,0,0,3,3
../kbl_data/2023-2024,S43G01N114,원주 DB,Away,김현호,3,0,0,0.0,1,1,100.0,1,1,100.0,0,0,0.0,0,1,1,0,0,0,0,0,0,0
../kbl_data/2023-2024,S43G01N114,원주 DB,Away,서민수,2,1,2,50.0,0,1,0.0,1,3,33.3,0,0,0.0,0,1,1,1,0,0,0,0,0,0
../kbl_data/2023-2024,S43G01N114,원주 DB,Away,두경민,2,1,1,100.0,0,1,0.0,1,2,50.0,0,0,0.0,0,2,2,2,2,0,0,0,2,2
../kbl_data/2023-2024,S43G01N114,원주 DB,Away,김종규,17,5,8,62.5,0,0,0.0,5,8,62.5,7,9,77.8,1,4,5,0,0,0,0,1,2,4
../kbl_data/2023-2024,S43G01N114,원주 DB,Away,최승욱,12,3,4,75.0,2,3,66.7,5,7,71.4,0,0,0.0,1,1,2,3,2,1,0,0,0,0
../kbl_data/2023-2024,S43G01N114,원주 DB,Away,강상재,17,6,10,60.0,1,2,50.0,7,12,58.3,2,2,100.0,3,5,8,4,0,0,0,0,1,2
../kbl_data/2023-2024,S43G01N114,원주 DB,Away,디드릭 로슨,11,1,2,50.0,2,6,33.3,3,8,37.5,3,4,75.0,0,9,9,8,5,0,0,0,3,1
../kbl_data/2023-2024,S43G01N114,원주 DB,Away,이용우,1,0,0,0.0,0,1,0.0,0,1,0.0,1,2,50.0,1,0,1,1,0,0,0,0,1,1
../kbl_data/2023-2024,S43G01N114,원주 DB,Away,이선 알바노,10,2,4,50.0,1,1,100.0,3,5,60.0,3,4,75.0,1,2,3,4,3,0,0,0,4,3
../kbl_data/2023-2024,S43G01N114,원주 DB,Away,박인웅,10,2,6,33.3,2,4,50.0,4,10,40.0,0,0,0.0,0,1,1,2,1,0,0,0,0,2
../kbl_data/2023-2024,S43G01N114,원주 DB,Away,박승재,3,0,1,0.0,1,2,50.0,1,3,33.3,0,0,0.0,0,0,0,1,0,0,0,0,0,2
../kbl_data/2023-2024,S43G01N114,원주 DB,Away,제프 위디,4,2,2,100.0,0,0,0.0,2,2,100.0,0,0,0.0,1,2,3,0,0,1,0,0,1,1
../kbl_data/2023-2024,S43G01N115,대구 한국가스공사,Home,김동량,0,0,0,0.0,0,0,0.0,0,0,0.0,0,0,0.0,0,0,0,1,0,0,0,0,0,1
../kbl_data/2023-2024,S43G01N115,대구 한국가스공사,Home,차바위,7,1,1,100.0,1,2,50.0,2,3,66.7,2,3,66.7,5,3,8,4,2,0,0,0,0,3
../kbl_data/2023-2024,S43G01N115,대구 한국가스공사,Home,박지훈,2,1,1,100.0,0,0,0.0,1,1,100.0,0,0,0.0,1,2,3,0,0,0,0,0,0,3
../kbl_data/2023-2024,S43G01N115,대구 한국가스공사,Home,이대헌,14,5,12,41.7,0,1,0.0,5,13,38.5,4,4,100.0,1,4,5,1,1,0,0,0,0,1
../kbl_data/2023-2024,S43G01N115,대구 한국가스공사,Home,박봉진,6,0,1,0.0,2,4,50.0,2,5,40.0,0,0,0.0,0,1,1,0,2,0,0,0,0,2
../kbl_data/2023-2024,S43G01N115,대구 한국가스공사,Home,김낙현,21,3,3,100.0,4,8,50.0,7,11,63.6,3,4,75.0,0,6,6,4,1,0,0,0,0,2
../kbl_data/2023-2024,S43G01N115,대구 한국가스공사,Home,양재혁,0,0,1,0.0,0,0,0.0,0,1,0.0,0,0,0.0,0,0,0,0,1,0,1,0,0,0
../kbl_data/2023-2024,S43G01N115,대구 한국가스공사,Home,양준우,0,0,1,0.0,0,4,0.0,0,5,0.0,0,0,0.0,1,1,2,2,0,0,0,0,0,2
../kbl_data/2023-2024,S43G01N115,대구 한국가스공사,Home,앤드류 니콜슨,21,2,6,33.3,3,9,33.3,5,15,33.3,8,8,100.0,1,6,7,0,1,1,0,1,2,3
../kbl_data/2023-2024,S43G01N115,대구 한국가스공사,Home,신승민,5,1,2,50.0,1,1,100.0,2,3,66.7,0,0,0.0,0,4,4,2,1,0,0,0,2,4
../kbl_data/2023-2024,S43G01N115,대구 한국가스공사,Home,샘조세프 벨란겔,18,6,6,100.0,2,4,50.0,8,10,80.0,0,0,0.0,0,2,2,4,1,0,0,0,1,3
../kbl_data/2023-2024,S43G01N115,대구 한국가스공사,Home,듀반 맥스웰,13,5,6,83.3,0,0,0.0,5,6,83.3,3,3,100.0,0,2,2,2,0,4,0,3,1,2
../kbl_data/2023-2024,S43G01N115,서울 삼성,Away,이정현,17,0,3,0.0,3,5,60.0,3,8,37.5,8,10,80.0,0,4,4,3,0,0,1,0,3,1
../kbl_data/2023-2024,S43G01N115,서울 삼성,Away,홍경기,0,0,2,0.0,0,1,0.0,0,3,0.0,0,0,0.0,0,1,1,0,0,0,0,0,1,1
../kbl_data/2023-2024,S43G01N115,서울 삼성,Away,김승원,0,0,1,0.0,0,0,0.0,0,1,0.0,0,0,0.0,1,0,1,2,0,0,0,0,1,1
../kbl_data/2023-2024,S43G01N115,서울 삼성,Away,김시래,5,1,4,25.0,1,4,25.0,2,8,25.0,0,0,0.0,1,1,2,3,0,0,1,0,1,0
../kbl_data/2023-2024,S43G01N115,서울 삼성,Away,이동엽,9,0,0,0.0,3,4,75.0,3,4,75.0,0,0,0.0,1,1,2,0,0,0,0,0,0,2
../kbl_data/2023-2024,S43G01N115,서울 삼성,Away,최승욱,5,1,1,100.0,0,1,0.0,1,2,50.0,3,4,75.0,0,0,0,0,0,0,0,0,1,2
../kbl_data/2023-2024,S43G01N115,서울 삼성,Away,윤성원,2,1,1,100.0,0,1,0.0,1,2,50.0,0,0,0.0,0,1,1,0,0,0,0,0,0,1
../kbl_data/2023-2024,S43G01N115,서울 삼성,Away,이원석,13,5,10,50.0,0,0,0.0,5,10,50.0,3,4,75.0,1,4,5,0,1,0,0,1,1,4
../kbl_data/2023-2024,S43G01N115,서울 삼성,Away,신동혁,2,0,1,0.0,0,2,0.0,0,3,0.0,2,2,100.0,0,3,3,2,1,0,0,0,0,2
../kbl_data/2023-2024,S43G01N115,서울 삼성,Away,아반 나바,4,2,5,40.0,0,2,0.0,2,7,28.6,0,0,0.0,1,2,3,2,0,0,0,0,1,2
../kbl_data/2023-2024,S43G01N115,서울 삼성,Away,이스마엘 레인,9,4,7,57.1,0,1,0.0,4,8,50.0,1,1,100.0,3,1,4,0,1,0,0,0,2,3
../kbl_data/2023-2024,S43G01N115,서울 삼성,Away,코피 코번,16,5,10,50.0,0,1,0.0,5,11,45.5,6,6,100.0,6,2,8,3,0,0,0,1,3,2
../kbl_data/2023-2024,S43G01N116,고양 소노,Home,김강선,4,1,1,100.0,0,6,0.0,1,7,14.3,2,2,100.0,0,0,0,1,2,0,0,0,1,3
../kbl_data/2023-2024,S43G01N116,고양 소노,Home,함준후,7,2,3,66.7,1,1,100.0,3,4,75.0,0,1,0.0,2,0,2,0,0,0,0,0,0,2
../kbl_data/2023-2024,S43G01N116,고양 소노,Home,최현민,11,4,7,57.1,1,4,25.0,5,11,45.5,0,2,0.0,3,2,5,1,0,0,0,0,1,3
../kbl_data/2023-2024,S43G01N116,고양 소노,Home,김민욱,0,0,0,0.0,0,0,0.0,0,0,0.0,0,0,0.0,0,1,1,0,0,0,0,0,1,2
../kbl_data/2023-2024,S43G01N116,고양 소노,Home,한호빈,6,2,3,66.7,0,5,0.0,2,8,25.0,2,3,66.7,0,1,1,3,1,0,0,0,0,0
../kbl_data/2023-2024,S43G01N116,고양 소노,Home,전성현,13,1,2,50.0,3,10,30.0,4,12,33.3,2,3,66.7,1,1,2,0,1,0,0,0,0,2
../kbl_data/2023-2024,S43G01N116,고양 소노,Home,김진유,3,0,0,0.0,1,2,50.0,1,2,50.0,0,0,0.0,1,0,1,0,0,0,0,0,0,3
../kbl_data/2023-2024,S43G01N116,고양 소노,Home,치나누 오누아쿠,20,7,13,53.8,1,1,100.0,8,14,57.1,3,5,60.0,4,10,14,6,2,0,0,0,5,4
../kbl_data/2023-2024,S43G01N116,고양 소노,Home,백지웅,0,0,0,0.0,0,0,0.0,0,0,0.0,0,0,0.0,0,0,0,0,0,0,0,0,1,0
../kbl_data/2023-2024,S43G01N116,고양 소노,Home,안정욱,0,0,0,0.0,0,0,0.0,0,0,0.0,0,0,0.0,0,1,1,0,0,0,0,0,0,0
../kbl_data/2023-2024,S43G01N116,고양 소노,Home,디욘테 데이비스,0,0,0,0.0,0,0,0.0,0,0,0.0,0,0,0.0,0,0,0,0,0,0,0,0,0,0
../kbl_data/2023-2024,S43G01N116,고양 소노,Home,알렉스 카바노,8,1,4,25.0,2,3,66.7,3,7,42.9,0,0,0.0,0,1,1,2,0,0,0,0,0,0
../kbl_data/2023-2024,S43G01N116,울산 현대모비스,Away,함지훈,8,2,3,66.7,0,0,0.0,2,3,66.7,4,6,66.7,2,2,4,4,0,1,0,0,1,0
../kbl_data/2023-2024,S43G01N116,울산 현대모비스,Away,최진수,5,1,2,50.0,1,2,50.0,2,4,50.0,0,0,0.0,0,5,5,1,0,1,0,0,1,2
../kbl_data/2023-2024,S43G01N116,울산 현대모비스,Away,김현수,2,1,1,100.0,0,0,0.0,1,1,100.0,0,0,0.0,0,0,0,0,0,0,0,0,0,0
../kbl_data/2023-2024,S43G01N116,울산 현대모비스,Away,장재석,2,1,2,50.0,0,0,0.0,1,2,50.0,0,0,0.0,1,1,2,2,0,0,0,0,0,1
../kbl_data/2023-2024,S43G01N116,울산 현대모비스,Away,김지완,5,1,2,50.0,1,3,33.3,2,5,40.0,0,0,0.0,1,2,3,6,1,0,0,0,0,3
../kbl_data/2023-2024,S43G01N116,울산 현대모비스,Away,김준일,0,0,0,0.0,0,0,0.0,0,0,0.0,0,0,0.0,1,1,2,1,0,0,0,0,0,0
../kbl_data/2023-2024,S43G01N116,울산 현대모비스,Away,김국찬,14,1,1,100.0,4,10,40.0,5,11,45.5,0,0,0.0,1,2,3,1,0,0,0,0,1,4
../kbl_data/2023-2024,S43G01N116,울산 현대모비스,Away,이우석,10,2,4,50.0,2,3,66.7,4,7,57.1,0,1,0.0,0,4,4,2,0,0,0,0,0,2
../kbl_data/2023-2024,S43G01N116,울산 현대모비스,Away,게이지 프림,8,3,6,50.0,0,0,0.0,3,6,50.0,2,3,66.7,1,3,4,1,2,0,0,0,0,2
../kbl_data/2023-2024,S43G01N116,울산 현대모비스,Away,김태완,0,0,0,0.0,0,1,0.0,0,1,0.0,0,0,0.0,0,0,0,1,0,0,0,0,0,0
../kbl_data/2023-2024,S43G01N116,울산 현대모비스,Away,박무빈,15,3,6,50.0,3,7,42.9,6,13,46.2,0,0,0.0,1,2,3,7,2,0,1,0,2,3
../kbl_data/2023-2024,S43G01N116,울산 현대모비스,Away,케베 알루마,23,6,10,60.0,2,3,66.7,8,13,61.5,5,6,83.3,5,7,12,1,1,1,1,0,3,4
../kbl_data/2023-2024,S43G01N117,안양 정관장,Home,정준원,2,1,3,33.3,0,0,0.0,1,3,33.3,0,0,0.0,0,0,0,0,1,0,0,0,0,2
../kbl_data/2023-2024,S43G01N117,안양 정관장,Home,김상규,0,0,0,0.0,0,2,0.0,0,2,0.0,0,0,0.0,0,0,0,0,0,0,0,0,0,0
../kbl_data/2023-2024,S43G01N117,안양 정관장,Home,배병준,15,2,3,66.7,3,9,33.3,5,12,41.7,2,2,100.0,0,0,0,1,0,0,0,0,0,0
../kbl_data/2023-2024,S43G01N117,안양 정관장,Home,정효근,8,1,2,50.0,1,2,50.0,2,4,50.0,3,3,100.0,0,1,1,2,0,0,0,0,1,4
../kbl_data/2023-2024,S43G01N117,안양 정관장,Home,이종현,0,0,3,0.0,0,1,0.0,0,4,0.0,0,0,0.0,3,0,3,0,1,0,0,0,1,1
../kbl_data/2023-2024,S43G01N117,안양 정관장,Home,김철욱,10,2,3,66.7,2,2,100.0,4,5,80.0,0,0,0.0,1,1,2,2,0,0,0,0,0,1
../kbl_data/2023-2024,S43G01N117,안양 정관장,Home,박지훈,8,4,5,80.0,0,1,0.0,4,6,66.7,0,0,0.0,1,2,3,4,1,0,0,0,0,4
../kbl_data/2023-2024,S43G01N117,안양 정관장,Home,최성원,12,0,2,0.0,4,7,57.1,4,9,44.4,0,0,0.0,0,1,1,7,1,0,0,0,2,3
../kbl_data/2023-2024,S43G01N117,안양 정관장,Home,장태빈,0,0,0,0.0,0,0,0.0,0,0,0.0,0,0,0.0,0,0,0,0,0,0,0,0,0,0
../kbl_data/2023-2024,S43G01N117,안양 정관장,Home,렌즈 아반도,7,2,7,28.6,1,3,33.3,3,10,30.0,0,0,0.0,5,2,7,1,1,1,0,0,1,2
../kbl_data/2023-2024,S43G01N117,안양 정관장,Home,나성호,5,1,1,100.0,1,1,100.0,2,2,100.0,0,0,0.0,0,1,1,0,0,0,1,0,0,1
../kbl_data/2023-2024,S43G01N117,안양 정관장,Home,로버트 카터,18,5,12,41.7,2,6,33.3,7,18,38.9,2,4,50.0,3,5,8,3,2,0,0,1,3,2
../kbl_data/2023-2024,S43G01N117,수원 KT,Away,한희원,7,2,3,66.7,1,4,25.0,3,7,42.9,0,0,0.0,2,1,3,1,0,0,0,0,0,3
../kbl_data/2023-2024,S43G01N117,수원 KT,Away,최창진,6,0,1,0.0,2,3,66.7,2,4,50.0,0,0,0.0,0,1,1,3,0,0,0,0,0,4
../kbl_data/2023-2024,S43G01N117,수원 KT,Away,문성곤,12,0,0,0.0,4,9,44.4,4,9,44.4,0,0,0.0,2,3,5,3,1,0,0,0,0,1
../kbl_data/2023-2024,S43G01N117,수원 KT,Away,이현석,0,0,0,0.0,0,0,0.0,0,0,0.0,0,0,0.0,0,0,0,0,0,0,0,0,0,0
../kbl_data/2023-2024,S43G01N117,수원 KT,Away,정성우,15,3,3,100.0,3,4,75.0,6,7,85.7,0,0,0.0,0,0,0,5,3,0,0,0,2,2
../kbl_data/2023-2024,S43G01N117,수원 KT,Away,김준환,3,0,0,0.0,1,1,100.0,1,1,100.0,0,0,0.0,0,1,1,0,0,0,0,0,0,0
../kbl_data/2023-2024,S43G01N117,수원 KT,Away,하윤기,22,9,10,90.0,0,0,0.0,9,10,90.0,4,6,66.7,2,7,9,2,0,1,0,1,1,2
../kbl_data/2023-2024,S43G01N117,수원 KT,Away,이두원,3,1,1,100.0,0,0,0.0,1,1,100.0,1,2,50.0,1,1,2,0,0,0,0,0,0,0
../kbl_data/2023-2024,S43G01N117,수원 KT,Away,숀 데이브 일데폰소,0,0,2,0.0,0,0,0.0,0,2,0.0,0,0,0.0,0,0,0,1,0,0,0,0,0,1
../kbl_data/2023-2024,S43G01N117,수원 KT,Away,문정현,4,1,4,25.0,0,3,0.0,1,7,14.3,2,2,100.0,2,5,7,1,0,0,0,0,1,2
../kbl_data/2023-2024,S43G01N117,수원 KT,Away,마이클 에릭,8,4,4,100.0,0,0,0.0,4,4,100.0,0,0,0.0,3,1,4,1,0,1,0,2,2,0
../kbl_data/2023-2024,S43G01N117,수원 KT,Away,패리스 배스,33,7,10,70.0,5,7,71.4,12,17,70.6,4,5,80.0,2,10,12,10,2,1,0,3,5,2
../kbl_data/2023-2024,S43G01N118,창원 LG,Home,이관희,21,5,9,55.6,3,5,60.0,8,14,57.1,2,2,100.0,0,3,3,4,1,0,0,0,0,2
../kbl_data/2023-2024,S43G01N118,창원 LG,Home,정희재,0,0,1,0.0,0,3,0.0,0,4,0.0,0,0,0.0,0,2,2,1,0,1,1,0,0,5
../kbl_data/2023-2024,S43G01N118,창원 LG,Home,임동섭,0,0,0,0.0,0,0,0.0,0,0,0.0,0,0,0.0,0,0,0,0,0,0,0,0,0,0
../kbl_data/2023-2024,S43G01N118,창원 LG,Home,이재도,20,6,9,66.7,1,6,16.7,7,15,46.7,5,6,83.3,1,3,4,7,1,0,0,0,0,2
../kbl_data/2023-2024,S43G01N118,창원 LG,Home,정인덕,9,0,3,0.0,3,4,75.0,3,7,42.9,0,0,0.0,0,6,6,2,0,0,0,0,0,4
../kbl_data/2023-2024,S43G01N118,창원 LG,Home,양홍석,16,1,6,16.7,4,7,57.1,5,13,38.5,2,2,100.0,1,6,7,1,0,0,0,0,1,5
../kbl_data/2023-2024,S43G01N118,창원 LG,Home,박정현,0,0,0,0.0,0,0,0.0,0,0,0.0,0,0,0.0,0,0,0,0,0,0,0,0,0,0
../kbl_data/2023-2024,S43G01N118,창원 LG,Home,아셈 마레이,22,9,14,64.3,0,0,0.0,9,14,64.3,4,6,66.7,9,8,17,5,3,1,0,0,2,3
../kbl_data/2023-2024,S43G01N118,창원 LG,Home,저스틴 구탕,0,0,1,0.0,0,0,0.0,0,1,0.0,0,0,0.0,0,0,0,0,0,0,0,0,0,0
../kbl_data/2023-2024,S43G01N118,창원 LG,Home,양준석,1,0,3,0.0,0,1,0.0,0,4,0.0,1,2,50.0,0,0,0,2,0,0,0,0,0,0
../kbl_data/2023-2024,S43G01N118,창원 LG,Home,유기상,0,0,0,0.0,0,4,0.0,0,4,0.0,0,0,0.0,0,0,0,0,0,1,0,0,0,3
../kbl_data/2023-2024,S43G01N118,창원 LG,Home,후안 텔로,2,1,1,100.0,0,0,0.0,1,1,100.0,0,0,0.0,0,1,1,0,0,0,0,0,0,0
../kbl_data/2023-2024,S43G01N118,부산 KCC,Away,정창영,0,0,2,0.0,0,1,0.0,0,3,0.0,0,0,0.0,0,0,0,0,0,0,0,0,0,0
../kbl_data/2023-2024,S43G01N118,부산 KCC,Away,라건아,31,14,17,82.4,0,2,0.0,14,19,73.7,3,3,100.0,7,8,15,1,1,0,0,2,5,3
../kbl_data/2023-2024,S43G01N118,부산 KCC,Away,허웅,21,3,4,75.0,3,9,33.3,6,13,46.2,6,6,100.0,1,3,4,3,0,0,0,0,1,1
../kbl_data/2023-2024,S43G01N118,부산 KCC,Away,이승현,8,2,3,66.7,1,3,33.3,3,6,50.0,1,2,50.0,0,1,1,1,0,0,0,0,1,1
../kbl_data/2023-2024,S43G01N118,부산 KCC,Away,이호현,13,5,6,83.3,0,0,0.0,5,6,83.3,3,3,100.0,0,2,2,3,0,0,1,0,0,4
../kbl_data/2023-2024,S43G01N118,부산 KCC,Away,송교창,7,1,3,33.3,1,2,50.0,2,5,40.0,2,4,50.0,0,5,5,2,0,0,0,0,0,3
../kbl_data/2023-2024,S43G01N118,부산 KCC,Away,최준용,11,2,6,33.3,0,3,0.0,2,9,22.2,7,13,53.8,0,8,8,5,0,3,0,0,0,3
../kbl_data/2023-2024,S43G01N118,부산 KCC,Away,곽정훈,0,0,0,0.0,0,0,0.0,0,0,0.0,0,0,0.0,0,0,0,0,0,0,0,0,0,0
../kbl_data/2023-2024,S43G01N118,부산 KCC,Away,이근휘,0,0,0,0.0,0,0,0.0,0,0,0.0,0,0,0.0,0,0,0,0,0,0,0,0,0,1
../kbl_data/2023-2024,S43G01N118,부산 KCC,Away,김동현,0,0,0,0.0,0,0,0.0,0,0,0.0,0,0,0.0,0,0,0,0,0,0,0,0,0,0
../kbl_data/2023-2024,S43G01N118,부산 KCC,Away,송동훈,0,0,1,0.0,0,0,0.0,0,1,0.0,0,0,0.0,0,0,0,0,0,0,0,0,0,1
../kbl_data/2023-2024,S43G01N118,부산 KCC,Away,알리제 드숀 존슨,4,2,3,66.7,0,0,0.0,2,3,66.7,0,0,0.0,1,2,3,2,0,0,0,0,0,2
../kbl_data/2023-2024,S43G01N119,원주 DB,Home,김현호,0,0,0,0.0,0,0,0.0,0,0,0.0,0,0,0.0,0,0,0,0,0,0,0,0,0,0
../kbl_data/2023-2024,S43G01N119,원주 DB,Home,서민수,0,0,0,0.0,0,0,0.0,0,0,0.0,0,0,0.0,0,0,0,0,0,0,0,0,1,1
../kbl_data/2023-2024,S43G01N119,원주 DB,Home,두경민,7,0,2,0.0,2,5,40.0,2,7,28.6,1,4,25.0,0,2,2,2,2,0,0,0,0,2
../kbl_data/2023-2024,S43G01N119,원주 DB,Home,김종규,12,3,3,100.0,1,1,100.0,4,4,100.0,3,3,100.0,0,6,6,1,0,1,0,1,2,5
../kbl_data/2023-2024,S43G01N119,원주 DB,Home,최승욱,8,1,1,100.0,2,3,66.7,3,4,75.0,0,0,0.0,0,0,0,0,2,0,0,0,1,2
../kbl_data/2023-2024,S43G01N119,원주 DB,Home,강상재,10,2,5,40.0,2,2,100.0,4,7,57.1,0,0,0.0,0,4,4,5,1,2,0,0,2,2
../kbl_data/2023-2024,S43G01N119,원주 DB,Home,디드릭 로슨,36,12,19,63.2,2,5,40.0,14,24,58.3,6,6,100.0,2,6,8,3,2,0,0,1,1,1
../kbl_data/2023-2024,S43G01N119,원주 DB,Home,이용우,0,0,0,0.0,0,0,0.0,0,0,0.0,0,0,0.0,0,0,0,0,0,0,0,0,0,0
../kbl_data/2023-2024,S43G01N119,원주 DB,Home,이선 알바노,25,8,11,72.7,2,4,50.0,10,15,66.7,3,6,50.0,1,4,5,6,3,0,1,0,4,2
../kbl_data/2023-2024,S43G01N119,원주 DB,Home,박인웅,4,2,2,100.0,0,1,0.0,2,3,66.7,0,0,0.0,1,0,1,0,1,0,0,0,0,2
../kbl_data/2023-2024,S43G01N119,원주 DB,Home,박승재,0,0,0,0.0,0,0,0.0,0,0,0.0,0,0,0.0,0,0,0,0,0,0,0,0,0,0
../kbl_data/2023-2024,S43G01N119,원주 DB,Home,제프 위디,0,0,2,0.0,0,0,0.0,0,2,0.0,0,0,0.0,0,0,0,0,0,2,0,0,0,1
../kbl_data/2023-2024,S43G01N119,울산 현대모비스,Away,함지훈,11,4,7,57.1,1,1,100.0,5,8,62.5,0,0,0.0,3,1,4,4,1,1,0,0,3,3
../kbl_data/2023-2024,S43G01N119,울산 현대모비스,Away,최진수,5,1,2,50.0,1,3,33.3,2,5,40.0,0,0,0.0,2,1,3,0,0,1,0,0,1,1
../kbl_data/2023-2024,S43G01N119,울산 현대모비스,Away,김현수,0,0,0,0.0,0,0,0.0,0,0,0.0,0,0,0.0,0,0,0,0,0,0,0,0,0,0
../kbl_data/2023-2024,S43G01N119,울산 현대모비스,Away,장재석,2,1,2,50.0,0,0,0.0,1,2,50.0,0,0,0.0,0,0,0,0,0,0,0,0,0,1
../kbl_data/2023-2024,S43G01N119,울산 현대모비스,Away,김지완,5,1,2,50.0,1,4,25.0,2,6,33.3,0,0,0.0,1,0,1,4,0,0,0,0,1,3
../kbl_data/2023-2024,S43G01N119,울산 현대모비스,Away,김준일,0,0,0,0.0,0,0,0.0,0,0,0.0,0,0,0.0,0,2,2,0,0,0,0,0,0,0
../kbl_data/2023-2024,S43G01N119,울산 현대모비스,Away,김국찬,14,3,3,100.0,2,5,40.0,5,8,62.5,2,2,100.0,1,3,4,2,0,0,0,0,1,3
../kbl_data/2023-2024,S43G01N119,울산 현대모비스,Away,이우석,12,3,7,42.9,2,3,66.7,5,10,50.0,0,2,0.0,0,3,3,4,1,0,0,0,2,3
../kbl_data/2023-2024,S43G01N119,울산 현대모비스,Away,게이지 프림,29,11,19,57.9,0,1,0.0,11,20,55.0,7,7,100.0,9,5,14,3,4,2,0,2,1,4
../kbl_data/2023-2024,S43G01N119,울산 현대모비스,Away,김태완,0,0,0,0.0,0,1,0.0,0,1,0.0,0,0,0.0,0,0,0,0,0,0,0,0,0,0
../kbl_data/2023-2024,S43G01N119,울산 현대모비스,Away,박무빈,9,1,7,14.3,1,4,25.0,2,11,18.2,4,4,100.0,0,4,4,4,2,0,1,0,5,3
../kbl_data/2023-2024,S43G01N119,울산 현대모비스,Away,케베 알루마,5,1,2,50.0,1,1,100.0,2,3,66.7,0,0,0.0,0,1,1,1,1,0,1,0,1,0
../kbl_data/2023-2024,S43G01N120,서울 SK,Home,양우섭,0,0,2,0.0,0,2,0.0,0,4,0.0,0,0,0.0,3,0,3,0,0,0,0,0,0,1
../kbl_data/2023-2024,S43G01N120,서울 SK,Home,송창용,0,0,1,0.0,0,1,0.0,0,2,0.0,0,0,0.0,0,0,0,0,1,0,0,0,0,3
../kbl_data/2023-2024,S43G01N120,서울 SK,Home,김선형,9,3,5,60.0,0,1,0.0,3,6,50.0,3,4,75.0,0,1,1,8,3,0,0,0,0,1
../kbl_data/2023-2024,S43G01N120,서울 SK,Home,오세근,13,6,9,66.7,0,1,0.0,6,10,60.0,1,1,100.0,0,4,4,0,2,0,1,0,0,0
../kbl_data/2023-2024,S43G01N120,서울 SK,Home,최부경,6,3,7,42.9,0,0,0.0,3,7,42.9,0,0,0.0,1,3,4,0,0,1,0,0,2,4
../kbl_data/2023-2024,S43G01N120,서울 SK,Home,리온 윌리엄스,2,1,2,50.0,0,0,0.0,1,2,50.0,0,0,0.0,1,2,3,0,0,0,0,0,0,3
../kbl_data/2023-2024,S43G01N120,서울 SK,Home,최원혁,2,0,0,0.0,0,2,0.0,0,2,0.0,2,4,50.0,0,2,2,5,1,1,0,0,0,4
../kbl_data/2023-2024,S43G01N120,서울 SK,Home,안영준,16,5,6,83.3,2,8,25.0,7,14,50.0,0,0,0.0,0,6,6,2,4,0,0,0,0,2
../kbl_data/2023-2024,S43G01N120,서울 SK,Home,자밀 워니,28,12,19,63.2,1,2,50.0,13,21,61.9,1,2,50.0,3,10,13,9,0,4,0,2,2,2
../kbl_data/2023-2024,S43G01N120,서울 SK,Home,오재현,10,3,3,100.0,0,2,0.0,3,5,60.0,4,5,80.0,1,1,2,3,1,1,0,0,3,2
../kbl_data/2023-2024,S43G01N120,서울 SK,Home,김건우,0,0,0,0.0,0,0,0.0,0,0,0.0,0,0,0.0,0,0,0,0,0,0,0,0,0,0
../kbl_data/2023-2024,S43G01N120,서울 SK,Home,고메즈 딜 리아노,3,0,2,0.0,1,3,33.3,1,5,20.0,0,0,0.0,0,1,1,2,0,0,0,0,0,1
../kbl_data/2023-2024,S43G01N120,서울 삼성,Away,이정현,12,3,6,50.0,2,7,28.6,5,13,38.5,0,0,0.0,3,4,7,5,0,0,0,0,4,4
../kbl_data/2023-2024,S43G01N120,서울 삼성,Away,홍경기,2,0,0,0.0,0,2,0.0,0,2,0.0,2,2,100.0,0,0,0,1,1,0,0,0,0,1
../kbl_data/2023-2024,S43G01N120,서울 삼성,Away,김승원,0,0,0,0.0,0,0,0.0,0,0,0.0,0,0,0.0,0,0,0,0,0,0,0,0,0,0
../kbl_data/2023-2024,S43G01N120,서울 삼성,Away,김시래,8,1,5,20.0,1,3,33.3,2,8,25.0,3,4,75.0,1,0,1,3,1,0,0,0,1,1
../kbl_data/2023-2024,S43G01N120,서울 삼성,Away,이동엽,3,0,1,0.0,0,2,0.0,0,3,0.0,3,5,60.0,1,0,1,0,0,1,0,0,1,3
../kbl_data/2023-2024,S43G01N120,서울 삼성,Away,최승욱,6,3,3,100.0,0,1,0.0,3,4,75.0,0,0,0.0,0,3,3,0,1,0,1,0,0,1
../kbl_data/2023-2024,S43G01N120,서울 삼성,Away,윤성원,0,0,1,0.0,0,2,0.0,0,3,0.0,0,0,0.0,0,1,1,0,1,0,0,0,1,2
../kbl_data/2023-2024,S43G01N120,서울 삼성,Away,이원석,4,0,6,0.0,0,0,0.0,0,6,0.0,4,4,100.0,4,4,8,1,0,0,0,0,3,4
../kbl_data/2023-2024,S43G01N120,서울 삼성,Away,신동혁,0,0,0,0.0,0,3,0.0,0,3,0.0,0,0,0.0,1,0,1,1,0,0,0,0,0,0
../kbl_data/2023-2024,S43G01N120,서울 삼성,Away,아반 나바,3,0,2,0.0,1,3,33.3,1,5,20.0,0,0,0.0,0,0,0,0,0,0,0,0,0,0
../kbl_data/2023-2024,S43G01N120,서울 삼성,Away,이스마엘 레인,11,5,9,55.6,0,1,0.0,5,10,50.0,1,2,50.0,2,6,8,0,0,0,0,3,2,1
../kbl_data/2023-2024,S43G01N120,서울 삼성,Away,코피 코번,25,9,24,37.5,0,0,0.0,9,24,37.5,7,8,87.5,10,11,21,3,1,1,0,2,3,0
../kbl_data/2023-2024,S43G01N121,대구 한국가스공사,Home,차바위,8,0,0,0.0,2,5,40.0,2,5,40.0,2,2,100.0,3,2,5,2,1,0,0,0,0,4
../kbl_data/2023-2024,S43G01N121,대구 한국가스공사,Home,박지훈,2,1,1,100.0,0,0,0.0,1,1,100.0,0,0,0.0,0,1,1,0,1,0,0,0,0,1
../kbl_data/2023-2024,S43G01N121,대구 한국가스공사,Home,이대헌,15,7,10,70.0,0,1,0.0,7,11,63.6,1,1,100.0,1,2,3,1,1,0,0,0,1,4
../kbl_data/2023-2024,S43G01N121,대구 한국가스공사,Home,박봉진,0,0,0,0.0,0,0,0.0,0,0,0.0,0,0,0.0,0,0,0,0,0,0,0,0,0,0
../kbl_data/2023-2024,S43G01N121,대구 한국가스공사,Home,김낙현,16,2,7,28.6,3,8,37.5,5,15,33.3,3,3,100.0,2,2,4,5,1,0,0,0,2,3
../kbl_data/2023-2024,S43G01N121,대구 한국가스공사,Home,양재혁,0,0,0,0.0,0,1,0.0,0,1,0.0,0,0,0.0,0,3,3,0,0,0,0,0,0,5
../kbl_data/2023-2024,S43G01N121,대구 한국가스공사,Home,양준우,0,0,0,0.0,0,0,0.0,0,0,0.0,0,0,0.0,0,0,0,0,0,0,0,0,0,0
../kbl_data/2023-2024,S43G01N121,대구 한국가스공사,Home,앤드류 니콜슨,23,6,10,60.0,3,6,50.0,9,16,56.2,2,2,100.0,1,6,7,1,0,0,0,1,2,0
../kbl_data/2023-2024,S43G01N121,대구 한국가스공사,Home,신승민,1,0,0,0.0,0,0,0.0,0,0,0.0,1,2,50.0,0,0,0,1,0,0,1,0,1,2
../kbl_data/2023-2024,S43G01N121,대구 한국가스공사,Home,샘조세프 벨란겔,6,3,5,60.0,0,1,0.0,3,6,50.0,0,0,0.0,0,1,1,1,0,0,0,0,0,2
../kbl_data/2023-2024,S43G01N121,대구 한국가스공사,Home,신주영,0,0,0,0.0,0,0,0.0,0,0,0.0,0,0,0.0,0,0,0,0,0,0,0,0,0,0
../kbl_data/2023-2024,S43G01N121,대구 한국가스공사,Home,듀반 맥스웰,19,9,11,81.8,0,0,0.0,9,11,81.8,1,3,33.3,0,3,3,3,2,1,0,2,1,3
../kbl_data/2023-2024,S43G01N121,부산 KCC,Away,정창영,12,0,1,0.0,3,5,60.0,3,6,50.0,3,4,75.0,1,4,5,4,2,0,0,0,0,1
../kbl_data/2023-2024,S43G01N121,부산 KCC,Away,라건아,13,4,6,66.7,1,1,100.0,5,7,71.4,2,3,66.7,1,4,5,0,0,0,0,0,4,2
../kbl_data/2023-2024,S43G01N121,부산 KCC,Away,허웅,14,0,1,0.0,4,5,80.0,4,6,66.7,2,2,100.0,0,2,2,5,0,0,1,0,0,3
../kbl_data/2023-2024,S43G01N121,부산 KCC,Away,이승현,17,7,7,100.0,1,2,50.0,8,9,88.9,0,0,0.0,0,2,2,0,0,0,0,0,0,3
../kbl_data/2023-2024,S43G01N121,부산 KCC,Away,이호현,3,0,1,0.0,1,2,50.0,1,3,33.3,0,0,0.0,1,0,1,1,0,0,0,0,0,2
../kbl_data/2023-2024,S43G01N121,부산 KCC,Away,송교창,11,4,8,50.0,0,2,0.0,4,10,40.0,3,5,60.0,0,2,2,4,2,0,0,0,1,4
../kbl_data/2023-2024,S43G01N121,부산 KCC,Away,최준용,12,3,7,42.9,2,5,40.0,5,12,41.7,0,1,0.0,1,4,5,5,0,1,0,0,2,1
../kbl_data/2023-2024,S43G01N121,부산 KCC,Away,곽정훈,0,0,0,0.0,0,0,0.0,0,0,0.0,0,0,0.0,0,0,0,0,0,0,0,0,0,0
../kbl_data/2023-2024,S43G01N121,부산 KCC,Away,이근휘,0,0,0,0.0,0,3,0.0,0,3,0.0,0,0,0.0,0,0,0,0,0,0,0,0,0,0
../kbl_data/2023-2024,S43G01N121,부산 KCC,Away,김동현,0,0,0,0.0,0,0,0.0,0,0,0.0,0,0,0.0,0,0,0,0,0,0,0,0,0,0
../kbl_data/2023-2024,S43G01N121,부산 KCC,Away,송동훈,0,0,0,0.0,0,0,0.0,0,0,0.0,0,0,0.0,0,0,0,0,0,0,0,0,0,0
../kbl_data/2023-2024,S43G01N121,부산 KCC,Away,알리제 드숀 존슨,14,3,5,60.0,1,2,50.0,4,7,57.1,5,6,83.3,4,3,7,4,0,0,0,0,2,3
../kbl_data/2023-2024,S43G01N122,창원 LG,Home,이관희,16,4,6,66.7,2,6,33.3,6,12,50.0,2,2,100.0,0,4,4,1,1,0,0,0,0,0
../kbl_data/2023-2024,S43G01N122,창원 LG,Home,정희재,6,0,1,0.0,2,4,50.0,2,5,40.0,0,0,0.0,0,3,3,1,1,1,0,0,1,2
../kbl_data/2023-2024,S43G01N122,창원 LG,Home,임동섭,1,0,0,0.0,0,1,0.0,0,1,0.0,1,2,50.0,1,0,1,1,0,0,0,0,0,2
../kbl_data/2023-2024,S43G01N122,창원 LG,Home,이재도,4,2,2,100.0,0,3,0.0,2,5,40.0,0,0,0.0,1,3,4,3,2,0,0,0,1,2
../kbl_data/2023-2024,S43G01N122,창원 LG,Home,정인덕,0,0,0,0.0,0,0,0.0,0,0,0.0,0,0,0.0,0,0,0,0,0,0,0,0,0,0
../kbl_data/2023-2024,S43G01N122,창원 LG,Home,양홍석,9,4,4,100.0,0,6,0.0,4,10,40.0,1,1,100.0,2,3,5,4,0,0,0,0,2,3
../kbl_data/2023-2024,S43G01N122,창원 LG,Home,박정현,6,3,3,100.0,0,0,0.0,3,3,100.0,0,0,0.0,1,1,2,0,1,0,0,0,0,0
../kbl_data/2023-2024,S43G01N122,창원 LG,Home,아셈 마레이,20,7,10,70.0,0,0,0.0,7,10,70.0,6,7,85.7,2,4,6,4,0,0,0,0,0,3
../kbl_data/2023-2024,S43G01N122,창원 LG,Home,저스틴 구탕,15,3,4,75.0,3,4,75.0,6,8,75.0,0,0,0.0,2,2,4,7,3,0,0,0,1,3
../kbl_data/2023-2024,S43G01N122,창원 LG,Home,양준석,7,2,2,100.0,0,0,0.0,2,2,100.0,3,4,75.0,1,1,2,4,0,0,0,0,1,1
../kbl_data/2023-2024,S43G01N122,창원 LG,Home,유기상,6,0,2,0.0,2,4,50.0,2,6,33.3,0,0,0.0,0,1,1,0,0,0,0,0,0,0
../kbl_data/2023-2024,S43G01N122,창원 LG,Home,후안 텔로,4,2,9,22.2,0,0,0.0,2,9,22.2,0,0,0.0,1,1,2,1,2,0,0,0,0,0
../kbl_data/2023-2024,S43G01N122,안양 정관장,Away,정준원,6,1,1,100.0,1,3,33.3,2,4,50.0,1,2,50.0,0,3,3,1,0,0,0,0,0,0
../kbl_data/2023-2024,S43G01N122,안양 정관장,Away,김상규,3,0,0,0.0,1,1,100.0,1,1,100.0,0,0,0.0,0,0,0,0,0,0,0,0,0,0
../kbl_data/2023-2024,S43G01N122,안양 정관장,Away,배병준,7,2,4,50.0,1,2,50.0,3,6,50.0,0,0,0.0,1,1,2,1,1,0,0,0,0,1
../kbl_data/2023-2024,S43G01N122,안양 정관장,Away,정효근,10,3,6,50.0,1,5,20.0,4,11,36.4,1,2,50.0,1,6,7,3,0,0,0,0,3,2
../kbl_data/2023-2024,S43G01N122,안양 정관장,Away,이종현,0,0,0,0.0,0,0,0.0,0,0,0.0,0,0,0.0,0,2,2,0,0,0,0,0,1,0
../kbl_data/2023-2024,S43G01N122,안양 정관장,Away,김철욱,11,1,1,100.0,3,5,60.0,4,6,66.7,0,0,0.0,0,0,0,0,0,0,0,0,0,3
../kbl_data/2023-2024,S43G01N122,안양 정관장,Away,박지훈,4,2,6,33.3,0,2,0.0,2,8,25.0,0,0,0.0,0,0,0,4,1,0,0,0,0,2
../kbl_data/2023-2024,S43G01N122,안양 정관장,Away,최성원,8,0,1,0.0,2,6,33.3,2,7,28.6,2,2,100.0,0,2,2,7,0,0,0,0,2,4
../kbl_data/2023-2024,S43G01N122,안양 정관장,Away,장태빈,0,0,0,0.0,0,0,0.0,0,0,0.0,0,0,0.0,0,1,1,1,0,0,0,0,1,0
../kbl_data/2023-2024,S43G01N122,안양 정관장,Away,렌즈 아반도,2,0,3,0.0,0,1,0.0,0,4,0.0,2,2,100.0,3,3,6,0,1,2,0,0,1,2
../kbl_data/2023-2024,S43G01N122,안양 정관장,Away,나성호,0,0,0,0.0,0,0,0.0,0,0,0.0,0,0,0.0,0,0,0,0,0,0,0,0,0,1
../kbl_data/2023-2024,S43G01N122,안양 정관장,Away,로버트 카터,24,9,10,90.0,2,6,33.3,11,16,68.8,0,0,0.0,1,7,8,3,0,0,0,0,5,3
../kbl_data/2023-2024,S43G01N123,대구 한국가스공사,Home,차바위,6,0,1,0.0,2,5,40.0,2,6,33.3,0,0,0.0,1,1,2,3,0,0,0,0,3,1
../kbl_data/2023-2024,S43G01N123,대구 한국가스공사,Home,박지훈,0,0,0,0.0,0,0,0.0,0,0,0.0,0,0,0.0,1,0,1,0,0,0,0,0,0,1
../kbl_data/2023-2024,S43G01N123,대구 한국가스공사,Home,이대헌,16,8,11,72.7,0,2,0.0,8,13,61.5,0,2,0.0,2,0,2,2,0,0,0,0,4,1
../kbl_data/2023-2024,S43G01N123,대구 한국가스공사,Home,박봉진,0,0,0,0.0,0,0,0.0,0,0,0.0,0,0,0.0,0,1,1,0,1,0,0,0,0,3
../kbl_data/2023-2024,S43G01N123,대구 한국가스공사,Home,김낙현,0,0,2,0.0,0,2,0.0,0,4,0.0,0,0,0.0,1,0,1,1,1,0,0,0,1,1
../kbl_data/2023-2024,S43G01N123,대구 한국가스공사,Home,양재혁,0,0,1,0.0,0,1,0.0,0,2,0.0,0,0,0.0,0,1,1,0,0,0,0,0,0,1
../kbl_data/2023-2024,S43G01N123,대구 한국가스공사,Home,양준우,6,1,3,33.3,1,1,100.0,2,4,50.0,1,2,50.0,0,1,1,2,2,0,0,0,0,0
../kbl_data/2023-2024,S43G01N123,대구 한국가스공사,Home,앤드류 니콜슨,11,4,6,66.7,1,2,50.0,5,8,62.5,0,0,0.0,1,6,7,0,0,0,0,0,2,1
../kbl_data/2023-2024,S43G01N123,대구 한국가스공사,Home,신승민,6,3,3,100.0,0,2,0.0,3,5,60.0,0,0,0.0,0,2,2,3,1,0,1,0,1,4
../kbl_data/2023-2024,S43G01N123,대구 한국가스공사,Home,샘조세프 벨란겔,18,4,6,66.7,2,7,28.6,6,13,46.2,4,4,100.0,0,0,0,4,0,0,0,0,2,3
../kbl_data/2023-2024,S43G01N123,대구 한국가스공사,Home,신주영,0,0,0,0.0,0,0,0.0,0,0,0.0,0,0,0.0,0,0,0,0,0,0,0,0,1,0
../kbl_data/2023-2024,S43G01N123,대구 한국가스공사,Home,듀반 맥스웰,12,5,8,62.5,0,0,0.0,5,8,62.5,2,2,100.0,2,6,8,3,4,1,0,3,1,2
../kbl_data/2023-2024,S43G01N123,수원 KT,Away,한희원,14,0,1,0.0,4,7,57.1,4,8,50.0,2,3,66.7,1,2,3,0,1,0,0,0,2,1
../kbl_data/2023-2024,S43G01N123,수원 KT,Away,최창진,0,0,1,0.0,0,0,0.0,0,1,0.0,0,0,0.0,0,0,0,2,1,0,0,0,2,0
../kbl_data/2023-2024,S43G01N123,수원 KT,Away,문성곤,5,1,2,50.0,1,6,16.7,2,8,25.0,0,0,0.0,1,2,3,3,0,0,0,0,1,3
../kbl_data/2023-2024,S43G01N123,수원 KT,Away,이현석,0,0,0,0.0,0,2,0.0,0,2,0.0,0,0,0.0,0,1,1,1,1,0,0,0,1,2
../kbl_data/2023-2024,S43G01N123,수원 KT,Away,정성우,8,4,5,80.0,0,1,0.0,4,6,66.7,0,0,0.0,2,3,5,7,2,0,0,0,1,2
../kbl_data/2023-2024,S43G01N123,수원 KT,Away,김준환,9,0,2,0.0,3,5,60.0,3,7,42.9,0,2,0.0,0,0,0,1,2,0,0,0,0,2
../kbl_data/2023-2024,S43G01N123,수원 KT,Away,하윤기,18,9,12,75.0,0,0,0.0,9,12,75.0,0,1,0.0,3,4,7,2,0,0,0,0,1,2
../kbl_data/2023-2024,S43G01N123,수원 KT,Away,이두원,1,0,0,0.0,0,0,0.0,0,0,0.0,1,2,50.0,0,0,0,0,0,0,0,0,0,0
../kbl_data/2023-2024,S43G01N123,수원 KT,Away,숀 데이브 일데폰소,0,0,0,0.0,0,0,0.0,0,0,0.0,0,0,0.0,0,0,0,1,0,0,0,0,0,1
../kbl_data/2023-2024,S43G01N123,수원 KT,Away,문정현,2,1,4,25.0,0,0,0.0,1,4,25.0,0,0,0.0,0,2,2,1,0,0,0,0,1,2
../kbl_data/2023-2024,S43G01N123,수원 KT,Away,마이클 에릭,4,2,3,66.7,0,0,0.0,2,3,66.7,0,0,0.0,3,1,4,0,0,0,0,0,2,1
../kbl_data/2023-2024,S43G01N123,수원 KT,Away,패리스 배스,24,6,10,60.0,3,6,50.0,9,16,56.2,3,6,50.0,5,7,12,7,1,0,0,1,5,2
../kbl_data/2023-2024,S43G01N124,고양 소노,Home,김강선,7,2,2,100.0,1,3,33.3,3,5,60.0,0,0,0.0,3,1,4,1,0,0,0,0,0,1
../kbl_data/2023-2024,S43G01N124,고양 소노,Home,함준후,6,1,1,100.0,1,1,100.0,2,2,100.0,1,1,100.0,0,3,3,1,0,0,1,0,1,2
../kbl_data/2023-2024,S43G01N124,고양 소노,Home,최현민,6,3,3,100.0,0,1,0.0,3,4,75.0,0,0,0.0,3,7,10,2,2,0,0,0,0,3
../kbl_data/2023-2024,S43G01N124,고양 소노,Home,김민욱,0,0,0,0.0,0,0,0.0,0,0,0.0,0,0,0.0,0,0,0,0,0,0,0,0,0,0
../kbl_data/2023-2024,S43G01N124,고양 소노,Home,한호빈,10,2,4,50.0,2,5,40.0,4,9,44.4,0,0,0.0,0,3,3,4,1,0,1,0,2,2
../kbl_data/2023-2024,S43G01N124,고양 소노,Home,전성현,14,3,6,50.0,2,9,22.2,5,15,33.3,2,2,100.0,1,2,3,0,1,0,0,0,2,1
../kbl_data/2023-2024,S43G01N124,고양 소노,Home,김지후,0,0,0,0.0,0,2,0.0,0,2,0.0,0,0,0.0,0,0,0,1,0,0,0,0,0,0
../kbl_data/2023-2024,S43G01N124,고양 소노,Home,김진유,0,0,0,0.0,0,0,0.0,0,0,0.0,0,0,0.0,1,1,2,0,1,0,1,0,1,4
../kbl_data/2023-2024,S43G01N124,고양 소노,Home,치나누 오누아쿠,30,12,20,60.0,1,2,50.0,13,22,59.1,3,5,60.0,3,6,9,3,1,1,0,1,4,4
../kbl_data/2023-2024,S43G01N124,고양 소노,Home,이진석,0,0,0,0.0,0,0,0.0,0,0,0.0,0,0,0.0,0,0,0,0,0,0,0,0,0,0
../kbl_data/2023-2024,S43G01N124,고양 소노,Home,백지웅,0,0,0,0.0,0,0,0.0,0,0,0.0,0,0,0.0,0,0,0,0,0,0,0,0,0,0
../kbl_data/2023-2024,S43G01N124,고양 소노,Home,알렉스 카바노,12,4,10,40.0,1,2,50.0,5,12,41.7,1,1,100.0,1,0,1,5,0,0,0,0,0,3
../kbl_data/2023-2024,S43G01N124,안양 정관장,Away,정준원,7,1,2,50.0,1,3,33.3,2,5,40.0,2,2,100.0,1,0,1,1,0,0,0,0,0,5
../kbl_data/2023-2024,S43G01N124,안양 정관장,Away,김상규,0,0,0,0.0,0,1,0.0,0,1,0.0,0,0,0.0,0,0,0,0,0,0,0,0,0,1
../kbl_data/2023-2024,S43G01N124,안양 정관장,Away,배병준,0,0,2,0.0,0,5,0.0,0,7,0.0,0,0,0.0,1,1,2,2,0,0,0,0,1,1
../kbl_data/2023-2024,S43G01N124,안양 정관장,Away,정효근,10,2,3,66.7,1,4,25.0,3,7,42.9,3,3,100.0,0,10,10,2,3,0,0,0,3,3
../kbl_data/2023-2024,S43G01N124,안양 정관장,Away,이종현,0,0,0,0.0,0,0,0.0,0,0,0.0,0,0,0.0,0,0,0,0,0,0,0,0,0,0
../kbl_data/2023-2024,S43G01N124,안양 정관장,Away,김철욱,0,0,0,0.0,0,1,0.0,0,1,0.0,0,0,0.0,0,0,0,0,0,0,0,0,0,0
../kbl_data/2023-2024,S43G01N124,안양 정관장,Away,박지훈,19,7,10,70.0,1,3,33.3,8,13,61.5,2,2,100.0,3,2,5,6,3,0,1,0,4,4
../kbl_data/2023-2024,S43G01N124,안양 정관장,Away,최성원,12,1,5,20.0,2,3,66.7,3,8,37.5,4,5,80.0,1,0,1,3,0,0,0,0,3,2
../kbl_data/2023-2024,S43G01N124,안양 정관장,Away,이우정,0,0,0,0.0,0,0,0.0,0,0,0.0,0,0,0.0,0,0,0,0,0,0,0,0,0,0
../kbl_data/2023-2024,S43G01N124,안양 정관장,Away,렌즈 아반도,9,3,4,75.0,1,1,100.0,4,5,80.0,0,0,0.0,2,0,2,0,0,0,1,0,0,0
../kbl_data/2023-2024,S43G01N124,안양 정관장,Away,나성호,0,0,0,0.0,0,0,0.0,0,0,0.0,0,0,0.0,0,0,0,0,0,0,0,0,0,0
../kbl_data/2023-2024,S43G01N124,안양 정관장,Away,로버트 카터,24,6,11,54.5,4,10,40.0,10,21,47.6,0,0,0.0,2,9,11,3,0,0,0,0,1,5
../kbl_data/2023-2024,S43G01N125,울산 현대모비스,Home,함지훈,11,4,6,66.7,0,0,0.0,4,6,66.7,3,4,75.0,1,3,4,4,2,0,0,0,0,0
../kbl_data/2023-2024,S43G01N125,울산 현대모비스,Home,최진수,9,3,3,100.0,1,1,100.0,4,4,100.0,0,0,0.0,3,0,3,1,1,2,0,0,1,0
../kbl_data/2023-2024,S43G01N125,울산 현대모비스,Home,김현수,0,0,0,0.0,0,0,0.0,0,0,0.0,0,0,0.0,0,0,0,0,0,0,0,0,0,0
../kbl_data/2023-2024,S43G01N125,울산 현대모비스,Home,장재석,4,1,4,25.0,0,0,0.0,1,4,25.0,2,2,100.0,0,3,3,1,0,0,0,0,0,4
../kbl_data/2023-2024,S43G01N125,울산 현대모비스,Home,김지완,12,0,1,0.0,4,7,57.1,4,8,50.0,0,0,0.0,0,2,2,5,2,0,0,0,2,3
../kbl_data/2023-2024,S43G01N125,울산 현대모비스,Home,김준일,10,5,5,100.0,0,0,0.0,5,5,100.0,0,0,0.0,0,1,1,1,0,0,0,0,3,1
../kbl_data/2023-2024,S43G01N125,울산 현대모비스,Home,김국찬,20,1,3,33.3,6,8,75.0,7,11,63.6,0,0,0.0,1,3,4,2,1,0,0,0,0,4
../kbl_data/2023-2024,S43G01N125,울산 현대모비스,Home,이우석,0,0,2,0.0,0,0,0.0,0,2,0.0,0,2,0.0,0,6,6,4,1,0,0,0,1,1
../kbl_data/2023-2024,S43G01N125,울산 현대모비스,Home,게이지 프림,19,7,9,77.8,0,1,0.0,7,10,70.0,5,6,83.3,1,2,3,2,1,0,0,0,0,5
../kbl_data/2023-2024,S43G01N125,울산 현대모비스,Home,김태완,0,0,1,0.0,0,1,0.0,0,2,0.0,0,0,0.0,0,0,0,0,0,0,0,0,0,0
../kbl_data/2023-2024,S43G01N125,울산 현대모비스,Home,박무빈,2,1,2,50.0,0,4,0.0,1,6,16.7,0,0,0.0,2,2,4,7,2,0,0,0,1,4
../kbl_data/2023-2024,S43G01N125,울산 현대모비스,Home,케베 알루마,15,5,8,62.5,1,7,14.3,6,15,40.0,2,2,100.0,2,7,9,4,0,0,0,1,1,1
../kbl_data/2023-2024,S43G01N125,서울 삼성,Away,이정현,11,1,5,20.0,2,4,50.0,3,9,33.3,3,4,75.0,1,6,7,6,0,0,0,0,1,2
../kbl_data/2023-2024,S43G01N125,서울 삼성,Away,홍경기,0,0,0,0.0,0,0,0.0,0,0,0.0,0,0,0.0,0,0,0,0,0,0,0,0,0,0
../kbl_data/2023-2024,S43G01N125,서울 삼성,Away,김승원,2,0,0,0.0,0,0,0.0,0,0,0.0,2,2,100.0,1,2,3,2,1,1,0,0,1,1
../kbl_data/2023-2024,S43G01N125,서울 삼성,Away,김시래,6,1,2,50.0,0,3,0.0,1,5,20.0,4,6,66.7,0,2,2,8,2,0,0,0,2,2
../kbl_data/2023-2024,S43G01N125,서울 삼성,Away,이동엽,5,1,4,25.0,1,2,50.0,2,6,33.3,0,0,0.0,0,0,0,3,1,0,0,0,1,0
../kbl_data/2023-2024,S43G01N125,서울 삼성,Away,최승욱,8,1,3,33.3,2,3,66.7,3,6,50.0,0,1,0.0,0,0,0,1,1,0,0,0,0,1
../kbl_data/2023-2024,S43G01N125,서울 삼성,Away,윤성원,0,0,0,0.0,0,1,0.0,0,1,0.0,0,0,0.0,0,2,2,0,0,0,0,0,0,4
../kbl_data/2023-2024,S43G01N125,서울 삼성,Away,조우성,0,0,2,0.0,0,0,0.0,0,2,0.0,0,0,0.0,2,1,3,0,0,0,0,0,0,5
../kbl_data/2023-2024,S43G01N125,서울 삼성,Away,신동혁,7,2,3,66.7,1,1,100.0,3,4,75.0,0,0,0.0,0,1,1,2,0,0,0,0,0,3
../kbl_data/2023-2024,S43G01N125,서울 삼성,Away,아반 나바,0,0,1,0.0,0,2,0.0,0,3,0.0,0,0,0.0,0,0,0,1,0,0,0,0,1,0
../kbl_data/2023-2024,S43G01N125,서울 삼성,Away,이스마엘 레인,20,3,3,100.0,4,6,66.7,7,9,77.8,2,3,66.7,2,3,5,1,2,1,1,0,4,0
../kbl_data/2023-2024,S43G01N125,서울 삼성,Away,코피 코번,26,9,16,56.2,0,0,0.0,9,16,56.2,8,15,53.3,2,7,9,2,0,0,0,0,1,2
../kbl_data/2023-2024,S43G01N126,원주 DB,Home,김현호,3,0,0,0.0,1,2,50.0,1,2,50.0,0,0,0.0,0,0,0,1,0,0,0,0,0,1
../kbl_data/2023-2024,S43G01N126,원주 DB,Home,서민수,2,1,1,100.0,0,0,0.0,1,1,100.0,0,0,0.0,0,1,1,0,0,0,0,0,0,0
../kbl_data/2023-2024,S43G01N126,원주 DB,Home,두경민,7,2,4,50.0,1,5,20.0,3,9,33.3,0,0,0.0,0,2,2,3,1,0,0,0,1,2
../kbl_data/2023-2024,S43G01N126,원주 DB,Home,김종규,15,7,10,70.0,0,0,0.0,7,10,70.0,1,1,100.0,4,6,10,4,2,1,0,2,1,1
../kbl_data/2023-2024,S43G01N126,원주 DB,Home,최승욱,0,0,0,0.0,0,0,0.0,0,0,0.0,0,0,0.0,0,0,0,0,0,0,0,0,0,0
../kbl_data/2023-2024,S43G01N126,원주 DB,Home,강상재,15,6,8,75.0,1,2,50.0,7,10,70.0,0,0,0.0,0,5,5,8,1,0,0,0,2,3
../kbl_data/2023-2024,S43G01N126,원주 DB,Home,디드릭 로슨,21,7,11,63.6,2,5,40.0,9,16,56.2,1,2,50.0,2,15,17,5,0,0,0,0,4,3
../kbl_data/2023-2024,S43G01N126,원주 DB,Home,이용우,0,0,0,0.0,0,1,0.0,0,1,0.0,0,0,0.0,1,0,1,0,0,0,0,0,0,0
../kbl_data/2023-2024,S43G01N126,원주 DB,Home,이선 알바노,15,6,8,75.0,1,2,50.0,7,10,70.0,0,0,0.0,0,0,0,5,0,0,0,0,1,2
../kbl_data/2023-2024,S43G01N126,원주 DB,Home,박인웅,5,1,2,50.0,1,4,25.0,2,6,33.3,0,0,0.0,1,2,3,1,0,1,0,0,1,4
../kbl_data/2023-2024,S43G01N126,원주 DB,Home,박승재,0,0,1,0.0,0,0,0.0,0,1,0.0,0,0,0.0,0,1,1,0,0,0,0,0,1,0
../kbl_data/2023-2024,S43G01N126,원주 DB,Home,제프 위디,8,1,2,50.0,1,2,50.0,2,4,50.0,3,3,100.0,0,1,1,0,0,0,0,0,0,1
../kbl_data/2023-2024,S43G01N126,창원 LG,Away,이관희,7,1,4,25.0,1,4,25.0,2,8,25.0,2,2,100.0,1,0,1,0,0,0,0,0,0,2
../kbl_data/2023-2024,S43G01N126,창원 LG,Away,정희재,14,1,2,50.0,3,5,60.0,4,7,57.1,3,4,75.0,0,1,1,1,0,0,0,0,1,3
../kbl_data/2023-2024,S43G01N126,창원 LG,Away,임동섭,3,0,0,0.0,1,1,100.0,1,1,100.0,0,0,0.0,0,0,0,0,0,0,0,0,0,1
../kbl_data/2023-2024,S43G01N126,창원 LG,Away,이재도,8,1,3,33.3,2,5,40.0,3,8,37.5,0,0,0.0,1,0,1,3,0,0,0,0,2,3
../kbl_data/2023-2024,S43G01N126,창원 LG,Away,정인덕,0,0,0,0.0,0,1,0.0,0,1,0.0,0,0,0.0,0,0,0,0,0,0,0,0,0,0
../kbl_data/2023-2024,S43G01N126,창원 LG,Away,양홍석,12,6,8,75.0,0,7,0.0,6,15,40.0,0,0,0.0,4,4,8,1,0,0,0,0,1,1
../kbl_data/2023-2024,S43G01N126,창원 LG,Away,박정현,0,0,2,0.0,0,0,0.0,0,2,0.0,0,0,0.0,0,0,0,0,0,0,0,0,0,1
../kbl_data/2023-2024,S43G01N126,창원 LG,Away,아셈 마레이,7,3,7,42.9,0,0,0.0,3,7,42.9,1,2,50.0,4,5,9,2,1,1,0,0,0,2
../kbl_data/2023-2024,S43G01N126,창원 LG,Away,저스틴 구탕,14,3,7,42.9,2,5,40.0,5,12,41.7,2,2,100.0,1,4,5,5,0,1,1,0,0,3
../kbl_data/2023-2024,S43G01N126,창원 LG,Away,양준석,2,1,4,25.0,0,2,0.0,1,6,16.7,0,0,0.0,1,1,2,0,1,0,0,0,0,0
../kbl_data/2023-2024,S43G01N126,창원 LG,Away,유기상,0,0,2,0.0,0,3,0.0,0,5,0.0,0,0,0.0,1,0,1,1,3,0,0,0,1,0
../kbl_data/2023-2024,S43G01N126,창원 LG,Away,후안 텔로,8,3,6,50.0,0,1,0.0,3,7,42.9,2,3,66.7,3,2,5,1,1,0,0,0,0,1
../kbl_data/2023-2024,S43G01N127,고양 소노,Home,김강선,7,1,1,100.0,0,4,0.0,1,5,20.0,5,5,100.0,1,2,3,2,0,0,1,0,1,1
../kbl_data/2023-2024,S43G01N127,고양 소노,Home,함준후,9,0,2,0.0,3,5,60.0,3,7,42.9,0,0,0.0,0,0,0,1,0,0,0,0,0,1
../kbl_data/2023-2024,S43G01N127,고양 소노,Home,최현민,7,3,5,60.0,0,1,0.0,3,6,50.0,1,3,33.3,2,2,4,2,2,0,0,0,1,2
../kbl_data/2023-2024,S43G01N127,고양 소노,Home,김민욱,9,3,3,100.0,1,3,33.3,4,6,66.7,0,0,0.0,2,1,3,0,0,0,1,0,0,1
../kbl_data/2023-2024,S43G01N127,고양 소노,Home,한호빈,7,0,5,0.0,2,6,33.3,2,11,18.2,1,2,50.0,2,1,3,6,1,0,1,0,2,2
../kbl_data/2023-2024,S43G01N127,고양 소노,Home,전성현,6,2,6,33.3,0,6,0.0,2,12,16.7,2,2,100.0,0,1,1,1,0,0,0,0,1,1
../kbl_data/2023-2024,S43G01N127,고양 소노,Home,김진유,2,1,3,33.3,0,0,0.0,1,3,33.3,0,0,0.0,5,5,10,1,0,0,0,0,1,2
../kbl_data/2023-2024,S43G01N127,고양 소노,Home,치나누 오누아쿠,15,7,15,46.7,0,0,0.0,7,15,46.7,1,3,33.3,3,12,15,0,2,0,0,2,2,4
../kbl_data/2023-2024,S43G01N127,고양 소노,Home,이진석,0,0,0,0.0,0,0,0.0,0,0,0.0,0,0,0.0,0,0,0,0,0,0,0,0,0,0
../kbl_data/2023-2024,S43G01N127,고양 소노,Home,백지웅,0,0,1,0.0,0,1,0.0,0,2,0.0,0,0,0.0,3,0,3,0,0,0,0,0,0,2
../kbl_data/2023-2024,S43G01N127,고양 소노,Home,민기남,0,0,0,0.0,0,1,0.0,0,1,0.0,0,0,0.0,0,0,0,0,0,0,0,0,0,0
../kbl_data/2023-2024,S43G01N127,고양 소노,Home,알렉스 카바노,5,2,4,50.0,0,4,0.0,2,8,25.0,1,2,50.0,0,1,1,4,0,0,0,0,2,1
../kbl_data/2023-2024,S43G01N127,서울 삼성,Away,이정현,12,5,7,71.4,0,5,0.0,5,12,41.7,2,2,100.0,0,8,8,5,1,0,0,0,1,1
../kbl_data/2023-2024,S43G01N127,서울 삼성,Away,홍경기,6,2,2,100.0,0,2,0.0,2,4,50.0,2,3,66.7,0,1,1,2,1,0,1,0,0,4
../kbl_data/2023-2024,S43G01N127,서울 삼성,Away,김승원,0,0,0,0.0,0,0,0.0,0,0,0.0,0,0,0.0,1,0,1,1,0,0,0,0,0,0
../kbl_data/2023-2024,S43G01N127,서울 삼성,Away,김시래,5,1,4,25.0,1,3,33.3,2,7,28.6,0,0,0.0,0,4,4,6,0,0,0,0,0,2
../kbl_data/2023-2024,S43G01N127,서울 삼성,Away,이동엽,8,1,1,100.0,2,4,50.0,3,5,60.0,0,0,0.0,0,2,2,4,1,0,0,0,2,2
../kbl_data/2023-2024,S43G01N127,서울 삼성,Away,최승욱,2,1,1,100.0,0,0,0.0,1,1,100.0,0,0,0.0,2,1,3,0,0,0,0,0,1,5
../kbl_data/2023-2024,S43G01N127,서울 삼성,Away,윤성원,12,3,5,60.0,2,3,66.7,5,8,62.5,0,0,0.0,1,3,4,0,0,2,0,0,0,1
../kbl_data/2023-2024,S43G01N127,서울 삼성,Away,조우성,0,0,0,0.0,0,0,0.0,0,0,0.0,0,0,0.0,0,2,2,0,0,0,0,0,0,0
../kbl_data/2023-2024,S43G01N127,서울 삼성,Away,신동혁,13,2,4,50.0,3,3,100.0,5,7,71.4,0,0,0.0,0,2,2,0,0,0,0,0,0,0
../kbl_data/2023-2024,S43G01N127,서울 삼성,Away,아반 나바,3,0,0,0.0,1,1,100.0,1,1,100.0,0,0,0.0,0,0,0,0,0,0,0,0,2,1
../kbl_data/2023-2024,S43G01N127,서울 삼성,Away,이스마엘 레인,10,3,5,60.0,1,3,33.3,4,8,50.0,1,2,50.0,0,4,4,0,0,0,0,0,2,1
../kbl_data/2023-2024,S43G01N127,서울 삼성,Away,코피 코번,15,6,12,50.0,0,0,0.0,6,12,50.0,3,9,33.3,4,8,12,4,1,0,0,1,3,3
../kbl_data/2023-2024,S43G01N128,안양 정관장,Home,정준원,2,1,1,100.0,0,2,0.0,1,3,33.3,0,0,0.0,0,0,0,1,0,1,0,0,0,2
../kbl_data/2023-2024,S43G01N128,안양 정관장,Home,배병준,13,2,5,40.0,3,9,33.3,5,14,35.7,0,0,0.0,0,0,0,0,1,0,0,0,1,1
../kbl_data/2023-2024,S43G01N128,안양 정관장,Home,정효근,7,2,3,66.7,0,3,0.0,2,6,33.3,3,4,75.0,0,4,4,0,2,0,0,0,3,2
../kbl_data/2023-2024,S43G01N128,안양 정관장,Home,이종현,3,0,4,0.0,0,1,0.0,0,5,0.0,3,4,75.0,1,2,3,1,0,1,1,0,0,1
../kbl_data/2023-2024,S43G01N128,안양 정관장,Home,김철욱,18,2,2,100.0,4,5,80.0,6,7,85.7,2,2,100.0,1,6,7,0,0,0,1,0,0,3
../kbl_data/2023-2024,S43G01N128,안양 정관장,Home,박지훈,2,1,4,25.0,0,4,0.0,1,8,12.5,0,0,0.0,0,1,1,3,3,0,0,0,2,4
../kbl_data/2023-2024,S43G01N128,안양 정관장,Home,최성원,3,0,1,0.0,1,4,25.0,1,5,20.0,0,0,0.0,0,1,1,6,1,0,0,0,0,1
../kbl_data/2023-2024,S43G01N128,안양 정관장,Home,이우정,0,0,0,0.0,0,0,0.0,0,0,0.0,0,0,0.0,0,0,0,0,0,0,1,0,0,0
../kbl_data/2023-2024,S43G01N128,안양 정관장,Home,고찬혁,3,0,1,0.0,1,2,50.0,1,3,33.3,0,0,0.0,0,0,0,0,0,0,0,0,0,0
../kbl_data/2023-2024,S43G01N128,안양 정관장,Home,표승빈,2,1,1,100.0,0,2,0.0,1,3,33.3,0,0,0.0,2,0,2,0,1,0,0,0,0,0
../kbl_data/2023-2024,S43G01N128,안양 정관장,Home,나성호,0,0,0,0.0,0,4,0.0,0,4,0.0,0,0,0.0,0,1,1,0,0,0,0,0,0,3
../kbl_data/2023-2024,S43G01N128,안양 정관장,Home,로버트 카터,15,3,7,42.9,3,7,42.9,6,14,42.9,0,0,0.0,3,9,12,4,1,0,0,0,2,2
../kbl_data/2023-2024,S43G01N128,서울 SK,Away,양우섭,0,0,0,0.0,0,1,0.0,0,1,0.0,0,0,0.0,0,1,1,1,0,0,0,0,1,1
../kbl_data/2023-2024,S43G01N128,서울 SK,Away,송창용,2,0,0,0.0,0,0,0.0,0,0,0.0,2,2,100.0,0,0,0,0,0,0,0,0,2,0
../kbl_data/2023-2024,S43G01N128,서울 SK,Away,김선형,7,1,1,100.0,1,3,33.3,2,4,50.0,2,2,100.0,0,0,0,4,1,0,0,0,1,2
../kbl_data/2023-2024,S43G01N128,서울 SK,Away,오세근,6,3,8,37.5,0,1,0.0,3,9,33.3,0,0,0.0,0,4,4,2,1,0,0,0,2,3
../kbl_data/2023-2024,S43G01N128,서울 SK,Away,최부경,10,5,6,83.3,0,0,0.0,5,6,83.3,0,1,0.0,1,4,5,0,1,1,0,0,2,0
../kbl_data/2023-2024,S43G01N128,서울 SK,Away,리온 윌리엄스,9,2,4,50.0,1,1,100.0,3,5,60.0,2,2,100.0,0,3,3,0,0,1,0,0,1,2
../kbl_data/2023-2024,S43G01N128,서울 SK,Away,최원혁,4,2,2,100.0,0,0,0.0,2,2,100.0,0,0,0.0,1,4,5,7,2,0,0,0,0,2
../kbl_data/2023-2024,S43G01N128,서울 SK,Away,안영준,11,2,2,100.0,2,6,33.3,4,8,50.0,1,2,50.0,1,7,8,4,0,2,0,0,1,2
../kbl_data/2023-2024,S43G01N128,서울 SK,Away,자밀 워니,23,11,17,64.7,0,0,0.0,11,17,64.7,1,1,100.0,1,9,10,1,1,1,0,3,2,0
../kbl_data/2023-2024,S43G01N128,서울 SK,Away,오재현,5,1,2,50.0,1,5,20.0,2,7,28.6,0,0,0.0,0,2,2,0,0,0,0,0,0,3
../kbl_data/2023-2024,S43G01N128,서울 SK,Away,김건우,3,1,1,100.0,0,0,0.0,1,1,100.0,1,2,50.0,0,1,1,0,0,0,0,1,0,0
../kbl_data/2023-2024,S43G01N128,서울 SK,Away,고메즈 딜 리아노,6,3,3,100.0,0,1,0.0,3,4,75.0,0,0,0.0,0,2,2,4,0,0,0,0,1,1
../kbl_data/2023-2024,S43G01N129,수원 KT,Home,한희원,14,1,3,33.3,4,4,100.0,5,7,71.4,0,2,0.0,0,1,1,0,0,0,0,0,0,3
../kbl_data/2023-2024,S43G01N129,수원 KT,Home,문성곤,11,1,1,100.0,3,7,42.9,4,8,50.0,0,0,0.0,1,3,4,4,7,0,0,0,1,2
../kbl_data/2023-2024,S43G01N129,수원 KT,Home,이현석,0,0,0,0.0,0,0,0.0,0,0,0.0,0,0,0.0,0,0,0,0,0,0,0,0,0,0
../kbl_data/2023-2024,S43G01N129,수원 KT,Home,정성우,13,5,8,62.5,1,5,20.0,6,13,46.2,0,0,0.0,1,1,2,6,2,0,0,0,1,2
../kbl_data/2023-2024,S43G01N129,수원 KT,Home,허훈,15,2,5,40.0,3,4,75.0,5,9,55.6,2,2,100.0,2,1,3,2,2,2,0,0,1,0
../kbl_data/2023-2024,S43G01N129,수원 KT,Home,이윤기,0,0,1,0.0,0,1,0.0,0,2,0.0,0,0,0.0,0,0,0,0,0,0,0,0,0,0
../kbl_data/2023-2024,S43G01N129,수원 KT,Home,김준환,0,0,0,0.0,0,0,0.0,0,0,0.0,0,0,0.0,0,0,0,0,0,0,0,0,0,0
../kbl_data/2023-2024,S43G01N129,수원 KT,Home,하윤기,4,2,6,33.3,0,0,0.0,2,6,33.3,0,0,0.0,2,2,4,3,2,0,0,0,0,4
../kbl_data/2023-2024,S43G01N129,수원 KT,Home,숀 데이브 일데폰소,0,0,0,0.0,0,0,0.0,0,0,0.0,0,0,0.0,0,0,0,0,0,0,0,0,0,0
../kbl_data/2023-2024,S43G01N129,수원 KT,Home,문정현,11,4,4,100.0,1,2,50.0,5,6,83.3,0,0,0.0,1,2,3,1,1,0,0,0,1,4
../kbl_data/2023-2024,S43G01N129,수원 KT,Home,마이클 에릭,1,0,0,0.0,0,0,0.0,0,0,0.0,1,2,50.0,1,2,3,1,0,0,0,0,2,3
../kbl_data/2023-2024,S43G01N129,수원 KT,Home,패리스 배스,29,10,16,62.5,2,7,28.6,12,23,52.2,3,3,100.0,4,7,11,8,1,0,0,2,3,2
../kbl_data/2023-2024,S43G01N129,부산 KCC,Away,정창영,0,0,0,0.0,0,0,0.0,0,0,0.0,0,0,0.0,0,0,0,0,0,0,0,0,0,0
../kbl_data/2023-2024,S43G01N129,부산 KCC,Away,라건아,16,5,10,50.0,1,2,50.0,6,12,50.0,3,4,75.0,5,1,6,1,0,0,0,0,3,1
../kbl_data/2023-2024,S43G01N129,부산 KCC,Away,허웅,16,2,3,66.7,4,8,50.0,6,11,54.5,0,0,0.0,0,1,1,2,0,0,0,0,4,2
../kbl_data/2023-2024,S43G01N129,부산 KCC,Away,이승현,6,1,3,33.3,1,1,100.0,2,4,50.0,1,2,50.0,2,0,2,0,0,0,0,0,0,1
../kbl_data/2023-2024,S43G01N129,부산 KCC,Away,이호현,5,1,5,20.0,1,2,50.0,2,7,28.6,0,0,0.0,0,0,0,2,2,0,1,0,1,0
../kbl_data/2023-2024,S43G01N129,부산 KCC,Away,송교창,7,2,3,66.7,1,4,25.0,3,7,42.9,0,0,0.0,0,5,5,2,0,0,0,0,2,2
../kbl_data/2023-2024,S43G01N129,부산 KCC,Away,최준용,2,1,5,20.0,0,2,0.0,1,7,14.3,0,0,0.0,2,1,3,2,0,1,0,0,2,1
../kbl_data/2023-2024,S43G01N129,부산 KCC,Away,곽정훈,4,2,3,66.7,0,0,0.0,2,3,66.7,0,0,0.0,0,1,1,0,0,0,1,0,0,0
../kbl_data/2023-2024,S43G01N129,부산 KCC,Away,이근휘,9,0,0,0.0,3,4,75.0,3,4,75.0,0,0,0.0,0,1,1,0,1,0,0,0,0,2
../kbl_data/2023-2024,S43G01N129,부산 KCC,Away,김동현,0,0,0,0.0,0,1,0.0,0,1,0.0,0,0,0.0,0,0,0,0,0,0,0,0,0,0
../kbl_data/2023-2024,S43G01N129,부산 KCC,Away,송동훈,0,0,0,0.0,0,0,0.0,0,0,0.0,0,0,0.0,0,0,0,1,0,0,0,0,1,1
../kbl_data/2023-2024,S43G01N129,부산 KCC,Away,알리제 드숀 존슨,18,7,9,77.8,0,2,0.0,7,11,63.6,4,4,100.0,3,10,13,7,0,1,0,0,5,4
../kbl_data/2023-2024,S43G01N130,안양 정관장,Home,정준원,4,2,2,100.0,0,2,0.0,2,4,50.0,0,0,0.0,0,0,0,1,0,0,0,0,0,1
../kbl_data/2023-2024,S43G01N130,안양 정관장,Home,배병준,3,0,2,0.0,1,2,50.0,1,4,25.0,0,0,0.0,1,0,1,0,0,0,0,0,1,1
../kbl_data/2023-2024,S43G01N130,안양 정관장,Home,정효근,17,5,8,62.5,2,5,40.0,7,13,53.8,1,2,50.0,1,5,6,3,3,1,0,0,1,3
../kbl_data/2023-2024,S43G01N130,안양 정관장,Home,이종현,8,1,5,20.0,2,2,100.0,3,7,42.9,0,0,0.0,3,6,9,1,2,2,0,0,0,1
../kbl_data/2023-2024,S43G01N130,안양 정관장,Home,김철욱,0,0,1,0.0,0,0,0.0,0,1,0.0,0,0,0.0,0,1,1,0,0,0,0,0,0,3
../kbl_data/2023-2024,S43G01N130,안양 정관장,Home,박지훈,15,4,6,66.7,2,5,40.0,6,11,54.5,1,1,100.0,1,3,4,5,1,0,1,0,1,4
../kbl_data/2023-2024,S43G01N130,안양 정관장,Home,최성원,17,2,3,66.7,4,7,57.1,6,10,60.0,1,1,100.0,1,0,1,1,0,0,0,0,1,4
../kbl_data/2023-2024,S43G01N130,안양 정관장,Home,이우정,0,0,0,0.0,0,0,0.0,0,0,0.0,0,0,0.0,0,0,0,0,0,0,0,0,0,0
../kbl_data/2023-2024,S43G01N130,안양 정관장,Home,고찬혁,0,0,0,0.0,0,0,0.0,0,0,0.0,0,0,0.0,0,0,0,0,0,0,0,0,0,0
../kbl_data/2023-2024,S43G01N130,안양 정관장,Home,표승빈,0,0,0,0.0,0,0,0.0,0,0,0.0,0,0,0.0,0,0,0,0,0,0,0,0,0,0
../kbl_data/2023-2024,S43G01N130,안양 정관장,Home,나성호,0,0,0,0.0,0,0,0.0,0,0,0.0,0,0,0.0,0,0,0,0,0,0,0,0,0,0
../kbl_data/2023-2024,S43G01N130,안양 정관장,Home,로버트 카터,22,2,7,28.6,5,13,38.5,7,20,35.0,3,5,60.0,2,7,9,3,2,1,0,0,4,2
../kbl_data/2023-2024,S43G01N130,원주 DB,Away,김현호,2,1,2,50.0,0,2,0.0,1,4,25.0,0,0,0.0,0,2,2,0,0,0,0,0,1,1
../kbl_data/2023-2024,S43G01N130,원주 DB,Away,서민수,0,0,0,0.0,0,0,0.0,0,0,0.0,0,0,0.0,0,0,0,0,0,0,0,0,1,1
../kbl_data/2023-2024,S43G01N130,원주 DB,Away,두경민,15,1,2,50.0,3,8,37.5,4,10,40.0,4,4,100.0,0,1,1,0,1,0,0,0,0,4
../kbl_data/2023-2024,S43G01N130,원주 DB,Away,김종규,14,6,9,66.7,0,0,0.0,6,9,66.7,2,3,66.7,4,3,7,2,0,1,0,2,0,1
../kbl_data/2023-2024,S43G01N130,원주 DB,Away,강상재,22,8,11,72.7,2,5,40.0,10,16,62.5,0,0,0.0,3,3,6,5,0,0,0,0,3,2
../kbl_data/2023-2024,S43G01N130,원주 DB,Away,디드릭 로슨,22,4,10,40.0,3,9,33.3,7,19,36.8,5,5,100.0,3,14,17,7,1,3,0,0,3,1
../kbl_data/2023-2024,S43G01N130,원주 DB,Away,이용우,0,0,0,0.0,0,0,0.0,0,0,0.0,0,0,0.0,0,0,0,0,0,0,0,0,0,0
../kbl_data/2023-2024,S43G01N130,원주 DB,Away,이선 알바노,18,6,11,54.5,2,4,50.0,8,15,53.3,0,0,0.0,2,4,6,5,2,0,0,0,1,3
../kbl_data/2023-2024,S43G01N130,원주 DB,Away,박인웅,0,0,0,0.0,0,2,0.0,0,2,0.0,0,0,0.0,0,1,1,1,0,0,0,0,0,1
../kbl_data/2023-2024,S43G01N130,원주 DB,Away,인승찬,0,0,0,0.0,0,0,0.0,0,0,0.0,0,0,0.0,0,0,0,0,0,0,0,0,0,0
../kbl_data/2023-2024,S43G01N130,원주 DB,Away,박승재,0,0,0,0.0,0,0,0.0,0,0,0.0,0,0,0.0,0,0,0,0,0,0,0,0,0,0
../kbl_data/2023-2024,S43G01N130,원주 DB,Away,제프 위디,0,0,0,0.0,0,0,0.0,0,0,0.0,0,0,0.0,0,0,0,0,0,0,0,0,0,0
../kbl_data/2023-2024,S43G01N131,창원 LG,Home,이관희,13,2,5,40.0,2,4,50.0,4,9,44.4,3,3,100.0,1,4,5,0,2,0,0,0,2,0
../kbl_data/2023-2024,S43G01N131,창원 LG,Home,정희재,7,2,3,66.7,1,2,50.0,3,5,60.0,0,1,0.0,1,1,2,0,2,0,1,0,0,3
../kbl_data/2023-2024,S43G01N131,창원 LG,Home,이재도,12,4,7,57.1,1,3,33.3,5,10,50.0,1,2,50.0,0,2,2,3,0,0,0,0,1,2
../kbl_data/2023-2024,S43G01N131,창원 LG,Home,정인덕,0,0,0,0.0,0,0,0.0,0,0,0.0,0,0,0.0,0,1,1,0,0,0,0,0,0,0
../kbl_data/2023-2024,S43G01N131,창원 LG,Home,양홍석,10,2,5,40.0,1,2,50.0,3,7,42.9,3,4,75.0,4,4,8,2,1,0,0,0,0,0
../kbl_data/2023-2024,S43G01N131,창원 LG,Home,박정현,4,2,6,33.3,0,0,0.0,2,6,33.3,0,0,0.0,1,0,1,0,0,0,0,0,1,2
../kbl_data/2023-2024,S43G01N131,창원 LG,Home,윤원상,0,0,0,0.0,0,1,0.0,0,1,0.0,0,0,0.0,0,0,0,0,0,0,0,0,0,0
../kbl_data/2023-2024,S43G01N131,창원 LG,Home,아셈 마레이,0,0,0,0.0,0,0,0.0,0,0,0.0,0,0,0.0,0,0,0,0,0,0,0,0,0,0
../kbl_data/2023-2024,S43G01N131,창원 LG,Home,저스틴 구탕,7,2,5,40.0,0,2,0.0,2,7,28.6,3,4,75.0,1,3,4,5,0,0,0,0,1,5
../kbl_data/2023-2024,S43G01N131,창원 LG,Home,양준석,2,1,2,50.0,0,0,0.0,1,2,50.0,0,0,0.0,0,1,1,1,0,0,0,0,1,0
../kbl_data/2023-2024,S43G01N131,창원 LG,Home,유기상,9,0,1,0.0,3,5,60.0,3,6,50.0,0,0,0.0,0,2,2,0,0,2,0,0,0,2
../kbl_data/2023-2024,S43G01N131,창원 LG,Home,후안 텔로,15,3,9,33.3,2,3,66.7,5,12,41.7,3,4,75.0,1,10,11,4,0,0,0,0,1,4
../kbl_data/2023-2024,S43G01N131,고양 소노,Away,김강선,8,1,2,50.0,2,5,40.0,3,7,42.9,0,0,0.0,3,3,6,1,1,0,0,0,1,3
../kbl_data/2023-2024,S43G01N131,고양 소노,Away,함준후,1,0,1,0.0,0,1,0.0,0,2,0.0,1,2,50.0,1,1,2,0,1,0,0,0,0,2
../kbl_data/2023-2024,S43G01N131,고양 소노,Away,최현민,0,0,0,0.0,0,1,0.0,0,1,0.0,0,0,0.0,0,0,0,0,0,0,0,0,0,0
../kbl_data/2023-2024,S43G01N131,고양 소노,Away,김민욱,0,0,0,0.0,0,0,0.0,0,0,0.0,0,0,0.0,0,0,0,0,0,0,0,0,0,0
../kbl_data/2023-2024,S43G01N131,고양 소노,Away,한호빈,9,1,4,25.0,2,6,33.3,3,10,30.0,1,2,50.0,0,1,1,5,0,0,0,0,0,4
../kbl_data/2023-2024,S43G01N131,고양 소노,Away,김지후,17,1,6,16.7,5,11,45.5,6,17,35.3,0,2,0.0,3,0,3,0,0,0,0,0,2,2
../kbl_data/2023-2024,S43G01N131,고양 소노,Away,김진유,11,3,5,60.0,1,6,16.7,4,11,36.4,2,2,100.0,2,9,11,3,1,0,0,0,2,3
../kbl_data/2023-2024,S43G01N131,고양 소노,Away,치나누 오누아쿠,26,9,19,47.4,1,1,100.0,10,20,50.0,5,5,100.0,5,14,19,7,2,1,0,0,3,4
../kbl_data/2023-2024,S43G01N131,고양 소노,Away,이진석,0,0,0,0.0,0,0,0.0,0,0,0.0,0,0,0.0,0,0,0,0,0,0,0,0,0,0
../kbl_data/2023-2024,S43G01N131,고양 소노,Away,이정현,0,0,0,0.0,0,0,0.0,0,0,0.0,0,0,0.0,0,0,0,0,0,0,0,0,0,0
../kbl_data/2023-2024,S43G01N131,고양 소노,Away,백지웅,0,0,0,0.0,0,1,0.0,0,1,0.0,0,0,0.0,0,0,0,0,0,0,0,0,0,2
../kbl_data/2023-2024,S43G01N131,고양 소노,Away,알렉스 카바노,0,0,2,0.0,0,0,0.0,0,2,0.0,0,0,0.0,0,0,0,1,0,0,0,0,1,2
../kbl_data/2023-2024,S43G01N132,대구 한국가스공사,Home,김동량,3,0,1,0.0,1,1,100.0,1,2,50.0,0,0,0.0,0,0,0,0,0,0,0,0,0,0
../kbl_data/2023-2024,S43G01N132,대구 한국가스공사,Home,차바위,6,0,0,0.0,1,2,50.0,1,2,50.0,3,4,75.0,3,1,4,3,0,2,2,0,1,5
../kbl_data/2023-2024,S43G01N132,대구 한국가스공사,Home,박지훈,0,0,0,0.0,0,0,0.0,0,0,0.0,0,0,0.0,0,0,0,0,0,0,0,0,0,1
../kbl_data/2023-2024,S43G01N132,대구 한국가스공사,Home,이원대,0,0,0,0.0,0,0,0.0,0,0,0.0,0,0,0.0,0,0,0,1,0,0,0,0,1,0
../kbl_data/2023-2024,S43G01N132,대구 한국가스공사,Home,이대헌,9,3,6,50.0,1,1,100.0,4,7,57.1,0,0,0.0,0,4,4,0,0,0,1,0,0,4
../kbl_data/2023-2024,S43G01N132,대구 한국가스공사,Home,김낙현,11,1,7,14.3,2,8,25.0,3,15,20.0,3,3,100.0,0,0,0,6,1,0,2,0,1,3
../kbl_data/2023-2024,S43G01N132,대구 한국가스공사,Home,양재혁,0,0,0,0.0,0,0,0.0,0,0,0.0,0,0,0.0,0,0,0,0,0,0,0,0,0,0
../kbl_data/2023-2024,S43G01N132,대구 한국가스공사,Home,양준우,0,0,0,0.0,0,0,0.0,0,0,0.0,0,0,0.0,0,0,0,0,0,0,0,0,0,0
../kbl_data/2023-2024,S43G01N132,대구 한국가스공사,Home,앤드류 니콜슨,37,9,13,69.2,3,8,37.5,12,21,57.1,10,13,76.9,2,9,11,2,1,2,0,2,0,2
../kbl_data/2023-2024,S43G01N132,대구 한국가스공사,Home,신승민,11,4,5,80.0,1,4,25.0,5,9,55.6,0,0,0.0,2,2,4,1,0,0,0,0,1,3
../kbl_data/2023-2024,S43G01N132,대구 한국가스공사,Home,샘조세프 벨란겔,0,0,0,0.0,0,0,0.0,0,0,0.0,0,0,0.0,0,0,0,0,0,0,0,0,0,0
../kbl_data/2023-2024,S43G01N132,대구 한국가스공사,Home,듀반 맥스웰,6,2,5,40.0,0,0,0.0,2,5,40.0,2,2,100.0,2,0,2,0,1,0,0,0,1,2
../kbl_data/2023-2024,S43G01N132,울산 현대모비스,Away,함지훈,6,3,4,75.0,0,0,0.0,3,4,75.0,0,0,0.0,1,1,2,6,0,0,0,0,1,1
../kbl_data/2023-2024,S43G01N132,울산 현대모비스,Away,최진수,6,2,3,66.7,0,3,0.0,2,6,33.3,2,2,100.0,2,2,4,0,0,2,0,0,0,0
../kbl_data/2023-2024,S43G01N132,울산 현대모비스,Away,장재석,8,3,5,60.0,0,0,0.0,3,5,60.0,2,2,100.0,1,3,4,1,1,0,0,0,1,4
../kbl_data/2023-2024,S43G01N132,울산 현대모비스,Away,김지완,11,1,3,33.3,3,4,75.0,4,7,57.1,0,0,0.0,1,1,2,2,0,0,0,0,1,3
../kbl_data/2023-2024,S43G01N132,울산 현대모비스,Away,김준일,0,0,0,0.0,0,0,0.0,0,0,0.0,0,0,0.0,1,2,3,0,0,0,0,0,2,3
../kbl_data/2023-2024,S43G01N132,울산 현대모비스,Away,김국찬,2,1,1,100.0,0,0,0.0,1,1,100.0,0,0,0.0,0,0,0,4,0,0,0,0,0,3
../kbl_data/2023-2024,S43G01N132,울산 현대모비스,Away,이우석,10,2,6,33.3,2,3,66.7,4,9,44.4,0,0,0.0,1,4,5,0,0,0,0,0,0,2
../kbl_data/2023-2024,S43G01N132,울산 현대모비스,Away,게이지 프림,26,9,12,75.0,0,0,0.0,9,12,75.0,8,9,88.9,2,6,8,0,1,0,0,1,1,3
../kbl_data/2023-2024,S43G01N132,울산 현대모비스,Away,김태완,0,0,0,0.0,0,0,0.0,0,0,0.0,0,0,0.0,0,0,0,0,0,0,0,0,0,0
../kbl_data/2023-2024,S43G01N132,울산 현대모비스,Away,박무빈,10,2,4,50.0,2,6,33.3,4,10,40.0,0,0,0.0,1,2,3,6,0,0,1,0,2,4
../kbl_data/2023-2024,S43G01N132,울산 현대모비스,Away,케베 알루마,7,2,3,66.7,1,3,33.3,3,6,50.0,0,0,0.0,1,1,2,1,0,0,0,1,0,3
../kbl_data/2023-2024,S43G01N132,울산 현대모비스,Away,미구엘 안드레 옥존,4,1,4,25.0,0,1,0.0,1,5,20.0,2,2,100.0,1,1,2,1,0,0,0,0,0,1
../kbl_data/2023-2024,S43G01N133,수원 KT,Home,한희원,0,0,0,0.0,0,3,0.0,0,3,0.0,0,2,0.0,0,3,3,0,2,0,0,0,0,4
../kbl_data/2023-2024,S43G01N133,수원 KT,Home,문성곤,5,1,1,100.0,1,3,33.3,2,4,50.0,0,0,0.0,1,3,4,1,1,0,0,0,0,2
../kbl_data/2023-2024,S43G01N133,수원 KT,Home,이현석,0,0,0,0.0,0,0,0.0,0,0,0.0,0,0,0.0,0,0,0,0,0,0,0,0,0,0
../kbl_data/2023-2024,S43G01N133,수원 KT,Home,정성우,4,2,4,50.0,0,1,0.0,2,5,40.0,0,0,0.0,0,0,0,2,2,0,0,0,0,2
../kbl_data/2023-2024,S43G01N133,수원 KT,Home,최성모,0,0,0,0.0,0,0,0.0,0,0,0.0,0,0,0.0,0,0,0,0,0,0,0,0,0,0
../kbl_data/2023-2024,S43G01N133,수원 KT,Home,허훈,6,3,8,37.5,0,4,0.0,3,12,25.0,0,0,0.0,0,2,2,4,4,0,0,0,1,3
../kbl_data/2023-2024,S43G01N133,수원 KT,Home,이윤기,4,2,2,100.0,0,1,0.0,2,3,66.7,0,0,0.0,0,0,0,0,0,0,0,0,0,1
../kbl_data/2023-2024,S43G01N133,수원 KT,Home,하윤기,13,4,10,40.0,0,0,0.0,4,10,40.0,5,6,83.3,2,2,4,1,0,0,0,0,1,1
../kbl_data/2023-2024,S43G01N133,수원 KT,Home,숀 데이브 일데폰소,0,0,0,0.0,0,0,0.0,0,0,0.0,0,0,0.0,0,0,0,0,0,0,0,0,0,0
../kbl_data/2023-2024,S43G01N133,수원 KT,Home,문정현,7,2,6,33.3,1,1,100.0,3,7,42.9,0,0,0.0,6,0,6,2,1,0,0,0,0,4
../kbl_data/2023-2024,S43G01N133,수원 KT,Home,마이클 에릭,0,0,1,0.0,0,0,0.0,0,1,0.0,0,0,0.0,0,1,1,0,0,0,0,0,0,0
../kbl_data/2023-2024,S43G01N133,수원 KT,Home,패리스 배스,44,13,17,76.5,4,11,36.4,17,28,60.7,6,9,66.7,2,7,9,5,1,2,0,2,2,4
../kbl_data/2023-2024,S43G01N133,부산 KCC,Away,정창영,6,1,2,50.0,1,1,100.0,2,3,66.7,1,2,50.0,1,1,2,0,0,0,0,0,1,1
../kbl_data/2023-2024,S43G01N133,부산 KCC,Away,라건아,23,10,12,83.3,0,1,0.0,10,13,76.9,3,4,75.0,5,10,15,0,0,2,0,0,2,1
../kbl_data/2023-2024,S43G01N133,부산 KCC,Away,전준범,9,1,1,100.0,2,3,66.7,3,4,75.0,1,1,100.0,0,0,0,0,0,1,0,0,0,1
../kbl_data/2023-2024,S43G01N133,부산 KCC,Away,허웅,7,1,4,25.0,1,4,25.0,2,8,25.0,2,2,100.0,0,3,3,9,0,0,1,0,4,2
../kbl_data/2023-2024,S43G01N133,부산 KCC,Away,이승현,3,0,1,0.0,1,3,33.3,1,4,25.0,0,0,0.0,0,1,1,0,0,0,0,0,1,2
../kbl_data/2023-2024,S43G01N133,부산 KCC,Away,이호현,11,3,4,75.0,1,3,33.3,4,7,57.1,2,2,100.0,0,4,4,1,0,0,0,0,2,2
../kbl_data/2023-2024,S43G01N133,부산 KCC,Away,송교창,5,1,4,25.0,1,4,25.0,2,8,25.0,0,2,0.0,0,2,2,2,0,0,0,0,2,4
../kbl_data/2023-2024,S43G01N133,부산 KCC,Away,최준용,7,2,6,33.3,1,4,25.0,3,10,30.0,0,0,0.0,1,2,3,5,1,3,0,0,1,4
../kbl_data/2023-2024,S43G01N133,부산 KCC,Away,곽정훈,0,0,0,0.0,0,0,0.0,0,0,0.0,0,0,0.0,0,0,0,0,0,0,0,0,0,0
../kbl_data/2023-2024,S43G01N133,부산 KCC,Away,이근휘,0,0,0,0.0,0,1,0.0,0,1,0.0,0,0,0.0,1,1,2,1,0,0,0,0,0,1
../kbl_data/2023-2024,S43G01N133,부산 KCC,Away,김동현,0,0,0,0.0,0,0,0.0,0,0,0.0,0,0,0.0,0,0,0,0,0,0,0,0,0,0
../kbl_data/2023-2024,S43G01N133,부산 KCC,Away,알리제 드숀 존슨,9,4,4,100.0,0,0,0.0,4,4,100.0,1,4,25.0,3,6,9,0,0,0,0,0,1,1
../kbl_data/2023-2024,S43G01N134,서울 삼성,Home,이정현,18,0,2,0.0,5,12,41.7,5,14,35.7,3,3,100.0,0,3,3,7,1,1,0,0,1,4
../kbl_data/2023-2024,S43G01N134,서울 삼성,Home,홍경기,0,0,2,0.0,0,0,0.0,0,2,0.0,0,0,0.0,0,0,0,0,0,0,0,0,1,0
../kbl_data/2023-2024,S43G01N134,서울 삼성,Home,김승원,0,0,1,0.0,0,0,0.0,0,1,0.0,0,0,0.0,1,2,3,0,1,0,0,0,0,0
../kbl_data/2023-2024,S43G01N134,서울 삼성,Home,김시래,11,1,3,33.3,3,4,75.0,4,7,57.1,0,0,0.0,0,2,2,3,0,0,0,0,1,2
../kbl_data/2023-2024,S43G01N134,서울 삼성,Home,이동엽,2,1,2,50.0,0,1,0.0,1,3,33.3,0,0,0.0,1,0,1,3,0,0,0,0,3,2
../kbl_data/2023-2024,S43G01N134,서울 삼성,Home,최승욱,11,3,5,60.0,1,1,100.0,4,6,66.7,2,2,100.0,3,2,5,1,0,0,1,0,0,1
../kbl_data/2023-2024,S43G01N134,서울 삼성,Home,윤성원,8,1,1,100.0,2,8,25.0,3,9,33.3,0,0,0.0,2,3,5,0,2,0,0,0,2,4
../kbl_data/2023-2024,S43G01N134,서울 삼성,Home,조우성,0,0,1,0.0,0,0,0.0,0,1,0.0,0,0,0.0,2,4,6,1,0,0,0,0,0,3
../kbl_data/2023-2024,S43G01N134,서울 삼성,Home,신동혁,5,1,2,50.0,1,3,33.3,2,5,40.0,0,0,0.0,0,1,1,0,0,0,0,0,1,2
../kbl_data/2023-2024,S43G01N134,서울 삼성,Home,아반 나바,0,0,0,0.0,0,0,0.0,0,0,0.0,0,0,0.0,0,0,0,0,0,0,0,0,0,0
../kbl_data/2023-2024,S43G01N134,서울 삼성,Home,이스마엘 레인,21,7,13,53.8,2,6,33.3,9,19,47.4,1,2,50.0,1,10,11,5,0,2,0,2,5,3
../kbl_data/2023-2024,S43G01N134,서울 삼성,Home,코피 코번,0,0,0,0.0,0,0,0.0,0,0,0.0,0,0,0.0,0,0,0,0,0,0,0,0,0,0
../kbl_data/2023-2024,S43G01N134,서울 SK,Away,양우섭,0,0,0,0.0,0,0,0.0,0,0,0.0,0,0,0.0,0,0,0,0,0,0,0,0,0,0
../kbl_data/2023-2024,S43G01N134,서울 SK,Away,송창용,2,1,1,100.0,0,1,0.0,1,2,50.0,0,0,0.0,0,0,0,1,0,0,0,0,0,0
../kbl_data/2023-2024,S43G01N134,서울 SK,Away,김선형,7,2,4,50.0,1,8,12.5,3,12,25.0,0,0,0.0,2,3,5,2,2,0,0,0,0,2
../kbl_data/2023-2024,S43G01N134,서울 SK,Away,오세근,19,7,12,58.3,1,3,33.3,8,15,53.3,2,2,100.0,4,2,6,1,0,0,0,0,0,0
../kbl_data/2023-2024,S43G01N134,서울 SK,Away,최부경,7,3,4,75.0,0,0,0.0,3,4,75.0,1,2,50.0,1,3,4,1,0,0,0,0,3,2
../kbl_data/2023-2024,S43G01N134,서울 SK,Away,리온 윌리엄스,0,0,0,0.0,0,0,0.0,0,0,0.0,0,0,0.0,0,2,2,0,0,0,0,0,0,1
../kbl_data/2023-2024,S43G01N134,서울 SK,Away,최원혁,0,0,0,0.0,0,4,0.0,0,4,0.0,0,0,0.0,3,1,4,4,1,0,0,0,2,4
../kbl_data/2023-2024,S43G01N134,서울 SK,Away,안영준,4,2,7,28.6,0,1,0.0,2,8,25.0,0,2,0.0,1,2,3,4,1,1,0,0,1,1
../kbl_data/2023-2024,S43G01N134,서울 SK,Away,자밀 워니,31,12,23,52.2,1,2,50.0,13,25,52.0,4,7,57.1,6,10,16,4,3,2,0,2,1,1
../kbl_data/2023-2024,S43G01N134,서울 SK,Away,오재현,10,1,4,25.0,2,6,33.3,3,10,30.0,2,2,100.0,1,4,5,3,1,1,1,0,1,5
../kbl_data/2023-2024,S43G01N134,서울 SK,Away,김건우,0,0,0,0.0,0,0,0.0,0,0,0.0,0,0,0.0,0,0,0,0,0,0,0,0,0,0
../kbl_data/2023-2024,S43G01N134,서울 SK,Away,고메즈 딜 리아노,0,0,0,0.0,0,0,0.0,0,0,0.0,0,0,0.0,0,0,0,0,0,0,0,0,0,0
../kbl_data/2023-2024,S43G01N135,원주 DB,Home,김현호,2,1,1,100.0,0,1,0.0,1,2,50.0,0,0,0.0,0,1,1,0,0,0,0,0,0,1
../kbl_data/2023-2024,S43G01N135,원주 DB,Home,두경민,12,1,1,100.0,3,8,37.5,4,9,44.4,1,2,50.0,0,1,1,3,2,0,0,0,1,4
../kbl_data/2023-2024,S43G01N135,원주 DB,Home,김종규,16,7,8,87.5,0,0,0.0,7,8,87.5,2,3,66.7,1,2,3,1,1,3,0,2,3,0
../kbl_data/2023-2024,S43G01N135,원주 DB,Home,최승욱,2,1,3,33.3,0,2,0.0,1,5,20.0,0,0,0.0,1,0,1,1,0,0,0,0,0,1
../kbl_data/2023-2024,S43G01N135,원주 DB,Home,강상재,21,8,9,88.9,1,1,100.0,9,10,90.0,2,2,100.0,3,7,10,5,0,0,0,0,6,5
../kbl_data/2023-2024,S43G01N135,원주 DB,Home,디드릭 로슨,20,4,7,57.1,3,9,33.3,7,16,43.8,3,6,50.0,2,8,10,4,0,0,0,0,5,4
../kbl_data/2023-2024,S43G01N135,원주 DB,Home,이용우,0,0,0,0.0,0,0,0.0,0,0,0.0,0,0,0.0,0,0,0,0,0,0,0,0,0,0
../kbl_data/2023-2024,S43G01N135,원주 DB,Home,이선 알바노,11,0,3,0.0,3,5,60.0,3,8,37.5,2,4,50.0,1,3,4,6,2,0,0,0,3,3
../kbl_data/2023-2024,S43G01N135,원주 DB,Home,박인웅,4,1,1,100.0,0,1,0.0,1,2,50.0,2,2,100.0,1,0,1,2,0,0,0,0,0,0
../kbl_data/2023-2024,S43G01N135,원주 DB,Home,인승찬,0,0,0,0.0,0,0,0.0,0,0,0.0,0,0,0.0,0,0,0,0,0,0,0,0,0,0
../kbl_data/2023-2024,S43G01N135,원주 DB,Home,박승재,0,0,0,0.0,0,0,0.0,0,0,0.0,0,0,0.0,0,0,0,0,0,0,0,0,0,0
../kbl_data/2023-2024,S43G01N135,원주 DB,Home,제프 위디,0,0,0,0.0,0,1,0.0,0,1,0.0,0,0,0.0,0,1,1,0,0,0,0,0,1,0
../kbl_data/2023-2024,S43G01N135,고양 소노,Away,김강선,16,2,2,100.0,4,8,50.0,6,10,60.0,0,0,0.0,2,1,3,2,2,0,0,0,0,5
../kbl_data/2023-2024,S43G01N135,고양 소노,Away,최현민,0,0,0,0.0,0,2,0.0,0,2,0.0,0,0,0.0,0,1,1,0,0,0,0,0,0,1
../kbl_data/2023-2024,S43G01N135,고양 소노,Away,김민욱,14,1,2,50.0,4,7,57.1,5,9,55.6,0,0,0.0,0,5,5,3,1,1,0,0,1,1
../kbl_data/2023-2024,S43G01N135,고양 소노,Away,한호빈,16,2,5,40.0,4,7,57.1,6,12,50.0,0,0,0.0,4,2,6,10,2,0,1,0,0,4
../kbl_data/2023-2024,S43G01N135,고양 소노,Away,김지후,3,0,0,0.0,1,8,12.5,1,8,12.5,0,0,0.0,0,0,0,0,0,0,0,0,1,0
../kbl_data/2023-2024,S43G01N135,고양 소노,Away,김진유,3,0,0,0.0,1,1,100.0,1,1,100.0,0,0,0.0,2,0,2,1,1,0,0,0,1,4
../kbl_data/2023-2024,S43G01N135,고양 소노,Away,다후안 서머스,7,2,5,40.0,1,2,50.0,3,7,42.9,0,0,0.0,1,0,1,0,0,0,0,0,1,0
../kbl_data/2023-2024,S43G01N135,고양 소노,Away,치나누 오누아쿠,20,8,15,53.3,0,1,0.0,8,16,50.0,4,7,57.1,4,11,15,4,1,3,0,2,5,2
../kbl_data/2023-2024,S43G01N135,고양 소노,Away,이진석,0,0,0,0.0,0,0,0.0,0,0,0.0,0,0,0.0,0,0,0,1,0,0,1,0,0,0
../kbl_data/2023-2024,S43G01N135,고양 소노,Away,이정현,0,0,0,0.0,0,0,0.0,0,0,0.0,0,0,0.0,0,0,0,0,0,0,0,0,0,0
../kbl_data/2023-2024,S43G01N135,고양 소노,Away,박종하,13,3,3,100.0,2,4,50.0,5,7,71.4,1,2,50.0,0,0,0,0,4,0,0,0,0,4
../kbl_data/2023-2024,S43G01N135,고양 소노,Away,알렉스 카바노,2,1,2,50.0,0,2,0.0,1,4,25.0,0,0,0.0,0,0,0,1,1,0,0,0,1,1
../kbl_data/2023-2024,S43G01N136,안양 정관장,Home,정준원,3,0,1,0.0,1,4,25.0,1,5,20.0,0,0,0.0,2,2,4,0,0,0,0,0,1,5
../kbl_data/2023-2024,S43G01N136,안양 정관장,Home,배병준,6,2,6,33.3,0,4,0.0,2,10,20.0,2,2,100.0,0,2,2,2,1,0,0,0,0,4
../kbl_data/2023-2024,S43G01N136,안양 정관장,Home,정효근,14,4,9,44.4,0,2,0.0,4,11,36.4,6,8,75.0,3,5,8,2,1,1,0,0,0,4
../kbl_data/2023-2024,S43G01N136,안양 정관장,Home,이종현,11,3,6,50.0,1,2,50.0,4,8,50.0,2,2,100.0,6,6,12,2,2,0,0,0,0,2
../kbl_data/2023-2024,S43G01N136,안양 정관장,Home,김철욱,0,0,0,0.0,0,0,0.0,0,0,0.0,0,0,0.0,0,0,0,0,0,0,0,0,0,0
../kbl_data/2023-2024,S43G01N136,안양 정관장,Home,박지훈,24,5,6,83.3,3,6,50.0,8,12,66.7,5,7,71.4,2,1,3,3,2,0,0,0,1,4
../kbl_data/2023-2024,S43G01N136,안양 정관장,Home,최성원,10,2,3,66.7,2,7,28.6,4,10,40.0,0,0,0.0,0,1,1,1,0,0,0,0,1,2
../kbl_data/2023-2024,S43G01N136,안양 정관장,Home,이우정,0,0,0,0.0,0,0,0.0,0,0,0.0,0,0,0.0,0,0,0,0,0,0,0,0,0,0
../kbl_data/2023-2024,S43G01N136,안양 정관장,Home,고찬혁,0,0,0,0.0,0,0,0.0,0,0,0.0,0,0,0.0,0,0,0,0,0,0,0,0,0,0
../kbl_data/2023-2024,S43G01N136,안양 정관장,Home,표승빈,0,0,0,0.0,0,0,0.0,0,0,0.0,0,0,0.0,0,0,0,0,0,0,0,0,0,0
../kbl_data/2023-2024,S43G01N136,안양 정관장,Home,나성호,0,0,0,0.0,0,0,0.0,0,0,0.0,0,0,0.0,0,0,0,0,0,0,0,0,0,0
../kbl_data/2023-2024,S43G01N136,안양 정관장,Home,로버트 카터,16,7,14,50.0,0,4,0.0,7,18,38.9,2,4,50.0,2,7,9,2,0,1,0,0,2,1
../kbl_data/2023-2024,S43G01N136,창원 LG,Away,이관희,9,3,4,75.0,0,2,0.0,3,6,50.0,3,3,100.0,1,1,2,3,0,0,0,0,2,1
../kbl_data/2023-2024,S43G01N136,창원 LG,Away,정희재,0,0,0,0.0,0,2,0.0,0,2,0.0,0,0,0.0,0,0,0,0,0,0,0,0,1,4
../kbl_data/2023-2024,S43G01N136,창원 LG,Away,이재도,11,3,5,60.0,1,4,25.0,4,9,44.4,2,2,100.0,0,3,3,8,1,0,0,0,1,4
../kbl_data/2023-2024,S43G01N136,창원 LG,Away,정인덕,3,0,0,0.0,1,1,100.0,1,1,100.0,0,0,0.0,0,0,0,0,0,0,0,0,0,0
../kbl_data/2023-2024,S43G01N136,창원 LG,Away,양홍석,21,6,9,66.7,3,6,50.0,9,15,60.0,0,3,0.0,2,2,4,2,0,0,0,0,1,3
../kbl_data/2023-2024,S43G01N136,창원 LG,Away,박정현,0,0,1,0.0,0,0,0.0,0,1,0.0,0,0,0.0,0,1,1,0,0,0,0,0,0,0
../kbl_data/2023-2024,S43G01N136,창원 LG,Away,윤원상,0,0,0,0.0,0,2,0.0,0,2,0.0,0,0,0.0,0,0,0,0,0,0,0,0,0,1
../kbl_data/2023-2024,S43G01N136,창원 LG,Away,아셈 마레이,0,0,0,0.0,0,0,0.0,0,0,0.0,0,0,0.0,0,0,0,0,0,0,0,0,0,0
../kbl_data/2023-2024,S43G01N136,창원 LG,Away,저스틴 구탕,13,3,5,60.0,0,2,0.0,3,7,42.9,7,8,87.5,1,5,6,3,0,0,0,1,1,3
../kbl_data/2023-2024,S43G01N136,창원 LG,Away,양준석,3,1,1,100.0,0,0,0.0,1,1,100.0,1,1,100.0,0,0,0,1,0,0,0,0,0,2
../kbl_data/2023-2024,S43G01N136,창원 LG,Away,유기상,2,0,0,0.0,0,1,0.0,0,1,0.0,2,3,66.7,0,1,1,0,0,1,0,0,0,5
../kbl_data/2023-2024,S43G01N136,창원 LG,Away,후안 텔로,18,7,11,63.6,1,4,25.0,8,15,53.3,1,2,50.0,2,9,11,3,1,0,0,0,2,2
../kbl_data/2023-2024,S43G01N137,부산 KCC,Home,정창영,2,1,1,100.0,0,0,0.0,1,1,100.0,0,0,0.0,0,0,0,0,0,0,0,0,2,2
../kbl_data/2023-2024,S43G01N137,부산 KCC,Home,라건아,7,3,4,75.0,0,1,0.0,3,5,60.0,1,1,100.0,3,1,4,0,0,0,0,0,1,1
../kbl_data/2023-2024,S43G01N137,부산 KCC,Home,전준범,0,0,0,0.0,0,0,0.0,0,0,0.0,0,0,0.0,0,0,0,0,0,0,0,0,0,0
../kbl_data/2023-2024,S43G01N137,부산 KCC,Home,허웅,19,2,6,33.3,5,11,45.5,7,17,41.2,0,0,0.0,0,3,3,0,1,0,0,0,1,3
../kbl_data/2023-2024,S43G01N137,부산 KCC,Home,이승현,0,0,0,0.0,0,0,0.0,0,0,0.0,0,0,0.0,0,1,1,0,0,0,0,0,0,2
../kbl_data/2023-2024,S43G01N137,부산 KCC,Home,이호현,0,0,2,0.0,0,0,0.0,0,2,0.0,0,0,0.0,1,1,2,2,0,0,0,0,0,1
../kbl_data/2023-2024,S43G01N137,부산 KCC,Home,송교창,14,3,3,100.0,2,11,18.2,5,14,35.7,2,4,50.0,0,2,2,4,1,0,0,0,2,3
../kbl_data/2023-2024,S43G01N137,부산 KCC,Home,최준용,14,3,5,60.0,1,4,25.0,4,9,44.4,5,7,71.4,0,10,10,5,1,1,0,0,2,3
../kbl_data/2023-2024,S43G01N137,부산 KCC,Home,곽정훈,0,0,0,0.0,0,0,0.0,0,0,0.0,0,0,0.0,0,0,0,0,0,0,0,0,0,0
../kbl_data/2023-2024,S43G01N137,부산 KCC,Home,이근휘,2,1,1,100.0,0,1,0.0,1,2,50.0,0,0,0.0,0,0,0,0,1,0,0,0,0,1
../kbl_data/2023-2024,S43G01N137,부산 KCC,Home,김동현,0,0,0,0.0,0,0,0.0,0,0,0.0,0,0,0.0,0,0,0,0,0,0,0,0,0,0
../kbl_data/2023-2024,S43G01N137,부산 KCC,Home,알리제 드숀 존슨,16,6,9,66.7,0,5,0.0,6,14,42.9,4,5,80.0,4,9,13,4,2,1,0,1,2,2
../kbl_data/2023-2024,S43G01N137,서울 SK,Away,양우섭,0,0,0,0.0,0,0,0.0,0,0,0.0,0,0,0.0,0,0,0,0,0,0,0,0,0,0
../kbl_data/2023-2024,S43G01N137,서울 SK,Away,송창용,5,1,2,50.0,1,3,33.3,2,5,40.0,0,0,0.0,1,2,3,0,1,0,0,0,0,2
../kbl_data/2023-2024,S43G01N137,서울 SK,Away,김선형,5,2,7,28.6,0,3,0.0,2,10,20.0,1,1,100.0,0,3,3,4,3,0,0,0,2,2
../kbl_data/2023-2024,S43G01N137,서울 SK,Away,오세근,11,3,5,60.0,1,3,33.3,4,8,50.0,2,2,100.0,2,3,5,1,0,1,0,0,1,1
../kbl_data/2023-2024,S43G01N137,서울 SK,Away,최부경,8,4,6,66.7,0,1,0.0,4,7,57.1,0,0,0.0,4,3,7,0,0,0,0,0,0,3
../kbl_data/2023-2024,S43G01N137,서울 SK,Away,리온 윌리엄스,0,0,0,0.0,0,0,0.0,0,0,0.0,0,0,0.0,0,0,0,0,0,0,0,0,0,0
../kbl_data/2023-2024,S43G01N137,서울 SK,Away,최원혁,5,1,2,50.0,1,3,33.3,2,5,40.0,0,0,0.0,0,5,5,3,0,0,0,0,1,3
../kbl_data/2023-2024,S43G01N137,서울 SK,Away,안영준,3,0,4,0.0,0,2,0.0,0,6,0.0,3,4,75.0,1,2,3,0,0,1,0,0,3,5
../kbl_data/2023-2024,S43G01N137,서울 SK,Away,자밀 워니,36,16,28,57.1,1,3,33.3,17,31,54.8,1,3,33.3,4,5,9,3,0,2,0,1,0,0
../kbl_data/2023-2024,S43G01N137,서울 SK,Away,오재현,4,2,4,50.0,0,1,0.0,2,5,40.0,0,0,0.0,1,1,2,0,1,0,0,0,0,2
../kbl_data/2023-2024,S43G01N137,서울 SK,Away,김건우,0,0,0,0.0,0,0,0.0,0,0,0.0,0,0,0.0,0,0,0,0,0,0,0,0,0,0
../kbl_data/2023-2024,S43G01N137,서울 SK,Away,고메즈 딜 리아노,0,0,0,0.0,0,0,0.0,0,0,0.0,0,0,0.0,0,0,0,0,0,0,0,0,0,0
../kbl_data/2023-2024,S43G01N138,대구 한국가스공사,Home,김동량,0,0,2,0.0,0,0,0.0,0,2,0.0,0,0,0.0,1,3,4,1,0,0,0,0,1,1
../kbl_data/2023-2024,S43G01N138,대구 한국가스공사,Home,차바위,8,0,2,0.0,2,4,50.0,2,6,33.3,2,2,100.0,1,4,5,3,1,0,1,0,0,3
../kbl_data/2023-2024,S43G01N138,대구 한국가스공사,Home,박지훈,10,2,14,14.3,2,6,33.3,4,20,20.0,0,0,0.0,8,6,14,10,6,0,0,0,4,6
../kbl_data/2023-2024,S43G01N138,대구 한국가스공사,Home,조상열,0,0,0,0.0,0,2,0.0,0,2,0.0,0,0,0.0,0,0,0,0,0,0,0,0,0,1
../kbl_data/2023-2024,S43G01N138,대구 한국가스공사,Home,이대헌,0,0,4,0.0,0,1,0.0,0,5,0.0,0,0,0.0,4,6,10,1,1,0,1,0,3,3
../kbl_data/2023-2024,S43G01N138,대구 한국가스공사,Home,김낙현,13,2,4,50.0,3,5,60.0,5,9,55.6,0,0,0.0,3,0,3,5,0,0,0,0,1,2
../kbl_data/2023-2024,S43G01N138,대구 한국가스공사,Home,양재혁,0,0,0,0.0,0,2,0.0,0,2,0.0,0,0,0.0,0,0,0,0,0,0,0,0,0,1
../kbl_data/2023-2024,S43G01N138,대구 한국가스공사,Home,양준우,0,0,0,0.0,0,0,0.0,0,0,0.0,0,0,0.0,1,0,1,0,0,0,0,0,0,0
../kbl_data/2023-2024,S43G01N138,대구 한국가스공사,Home,앤드류 니콜슨,33,9,12,75.0,4,7,57.1,13,19,68.4,3,3,100.0,4,6,10,1,0,0,0,0,2,1
../kbl_data/2023-2024,S43G01N138,대구 한국가스공사,Home,신승민,10,1,3,33.3,2,3,66.7,3,6,50.0,2,2,100.0,0,2,2,2,1,0,0,0,3,4
../kbl_data/2023-2024,S43G01N138,대구 한국가스공사,Home,샘조세프 벨란겔,13,1,4,25.0,3,5,60.0,4,9,44.4,2,2,100.0,0,2,2,2,2,0,1,0,0,1
../kbl_data/2023-2024,S43G01N138,대구 한국가스공사,Home,듀반 맥스웰,4,2,5,40.0,0,0,0.0,2,5,40.0,0,0,0.0,2,1,3,0,2,1,0,0,2,1
../kbl_data/2023-2024,S43G01N138,안양 정관장,Away,정준원,2,1,1,100.0,0,0,0.0,1,1,100.0,0,1,0.0,0,0,0,0,0,0,0,0,0,1
../kbl_data/2023-2024,S43G01N138,안양 정관장,Away,배병준,18,3,5,60.0,2,2,100.0,5,7,71.4,6,6,100.0,0,4,4,0,0,0,0,0,0,1
../kbl_data/2023-2024,S43G01N138,안양 정관장,Away,정효근,7,2,7,28.6,1,6,16.7,3,13,23.1,0,0,0.0,2,2,4,3,3,2,0,0,3,4
../kbl_data/2023-2024,S43G01N138,안양 정관장,Away,이종현,9,2,3,66.7,1,2,50.0,3,5,60.0,2,2,100.0,3,3,6,0,2,1,0,0,1,2
../kbl_data/2023-2024,S43G01N138,안양 정관장,Away,김철욱,5,1,1,100.0,1,1,100.0,2,2,100.0,0,0,0.0,1,1,2,0,0,1,0,0,2,2
../kbl_data/2023-2024,S43G01N138,안양 정관장,Away,박지훈,10,2,14,14.3,2,6,33.3,4,20,20.0,0,0,0.0,8,6,14,10,6,0,0,0,4,6
../kbl_data/2023-2024,S43G01N138,안양 정관장,Away,최성원,9,0,0,0.0,3,6,50.0,3,6,50.0,0,0,0.0,0,1,1,2,0,0,0,0,1,1
../kbl_data/2023-2024,S43G01N138,안양 정관장,Away,이우정,3,0,0,0.0,1,1,100.0,1,1,100.0,0,0,0.0,0,1,1,0,0,0,0,0,0,1
../kbl_data/2023-2024,S43G01N138,안양 정관장,Away,고찬혁,2,1,1,100.0,0,0,0.0,1,1,100.0,0,0,0.0,0,0,0,0,0,0,0,0,0,0
../kbl_data/2023-2024,S43G01N138,안양 정관장,Away,표승빈,0,0,0,0.0,0,0,0.0,0,0,0.0,0,0,0.0,0,0,0,0,0,0,0,0,0,0
../kbl_data/2023-2024,S43G01N138,안양 정관장,Away,나성호,0,0,0,0.0,0,0,0.0,0,0,0.0,0,2,0.0,0,0,0,0,0,0,0,0,0,1
../kbl_data/2023-2024,S43G01N138,안양 정관장,Away,로버트 카터,10,2,10,20.0,2,8,25.0,4,18,22.2,0,2,0.0,2,6,8,4,1,1,0,0,2,2
../kbl_data/2023-2024,S43G01N139,서울 삼성,Home,이정현,7,2,3,66.7,0,3,0.0,2,6,33.3,3,5,60.0,0,3,3,3,1,0,0,0,1,0
../kbl_data/2023-2024,S43G01N139,서울 삼성,Home,홍경기,8,1,3,33.3,2,2,100.0,3,5,60.0,0,0,0.0,2,0,2,1,0,0,0,0,1,3
../kbl_data/2023-2024,S43G01N139,서울 삼성,Home,김승원,0,0,1,0.0,0,0,0.0,0,1,0.0,0,0,0.0,0,0,0,0,0,0,0,0,0,0
../kbl_data/2023-2024,S43G01N139,서울 삼성,Home,김시래,0,0,1,0.0,0,6,0.0,0,7,0.0,0,0,0.0,0,1,1,3,0,0,1,0,2,0
../kbl_data/2023-2024,S43G01N139,서울 삼성,Home,이동엽,7,1,5,20.0,1,3,33.3,2,8,25.0,2,2,100.0,3,0,3,0,0,0,0,0,1,2
../kbl_data/2023-2024,S43G01N139,서울 삼성,Home,최승욱,7,1,3,33.3,1,3,33.3,2,6,33.3,2,2,100.0,2,3,5,1,1,0,0,0,0,1
../kbl_data/2023-2024,S43G01N139,서울 삼성,Home,윤성원,5,1,1,100.0,1,4,25.0,2,5,40.0,0,0,0.0,1,1,2,0,1,0,0,0,1,3
../kbl_data/2023-2024,S43G01N139,서울 삼성,Home,김한솔,0,0,0,0.0,0,0,0.0,0,0,0.0,0,0,0.0,0,0,0,0,0,0,0,0,0,1
../kbl_data/2023-2024,S43G01N139,서울 삼성,Home,조우성,4,2,4,50.0,0,0,0.0,2,4,50.0,0,0,0.0,2,1,3,2,0,0,0,0,1,2
../kbl_data/2023-2024,S43G01N139,서울 삼성,Home,신동혁,6,0,2,0.0,2,5,40.0,2,7,28.6,0,0,0.0,0,4,4,2,1,0,0,0,2,1
../kbl_data/2023-2024,S43G01N139,서울 삼성,Home,아반 나바,0,0,0,0.0,0,4,0.0,0,4,0.0,0,0,0.0,0,0,0,3,0,0,0,0,1,1
../kbl_data/2023-2024,S43G01N139,서울 삼성,Home,이스마엘 레인,17,7,13,53.8,1,2,50.0,8,15,53.3,0,0,0.0,3,3,6,1,0,0,0,1,3,0
../kbl_data/2023-2024,S43G01N139,수원 KT,Away,한희원,3,0,0,0.0,1,2,50.0,1,2,50.0,0,0,0.0,0,3,3,3,3,0,0,0,0,3
../kbl_data/2023-2024,S43G01N139,수원 KT,Away,문성곤,3,0,0,0.0,1,2,50.0,1,2,50.0,0,0,0.0,1,1,2,1,1,2,0,0,2,3
../kbl_data/2023-2024,S43G01N139,수원 KT,Away,이현석,6,0,0,0.0,2,4,50.0,2,4,50.0,0,0,0.0,1,0,1,0,1,0,0,0,0,0
../kbl_data/2023-2024,S43G01N139,수원 KT,Away,정성우,2,1,2,50.0,0,4,0.0,1,6,16.7,0,0,0.0,1,1,2,5,0,0,0,0,0,0
../kbl_data/2023-2024,S43G01N139,수원 KT,Away,최성모,6,0,0,0.0,2,3,66.7,2,3,66.7,0,0,0.0,0,2,2,2,1,0,0,0,2,1
../kbl_data/2023-2024,S43G01N139,수원 KT,Away,허훈,23,1,1,100.0,6,8,75.0,7,9,77.8,3,3,100.0,0,1,1,1,2,0,0,0,1,0
../kbl_data/2023-2024,S43G01N139,수원 KT,Away,이윤기,6,0,0,0.0,2,7,28.6,2,7,28.6,0,0,0.0,0,1,1,1,0,0,0,0,0,3
../kbl_data/2023-2024,S43G01N139,수원 KT,Away,하윤기,12,5,6,83.3,0,0,0.0,5,6,83.3,2,2,100.0,2,3,5,0,0,1,0,0,0,0
../kbl_data/2023-2024,S43G01N139,수원 KT,Away,이두원,5,2,3,66.7,0,0,0.0,2,3,66.7,1,2,50.0,1,0,1,2,1,0,0,0,1,1
../kbl_data/2023-2024,S43G01N139,수원 KT,Away,문정현,3,0,1,0.0,1,3,33.3,1,4,25.0,0,2,0.0,2,1,3,2,0,0,0,0,0,2
../kbl_data/2023-2024,S43G01N139,수원 KT,Away,마이클 에릭,6,3,3,100.0,0,0,0.0,3,3,100.0,0,0,0.0,2,8,10,1,0,0,0,1,0,1
../kbl_data/2023-2024,S43G01N139,수원 KT,Away,패리스 배스,28,11,14,78.6,2,7,28.6,13,21,61.9,0,0,0.0,1,9,10,3,3,0,0,2,1,2
../kbl_data/2023-2024,S43G01N140,서울 SK,Home,양우섭,2,0,0,0.0,0,1,0.0,0,1,0.0,2,2,100.0,0,0,0,3,0,0,1,0,1,3
../kbl_data/2023-2024,S43G01N140,서울 SK,Home,송창용,5,1,2,50.0,1,1,100.0,2,3,66.7,0,0,0.0,0,4,4,1,0,0,0,0,0,2
../kbl_data/2023-2024,S43G01N140,서울 SK,Home,오세근,4,2,4,50.0,0,1,0.0,2,5,40.0,0,0,0.0,2,2,4,1,0,0,0,0,1,1
../kbl_data/2023-2024,S43G01N140,서울 SK,Home,최부경,11,4,7,57.1,0,0,0.0,4,7,57.1,3,3,100.0,1,4,5,2,2,0,1,0,4,2
../kbl_data/2023-2024,S43G01N140,서울 SK,Home,리온 윌리엄스,4,1,1,100.0,0,0,0.0,1,1,100.0,2,2,100.0,0,1,1,1,1,0,0,0,0,1
../kbl_data/2023-2024,S43G01N140,서울 SK,Home,최원혁,2,1,1,100.0,0,0,0.0,1,1,100.0,0,0,0.0,1,1,2,2,0,0,0,0,1,1
../kbl_data/2023-2024,S43G01N140,서울 SK,Home,안영준,12,4,9,44.4,0,2,0.0,4,11,36.4,4,4,100.0,0,3,3,1,1,0,0,0,1,1
../kbl_data/2023-2024,S43G01N140,서울 SK,Home,자밀 워니,23,8,13,61.5,0,3,0.0,8,16,50.0,7,8,87.5,5,10,15,4,2,0,0,0,1,2
../kbl_data/2023-2024,S43G01N140,서울 SK,Home,박민우,0,0,0,0.0,0,2,0.0,0,2,0.0,0,0,0.0,0,0,0,0,0,0,0,0,0,0
../kbl_data/2023-2024,S43G01N140,서울 SK,Home,오재현,14,4,8,50.0,2,2,100.0,6,10,60.0,0,0,0.0,3,4,7,4,2,0,0,0,0,3
../kbl_data/2023-2024,S43G01N140,서울 SK,Home,김건우,2,1,2,50.0,0,0,0.0,1,2,50.0,0,0,0.0,0,0,0,0,0,0,0,0,0,0
../kbl_data/2023-2024,S43G01N140,서울 SK,Home,고메즈 딜 리아노,8,4,6,66.7,0,3,0.0,4,9,44.4,0,0,0.0,1,2,3,2,0,0,0,0,1,5
../kbl_data/2023-2024,S43G01N140,고양 소노,Away,김강선,3,1,1,100.0,0,4,0.0,1,5,20.0,1,1,100.0,2,0,2,2,0,0,1,0,1,1
../kbl_data/2023-2024,S43G01N140,고양 소노,Away,함준후,0,0,0,0.0,0,0,0.0,0,0,0.0,0,0,0.0,0,1,1,1,0,0,0,0,0,0
../kbl_data/2023-2024,S43G01N140,고양 소노,Away,최현민,2,1,1,100.0,0,0,0.0,1,1,100.0,0,0,0.0,0,1,1,0,1,0,0,0,0,1
../kbl_data/2023-2024,S43G01N140,고양 소노,Away,김민욱,12,2,5,40.0,2,4,50.0,4,9,44.4,2,2,100.0,4,1,5,0,1,0,0,0,4,4
../kbl_data/2023-2024,S43G01N140,고양 소노,Away,한호빈,7,0,0,0.0,2,9,22.2,2,9,22.2,1,2,50.0,0,1,1,4,1,0,1,0,1,0
../kbl_data/2023-2024,S43G01N140,고양 소노,Away,김지후,0,0,1,0.0,0,0,0.0,0,1,0.0,0,0,0.0,0,0,0,0,0,0,0,0,0,0
../kbl_data/2023-2024,S43G01N140,고양 소노,Away,김진유,0,0,1,0.0,0,0,0.0,0,1,0.0,0,0,0.0,2,1,3,0,0,0,0,0,0,1
../kbl_data/2023-2024,S43G01N140,고양 소노,Away,다후안 서머스,12,1,5,20.0,3,5,60.0,4,10,40.0,1,4,25.0,1,4,5,2,0,0,0,1,1,1
../kbl_data/2023-2024,S43G01N140,고양 소노,Away,치나누 오누아쿠,5,2,3,66.7,0,0,0.0,2,3,66.7,1,2,50.0,0,5,5,0,0,0,0,1,6,3
../kbl_data/2023-2024,S43G01N140,고양 소노,Away,이정현,11,4,5,80.0,0,9,0.0,4,14,28.6,3,3,100.0,1,3,4,5,1,0,0,0,2,3
../kbl_data/2023-2024,S43G01N140,고양 소노,Away,박종하,7,2,3,66.7,1,5,20.0,3,8,37.5,0,0,0.0,1,0,1,0,1,0,0,0,0,1
../kbl_data/2023-2024,S43G01N140,고양 소노,Away,알렉스 카바노,2,0,0,0.0,0,1,0.0,0,1,0.0,2,2,100.0,0,1,1,0,0,0,0,0,0,0
../kbl_data/2023-2024,S43G01N141,창원 LG,Home,이관희,4,2,4,50.0,0,1,0.0,2,5,40.0,0,0,0.0,0,0,0,0,1,0,0,0,1,0
../kbl_data/2023-2024,S43G01N141,창원 LG,Home,정희재,6,3,7,42.9,0,2,0.0,3,9,33.3,0,0,0.0,1,2,3,2,0,0,1,0,1,4
../kbl_data/2023-2024,S43G01N141,창원 LG,Home,이재도,16,3,6,50.0,3,5,60.0,6,11,54.5,1,3,33.3,1,3,4,3,0,0,1,0,2,3
../kbl_data/2023-2024,S43G01N141,창원 LG,Home,정인덕,0,0,0,0.0,0,0,0.0,0,0,0.0,0,0,0.0,0,0,0,0,1,0,0,0,0,0
../kbl_data/2023-2024,S43G01N141,창원 LG,Home,양홍석,11,3,7,42.9,1,4,25.0,4,11,36.4,2,4,50.0,3,4,7,4,0,0,0,0,2,4
../kbl_data/2023-2024,S43G01N141,창원 LG,Home,박정현,0,0,1,0.0,0,1,0.0,0,2,0.0,0,0,0.0,1,2,3,0,1,0,0,0,0,4
../kbl_data/2023-2024,S43G01N141,창원 LG,Home,아셈 마레이,19,7,11,63.6,0,0,0.0,7,11,63.6,5,13,38.5,7,7,14,3,0,0,0,0,0,4
../kbl_data/2023-2024,S43G01N141,창원 LG,Home,이승우,0,0,0,0.0,0,0,0.0,0,0,0.0,0,0,0.0,0,0,0,0,0,0,0,0,0,0
../kbl_data/2023-2024,S43G01N141,창원 LG,Home,저스틴 구탕,13,5,10,50.0,1,2,50.0,6,12,50.0,0,0,0.0,1,2,3,0,1,0,0,1,1,3
../kbl_data/2023-2024,S43G01N141,창원 LG,Home,양준석,0,0,0,0.0,0,0,0.0,0,0,0.0,0,0,0.0,1,3,4,4,1,0,0,0,0,1
../kbl_data/2023-2024,S43G01N141,창원 LG,Home,유기상,6,0,0,0.0,2,6,33.3,2,6,33.3,0,0,0.0,0,1,1,0,0,0,0,0,1,1
../kbl_data/2023-2024,S43G01N141,창원 LG,Home,후안 텔로,3,0,2,0.0,1,3,33.3,1,5,20.0,0,0,0.0,0,1,1,0,0,1,0,0,1,0
../kbl_data/2023-2024,S43G01N141,대구 한국가스공사,Away,김동량,0,0,0,0.0,0,0,0.0,0,0,0.0,0,0,0.0,0,1,1,1,0,0,0,0,0,0
../kbl_data/2023-2024,S43G01N141,대구 한국가스공사,Away,차바위,5,1,1,100.0,1,5,20.0,2,6,33.3,0,0,0.0,1,3,4,3,0,0,0,0,2,2
../kbl_data/2023-2024,S43G01N141,대구 한국가스공사,Away,박지훈,0,0,0,0.0,0,0,0.0,0,0,0.0,0,0,0.0,0,0,0,0,0,0,0,0,0,1
../kbl_data/2023-2024,S43G01N141,대구 한국가스공사,Away,조상열,6,0,0,0.0,2,3,66.7,2,3,66.7,0,0,0.0,0,0,0,1,0,0,1,0,1,3
../kbl_data/2023-2024,S43G01N141,대구 한국가스공사,Away,이대헌,9,4,5,80.0,0,1,0.0,4,6,66.7,1,2,50.0,0,1,1,3,1,0,0,0,2,3
../kbl_data/2023-2024,S43G01N141,대구 한국가스공사,Away,박봉진,0,0,0,0.0,0,0,0.0,0,0,0.0,0,0,0.0,0,0,0,0,1,0,0,0,0,1
../kbl_data/2023-2024,S43G01N141,대구 한국가스공사,Away,김낙현,5,1,4,25.0,1,3,33.3,2,7,28.6,0,0,0.0,0,1,1,2,0,0,0,0,2,5
../kbl_data/2023-2024,S43G01N141,대구 한국가스공사,Away,양준우,0,0,0,0.0,0,1,0.0,0,1,0.0,0,0,0.0,0,1,1,0,0,0,0,0,0,0
../kbl_data/2023-2024,S43G01N141,대구 한국가스공사,Away,앤드류 니콜슨,26,9,14,64.3,0,4,0.0,9,18,50.0,8,10,80.0,1,12,13,3,0,2,0,0,1,3
../kbl_data/2023-2024,S43G01N141,대구 한국가스공사,Away,신승민,16,3,4,75.0,2,2,100.0,5,6,83.3,4,6,66.7,0,4,4,1,0,0,0,0,0,4
../kbl_data/2023-2024,S43G01N141,대구 한국가스공사,Away,샘조세프 벨란겔,13,4,5,80.0,1,4,25.0,5,9,55.6,2,2,100.0,3,1,4,3,0,0,1,0,2,3
../kbl_data/2023-2024,S43G01N141,대구 한국가스공사,Away,듀반 맥스웰,2,1,3,33.3,0,0,0.0,1,3,33.3,0,0,0.0,0,1,1,0,0,2,0,1,0,1
../kbl_data/2023-2024,S43G01N142,울산 현대모비스,Home,함지훈,5,2,3,66.7,0,1,0.0,2,4,50.0,1,2,50.0,3,2,5,0,0,0,0,0,0,1
../kbl_data/2023-2024,S43G01N142,울산 현대모비스,Home,최진수,0,0,1,0.0,0,1,0.0,0,2,0.0,0,2,0.0,1,0,1,2,0,0,0,0,1,2
../kbl_data/2023-2024,S43G01N142,울산 현대모비스,Home,장재석,14,4,5,80.0,0,0,0.0,4,5,80.0,6,8,75.0,5,3,8,0,2,0,0,0,1,2
../kbl_data/2023-2024,S43G01N142,울산 현대모비스,Home,김지완,7,1,1,100.0,1,2,50.0,2,3,66.7,2,2,100.0,0,0,0,0,1,0,0,0,0,1
../kbl_data/2023-2024,S43G01N142,울산 현대모비스,Home,김준일,0,0,1,0.0,0,0,0.0,0,1,0.0,0,0,0.0,0,1,1,0,0,0,0,0,0,0
../kbl_data/2023-2024,S43G01N142,울산 현대모비스,Home,김국찬,3,0,2,0.0,1,3,33.3,1,5,20.0,0,0,0.0,1,2,3,1,0,0,0,0,1,3
../kbl_data/2023-2024,S43G01N142,울산 현대모비스,Home,이우석,4,2,5,40.0,0,3,0.0,2,8,25.0,0,0,0.0,1,2,3,0,2,1,0,0,2,0
../kbl_data/2023-2024,S43G01N142,울산 현대모비스,Home,게이지 프림,8,1,7,14.3,1,1,100.0,2,8,25.0,3,4,75.0,3,2,5,0,0,0,0,0,1,2
../kbl_data/2023-2024,S43G01N142,울산 현대모비스,Home,김태완,0,0,0,0.0,0,0,0.0,0,0,0.0,0,0,0.0,0,0,0,0,0,0,0,0,0,0
../kbl_data/2023-2024,S43G01N142,울산 현대모비스,Home,박무빈,2,1,3,33.3,0,2,0.0,1,5,20.0,0,0,0.0,0,1,1,1,0,0,0,0,1,2
../kbl_data/2023-2024,S43G01N142,울산 현대모비스,Home,케베 알루마,17,5,9,55.6,2,6,33.3,7,15,46.7,1,4,25.0,0,9,9,6,4,1,0,0,2,0
../kbl_data/2023-2024,S43G01N142,울산 현대모비스,Home,미구엘 안드레 옥존,23,6,7,85.7,3,6,50.0,9,13,69.2,2,2,100.0,0,3,3,5,0,0,0,0,2,3
../kbl_data/2023-2024,S43G01N142,수원 KT,Away,한희원,4,2,2,100.0,0,1,0.0,2,3,66.7,0,0,0.0,1,5,6,1,1,0,0,0,1,4
../kbl_data/2023-2024,S43G01N142,수원 KT,Away,문성곤,5,1,2,50.0,1,4,25.0,2,6,33.3,0,0,0.0,0,1,1,1,0,1,0,0,0,3
../kbl_data/2023-2024,S43G01N142,수원 KT,Away,이현석,0,0,0,0.0,0,0,0.0,0,0,0.0,0,0,0.0,0,0,0,0,0,0,0,0,0,0
../kbl_data/2023-2024,S43G01N142,수원 KT,Away,정성우,7,2,4,50.0,1,2,50.0,3,6,50.0,0,0,0.0,0,0,0,6,0,0,0,0,1,4
../kbl_data/2023-2024,S43G01N142,수원 KT,Away,최성모,2,1,1,100.0,0,1,0.0,1,2,50.0,0,0,0.0,0,1,1,1,0,0,0,0,0,0
../kbl_data/2023-2024,S43G01N142,수원 KT,Away,허훈,10,2,4,50.0,2,4,50.0,4,8,50.0,0,2,0.0,0,1,1,3,1,0,0,0,3,0
../kbl_data/2023-2024,S43G01N142,수원 KT,Away,이윤기,0,0,0,0.0,0,0,0.0,0,0,0.0,0,0,0.0,0,0,0,0,0,0,0,0,0,0
../kbl_data/2023-2024,S43G01N142,수원 KT,Away,하윤기,23,8,11,72.7,0,0,0.0,8,11,72.7,7,8,87.5,2,3,5,3,2,0,0,0,1,1
../kbl_data/2023-2024,S43G01N142,수원 KT,Away,이두원,0,0,0,0.0,0,0,0.0,0,0,0.0,0,0,0.0,0,0,0,0,0,0,0,0,0,1
../kbl_data/2023-2024,S43G01N142,수원 KT,Away,문정현,5,1,3,33.3,1,7,14.3,2,10,20.0,0,0,0.0,3,0,3,2,2,0,0,0,0,0
../kbl_data/2023-2024,S43G01N142,수원 KT,Away,마이클 에릭,2,1,2,50.0,0,0,0.0,1,2,50.0,0,0,0.0,1,3,4,0,0,0,0,0,0,1
../kbl_data/2023-2024,S43G01N142,수원 KT,Away,패리스 배스,24,9,21,42.9,2,6,33.3,11,27,40.7,0,0,0.0,3,12,15,3,2,0,0,3,5,4
../kbl_data/2023-2024,S43G01N143,서울 삼성,Home,이정현,6,2,4,50.0,0,4,0.0,2,8,25.0,2,2,100.0,1,0,1,4,0,0,0,0,0,3
../kbl_data/2023-2024,S43G01N143,서울 삼성,Home,홍경기,6,0,0,0.0,2,3,66.7,2,3,66.7,0,0,0.0,0,0,0,1,0,0,0,0,0,1
../kbl_data/2023-2024,S43G01N143,서울 삼성,Home,김승원,0,0,0,0.0,0,0,0.0,0,0,0.0,0,0,0.0,1,0,1,0,0,0,0,0,0,0
../kbl_data/2023-2024,S43G01N143,서울 삼성,Home,김시래,8,1,6,16.7,2,5,40.0,3,11,27.3,0,0,0.0,1,3,4,2,0,0,0,0,0,1
../kbl_data/2023-2024,S43G01N143,서울 삼성,Home,이동엽,4,0,2,0.0,1,3,33.3,1,5,20.0,1,2,50.0,1,3,4,3,1,0,0,0,2,1
../kbl_data/2023-2024,S43G01N143,서울 삼성,Home,최승욱,16,6,14,42.9,0,10,0.0,6,24,25.0,4,8,50.0,10,4,14,0,2,0,0,0,0,8
../kbl_data/2023-2024,S43G01N143,서울 삼성,Home,윤성원,4,1,2,50.0,0,5,0.0,1,7,14.3,2,2,100.0,1,4,5,0,0,1,0,0,1,3
../kbl_data/2023-2024,S43G01N143,서울 삼성,Home,조우성,3,1,1,100.0,0,0,0.0,1,1,100.0,1,2,50.0,1,2,3,0,0,0,0,0,1,2
../kbl_data/2023-2024,S43G01N143,서울 삼성,Home,이원석,0,0,0,0.0,0,0,0.0,0,0,0.0,0,0,0.0,0,0,0,0,0,0,1,0,0,0
../kbl_data/2023-2024,S43G01N143,서울 삼성,Home,신동혁,11,4,5,80.0,1,3,33.3,5,8,62.5,0,0,0.0,0,3,3,2,1,0,0,0,0,4
../kbl_data/2023-2024,S43G01N143,서울 삼성,Home,조준희,0,0,1,0.0,0,0,0.0,0,1,0.0,0,0,0.0,0,0,0,0,0,0,0,0,1,0
../kbl_data/2023-2024,S43G01N143,서울 삼성,Home,이스마엘 레인,27,8,15,53.3,3,5,60.0,11,20,55.0,2,4,50.0,3,10,13,1,0,3,0,1,1,3
../kbl_data/2023-2024,S43G01N143,원주 DB,Away,김현호,0,0,0,0.0,0,0,0.0,0,0,0.0,0,0,0.0,0,0,0,0,0,0,0,0,0,0
../kbl_data/2023-2024,S43G01N143,원주 DB,Away,두경민,3,1,2,50.0,0,4,0.0,1,6,16.7,1,2,50.0,1,5,6,2,0,0,0,0,1,3
../kbl_data/2023-2024,S43G01N143,원주 DB,Away,김종규,5,1,7,14.3,0,1,0.0,1,8,12.5,3,3,100.0,3,7,10,0,0,2,0,1,2,3
../kbl_data/2023-2024,S43G01N143,원주 DB,Away,최승욱,16,6,14,42.9,0,10,0.0,6,24,25.0,4,8,50.0,10,4,14,0,2,0,0,0,0,8
../kbl_data/2023-2024,S43G01N143,원주 DB,Away,김훈,0,0,0,0.0,0,0,0.0,0,0,0.0,0,0,0.0,0,1,1,0,0,0,0,0,0,0
../kbl_data/2023-2024,S43G01N143,원주 DB,Away,이윤수,0,0,0,0.0,0,0,0.0,0,0,0.0,0,0,0.0,0,0,0,0,0,0,0,0,0,0
../kbl_data/2023-2024,S43G01N143,원주 DB,Away,디드릭 로슨,21,8,13,61.5,1,4,25.0,9,17,52.9,2,3,66.7,1,9,10,7,0,0,0,0,0,4
../kbl_data/2023-2024,S43G01N143,원주 DB,Away,이용우,10,2,2,100.0,2,6,33.3,4,8,50.0,0,0,0.0,0,1,1,0,0,0,0,0,0,1
../kbl_data/2023-2024,S43G01N143,원주 DB,Away,이선 알바노,21,3,5,60.0,4,6,66.7,7,11,63.6,3,4,75.0,4,5,9,6,1,0,1,0,1,2
../kbl_data/2023-2024,S43G01N143,원주 DB,Away,박인웅,17,1,2,50.0,4,7,57.1,5,9,55.6,3,4,75.0,1,3,4,2,1,0,1,0,0,3
../kbl_data/2023-2024,S43G01N143,원주 DB,Away,박승재,0,0,1,0.0,0,1,0.0,0,2,0.0,0,0,0.0,1,0,1,0,0,0,0,0,0,0
../kbl_data/2023-2024,S43G01N143,원주 DB,Away,제프 위디,6,3,4,75.0,0,0,0.0,3,4,75.0,0,0,0.0,0,0,0,1,0,0,0,0,0,0
../kbl_data/2023-2024,S43G01N144,서울 SK,Home,양우섭,5,1,1,100.0,1,1,100.0,2,2,100.0,0,0,0.0,1,2,3,2,0,0,0,0,0,2
../kbl_data/2023-2024,S43G01N144,서울 SK,Home,송창용,6,0,1,0.0,2,2,100.0,2,3,66.7,0,0,0.0,0,2,2,1,0,0,0,0,0,4
../kbl_data/2023-2024,S43G01N144,서울 SK,Home,김선형,0,0,0,0.0,0,0,0.0,0,0,0.0,0,0,0.0,0,0,0,0,0,0,0,0,0,0
../kbl_data/2023-2024,S43G01N144,서울 SK,Home,오세근,11,3,7,42.9,1,5,20.0,4,12,33.3,2,2,100.0,2,5,7,1,0,2,0,0,1,1
../kbl_data/2023-2024,S43G01N144,서울 SK,Home,최부경,2,1,4,25.0,0,0,0.0,1,4,25.0,0,0,0.0,2,1,3,1,0,0,0,0,0,0
../kbl_data/2023-2024,S43G01N144,서울 SK,Home,리온 윌리엄스,1,0,1,0.0,0,0,0.0,0,1,0.0,1,2,50.0,0,1,1,0,0,0,0,0,0,1
../kbl_data/2023-2024,S43G01N144,서울 SK,Home,최원혁,8,0,1,0.0,2,2,100.0,2,3,66.7,2,2,100.0,0,2,2,2,1,0,0,0,2,3
../kbl_data/2023-2024,S43G01N144,서울 SK,Home,안영준,13,2,4,50.0,3,9,33.3,5,13,38.5,0,0,0.0,1,6,7,3,1,1,0,0,2,1
../kbl_data/2023-2024,S43G01N144,서울 SK,Home,자밀 워니,28,12,19,63.2,1,1,100.0,13,20,65.0,1,3,33.3,4,7,11,10,0,3,0,4,3,1
../kbl_data/2023-2024,S43G01N144,서울 SK,Home,오재현,9,3,5,60.0,0,3,0.0,3,8,37.5,3,3,100.0,0,2,2,0,0,0,0,0,0,5
../kbl_data/2023-2024,S43G01N144,서울 SK,Home,김건우,0,0,1,0.0,0,0,0.0,0,1,0.0,0,0,0.0,0,0,0,0,0,1,0,0,0,0
../kbl_data/2023-2024,S43G01N144,서울 SK,Home,고메즈 딜 리아노,0,0,0,0.0,0,0,0.0,0,0,0.0,0,0,0.0,1,2,3,0,0,0,0,0,1,0
../kbl_data/2023-2024,S43G01N144,안양 정관장,Away,정준원,7,2,2,100.0,1,1,100.0,3,3,100.0,0,0,0.0,1,0,1,0,0,1,0,0,1,1
../kbl_data/2023-2024,S43G01N144,안양 정관장,Away,배병준,2,1,3,33.3,0,4,0.0,1,7,14.3,0,0,0.0,1,0,1,1,1,0,0,0,1,1
../kbl_data/2023-2024,S43G01N144,안양 정관장,Away,정효근,19,3,8,37.5,3,6,50.0,6,14,42.9,4,5,80.0,1,4,5,1,2,0,0,0,0,3
../kbl_data/2023-2024,S43G01N144,안양 정관장,Away,이종현,12,6,8,75.0,0,1,0.0,6,9,66.7,0,0,0.0,2,4,6,0,1,0,0,1,0,1
../kbl_data/2023-2024,S43G01N144,안양 정관장,Away,김철욱,0,0,0,0.0,0,1,0.0,0,1,0.0,0,0,0.0,0,0,0,0,0,1,0,0,0,1
../kbl_data/2023-2024,S43G01N144,안양 정관장,Away,최성원,11,3,5,60.0,1,4,25.0,4,9,44.4,2,3,66.7,0,0,0,9,0,0,0,0,0,2
../kbl_data/2023-2024,S43G01N144,안양 정관장,Away,이우정,1,0,2,0.0,0,2,0.0,0,4,0.0,1,2,50.0,1,1,2,3,2,0,0,0,0,2
../kbl_data/2023-2024,S43G01N144,안양 정관장,Away,장태빈,0,0,0,0.0,0,0,0.0,0,0,0.0,0,0,0.0,0,0,0,0,0,0,0,0,0,0
../kbl_data/2023-2024,S43G01N144,안양 정관장,Away,고찬혁,0,0,0,0.0,0,0,0.0,0,0,0.0,0,0,0.0,0,0,0,0,0,0,0,0,0,0
../kbl_data/2023-2024,S43G01N144,안양 정관장,Away,표승빈,2,1,3,33.3,0,0,0.0,1,3,33.3,0,0,0.0,1,1,2,0,0,0,0,0,0,0
../kbl_data/2023-2024,S43G01N144,안양 정관장,Away,나성호,0,0,0,0.0,0,0,0.0,0,0,0.0,0,0,0.0,0,0,0,0,0,0,0,0,0,0
../kbl_data/2023-2024,S43G01N144,안양 정관장,Away,로버트 카터,17,4,9,44.4,3,14,21.4,7,23,30.4,0,0,0.0,2,15,17,3,0,0,0,0,1,3
../kbl_data/2023-2024,S43G01N145,부산 KCC,Home,정창영,2,0,1,0.0,0,2,0.0,0,3,0.0,2,2,100.0,0,1,1,4,0,0,0,0,1,1
../kbl_data/2023-2024,S43G01N145,부산 KCC,Home,라건아,15,7,11,63.6,0,2,0.0,7,13,53.8,1,2,50.0,3,6,9,0,1,0,0,0,1,1
../kbl_data/2023-2024,S43G01N145,부산 KCC,Home,전준범,3,0,0,0.0,1,1,100.0,1,1,100.0,0,0,0.0,0,1,1,0,0,0,0,0,0,1
../kbl_data/2023-2024,S43G01N145,부산 KCC,Home,허웅,18,2,4,50.0,3,8,37.5,5,12,41.7,5,7,71.4,1,3,4,7,1,0,0,0,1,2
../kbl_data/2023-2024,S43G01N145,부산 KCC,Home,이승현,9,2,3,66.7,1,2,50.0,3,5,60.0,2,2,100.0,2,4,6,1,1,0,0,0,2,2
../kbl_data/2023-2024,S43G01N145,부산 KCC,Home,이호현,8,0,4,0.0,2,3,66.7,2,7,28.6,2,2,100.0,0,1,1,2,1,0,0,0,0,5
../kbl_data/2023-2024,S43G01N145,부산 KCC,Home,송교창,6,1,4,25.0,1,2,50.0,2,6,33.3,1,2,50.0,0,1,1,1,1,1,1,0,4,1
../kbl_data/2023-2024,S43G01N145,부산 KCC,Home,최준용,8,1,5,20.0,1,2,50.0,2,7,28.6,3,3,100.0,2,10,12,5,0,0,0,0,3,1
../kbl_data/2023-2024,S43G01N145,부산 KCC,Home,곽정훈,0,0,0,0.0,0,0,0.0,0,0,0.0,0,0,0.0,0,0,0,0,0,0,0,0,0,0
../kbl_data/2023-2024,S43G01N145,부산 KCC,Home,이근휘,2,0,1,0.0,0,1,0.0,0,2,0.0,2,2,100.0,0,1,1,0,0,0,0,0,0,1
../kbl_data/2023-2024,S43G01N145,부산 KCC,Home,김동현,0,0,0,0.0,0,0,0.0,0,0,0.0,0,0,0.0,0,0,0,0,0,0,0,0,0,0
../kbl_data/2023-2024,S43G01N145,부산 KCC,Home,알리제 드숀 존슨,12,3,5,60.0,1,2,50.0,4,7,57.1,3,4,75.0,1,4,5,0,0,0,0,0,1,3
../kbl_data/2023-2024,S43G01N145,고양 소노,Away,김강선,2,1,1,100.0,0,2,0.0,1,3,33.3,0,0,0.0,0,1,1,1,1,0,0,0,0,5
../kbl_data/2023-2024,S43G01N145,고양 소노,Away,함준후,3,1,1,100.0,0,1,0.0,1,2,50.0,1,2,50.0,0,3,3,0,0,0,0,0,0,1
../kbl_data/2023-2024,S43G01N145,고양 소노,Away,최현민,0,0,0,0.0,0,0,0.0,0,0,0.0,0,0,0.0,0,0,0,0,0,0,0,0,0,0
../kbl_data/2023-2024,S43G01N145,고양 소노,Away,김민욱,18,3,6,50.0,4,9,44.4,7,15,46.7,0,0,0.0,1,5,6,2,2,1,0,0,1,5
../kbl_data/2023-2024,S43G01N145,고양 소노,Away,김진유,0,0,0,0.0,0,0,0.0,0,0,0.0,0,0,0.0,0,1,1,0,0,0,0,0,1,4
../kbl_data/2023-2024,S43G01N145,고양 소노,Away,다후안 서머스,4,2,7,28.6,0,1,0.0,2,8,25.0,0,1,0.0,1,3,4,0,0,0,0,0,1,2
../kbl_data/2023-2024,S43G01N145,고양 소노,Away,치나누 오누아쿠,17,5,8,62.5,1,2,50.0,6,10,60.0,4,4,100.0,3,8,11,5,2,3,0,0,0,2
../kbl_data/2023-2024,S43G01N145,고양 소노,Away,이정현,23,6,12,50.0,2,9,22.2,8,21,38.1,5,5,100.0,0,1,1,8,2,0,0,0,3,4
../kbl_data/2023-2024,S43G01N145,고양 소노,Away,안정욱,0,0,0,0.0,0,0,0.0,0,0,0.0,0,0,0.0,0,0,0,0,0,0,0,0,0,1
../kbl_data/2023-2024,S43G01N145,고양 소노,Away,박종하,7,2,3,66.7,1,4,25.0,3,7,42.9,0,0,0.0,0,0,0,0,2,0,0,0,3,3
../kbl_data/2023-2024,S43G01N145,고양 소노,Away,민기남,0,0,1,0.0,0,0,0.0,0,1,0.0,0,0,0.0,0,0,0,1,0,0,0,0,0,0
../kbl_data/2023-2024,S43G01N145,고양 소노,Away,알렉스 카바노,0,0,0,0.0,0,1,0.0,0,1,0.0,0,0,0.0,0,0,0,0,0,0,0,0,0,0
../kbl_data/2023-2024,S43G01N146,창원 LG,Home,이관희,18,4,7,57.1,2,5,40.0,6,12,50.0,4,4,100.0,0,6,6,1,0,0,0,0,0,0
../kbl_data/2023-2024,S43G01N146,창원 LG,Home,정희재,15,0,1,0.0,5,5,100.0,5,6,83.3,0,0,0.0,0,1,1,2,0,1,0,0,0,3
../kbl_data/2023-2024,S43G01N146,창원 LG,Home,이재도,10,4,6,66.7,0,2,0.0,4,8,50.0,2,2,100.0,0,3,3,8,1,0,0,0,1,2
../kbl_data/2023-2024,S43G01N146,창원 LG,Home,정인덕,0,0,2,0.0,0,2,0.0,0,4,0.0,0,0,0.0,0,0,0,0,0,0,0,0,0,1
../kbl_data/2023-2024,S43G01N146,창원 LG,Home,양홍석,2,1,1,100.0,0,0,0.0,1,1,100.0,0,0,0.0,1,0,1,1,0,0,0,0,1,1
../kbl_data/2023-2024,S43G01N146,창원 LG,Home,박정현,0,0,0,0.0,0,0,0.0,0,0,0.0,0,0,0.0,0,1,1,0,0,0,0,0,0,2
../kbl_data/2023-2024,S43G01N146,창원 LG,Home,아셈 마레이,3,1,2,50.0,0,0,0.0,1,2,50.0,1,3,33.3,1,6,7,3,1,0,1,0,2,2
../kbl_data/2023-2024,S43G01N146,창원 LG,Home,이승우,10,2,2,100.0,1,3,33.3,3,5,60.0,3,3,100.0,0,2,2,1,0,2,0,0,0,2
../kbl_data/2023-2024,S43G01N146,창원 LG,Home,저스틴 구탕,17,4,6,66.7,3,3,100.0,7,9,77.8,0,0,0.0,0,1,1,2,2,0,0,0,2,1
../kbl_data/2023-2024,S43G01N146,창원 LG,Home,양준석,6,3,5,60.0,0,0,0.0,3,5,60.0,0,0,0.0,1,4,5,2,0,0,0,0,0,3
../kbl_data/2023-2024,S43G01N146,창원 LG,Home,유기상,3,0,0,0.0,1,3,33.3,1,3,33.3,0,0,0.0,0,0,0,0,1,0,0,0,0,1
../kbl_data/2023-2024,S43G01N146,창원 LG,Home,후안 텔로,6,3,10,30.0,0,2,0.0,3,12,25.0,0,0,0.0,2,8,10,1,2,1,0,0,4,2
../kbl_data/2023-2024,S43G01N146,울산 현대모비스,Away,함지훈,6,2,8,25.0,0,1,0.0,2,9,22.2,2,3,66.7,4,2,6,1,1,0,0,0,0,2
../kbl_data/2023-2024,S43G01N146,울산 현대모비스,Away,최진수,7,0,3,0.0,2,5,40.0,2,8,25.0,1,1,100.0,1,1,2,1,2,0,0,0,1,1
../kbl_data/2023-2024,S43G01N146,울산 현대모비스,Away,장재석,4,2,4,50.0,0,0,0.0,2,4,50.0,0,2,0.0,2,2,4,2,1,0,0,0,0,1
../kbl_data/2023-2024,S43G01N146,울산 현대모비스,Away,김지완,0,0,1,0.0,0,1,0.0,0,2,0.0,0,0,0.0,0,2,2,0,0,0,0,0,1,4
../kbl_data/2023-2024,S43G01N146,울산 현대모비스,Away,김준일,3,1,2,50.0,0,0,0.0,1,2,50.0,1,2,50.0,0,0,0,0,0,0,0,0,0,1
../kbl_data/2023-2024,S43G01N146,울산 현대모비스,Away,김국찬,3,0,2,0.0,1,3,33.3,1,5,20.0,0,0,0.0,2,3,5,2,1,0,0,0,2,2
../kbl_data/2023-2024,S43G01N146,울산 현대모비스,Away,이우석,7,2,3,66.7,1,2,50.0,3,5,60.0,0,0,0.0,1,4,5,0,0,0,0,0,1,1
../kbl_data/2023-2024,S43G01N146,울산 현대모비스,Away,게이지 프림,21,9,14,64.3,0,2,0.0,9,16,56.2,3,3,100.0,1,5,6,1,1,0,0,0,1,1
../kbl_data/2023-2024,S43G01N146,울산 현대모비스,Away,김태완,2,1,1,100.0,0,0,0.0,1,1,100.0,0,0,0.0,0,0,0,0,0,0,0,0,0,0
../kbl_data/2023-2024,S43G01N146,울산 현대모비스,Away,박무빈,1,0,4,0.0,0,2,0.0,0,6,0.0,1,2,50.0,3,1,4,1,0,0,0,0,1,1
../kbl_data/2023-2024,S43G01N146,울산 현대모비스,Away,케베 알루마,14,5,8,62.5,0,0,0.0,5,8,62.5,4,4,100.0,2,4,6,3,1,1,0,0,1,2
../kbl_data/2023-2024,S43G01N146,울산 현대모비스,Away,미구엘 안드레 옥존,11,4,8,50.0,1,3,33.3,5,11,45.5,0,1,0.0,0,1,1,8,1,0,0,0,3,2
../kbl_data/2023-2024,S43G01N147,원주 DB,Home,박찬희,0,0,0,0.0,0,0,0.0,0,0,0.0,0,0,0.0,0,0,0,0,0,0,0,0,0,0
../kbl_data/2023-2024,S43G01N147,원주 DB,Home,서민수,0,0,0,0.0,0,0,0.0,0,0,0.0,0,0,0.0,0,0,0,0,0,0,0,0,0,0
../kbl_data/2023-2024,S43G01N147,원주 DB,Home,두경민,0,0,0,0.0,0,1,0.0,0,1,0.0,0,0,0.0,0,0,0,1,0,0,0,0,0,0
../kbl_data/2023-2024,S43G01N147,원주 DB,Home,김종규,15,4,6,66.7,1,1,100.0,5,7,71.4,4,6,66.7,5,3,8,0,1,1,0,0,1,4
../kbl_data/2023-2024,S43G01N147,원주 DB,Home,최승욱,4,2,4,50.0,0,1,0.0,2,5,40.0,0,0,0.0,0,0,0,2,0,0,0,0,0,3
../kbl_data/2023-2024,S43G01N147,원주 DB,Home,강상재,12,3,5,60.0,2,7,28.6,5,12,41.7,0,0,0.0,2,2,4,6,1,1,0,0,3,2
../kbl_data/2023-2024,S43G01N147,원주 DB,Home,김훈,0,0,0,0.0,0,0,0.0,0,0,0.0,0,0,0.0,0,0,0,0,0,0,0,0,0,0
../kbl_data/2023-2024,S43G01N147,원주 DB,Home,디드릭 로슨,14,5,9,55.6,1,4,25.0,6,13,46.2,1,4,25.0,1,7,8,2,2,1,0,0,2,4
../kbl_data/2023-2024,S43G01N147,원주 DB,Home,이용우,0,0,0,0.0,0,0,0.0,0,0,0.0,0,0,0.0,0,0,0,0,0,0,0,0,0,0
../kbl_data/2023-2024,S43G01N147,원주 DB,Home,이선 알바노,18,5,8,62.5,2,9,22.2,7,17,41.2,2,2,100.0,0,3,3,9,4,0,0,0,1,2
../kbl_data/2023-2024,S43G01N147,원주 DB,Home,박인웅,25,5,5,100.0,5,9,55.6,10,14,71.4,0,1,0.0,0,2,2,1,1,0,1,0,0,2
../kbl_data/2023-2024,S43G01N147,원주 DB,Home,제프 위디,6,3,3,100.0,0,0,0.0,3,3,100.0,0,0,0.0,0,2,2,0,0,0,0,2,1,0
../kbl_data/2023-2024,S43G01N147,수원 KT,Away,한희원,7,2,4,50.0,1,2,50.0,3,6,50.0,0,0,0.0,1,2,3,1,0,0,1,0,1,4
../kbl_data/2023-2024,S43G01N147,수원 KT,Away,문성곤,3,0,0,0.0,1,5,20.0,1,5,20.0,0,0,0.0,1,1,2,1,0,0,0,0,0,0
../kbl_data/2023-2024,S43G01N147,수원 KT,Away,이현석,0,0,0,0.0,0,0,0.0,0,0,0.0,0,0,0.0,0,0,0,0,0,0,0,0,1,1
../kbl_data/2023-2024,S43G01N147,수원 KT,Away,정성우,0,0,1,0.0,0,0,0.0,0,1,0.0,0,0,0.0,0,1,1,0,0,0,0,0,0,1
../kbl_data/2023-2024,S43G01N147,수원 KT,Away,최성모,0,0,0,0.0,0,0,0.0,0,0,0.0,0,0,0.0,0,0,0,0,0,0,0,0,0,0
../kbl_data/2023-2024,S43G01N147,수원 KT,Away,허훈,4,2,4,50.0,0,4,0.0,2,8,25.0,0,0,0.0,0,3,3,6,1,0,0,0,4,4
../kbl_data/2023-2024,S43G01N147,수원 KT,Away,이윤기,12,0,0,0.0,4,5,80.0,4,5,80.0,0,0,0.0,0,2,2,0,1,0,1,0,2,2
../kbl_data/2023-2024,S43G01N147,수원 KT,Away,하윤기,28,13,17,76.5,0,1,0.0,13,18,72.2,2,3,66.7,8,8,16,1,0,0,0,0,2,2
../kbl_data/2023-2024,S43G01N147,수원 KT,Away,이두원,0,0,0,0.0,0,0,0.0,0,0,0.0,0,0,0.0,0,0,0,0,0,0,0,0,0,1
../kbl_data/2023-2024,S43G01N147,수원 KT,Away,문정현,2,1,2,50.0,0,2,0.0,1,4,25.0,0,0,0.0,1,0,1,2,0,0,0,0,0,2
../kbl_data/2023-2024,S43G01N147,수원 KT,Away,마이클 에릭,0,0,0,0.0,0,0,0.0,0,0,0.0,0,0,0.0,0,0,0,0,0,0,0,0,0,0
../kbl_data/2023-2024,S43G01N147,수원 KT,Away,패리스 배스,30,11,27,40.7,1,5,20.0,12,32,37.5,5,7,71.4,7,11,18,9,2,0,0,0,4,4
../kbl_data/2023-2024,S43G01N148,대구 한국가스공사,Home,김동량,2,0,0,0.0,0,0,0.0,0,0,0.0,2,2,100.0,0,0,0,0,0,1,0,0,1,1
../kbl_data/2023-2024,S43G01N148,대구 한국가스공사,Home,차바위,8,1,1,100.0,1,2,50.0,2,3,66.7,3,3,100.0,2,6,8,1,2,0,1,0,3,2
../kbl_data/2023-2024,S43G01N148,대구 한국가스공사,Home,박지훈,0,0,0,0.0,0,2,0.0,0,2,0.0,0,0,0.0,1,1,2,0,0,0,0,0,0,1
../kbl_data/2023-2024,S43G01N148,대구 한국가스공사,Home,조상열,1,0,0,0.0,0,2,0.0,0,2,0.0,1,2,50.0,0,1,1,0,1,0,0,0,1,1
../kbl_data/2023-2024,S43G01N148,대구 한국가스공사,Home,이대헌,2,1,5,20.0,0,0,0.0,1,5,20.0,0,2,0.0,3,5,8,0,0,0,0,0,2,1
../kbl_data/2023-2024,S43G01N148,대구 한국가스공사,Home,박봉진,0,0,0,0.0,0,0,0.0,0,0,0.0,0,0,0.0,0,0,0,0,0,0,0,0,0,0
../kbl_data/2023-2024,S43G01N148,대구 한국가스공사,Home,김낙현,25,3,7,42.9,5,9,55.6,8,16,50.0,4,6,66.7,0,3,3,5,1,0,0,0,0,1
../kbl_data/2023-2024,S43G01N148,대구 한국가스공사,Home,양준우,0,0,0,0.0,0,1,0.0,0,1,0.0,0,0,0.0,0,0,0,0,0,0,0,0,0,1
../kbl_data/2023-2024,S43G01N148,대구 한국가스공사,Home,앤드류 니콜슨,31,11,16,68.8,2,6,33.3,13,22,59.1,3,3,100.0,0,8,8,1,0,0,0,0,0,0
../kbl_data/2023-2024,S43G01N148,대구 한국가스공사,Home,신승민,2,1,2,50.0,0,2,0.0,1,4,25.0,0,0,0.0,1,4,5,4,0,0,0,0,0,4
../kbl_data/2023-2024,S43G01N148,대구 한국가스공사,Home,샘조세프 벨란겔,4,2,2,100.0,0,2,0.0,2,4,50.0,0,0,0.0,0,2,2,1,0,0,0,0,2,4
../kbl_data/2023-2024,S43G01N148,대구 한국가스공사,Home,듀반 맥스웰,2,0,0,0.0,0,0,0.0,0,0,0.0,2,2,100.0,0,1,1,0,0,0,0,0,2,2
../kbl_data/2023-2024,S43G01N148,서울 삼성,Away,이정현,11,2,3,66.7,2,8,25.0,4,11,36.4,1,1,100.0,0,4,4,2,0,0,0,0,1,2
../kbl_data/2023-2024,S43G01N148,서울 삼성,Away,홍경기,0,0,0,0.0,0,0,0.0,0,0,0.0,0,0,0.0,0,0,0,1,0,0,0,0,0,0
../kbl_data/2023-2024,S43G01N148,서울 삼성,Away,김승원,0,0,0,0.0,0,0,0.0,0,0,0.0,0,0,0.0,0,0,0,0,0,0,0,0,0,0
../kbl_data/2023-2024,S43G01N148,서울 삼성,Away,김시래,12,3,4,75.0,1,5,20.0,4,9,44.4,3,3,100.0,0,2,2,6,1,0,0,0,1,3
../kbl_data/2023-2024,S43G01N148,서울 삼성,Away,이동엽,2,1,3,33.3,0,0,0.0,1,3,33.3,0,0,0.0,1,1,2,0,0,0,0,0,0,2
../kbl_data/2023-2024,S43G01N148,서울 삼성,Away,최승욱,6,3,7,42.9,0,1,0.0,3,8,37.5,0,0,0.0,1,1,2,0,2,0,0,0,0,0
../kbl_data/2023-2024,S43G01N148,서울 삼성,Away,윤성원,2,1,2,50.0,0,1,0.0,1,3,33.3,0,0,0.0,0,4,4,1,1,0,0,0,1,5
../kbl_data/2023-2024,S43G01N148,서울 삼성,Away,김한솔,4,2,6,33.3,0,0,0.0,2,6,33.3,0,0,0.0,1,0,1,0,0,0,0,0,0,0
../kbl_data/2023-2024,S43G01N148,서울 삼성,Away,조우성,0,0,0,0.0,0,0,0.0,0,0,0.0,0,0,0.0,0,0,0,0,0,0,0,0,0,1
../kbl_data/2023-2024,S43G01N148,서울 삼성,Away,신동혁,10,3,5,60.0,1,5,20.0,4,10,40.0,1,1,100.0,0,1,1,0,1,0,0,0,0,3
../kbl_data/2023-2024,S43G01N148,서울 삼성,Away,조준희,0,0,0,0.0,0,2,0.0,0,2,0.0,0,0,0.0,0,0,0,0,1,0,0,0,0,1
../kbl_data/2023-2024,S43G01N148,서울 삼성,Away,이스마엘 레인,24,11,17,64.7,0,4,0.0,11,21,52.4,2,2,100.0,4,9,13,1,1,0,0,0,3,4
../kbl_data/2023-2024,S43G01N149,창원 LG,Home,이관희,10,0,3,0.0,3,7,42.9,3,10,30.0,1,2,50.0,0,1,1,2,0,0,0,0,1,0
../kbl_data/2023-2024,S43G01N149,창원 LG,Home,정희재,5,0,2,0.0,1,6,16.7,1,8,12.5,2,2,100.0,4,1,5,0,0,0,0,0,0,2
../kbl_data/2023-2024,S43G01N149,창원 LG,Home,이재도,2,1,4,25.0,0,1,0.0,1,5,20.0,0,0,0.0,1,0,1,2,0,0,0,0,2,1
../kbl_data/2023-2024,S43G01N149,창원 LG,Home,정인덕,5,2,2,100.0,0,2,0.0,2,4,50.0,1,2,50.0,0,0,0,1,0,0,0,0,0,2
../kbl_data/2023-2024,S43G01N149,창원 LG,Home,양홍석,7,2,4,50.0,1,2,50.0,3,6,50.0,0,0,0.0,0,0,0,2,0,0,0,0,2,2
../kbl_data/2023-2024,S43G01N149,창원 LG,Home,박정현,0,0,0,0.0,0,0,0.0,0,0,0.0,0,0,0.0,0,0,0,0,0,0,0,0,0,0
../kbl_data/2023-2024,S43G01N149,창원 LG,Home,아셈 마레이,8,3,8,37.5,0,0,0.0,3,8,37.5,2,4,50.0,7,15,22,3,2,0,0,0,1,2
../kbl_data/2023-2024,S43G01N149,창원 LG,Home,이승우,0,0,1,0.0,0,1,0.0,0,2,0.0,0,0,0.0,0,0,0,1,0,0,0,0,0,0
../kbl_data/2023-2024,S43G01N149,창원 LG,Home,저스틴 구탕,2,1,2,50.0,0,1,0.0,1,3,33.3,0,0,0.0,0,1,1,2,0,0,0,0,0,3
../kbl_data/2023-2024,S43G01N149,창원 LG,Home,양준석,11,3,5,60.0,1,3,33.3,4,8,50.0,2,2,100.0,0,1,1,0,2,0,0,0,0,1
../kbl_data/2023-2024,S43G01N149,창원 LG,Home,유기상,5,0,2,0.0,1,5,20.0,1,7,14.3,2,2,100.0,1,1,2,1,1,1,0,0,1,2
../kbl_data/2023-2024,S43G01N149,창원 LG,Home,후안 텔로,2,1,2,50.0,0,2,0.0,1,4,25.0,0,0,0.0,0,4,4,0,1,0,0,0,0,2
../kbl_data/2023-2024,S43G01N149,서울 SK,Away,양우섭,2,1,1,100.0,0,0,0.0,1,1,100.0,0,0,0.0,1,0,1,0,0,1,0,0,1,1
../kbl_data/2023-2024,S43G01N149,서울 SK,Away,송창용,2,1,2,50.0,0,1,0.0,1,3,33.3,0,0,0.0,1,0,1,2,0,0,0,0,0,0
../kbl_data/2023-2024,S43G01N149,서울 SK,Away,김선형,2,1,2,50.0,0,1,0.0,1,3,33.3,0,2,0.0,0,1,1,0,0,0,0,0,2,0
../kbl_data/2023-2024,S43G01N149,서울 SK,Away,오세근,6,3,7,42.9,0,1,0.0,3,8,37.5,0,0,0.0,6,6,12,2,0,0,0,0,1,0
../kbl_data/2023-2024,S43G01N149,서울 SK,Away,최부경,2,1,3,33.3,0,0,0.0,1,3,33.3,0,0,0.0,4,2,6,0,2,1,0,0,1,2
../kbl_data/2023-2024,S43G01N149,서울 SK,Away,리온 윌리엄스,0,0,1,0.0,0,0,0.0,0,1,0.0,0,0,0.0,0,2,2,0,0,0,0,0,1,2
../kbl_data/2023-2024,S43G01N149,서울 SK,Away,최원혁,3,0,2,0.0,1,3,33.3,1,5,20.0,0,0,0.0,1,3,4,1,0,0,0,0,1,3
../kbl_data/2023-2024,S43G01N149,서울 SK,Away,안영준,16,3,5,60.0,3,8,37.5,6,13,46.2,1,3,33.3,1,5,6,0,0,1,0,0,1,4
../kbl_data/2023-2024,S43G01N149,서울 SK,Away,자밀 워니,19,8,15,53.3,1,6,16.7,9,21,42.9,0,0,0.0,1,5,6,3,1,4,1,1,0,1
../kbl_data/2023-2024,S43G01N149,서울 SK,Away,오재현,12,2,8,25.0,2,4,50.0,4,12,33.3,2,2,100.0,0,4,4,6,1,0,0,0,1,4
../kbl_data/2023-2024,S43G01N149,서울 SK,Away,김건우,0,0,0,0.0,0,0,0.0,0,0,0.0,0,0,0.0,0,0,0,0,0,0,0,0,0,0
../kbl_data/2023-2024,S43G01N149,서울 SK,Away,고메즈 딜 리아노,0,0,0,0.0,0,0,0.0,0,0,0.0,0,0,0.0,0,0,0,0,0,0,0,0,0,0
../kbl_data/2023-2024,S43G01N150,부산 KCC,Home,정창영,0,0,1,0.0,0,0,0.0,0,1,0.0,0,0,0.0,0,0,0,0,0,0,0,0,0,2
../kbl_data/2023-2024,S43G01N150,부산 KCC,Home,라건아,17,7,11,63.6,0,1,0.0,7,12,58.3,3,3,100.0,5,8,13,1,1,0,0,0,2,4
../kbl_data/2023-2024,S43G01N150,부산 KCC,Home,전준범,0,0,0,0.0,0,0,0.0,0,0,0.0,0,0,0.0,0,0,0,0,0,0,0,0,0,1
../kbl_data/2023-2024,S43G01N150,부산 KCC,Home,허웅,9,3,3,100.0,0,1,0.0,3,4,75.0,3,4,75.0,0,0,0,1,2,0,0,0,4,3
../kbl_data/2023-2024,S43G01N150,부산 KCC,Home,이승현,3,0,2,0.0,1,3,33.3,1,5,20.0,0,0,0.0,3,3,6,2,0,0,0,0,1,0
../kbl_data/2023-2024,S43G01N150,부산 KCC,Home,이호현,15,3,6,50.0,3,5,60.0,6,11,54.5,0,0,0.0,0,2,2,6,0,0,0,0,2,1
../kbl_data/2023-2024,S43G01N150,부산 KCC,Home,송교창,13,3,7,42.9,2,3,66.7,5,10,50.0,1,2,50.0,1,5,6,4,1,1,0,1,1,2
../kbl_data/2023-2024,S43G01N150,부산 KCC,Home,최준용,16,4,10,40.0,2,5,40.0,6,15,40.0,2,2,100.0,0,2,2,2,0,0,0,1,0,2
../kbl_data/2023-2024,S43G01N150,부산 KCC,Home,곽정훈,0,0,0,0.0,0,0,0.0,0,0,0.0,0,0,0.0,0,0,0,0,0,0,0,0,0,0
../kbl_data/2023-2024,S43G01N150,부산 KCC,Home,이근휘,3,0,0,0.0,1,2,50.0,1,2,50.0,0,0,0.0,0,1,1,1,0,0,0,0,0,3
../kbl_data/2023-2024,S43G01N150,부산 KCC,Home,김동현,0,0,0,0.0,0,0,0.0,0,0,0.0,0,0,0.0,0,0,0,0,0,0,0,0,0,0
../kbl_data/2023-2024,S43G01N150,부산 KCC,Home,알리제 드숀 존슨,15,6,8,75.0,1,2,50.0,7,10,70.0,0,0,0.0,1,4,5,1,1,0,0,1,0,2
../kbl_data/2023-2024,S43G01N150,울산 현대모비스,Away,함지훈,11,3,6,50.0,0,1,0.0,3,7,42.9,5,6,83.3,4,2,6,1,1,2,0,0,0,1
../kbl_data/2023-2024,S43G01N150,울산 현대모비스,Away,최진수,0,0,0,0.0,0,0,0.0,0,0,0.0,0,0,0.0,0,0,0,0,0,0,0,0,0,0
../kbl_data/2023-2024,S43G01N150,울산 현대모비스,Away,김현수,0,0,0,0.0,0,0,0.0,0,0,0.0,0,0,0.0,0,0,0,0,0,0,0,0,0,0
../kbl_data/2023-2024,S43G01N150,울산 현대모비스,Away,장재석,12,5,8,62.5,0,0,0.0,5,8,62.5,2,4,50.0,1,1,2,1,0,0,0,2,0,3
../kbl_data/2023-2024,S43G01N150,울산 현대모비스,Away,김지완,2,1,2,50.0,0,1,0.0,1,3,33.3,0,0,0.0,0,1,1,1,1,0,0,0,0,1
../kbl_data/2023-2024,S43G01N150,울산 현대모비스,Away,김준일,0,0,0,0.0,0,0,0.0,0,0,0.0,0,0,0.0,0,0,0,0,0,0,0,0,0,0
../kbl_data/2023-2024,S43G01N150,울산 현대모비스,Away,김국찬,10,0,0,0.0,2,7,28.6,2,7,28.6,4,5,80.0,2,4,6,1,0,0,0,0,2,3
../kbl_data/2023-2024,S43G01N150,울산 현대모비스,Away,이우석,14,7,8,87.5,0,6,0.0,7,14,50.0,0,0,0.0,2,6,8,3,3,0,0,0,0,2
../kbl_data/2023-2024,S43G01N150,울산 현대모비스,Away,게이지 프림,17,8,18,44.4,0,2,0.0,8,20,40.0,1,2,50.0,4,6,10,5,0,1,0,0,5,4
../kbl_data/2023-2024,S43G01N150,울산 현대모비스,Away,박무빈,9,3,3,100.0,1,2,50.0,4,5,80.0,0,0,0.0,1,0,1,1,0,0,0,0,0,1
../kbl_data/2023-2024,S43G01N150,울산 현대모비스,Away,케베 알루마,6,2,4,50.0,0,1,0.0,2,5,40.0,2,2,100.0,1,1,2,2,0,0,0,0,0,0
../kbl_data/2023-2024,S43G01N150,울산 현대모비스,Away,미구엘 안드레 옥존,5,2,4,50.0,0,3,0.0,2,7,28.6,1,1,100.0,1,1,2,6,0,0,0,0,1,1
../kbl_data/2023-2024,S43G01N151,부산 KCC,Home,정창영,4,1,2,50.0,0,0,0.0,1,2,50.0,2,2,100.0,1,4,5,4,0,0,0,0,0,3
../kbl_data/2023-2024,S43G01N151,부산 KCC,Home,라건아,29,12,18,66.7,0,1,0.0,12,19,63.2,5,8,62.5,6,9,15,6,1,1,0,0,4,3
../kbl_data/2023-2024,S43G01N151,부산 KCC,Home,전준범,8,1,1,100.0,2,3,66.7,3,4,75.0,0,0,0.0,0,0,0,0,0,0,0,0,0,3
../kbl_data/2023-2024,S43G01N151,부산 KCC,Home,허웅,22,3,5,60.0,3,9,33.3,6,14,42.9,7,7,100.0,0,2,2,4,1,0,0,0,2,3
../kbl_data/2023-2024,S43G01N151,부산 KCC,Home,이승현,0,0,0,0.0,0,0,0.0,0,0,0.0,0,0,0.0,0,1,1,0,0,0,0,0,0,0
../kbl_data/2023-2024,S43G01N151,부산 KCC,Home,이호현,12,2,3,66.7,1,2,50.0,3,5,60.0,5,5,100.0,0,2,2,4,1,0,1,0,1,3
../kbl_data/2023-2024,S43G01N151,부산 KCC,Home,송교창,0,0,0,0.0,0,0,0.0,0,0,0.0,0,0,0.0,0,0,0,0,0,0,0,0,0,0
../kbl_data/2023-2024,S43G01N151,부산 KCC,Home,최준용,15,3,7,42.9,3,7,42.9,6,14,42.9,0,0,0.0,0,8,8,6,0,1,0,0,2,2
../kbl_data/2023-2024,S43G01N151,부산 KCC,Home,곽정훈,0,0,0,0.0,0,0,0.0,0,0,0.0,0,0,0.0,0,0,0,0,0,0,0,0,0,0
../kbl_data/2023-2024,S43G01N151,부산 KCC,Home,이근휘,0,0,0,0.0,0,1,0.0,0,1,0.0,0,0,0.0,1,0,1,0,0,0,0,0,0,0
../kbl_data/2023-2024,S43G01N151,부산 KCC,Home,김동현,0,0,0,0.0,0,0,0.0,0,0,0.0,0,0,0.0,0,0,0,0,0,0,0,0,0,0
../kbl_data/2023-2024,S43G01N151,부산 KCC,Home,알리제 드숀 존슨,0,0,0,0.0,0,0,0.0,0,0,0.0,0,0,0.0,0,0,0,0,0,0,0,0,0,0
../kbl_data/2023-2024,S43G01N151,서울 SK,Away,양우섭,0,0,1,0.0,0,0,0.0,0,1,0.0,0,0,0.0,1,0,1,2,0,0,0,0,1,0
../kbl_data/2023-2024,S43G01N151,서울 SK,Away,송창용,3,0,0,0.0,1,2,50.0,1,2,50.0,0,2,0.0,1,0,1,1,1,0,0,0,0,2
../kbl_data/2023-2024,S43G01N151,서울 SK,Away,김선형,0,0,0,0.0,0,0,0.0,0,0,0.0,0,0,0.0,0,0,0,0,0,0,0,0,0,0
../kbl_data/2023-2024,S43G01N151,서울 SK,Away,오세근,4,2,4,50.0,0,2,0.0,2,6,33.3,0,0,0.0,0,1,1,1,0,0,0,0,0,2
../kbl_data/2023-2024,S43G01N151,서울 SK,Away,최부경,10,5,11,45.5,0,0,0.0,5,11,45.5,0,0,0.0,4,4,8,1,0,1,1,0,1,5
../kbl_data/2023-2024,S43G01N151,서울 SK,Away,리온 윌리엄스,0,0,0,0.0,0,0,0.0,0,0,0.0,0,0,0.0,0,0,0,0,0,0,0,0,0,0
../kbl_data/2023-2024,S43G01N151,서울 SK,Away,최원혁,2,1,3,33.3,0,3,0.0,1,6,16.7,0,0,0.0,5,0,5,6,1,0,0,0,0,4
../kbl_data/2023-2024,S43G01N151,서울 SK,Away,안영준,16,4,7,57.1,2,5,40.0,6,12,50.0,2,4,50.0,1,7,8,3,1,0,0,0,1,3
../kbl_data/2023-2024,S43G01N151,서울 SK,Away,자밀 워니,35,13,26,50.0,2,6,33.3,15,32,46.9,3,5,60.0,2,8,10,3,1,0,0,0,1,1
../kbl_data/2023-2024,S43G01N151,서울 SK,Away,오재현,3,1,1,100.0,0,1,0.0,1,2,50.0,1,2,50.0,1,0,1,3,1,0,0,0,0,2
../kbl_data/2023-2024,S43G01N151,서울 SK,Away,김건우,0,0,0,0.0,0,0,0.0,0,0,0.0,0,0,0.0,0,0,0,0,0,0,0,0,0,0
../kbl_data/2023-2024,S43G01N151,서울 SK,Away,고메즈 딜 리아노,2,1,3,33.3,0,1,0.0,1,4,25.0,0,0,0.0,1,1,2,1,0,1,0,0,1,3
../kbl_data/2023-2024,S43G01N152,부산 KCC,Home,정창영,13,2,2,100.0,3,4,75.0,5,6,83.3,0,0,0.0,1,1,2,2,0,0,1,0,0,1
../kbl_data/2023-2024,S43G01N152,부산 KCC,Home,라건아,28,12,18,66.7,1,4,25.0,13,22,59.1,1,2,50.0,7,8,15,5,0,0,0,0,5,1
../kbl_data/2023-2024,S43G01N152,부산 KCC,Home,전준범,0,0,0,0.0,0,0,0.0,0,0,0.0,0,0,0.0,0,0,0,0,0,0,0,0,0,0
../kbl_data/2023-2024,S43G01N152,부산 KCC,Home,허웅,14,3,7,42.9,0,4,0.0,3,11,27.3,8,9,88.9,0,5,5,4,0,0,1,0,2,4
../kbl_data/2023-2024,S43G01N152,부산 KCC,Home,이승현,3,1,6,16.7,0,0,0.0,1,6,16.7,1,1,100.0,0,1,1,0,0,0,0,0,0,0
../kbl_data/2023-2024,S43G01N152,부산 KCC,Home,이호현,11,4,6,66.7,1,3,33.3,5,9,55.6,0,0,0.0,3,2,5,2,0,0,2,0,2,3
../kbl_data/2023-2024,S43G01N152,부산 KCC,Home,최준용,9,1,5,20.0,1,6,16.7,2,11,18.2,4,6,66.7,1,7,8,7,4,1,0,0,2,4
../kbl_data/2023-2024,S43G01N152,부산 KCC,Home,이진욱,0,0,0,0.0,0,0,0.0,0,0,0.0,0,0,0.0,0,0,0,0,0,0,0,0,0,0
../kbl_data/2023-2024,S43G01N152,부산 KCC,Home,곽정훈,0,0,0,0.0,0,0,0.0,0,0,0.0,0,0,0.0,0,0,0,0,0,0,0,0,0,0
../kbl_data/2023-2024,S43G01N152,부산 KCC,Home,이근휘,6,0,0,0.0,2,4,50.0,2,4,50.0,0,0,0.0,0,1,1,0,0,0,0,0,0,2
../kbl_data/2023-2024,S43G01N152,부산 KCC,Home,김동현,0,0,0,0.0,0,0,0.0,0,0,0.0,0,0,0.0,0,0,0,0,0,0,0,0,0,0
../kbl_data/2023-2024,S43G01N152,부산 KCC,Home,알리제 드숀 존슨,0,0,2,0.0,0,0,0.0,0,2,0.0,0,0,0.0,0,1,1,0,0,0,0,0,0,1
../kbl_data/2023-2024,S43G01N152,원주 DB,Away,박찬희,0,0,0,0.0,0,0,0.0,0,0,0.0,0,0,0.0,0,0,0,0,0,0,0,0,0,0
../kbl_data/2023-2024,S43G01N152,원주 DB,Away,서민수,2,1,1,100.0,0,0,0.0,1,1,100.0,0,0,0.0,0,0,0,0,0,0,0,0,0,0
../kbl_data/2023-2024,S43G01N152,원주 DB,Away,김영현,6,0,1,0.0,2,5,40.0,2,6,33.3,0,0,0.0,0,1,1,2,1,0,1,0,0,4
../kbl_data/2023-2024,S43G01N152,원주 DB,Away,김종규,12,6,8,75.0,0,0,0.0,6,8,75.0,0,0,0.0,8,2,10,2,1,2,0,2,3,4
../kbl_data/2023-2024,S43G01N152,원주 DB,Away,최승욱,0,0,0,0.0,0,2,0.0,0,2,0.0,0,0,0.0,3,0,3,0,0,0,0,0,0,2
../kbl_data/2023-2024,S43G01N152,원주 DB,Away,강상재,9,1,5,20.0,2,5,40.0,3,10,30.0,1,2,50.0,0,5,5,1,2,1,0,0,5,3
../kbl_data/2023-2024,S43G01N152,원주 DB,Away,김훈,0,0,0,0.0,0,0,0.0,0,0,0.0,0,0,0.0,0,0,0,0,0,0,0,0,0,0
../kbl_data/2023-2024,S43G01N152,원주 DB,Away,디드릭 로슨,24,9,15,60.0,1,10,10.0,10,25,40.0,3,4,75.0,5,13,18,5,1,0,0,1,2,3
../kbl_data/2023-2024,S43G01N152,원주 DB,Away,이용우,0,0,0,0.0,0,0,0.0,0,0,0.0,0,0,0.0,0,0,0,0,0,0,0,0,0,0
../kbl_data/2023-2024,S43G01N152,원주 DB,Away,이선 알바노,17,5,11,45.5,2,5,40.0,7,16,43.8,1,2,50.0,0,2,2,3,1,0,0,0,1,2
../kbl_data/2023-2024,S43G01N152,원주 DB,Away,박인웅,13,2,5,40.0,3,4,75.0,5,9,55.6,0,0,0.0,0,1,1,3,1,0,0,0,0,2
../kbl_data/2023-2024,S43G01N152,원주 DB,Away,제프 위디,4,2,2,100.0,0,0,0.0,2,2,100.0,0,0,0.0,1,2,3,1,1,0,0,0,0,0
../kbl_data/2023-2024,S43G01N153,고양 소노,Home,김강선,0,0,0,0.0,0,1,0.0,0,1,0.0,0,0,0.0,0,1,1,0,0,0,0,0,0,0
../kbl_data/2023-2024,S43G01N153,고양 소노,Home,함준후,0,0,0,0.0,0,0,0.0,0,0,0.0,0,0,0.0,0,0,0,0,0,0,0,0,0,0
../kbl_data/2023-2024,S43G01N153,고양 소노,Home,최현민,13,0,2,0.0,3,6,50.0,3,8,37.5,4,4,100.0,3,0,3,2,0,0,0,0,1,2
../kbl_data/2023-2024,S43G01N153,고양 소노,Home,김민욱,9,3,3,100.0,1,6,16.7,4,9,44.4,0,0,0.0,1,3,4,1,3,0,0,0,1,4
../kbl_data/2023-2024,S43G01N153,고양 소노,Home,김진유,4,2,3,66.7,0,2,0.0,2,5,40.0,0,0,0.0,1,7,8,1,0,1,1,0,1,3
../kbl_data/2023-2024,S43G01N153,고양 소노,Home,다후안 서머스,6,2,3,66.7,0,2,0.0,2,5,40.0,2,2,100.0,0,1,1,0,0,0,0,0,1,1
../kbl_data/2023-2024,S43G01N153,고양 소노,Home,치나누 오누아쿠,22,10,15,66.7,0,2,0.0,10,17,58.8,2,5,40.0,7,8,15,6,1,3,0,1,1,3
../kbl_data/2023-2024,S43G01N153,고양 소노,Home,이정현,32,4,11,36.4,7,11,63.6,11,22,50.0,3,4,75.0,1,3,4,12,1,0,0,0,4,3
../kbl_data/2023-2024,S43G01N153,고양 소노,Home,조은후,0,0,0,0.0,0,1,0.0,0,1,0.0,0,0,0.0,0,0,0,0,0,0,0,0,1,2
../kbl_data/2023-2024,S43G01N153,고양 소노,Home,조재우,0,0,0,0.0,0,0,0.0,0,0,0.0,0,0,0.0,0,0,0,0,0,0,0,0,0,0
../kbl_data/2023-2024,S43G01N153,고양 소노,Home,박종하,7,2,2,100.0,1,4,25.0,3,6,50.0,0,0,0.0,2,0,2,3,0,0,0,0,0,4
../kbl_data/2023-2024,S43G01N153,고양 소노,Home,알렉스 카바노,0,0,0,0.0,0,0,0.0,0,0,0.0,0,0,0.0,0,0,0,0,0,0,0,0,0,0
../kbl_data/2023-2024,S43G01N153,안양 정관장,Away,정준원,8,1,3,33.3,2,4,50.0,3,7,42.9,0,0,0.0,2,1,3,1,0,1,0,0,2,3
../kbl_data/2023-2024,S43G01N153,안양 정관장,Away,김상규,0,0,2,0.0,0,0,0.0,0,2,0.0,0,0,0.0,0,0,0,0,0,0,0,0,0,0
../kbl_data/2023-2024,S43G01N153,안양 정관장,Away,배병준,11,1,1,100.0,3,5,60.0,4,6,66.7,0,0,0.0,1,3,4,1,1,1,0,0,0,2
../kbl_data/2023-2024,S43G01N153,안양 정관장,Away,이종현,11,3,4,75.0,1,2,50.0,4,6,66.7,2,4,50.0,2,6,8,2,1,0,0,0,1,2
../kbl_data/2023-2024,S43G01N153,안양 정관장,Away,김철욱,0,0,0,0.0,0,0,0.0,0,0,0.0,0,0,0.0,0,0,0,0,0,0,1,0,0,1
../kbl_data/2023-2024,S43G01N153,안양 정관장,Away,박지훈,6,3,4,75.0,0,4,0.0,3,8,37.5,0,0,0.0,0,1,1,5,1,0,1,0,0,4
../kbl_data/2023-2024,S43G01N153,안양 정관장,Away,최성원,18,2,4,50.0,4,7,57.1,6,11,54.5,2,2,100.0,0,1,1,4,1,0,0,0,2,3
../kbl_data/2023-2024,S43G01N153,안양 정관장,Away,이우정,0,0,0,0.0,0,0,0.0,0,0,0.0,0,0,0.0,0,0,0,0,0,0,0,0,0,0
../kbl_data/2023-2024,S43G01N153,안양 정관장,Away,장태빈,0,0,0,0.0,0,0,0.0,0,0,0.0,0,0,0.0,0,0,0,0,0,0,0,0,0,0
../kbl_data/2023-2024,S43G01N153,안양 정관장,Away,고찬혁,0,0,0,0.0,0,0,0.0,0,0,0.0,0,0,0.0,0,0,0,0,0,0,0,0,0,0
../kbl_data/2023-2024,S43G01N153,안양 정관장,Away,표승빈,0,0,0,0.0,0,0,0.0,0,0,0.0,0,0,0.0,0,0,0,0,0,0,0,0,0,0
../kbl_data/2023-2024,S43G01N153,안양 정관장,Away,로버트 카터,32,11,16,68.8,2,7,28.6,13,23,56.5,4,9,44.4,2,6,8,2,3,0,0,0,4,3
../kbl_data/2023-2024,S43G01N154,대구 한국가스공사,Home,김동량,0,0,0,0.0,0,0,0.0,0,0,0.0,0,0,0.0,1,0,1,0,0,0,0,0,0,2
../kbl_data/2023-2024,S43G01N154,대구 한국가스공사,Home,차바위,13,2,2,100.0,2,4,50.0,4,6,66.7,3,3,100.0,2,4,6,1,0,1,0,0,2,3
../kbl_data/2023-2024,S43G01N154,대구 한국가스공사,Home,박지훈,3,0,2,0.0,1,3,33.3,1,5,20.0,0,0,0.0,1,1,2,0,2,0,0,0,1,5
../kbl_data/2023-2024,S43G01N154,대구 한국가스공사,Home,조상열,3,0,0,0.0,0,2,0.0,0,2,0.0,3,4,75.0,1,0,1,1,0,0,0,0,1,0
../kbl_data/2023-2024,S43G01N154,대구 한국가스공사,Home,이대헌,5,2,5,40.0,0,0,0.0,2,5,40.0,1,4,25.0,2,5,7,1,0,0,0,0,2,1
../kbl_data/2023-2024,S43G01N154,대구 한국가스공사,Home,박봉진,0,0,0,0.0,0,0,0.0,0,0,0.0,0,0,0.0,0,0,0,0,0,0,0,0,0,0
../kbl_data/2023-2024,S43G01N154,대구 한국가스공사,Home,김낙현,15,3,7,42.9,3,6,50.0,6,13,46.2,0,0,0.0,0,2,2,5,2,0,0,0,0,2
../kbl_data/2023-2024,S43G01N154,대구 한국가스공사,Home,양준우,0,0,0,0.0,0,0,0.0,0,0,0.0,0,0,0.0,0,0,0,0,0,0,0,0,0,0
../kbl_data/2023-2024,S43G01N154,대구 한국가스공사,Home,앤드류 니콜슨,19,4,12,33.3,2,5,40.0,6,17,35.3,5,7,71.4,3,9,12,2,2,0,0,1,4,3
../kbl_data/2023-2024,S43G01N154,대구 한국가스공사,Home,신승민,2,1,2,50.0,0,0,0.0,1,2,50.0,0,0,0.0,1,3,4,0,0,0,1,0,0,4
../kbl_data/2023-2024,S43G01N154,대구 한국가스공사,Home,샘조세프 벨란겔,6,2,4,50.0,0,4,0.0,2,8,25.0,2,2,100.0,0,4,4,1,0,0,0,0,0,0
../kbl_data/2023-2024,S43G01N154,대구 한국가스공사,Home,듀반 맥스웰,14,6,9,66.7,0,0,0.0,6,9,66.7,2,6,33.3,1,4,5,1,0,0,0,0,1,2
../kbl_data/2023-2024,S43G01N154,수원 KT,Away,한희원,22,2,4,50.0,6,9,66.7,8,13,61.5,0,0,0.0,1,2,3,1,2,0,1,0,2,4
../kbl_data/2023-2024,S43G01N154,수원 KT,Away,최창진,0,0,1,0.0,0,0,0.0,0,1,0.0,0,0,0.0,0,0,0,0,0,0,0,0,0,0
../kbl_data/2023-2024,S43G01N154,수원 KT,Away,문성곤,3,0,1,0.0,1,4,25.0,1,5,20.0,0,0,0.0,0,1,1,1,1,0,0,0,0,2
../kbl_data/2023-2024,S43G01N154,수원 KT,Away,이현석,0,0,1,0.0,0,0,0.0,0,1,0.0,0,0,0.0,0,0,0,0,0,0,0,0,1,1
../kbl_data/2023-2024,S43G01N154,수원 KT,Away,정성우,7,3,6,50.0,0,3,0.0,3,9,33.3,1,2,50.0,1,3,4,4,0,0,0,0,0,1
../kbl_data/2023-2024,S43G01N154,수원 KT,Away,최성모,0,0,0,0.0,0,1,0.0,0,1,0.0,0,0,0.0,0,0,0,0,0,0,0,0,0,1
../kbl_data/2023-2024,S43G01N154,수원 KT,Away,이윤기,0,0,1,0.0,0,1,0.0,0,2,0.0,0,0,0.0,0,0,0,0,1,0,0,0,1,2
../kbl_data/2023-2024,S43G01N154,수원 KT,Away,하윤기,3,1,7,14.3,0,0,0.0,1,7,14.3,1,2,50.0,2,2,4,1,1,0,0,0,1,4
../kbl_data/2023-2024,S43G01N154,수원 KT,Away,이두원,10,4,5,80.0,0,0,0.0,4,5,80.0,2,2,100.0,1,4,5,0,1,3,1,0,0,0
../kbl_data/2023-2024,S43G01N154,수원 KT,Away,문정현,8,4,4,100.0,0,5,0.0,4,9,44.4,0,0,0.0,0,1,1,2,1,0,0,0,2,4
../kbl_data/2023-2024,S43G01N154,수원 KT,Away,마이클 에릭,0,0,1,0.0,0,0,0.0,0,1,0.0,0,0,0.0,1,1,2,0,0,0,0,0,0,1
../kbl_data/2023-2024,S43G01N154,수원 KT,Away,패리스 배스,16,5,12,41.7,0,5,0.0,5,17,29.4,6,10,60.0,3,16,19,7,0,0,0,1,2,4
../kbl_data/2023-2024,S43G01N155,서울 SK,Home,양우섭,0,0,0,0.0,0,0,0.0,0,0,0.0,0,0,0.0,0,0,0,1,1,0,0,0,1,1
../kbl_data/2023-2024,S43G01N155,서울 SK,Home,송창용,5,2,3,66.7,0,0,0.0,2,3,66.7,1,2,50.0,1,3,4,0,0,0,1,0,0,4
../kbl_data/2023-2024,S43G01N155,서울 SK,Home,오세근,12,3,5,60.0,0,2,0.0,3,7,42.9,6,6,100.0,0,5,5,0,0,1,0,0,1,2
../kbl_data/2023-2024,S43G01N155,서울 SK,Home,최부경,6,3,6,50.0,0,0,0.0,3,6,50.0,0,0,0.0,0,2,2,0,0,0,0,0,1,3
../kbl_data/2023-2024,S43G01N155,서울 SK,Home,리온 윌리엄스,2,0,1,0.0,0,3,0.0,0,4,0.0,2,2,100.0,2,0,2,0,0,0,0,0,1,3
../kbl_data/2023-2024,S43G01N155,서울 SK,Home,최원혁,3,0,2,0.0,1,1,100.0,1,3,33.3,0,0,0.0,2,1,3,5,1,0,1,0,1,5
../kbl_data/2023-2024,S43G01N155,서울 SK,Home,안영준,6,1,1,100.0,1,2,50.0,2,3,66.7,1,2,50.0,0,0,0,2,0,0,0,0,0,1
../kbl_data/2023-2024,S43G01N155,서울 SK,Home,자밀 워니,22,11,21,52.4,0,2,0.0,11,23,47.8,0,2,0.0,2,11,13,6,1,2,0,1,2,1
../kbl_data/2023-2024,S43G01N155,서울 SK,Home,오재현,36,7,12,58.3,4,9,44.4,11,21,52.4,10,11,90.9,0,4,4,1,2,0,1,0,3,3
../kbl_data/2023-2024,S43G01N155,서울 SK,Home,문가온,0,0,0,0.0,0,0,0.0,0,0,0.0,0,0,0.0,0,0,0,0,0,0,0,0,0,0
../kbl_data/2023-2024,S43G01N155,서울 SK,Home,김건우,0,0,0,0.0,0,0,0.0,0,0,0.0,0,0,0.0,0,0,0,0,0,0,0,0,0,0
../kbl_data/2023-2024,S43G01N155,서울 SK,Home,고메즈 딜 리아노,2,1,1,100.0,0,0,0.0,1,1,100.0,0,0,0.0,1,1,2,1,0,0,0,0,0,0
../kbl_data/2023-2024,S43G01N155,울산 현대모비스,Away,함지훈,0,0,0,0.0,0,0,0.0,0,0,0.0,0,0,0.0,0,0,0,0,0,0,0,0,0,0
../kbl_data/2023-2024,S43G01N155,울산 현대모비스,Away,최진수,7,2,2,100.0,1,1,100.0,3,3,100.0,0,0,0.0,2,1,3,1,1,0,0,1,0,1
../kbl_data/2023-2024,S43G01N155,울산 현대모비스,Away,김현수,0,0,0,0.0,0,0,0.0,0,0,0.0,0,0,0.0,0,0,0,0,0,0,0,0,0,0
../kbl_data/2023-2024,S43G01N155,울산 현대모비스,Away,장재석,9,3,8,37.5,0,0,0.0,3,8,37.5,3,5,60.0,2,3,5,5,2,1,0,1,3,4
../kbl_data/2023-2024,S43G01N155,울산 현대모비스,Away,김지완,9,1,2,50.0,2,4,50.0,3,6,50.0,1,2,50.0,1,1,2,1,0,0,0,0,2,1
../kbl_data/2023-2024,S43G01N155,울산 현대모비스,Away,김준일,4,2,3,66.7,0,0,0.0,2,3,66.7,0,0,0.0,0,0,0,1,0,0,0,0,0,2
../kbl_data/2023-2024,S43G01N155,울산 현대모비스,Away,김국찬,8,2,2,100.0,1,4,25.0,3,6,50.0,1,1,100.0,0,1,1,0,0,0,0,0,0,2
../kbl_data/2023-2024,S43G01N155,울산 현대모비스,Away,이우석,10,1,5,20.0,2,6,33.3,3,11,27.3,2,4,50.0,0,6,6,6,0,1,0,0,0,1
../kbl_data/2023-2024,S43G01N155,울산 현대모비스,Away,게이지 프림,21,10,18,55.6,0,0,0.0,10,18,55.6,1,2,50.0,1,2,3,2,1,0,0,0,0,5
../kbl_data/2023-2024,S43G01N155,울산 현대모비스,Away,박무빈,13,1,3,33.3,3,6,50.0,4,9,44.4,2,2,100.0,1,2,3,3,2,0,0,0,3,1
../kbl_data/2023-2024,S43G01N155,울산 현대모비스,Away,케베 알루마,12,2,3,66.7,2,4,50.0,4,7,57.1,2,2,100.0,3,10,13,4,1,0,0,1,3,3
../kbl_data/2023-2024,S43G01N155,울산 현대모비스,Away,미구엘 안드레 옥존,4,1,1,100.0,0,1,0.0,1,2,50.0,2,3,66.7,1,1,2,4,0,0,1,0,2,2
../kbl_data/2023-2024,S43G01N156,부산 KCC,Home,정창영,3,0,3,0.0,1,1,100.0,1,4,25.0,0,0,0.0,0,1,1,0,0,0,0,0,0,4
../kbl_data/2023-2024,S43G01N156,부산 KCC,Home,라건아,17,7,10,70.0,0,0,0.0,7,10,70.0,3,4,75.0,1,2,3,0,0,1,0,0,1,0
../kbl_data/2023-2024,S43G01N156,부산 KCC,Home,전준범,0,0,0,0.0,0,1,0.0,0,1,0.0,0,0,0.0,0,0,0,0,0,0,0,0,0,0
../kbl_data/2023-2024,S43G01N156,부산 KCC,Home,허웅,19,2,6,33.3,3,7,42.9,5,13,38.5,6,6,100.0,0,1,1,4,0,0,0,0,0,4
../kbl_data/2023-2024,S43G01N156,부산 KCC,Home,이승현,2,0,2,0.0,0,0,0.0,0,2,0.0,2,2,100.0,0,1,1,0,0,0,0,0,0,1
../kbl_data/2023-2024,S43G01N156,부산 KCC,Home,이호현,8,3,4,75.0,0,1,0.0,3,5,60.0,2,2,100.0,0,4,4,0,0,1,2,0,0,2
../kbl_data/2023-2024,S43G01N156,부산 KCC,Home,최준용,15,5,9,55.6,0,1,0.0,5,10,50.0,5,10,50.0,1,6,7,10,0,0,0,0,4,4
../kbl_data/2023-2024,S43G01N156,부산 KCC,Home,이진욱,0,0,0,0.0,0,0,0.0,0,0,0.0,0,0,0.0,0,0,0,0,0,0,0,0,0,0
../kbl_data/2023-2024,S43G01N156,부산 KCC,Home,곽정훈,0,0,0,0.0,0,0,0.0,0,0,0.0,0,0,0.0,0,0,0,0,0,0,0,0,0,0
../kbl_data/2023-2024,S43G01N156,부산 KCC,Home,이근휘,5,1,1,100.0,1,2,50.0,2,3,66.7,0,0,0.0,1,0,1,1,0,0,0,0,0,2
../kbl_data/2023-2024,S43G01N156,부산 KCC,Home,김동현,0,0,0,0.0,0,0,0.0,0,0,0.0,0,0,0.0,0,0,0,0,0,0,0,0,0,0
../kbl_data/2023-2024,S43G01N156,부산 KCC,Home,알리제 드숀 존슨,26,8,10,80.0,2,2,100.0,10,12,83.3,4,4,100.0,3,3,6,3,0,0,0,0,0,1
../kbl_data/2023-2024,S43G01N156,창원 LG,Away,이관희,16,2,3,66.7,4,7,57.1,6,10,60.0,0,0,0.0,0,1,1,5,0,0,0,0,0,1
../kbl_data/2023-2024,S43G01N156,창원 LG,Away,정희재,9,1,1,100.0,1,2,50.0,2,3,66.7,4,5,80.0,0,2,2,1,1,0,0,0,1,3
../kbl_data/2023-2024,S43G01N156,창원 LG,Away,이재도,17,4,10,40.0,2,4,50.0,6,14,42.9,3,3,100.0,2,2,4,4,0,0,0,0,1,3
../kbl_data/2023-2024,S43G01N156,창원 LG,Away,정인덕,0,0,0,0.0,0,0,0.0,0,0,0.0,0,0,0.0,0,0,0,0,0,0,0,0,0,0
../kbl_data/2023-2024,S43G01N156,창원 LG,Away,양홍석,20,6,9,66.7,2,5,40.0,8,14,57.1,2,2,100.0,1,4,5,3,1,0,0,0,1,3
../kbl_data/2023-2024,S43G01N156,창원 LG,Away,김준형,0,0,1,0.0,0,0,0.0,0,1,0.0,0,0,0.0,1,0,1,0,0,0,0,0,0,0
../kbl_data/2023-2024,S43G01N156,창원 LG,Away,박정현,4,2,3,66.7,0,0,0.0,2,3,66.7,0,0,0.0,2,1,3,1,0,0,0,0,2,4
../kbl_data/2023-2024,S43G01N156,창원 LG,Away,이승우,0,0,0,0.0,0,0,0.0,0,0,0.0,0,0,0.0,0,1,1,0,0,0,0,0,0,0
../kbl_data/2023-2024,S43G01N156,창원 LG,Away,저스틴 구탕,10,5,7,71.4,0,1,0.0,5,8,62.5,0,0,0.0,0,3,3,0,1,0,0,0,0,1
../kbl_data/2023-2024,S43G01N156,창원 LG,Away,양준석,2,1,1,100.0,0,1,0.0,1,2,50.0,0,0,0.0,0,1,1,2,0,0,0,0,0,3
../kbl_data/2023-2024,S43G01N156,창원 LG,Away,유기상,14,1,2,50.0,4,5,80.0,5,7,71.4,0,0,0.0,0,1,1,0,2,1,0,0,0,1
../kbl_data/2023-2024,S43G01N156,창원 LG,Away,후안 텔로,9,4,8,50.0,0,1,0.0,4,9,44.4,1,2,50.0,3,3,6,4,0,1,0,0,0,5
../kbl_data/2023-2024,S43G01N157,안양 정관장,Home,정준원,2,1,3,33.3,0,3,0.0,1,6,16.7,0,0,0.0,0,2,2,0,2,0,0,0,0,1
../kbl_data/2023-2024,S43G01N157,안양 정관장,Home,김상규,0,0,0,0.0,0,0,0.0,0,0,0.0,0,0,0.0,0,2,2,0,0,0,0,0,0,1
../kbl_data/2023-2024,S43G01N157,안양 정관장,Home,배병준,16,2,6,33.3,4,6,66.7,6,12,50.0,0,0,0.0,1,2,3,1,0,1,0,0,0,2
../kbl_data/2023-2024,S43G01N157,안양 정관장,Home,이종현,9,3,5,60.0,0,2,0.0,3,7,42.9,3,6,50.0,4,3,7,1,1,2,0,0,1,1
../kbl_data/2023-2024,S43G01N157,안양 정관장,Home,김철욱,0,0,0,0.0,0,1,0.0,0,1,0.0,0,0,0.0,0,0,0,0,0,0,0,0,0,1
../kbl_data/2023-2024,S43G01N157,안양 정관장,Home,박지훈,16,5,11,45.5,2,3,66.7,7,14,50.0,0,0,0.0,2,7,9,3,0,0,0,0,4,5
../kbl_data/2023-2024,S43G01N157,안양 정관장,Home,최성원,12,2,4,50.0,1,4,25.0,3,8,37.5,5,5,100.0,0,3,3,6,0,0,0,0,0,2
../kbl_data/2023-2024,S43G01N157,안양 정관장,Home,이우정,0,0,0,0.0,0,0,0.0,0,0,0.0,0,0,0.0,0,0,0,0,0,0,0,0,0,0
../kbl_data/2023-2024,S43G01N157,안양 정관장,Home,장태빈,0,0,0,0.0,0,0,0.0,0,0,0.0,0,0,0.0,0,0,0,0,0,0,0,0,0,0
../kbl_data/2023-2024,S43G01N157,안양 정관장,Home,고찬혁,0,0,0,0.0,0,0,0.0,0,0,0.0,0,0,0.0,0,0,0,0,0,0,0,0,0,0
../kbl_data/2023-2024,S43G01N157,안양 정관장,Home,표승빈,0,0,0,0.0,0,0,0.0,0,0,0.0,0,0,0.0,0,0,0,0,0,0,0,0,0,0
../kbl_data/2023-2024,S43G01N157,안양 정관장,Home,로버트 카터,31,8,11,72.7,3,6,50.0,11,17,64.7,6,8,75.0,2,8,10,4,2,1,0,0,1,4
../kbl_data/2023-2024,S43G01N157,서울 삼성,Away,이정현,22,3,7,42.9,4,9,44.4,7,16,43.8,4,4,100.0,0,2,2,7,0,0,0,0,1,2
../kbl_data/2023-2024,S43G01N157,서울 삼성,Away,홍경기,0,0,0,0.0,0,0,0.0,0,0,0.0,0,0,0.0,0,0,0,0,0,0,0,0,0,0
../kbl_data/2023-2024,S43G01N157,서울 삼성,Away,김시래,2,1,4,25.0,0,4,0.0,1,8,12.5,0,0,0.0,1,3,4,3,0,0,0,0,2,3
../kbl_data/2023-2024,S43G01N157,서울 삼성,Away,이동엽,3,0,3,0.0,1,2,50.0,1,5,20.0,0,0,0.0,0,1,1,2,0,0,0,0,0,2
../kbl_data/2023-2024,S43G01N157,서울 삼성,Away,최승욱,9,3,4,75.0,1,2,50.0,4,6,66.7,0,0,0.0,1,2,3,0,2,0,0,0,1,1
../kbl_data/2023-2024,S43G01N157,서울 삼성,Away,윤성원,0,0,1,0.0,0,0,0.0,0,1,0.0,0,0,0.0,0,3,3,0,0,0,1,0,0,1
../kbl_data/2023-2024,S43G01N157,서울 삼성,Away,김무성,0,0,0,0.0,0,0,0.0,0,0,0.0,0,0,0.0,0,0,0,0,0,0,0,0,0,0
../kbl_data/2023-2024,S43G01N157,서울 삼성,Away,조우성,4,2,5,40.0,0,0,0.0,2,5,40.0,0,0,0.0,1,0,1,0,0,0,0,0,0,0
../kbl_data/2023-2024,S43G01N157,서울 삼성,Away,이원석,2,0,2,0.0,0,0,0.0,0,2,0.0,2,4,50.0,3,3,6,0,1,0,0,0,0,4
../kbl_data/2023-2024,S43G01N157,서울 삼성,Away,신동혁,3,0,1,0.0,1,5,20.0,1,6,16.7,0,0,0.0,1,4,5,3,1,0,0,0,0,2
../kbl_data/2023-2024,S43G01N157,서울 삼성,Away,이스마엘 레인,15,7,9,77.8,0,4,0.0,7,13,53.8,1,1,100.0,1,2,3,0,0,1,0,2,1,1
../kbl_data/2023-2024,S43G01N157,서울 삼성,Away,코피 코번,17,8,13,61.5,0,0,0.0,8,13,61.5,1,2,50.0,4,5,9,2,0,0,0,3,3,1
../kbl_data/2023-2024,S43G01N158,울산 현대모비스,Home,함지훈,8,2,6,33.3,0,0,0.0,2,6,33.3,4,4,100.0,0,2,2,3,0,0,0,0,1,1
../kbl_data/2023-2024,S43G01N158,울산 현대모비스,Home,최진수,7,2,3,66.7,1,3,33.3,3,6,50.0,0,0,0.0,1,1,2,0,0,0,0,0,0,2
../kbl_data/2023-2024,S43G01N158,울산 현대모비스,Home,김현수,0,0,0,0.0,0,0,0.0,0,0,0.0,0,0,0.0,0,0,0,0,0,0,0,0,0,0
../kbl_data/2023-2024,S43G01N158,울산 현대모비스,Home,장재석,3,1,3,33.3,0,0,0.0,1,3,33.3,1,1,100.0,1,3,4,2,0,0,0,0,0,2
../kbl_data/2023-2024,S43G01N158,울산 현대모비스,Home,김지완,6,1,1,100.0,1,2,50.0,2,3,66.7,1,2,50.0,0,0,0,2,0,0,0,0,0,3
../kbl_data/2023-2024,S43G01N158,울산 현대모비스,Home,김준일,4,2,2,100.0,0,0,0.0,2,2,100.0,0,2,0.0,0,0,0,1,0,0,0,0,0,2
../kbl_data/2023-2024,S43G01N158,울산 현대모비스,Home,김국찬,6,0,0,0.0,2,6,33.3,2,6,33.3,0,0,0.0,1,1,2,0,0,1,0,0,1,2
../kbl_data/2023-2024,S43G01N158,울산 현대모비스,Home,이우석,11,4,4,100.0,1,2,50.0,5,6,83.3,0,0,0.0,2,4,6,2,3,0,0,0,0,0
../kbl_data/2023-2024,S43G01N158,울산 현대모비스,Home,게이지 프림,22,6,8,75.0,0,0,0.0,6,8,75.0,10,13,76.9,1,2,3,3,1,1,0,0,4,3
../kbl_data/2023-2024,S43G01N158,울산 현대모비스,Home,박무빈,10,2,4,50.0,2,2,100.0,4,6,66.7,0,1,0.0,1,3,4,4,0,0,0,0,2,1
../kbl_data/2023-2024,S43G01N158,울산 현대모비스,Home,케베 알루마,6,3,7,42.9,0,3,0.0,3,10,30.0,0,0,0.0,5,4,9,2,0,1,1,0,2,4
../kbl_data/2023-2024,S43G01N158,울산 현대모비스,Home,미구엘 안드레 옥존,8,1,3,33.3,2,6,33.3,3,9,33.3,0,0,0.0,2,1,3,5,0,0,0,0,1,2
../kbl_data/2023-2024,S43G01N158,대구 한국가스공사,Away,김동량,2,1,2,50.0,0,1,0.0,1,3,33.3,0,0,0.0,1,1,2,1,0,0,0,0,0,1
../kbl_data/2023-2024,S43G01N158,대구 한국가스공사,Away,차바위,6,0,2,0.0,2,2,100.0,2,4,50.0,0,2,0.0,1,2,3,2,1,0,0,0,1,1
../kbl_data/2023-2024,S43G01N158,대구 한국가스공사,Away,박지훈,0,0,0,0.0,0,1,0.0,0,1,0.0,0,0,0.0,1,0,1,1,0,0,1,0,0,2
../kbl_data/2023-2024,S43G01N158,대구 한국가스공사,Away,조상열,0,0,0,0.0,0,1,0.0,0,1,0.0,0,0,0.0,0,0,0,0,0,0,0,0,0,1
../kbl_data/2023-2024,S43G01N158,대구 한국가스공사,Away,박봉진,0,0,0,0.0,0,1,0.0,0,1,0.0,0,0,0.0,1,0,1,1,1,0,1,0,0,3
../kbl_data/2023-2024,S43G01N158,대구 한국가스공사,Away,김낙현,12,5,5,100.0,0,5,0.0,5,10,50.0,2,2,100.0,1,1,2,3,0,0,1,0,1,3
../kbl_data/2023-2024,S43G01N158,대구 한국가스공사,Away,양준우,0,0,0,0.0,0,0,0.0,0,0,0.0,0,0,0.0,0,0,0,0,0,0,0,0,0,0
../kbl_data/2023-2024,S43G01N158,대구 한국가스공사,Away,앤드류 니콜슨,42,13,21,61.9,3,8,37.5,16,29,55.2,7,8,87.5,5,4,9,1,1,0,0,1,0,1
../kbl_data/2023-2024,S43G01N158,대구 한국가스공사,Away,신승민,8,2,2,100.0,1,2,50.0,3,4,75.0,1,2,50.0,1,2,3,1,0,0,0,0,1,5
../kbl_data/2023-2024,S43G01N158,대구 한국가스공사,Away,샘조세프 벨란겔,5,1,6,16.7,1,3,33.3,2,9,22.2,0,0,0.0,1,3,4,1,0,0,0,0,2,4
../kbl_data/2023-2024,S43G01N158,대구 한국가스공사,Away,신주영,8,2,5,40.0,1,2,50.0,3,7,42.9,1,2,50.0,2,1,3,1,1,0,0,0,0,2
../kbl_data/2023-2024,S43G01N158,대구 한국가스공사,Away,듀반 맥스웰,5,2,4,50.0,0,0,0.0,2,4,50.0,1,2,50.0,1,0,1,1,0,0,0,0,1,1
../kbl_data/2023-2024,S43G01N159,서울 SK,Home,양우섭,3,0,1,0.0,1,2,50.0,1,3,33.3,0,0,0.0,2,0,2,2,1,0,0,0,1,2
../kbl_data/2023-2024,S43G01N159,서울 SK,Home,송창용,13,2,6,33.3,3,5,60.0,5,11,45.5,0,0,0.0,0,2,2,1,0,0,0,0,0,2
../kbl_data/2023-2024,S43G01N159,서울 SK,Home,오세근,24,9,12,75.0,2,4,50.0,11,16,68.8,0,0,0.0,2,4,6,2,0,0,0,0,0,3
../kbl_data/2023-2024,S43G01N159,서울 SK,Home,최부경,2,0,3,0.0,0,0,0.0,0,3,0.0,2,2,100.0,0,4,4,1,1,0,0,0,0,4
../kbl_data/2023-2024,S43G01N159,서울 SK,Home,리온 윌리엄스,0,0,0,0.0,0,0,0.0,0,0,0.0,0,0,0.0,0,0,0,0,0,0,0,0,0,0
../kbl_data/2023-2024,S43G01N159,서울 SK,Home,최원혁,3,0,0,0.0,1,4,25.0,1,4,25.0,0,0,0.0,3,2,5,3,3,0,0,0,1,3
../kbl_data/2023-2024,S43G01N159,서울 SK,Home,자밀 워니,20,5,15,33.3,2,4,50.0,7,19,36.8,4,7,57.1,4,15,19,5,0,1,0,0,2,3
../kbl_data/2023-2024,S43G01N159,서울 SK,Home,김형빈,0,0,0,0.0,0,0,0.0,0,0,0.0,0,0,0.0,0,0,0,0,0,0,0,0,0,0
../kbl_data/2023-2024,S43G01N159,서울 SK,Home,박민우,0,0,0,0.0,0,0,0.0,0,0,0.0,0,0,0.0,0,0,0,0,0,0,0,0,0,0
../kbl_data/2023-2024,S43G01N159,서울 SK,Home,오재현,11,3,7,42.9,0,5,0.0,3,12,25.0,5,5,100.0,0,1,1,3,1,0,0,0,4,3
../kbl_data/2023-2024,S43G01N159,서울 SK,Home,문가온,0,0,0,0.0,0,0,0.0,0,0,0.0,0,0,0.0,0,0,0,0,0,0,0,0,0,0
../kbl_data/2023-2024,S43G01N159,서울 SK,Home,고메즈 딜 리아노,0,0,0,0.0,0,0,0.0,0,0,0.0,0,0,0.0,0,0,0,0,0,0,0,0,0,0
../kbl_data/2023-2024,S43G01N159,원주 DB,Away,박찬희,0,0,0,0.0,0,0,0.0,0,0,0.0,0,0,0.0,0,1,1,0,0,0,0,0,0,0
../kbl_data/2023-2024,S43G01N159,원주 DB,Away,서민수,0,0,0,0.0,0,1,0.0,0,1,0.0,0,0,0.0,0,1,1,0,0,0,0,0,0,1
../kbl_data/2023-2024,S43G01N159,원주 DB,Away,김영현,5,1,1,100.0,1,6,16.7,2,7,28.6,0,0,0.0,0,0,0,0,1,0,1,0,0,1
../kbl_data/2023-2024,S43G01N159,원주 DB,Away,김종규,8,4,8,50.0,0,0,0.0,4,8,50.0,0,0,0.0,5,6,11,0,0,0,0,1,0,3
../kbl_data/2023-2024,S43G01N159,원주 DB,Away,최승욱,0,0,0,0.0,0,0,0.0,0,0,0.0,0,0,0.0,1,0,1,0,0,0,0,0,0,0
../kbl_data/2023-2024,S43G01N159,원주 DB,Away,강상재,4,0,4,0.0,1,2,50.0,1,6,16.7,1,2,50.0,0,6,6,3,1,0,0,0,4,2
../kbl_data/2023-2024,S43G01N159,원주 DB,Away,김훈,0,0,0,0.0,0,1,0.0,0,1,0.0,0,0,0.0,0,0,0,0,0,0,0,0,0,1
../kbl_data/2023-2024,S43G01N159,원주 DB,Away,디드릭 로슨,16,4,14,28.6,2,8,25.0,6,22,27.3,2,3,66.7,2,7,9,5,1,1,0,0,1,1
../kbl_data/2023-2024,S43G01N159,원주 DB,Away,이용우,7,2,2,100.0,1,1,100.0,3,3,100.0,0,1,0.0,1,0,1,0,0,0,0,0,1,1
../kbl_data/2023-2024,S43G01N159,원주 DB,Away,이선 알바노,21,6,10,60.0,2,4,50.0,8,14,57.1,3,4,75.0,0,3,3,5,2,0,0,0,3,4
../kbl_data/2023-2024,S43G01N159,원주 DB,Away,박인웅,5,1,3,33.3,1,1,100.0,2,4,50.0,0,0,0.0,1,1,2,1,1,0,0,0,1,1
../kbl_data/2023-2024,S43G01N159,원주 DB,Away,제프 위디,2,1,2,50.0,0,1,0.0,1,3,33.3,0,0,0.0,0,0,0,1,0,0,0,0,0,0
../kbl_data/2023-2024,S43G01N160,고양 소노,Home,김강선,3,0,0,0.0,1,2,50.0,1,2,50.0,0,0,0.0,0,0,0,3,2,0,0,0,1,1
../kbl_data/2023-2024,S43G01N160,고양 소노,Home,함준후,2,1,1,100.0,0,1,0.0,1,2,50.0,0,0,0.0,1,0,1,0,0,0,0,0,1,1
../kbl_data/2023-2024,S43G01N160,고양 소노,Home,최현민,11,0,0,0.0,3,6,50.0,3,6,50.0,2,2,100.0,2,4,6,1,1,0,0,0,1,1
../kbl_data/2023-2024,S43G01N160,고양 소노,Home,김민욱,17,3,5,60.0,3,11,27.3,6,16,37.5,2,3,66.7,2,0,2,3,1,0,0,0,0,1
../kbl_data/2023-2024,S43G01N160,고양 소노,Home,김지후,0,0,0,0.0,0,0,0.0,0,0,0.0,0,0,0.0,0,0,0,0,0,0,0,0,0,0
../kbl_data/2023-2024,S43G01N160,고양 소노,Home,김진유,0,0,0,0.0,0,1,0.0,0,1,0.0,0,0,0.0,0,1,1,0,0,0,0,0,0,0
../kbl_data/2023-2024,S43G01N160,고양 소노,Home,다후안 서머스,0,0,1,0.0,0,3,0.0,0,4,0.0,0,0,0.0,0,0,0,0,1,0,0,0,0,0
../kbl_data/2023-2024,S43G01N160,고양 소노,Home,치나누 오누아쿠,15,6,10,60.0,0,1,0.0,6,11,54.5,3,3,100.0,1,8,9,5,1,0,0,1,5,4
../kbl_data/2023-2024,S43G01N160,고양 소노,Home,이정현,16,5,10,50.0,1,6,16.7,6,16,37.5,3,4,75.0,2,4,6,7,2,0,2,0,4,2
../kbl_data/2023-2024,S43G01N160,고양 소노,Home,조재우,2,1,2,50.0,0,0,0.0,1,2,50.0,0,0,0.0,1,0,1,0,0,0,0,0,0,0
../kbl_data/2023-2024,S43G01N160,고양 소노,Home,박종하,7,2,3,66.7,1,6,16.7,3,9,33.3,0,0,0.0,0,1,1,5,4,0,0,0,0,4
../kbl_data/2023-2024,S43G01N160,고양 소노,Home,알렉스 카바노,0,0,1,0.0,0,0,0.0,0,1,0.0,0,0,0.0,0,0,0,0,0,0,0,0,1,0
../kbl_data/2023-2024,S43G01N160,수원 KT,Away,한희원,19,2,4,50.0,5,6,83.3,7,10,70.0,0,2,0.0,1,3,4,2,0,1,1,0,1,2
../kbl_data/2023-2024,S43G01N160,수원 KT,Away,최창진,2,1,1,100.0,0,0,0.0,1,1,100.0,0,0,0.0,0,1,1,0,0,0,0,0,0,0
../kbl_data/2023-2024,S43G01N160,수원 KT,Away,문성곤,19,2,3,66.7,5,10,50.0,7,13,53.8,0,0,0.0,1,2,3,1,2,2,0,0,1,1
../kbl_data/2023-2024,S43G01N160,수원 KT,Away,이현석,0,0,0,0.0,0,0,0.0,0,0,0.0,0,0,0.0,0,0,0,0,0,0,0,0,0,0
../kbl_data/2023-2024,S43G01N160,수원 KT,Away,정성우,11,1,4,25.0,3,7,42.9,4,11,36.4,0,2,0.0,0,3,3,9,0,0,2,0,2,1
../kbl_data/2023-2024,S43G01N160,수원 KT,Away,최성모,3,0,2,0.0,1,1,100.0,1,3,33.3,0,0,0.0,1,1,2,2,1,0,0,0,1,1
../kbl_data/2023-2024,S43G01N160,수원 KT,Away,이윤기,0,0,0,0.0,0,0,0.0,0,0,0.0,0,0,0.0,0,0,0,0,1,0,0,0,0,0
../kbl_data/2023-2024,S43G01N160,수원 KT,Away,하윤기,13,6,10,60.0,0,0,0.0,6,10,60.0,1,1,100.0,4,6,10,1,0,1,0,0,3,3
../kbl_data/2023-2024,S43G01N160,수원 KT,Away,이두원,0,0,2,0.0,0,0,0.0,0,2,0.0,0,0,0.0,1,0,1,0,0,0,0,0,0,0
../kbl_data/2023-2024,S43G01N160,수원 KT,Away,문정현,0,0,0,0.0,0,0,0.0,0,0,0.0,0,0,0.0,0,0,0,0,0,0,0,0,0,0
../kbl_data/2023-2024,S43G01N160,수원 KT,Away,마이클 에릭,2,1,2,50.0,0,0,0.0,1,2,50.0,0,0,0.0,0,8,8,0,0,1,0,1,2,4
../kbl_data/2023-2024,S43G01N160,수원 KT,Away,패리스 배스,23,6,9,66.7,3,6,50.0,9,15,60.0,2,2,100.0,3,7,10,7,3,0,0,1,9,4
../kbl_data/2023-2024,S43G01N161,원주 DB,Home,박찬희,2,1,1,100.0,0,1,0.0,1,2,50.0,0,0,0.0,0,1,1,0,0,0,0,0,0,0
../kbl_data/2023-2024,S43G01N161,원주 DB,Home,서민수,0,0,0,0.0,0,0,0.0,0,0,0.0,0,0,0.0,0,0,0,0,0,0,0,0,0,0
../kbl_data/2023-2024,S43G01N161,원주 DB,Home,김영현,2,1,1,100.0,0,1,0.0,1,2,50.0,0,0,0.0,0,0,0,0,1,0,0,0,0,1
../kbl_data/2023-2024,S43G01N161,원주 DB,Home,김종규,16,7,10,70.0,0,0,0.0,7,10,70.0,2,2,100.0,1,2,3,1,1,0,0,1,0,3
../kbl_data/2023-2024,S43G01N161,원주 DB,Home,최승욱,2,1,1,100.0,0,1,0.0,1,2,50.0,0,0,0.0,0,2,2,2,0,0,0,0,0,1
../kbl_data/2023-2024,S43G01N161,원주 DB,Home,강상재,19,6,9,66.7,2,3,66.7,8,12,66.7,1,2,50.0,2,6,8,2,0,0,0,0,1,1
../kbl_data/2023-2024,S43G01N161,원주 DB,Home,김훈,4,0,0,0.0,1,3,33.3,1,3,33.3,1,2,50.0,2,0,2,0,0,0,0,0,0,1
../kbl_data/2023-2024,S43G01N161,원주 DB,Home,디드릭 로슨,25,6,9,66.7,2,5,40.0,8,14,57.1,7,10,70.0,3,9,12,5,1,1,0,1,3,1
../kbl_data/2023-2024,S43G01N161,원주 DB,Home,이용우,3,0,0,0.0,1,3,33.3,1,3,33.3,0,0,0.0,0,0,0,0,0,0,0,0,0,4
../kbl_data/2023-2024,S43G01N161,원주 DB,Home,이선 알바노,16,3,4,75.0,2,4,50.0,5,8,62.5,4,5,80.0,0,2,2,8,0,0,0,0,0,3
../kbl_data/2023-2024,S43G01N161,원주 DB,Home,박인웅,0,0,0,0.0,0,1,0.0,0,1,0.0,0,0,0.0,0,2,2,1,0,0,0,0,0,2
../kbl_data/2023-2024,S43G01N161,원주 DB,Home,제프 위디,4,2,3,66.7,0,0,0.0,2,3,66.7,0,0,0.0,0,1,1,1,0,1,0,1,1,0
../kbl_data/2023-2024,S43G01N161,창원 LG,Away,이관희,11,0,2,0.0,2,6,33.3,2,8,25.0,5,5,100.0,0,1,1,0,0,0,0,0,0,0
../kbl_data/2023-2024,S43G01N161,창원 LG,Away,정희재,0,0,2,0.0,0,2,0.0,0,4,0.0,0,0,0.0,0,1,1,1,2,0,0,0,0,4
../kbl_data/2023-2024,S43G01N161,창원 LG,Away,이재도,4,1,1,100.0,0,4,0.0,1,5,20.0,2,2,100.0,0,2,2,2,1,0,0,0,0,2
../kbl_data/2023-2024,S43G01N161,창원 LG,Away,정인덕,0,0,0,0.0,0,0,0.0,0,0,0.0,0,0,0.0,0,0,0,0,0,0,0,0,0,0
../kbl_data/2023-2024,S43G01N161,창원 LG,Away,양홍석,17,4,10,40.0,3,5,60.0,7,15,46.7,0,0,0.0,3,1,4,2,0,1,0,0,0,2
../kbl_data/2023-2024,S43G01N161,창원 LG,Away,김준형,0,0,0,0.0,0,2,0.0,0,2,0.0,0,0,0.0,0,0,0,0,0,0,0,0,1,0
../kbl_data/2023-2024,S43G01N161,창원 LG,Away,박정현,4,1,2,50.0,0,0,0.0,1,2,50.0,2,2,100.0,3,3,6,0,0,1,0,0,0,4
../kbl_data/2023-2024,S43G01N161,창원 LG,Away,이승우,3,1,2,50.0,0,0,0.0,1,2,50.0,1,1,100.0,0,0,0,0,0,0,0,0,0,1
../kbl_data/2023-2024,S43G01N161,창원 LG,Away,저스틴 구탕,0,0,1,0.0,0,0,0.0,0,1,0.0,0,0,0.0,0,1,1,2,0,0,0,0,0,1
../kbl_data/2023-2024,S43G01N161,창원 LG,Away,양준석,13,2,4,50.0,3,4,75.0,5,8,62.5,0,0,0.0,1,2,3,4,0,0,0,0,1,3
../kbl_data/2023-2024,S43G01N161,창원 LG,Away,유기상,13,4,7,57.1,1,3,33.3,5,10,50.0,2,2,100.0,3,1,4,0,0,0,0,0,0,2
../kbl_data/2023-2024,S43G01N161,창원 LG,Away,후안 텔로,8,4,10,40.0,0,1,0.0,4,11,36.4,0,0,0.0,3,5,8,1,0,0,0,0,3,3
../kbl_data/2023-2024,S43G01N162,서울 삼성,Home,이정현,9,3,7,42.9,1,9,11.1,4,16,25.0,0,0,0.0,0,4,4,6,1,0,0,0,2,2
../kbl_data/2023-2024,S43G01N162,서울 삼성,Home,홍경기,0,0,0,0.0,0,0,0.0,0,0,0.0,0,0,0.0,0,0,0,0,0,0,0,0,0,0
../kbl_data/2023-2024,S43G01N162,서울 삼성,Home,김시래,8,2,3,66.7,1,3,33.3,3,6,50.0,1,2,50.0,0,3,3,1,1,0,0,0,2,3
../kbl_data/2023-2024,S43G01N162,서울 삼성,Home,이동엽,16,2,4,50.0,4,6,66.7,6,10,60.0,0,0,0.0,0,0,0,1,0,0,0,0,0,3
../kbl_data/2023-2024,S43G01N162,서울 삼성,Home,최승욱,4,2,4,50.0,0,0,0.0,2,4,50.0,0,1,0.0,1,3,4,0,1,0,0,0,0,1
../kbl_data/2023-2024,S43G01N162,서울 삼성,Home,윤성원,2,1,3,33.3,0,0,0.0,1,3,33.3,0,0,0.0,1,2,3,1,0,0,0,0,1,2
../kbl_data/2023-2024,S43G01N162,서울 삼성,Home,차민석,0,0,0,0.0,0,0,0.0,0,0,0.0,0,0,0.0,0,0,0,0,0,0,0,0,0,0
../kbl_data/2023-2024,S43G01N162,서울 삼성,Home,이원석,12,6,13,46.2,0,0,0.0,6,13,46.2,0,0,0.0,8,3,11,1,2,0,0,1,0,5
../kbl_data/2023-2024,S43G01N162,서울 삼성,Home,신동혁,7,2,3,66.7,1,2,50.0,3,5,60.0,0,0,0.0,0,4,4,0,0,0,0,0,0,2
../kbl_data/2023-2024,S43G01N162,서울 삼성,Home,아반 나바,0,0,0,0.0,0,1,0.0,0,1,0.0,0,0,0.0,0,0,0,0,0,0,0,0,0,0
../kbl_data/2023-2024,S43G01N162,서울 삼성,Home,이스마엘 레인,0,0,3,0.0,0,3,0.0,0,6,0.0,0,0,0.0,1,3,4,1,1,1,0,0,1,1
../kbl_data/2023-2024,S43G01N162,서울 삼성,Home,코피 코번,16,8,17,47.1,0,0,0.0,8,17,47.1,0,0,0.0,3,6,9,4,0,0,0,1,6,3
../kbl_data/2023-2024,S43G01N162,부산 KCC,Away,정창영,6,1,1,100.0,1,1,100.0,2,2,100.0,1,2,50.0,0,0,0,3,0,0,1,0,2,2
../kbl_data/2023-2024,S43G01N162,부산 KCC,Away,라건아,16,3,8,37.5,2,3,66.7,5,11,45.5,4,7,57.1,3,8,11,1,1,1,0,0,0,1
../kbl_data/2023-2024,S43G01N162,부산 KCC,Away,전준범,0,0,0,0.0,0,0,0.0,0,0,0.0,0,0,0.0,0,0,0,0,0,0,0,0,0,0
../kbl_data/2023-2024,S43G01N162,부산 KCC,Away,허웅,20,4,7,57.1,4,9,44.4,8,16,50.0,0,0,0.0,0,4,4,4,1,0,1,0,3,1
../kbl_data/2023-2024,S43G01N162,부산 KCC,Away,이승현,2,1,3,33.3,0,0,0.0,1,3,33.3,0,0,0.0,1,4,5,0,0,2,0,0,0,0
../kbl_data/2023-2024,S43G01N162,부산 KCC,Away,이호현,0,0,0,0.0,0,0,0.0,0,0,0.0,0,0,0.0,0,0,0,0,1,0,0,0,0,0
../kbl_data/2023-2024,S43G01N162,부산 KCC,Away,최준용,22,6,14,42.9,2,6,33.3,8,20,40.0,4,8,50.0,1,7,8,5,0,4,0,0,0,0
../kbl_data/2023-2024,S43G01N162,부산 KCC,Away,곽정훈,7,2,2,100.0,1,1,100.0,3,3,100.0,0,0,0.0,1,4,5,0,0,0,0,0,1,4
../kbl_data/2023-2024,S43G01N162,부산 KCC,Away,이근휘,12,2,4,50.0,2,5,40.0,4,9,44.4,2,2,100.0,1,3,4,0,3,0,0,0,0,2
../kbl_data/2023-2024,S43G01N162,부산 KCC,Away,여준형,0,0,0,0.0,0,0,0.0,0,0,0.0,0,0,0.0,0,0,0,0,0,0,0,0,0,0
../kbl_data/2023-2024,S43G01N162,부산 KCC,Away,캘빈 제프리 에피스톨라,5,2,2,100.0,0,1,0.0,2,3,66.7,1,1,100.0,0,1,1,1,0,0,0,0,1,1
../kbl_data/2023-2024,S43G01N162,부산 KCC,Away,알리제 드숀 존슨,0,0,3,0.0,0,2,0.0,0,5,0.0,0,0,0.0,0,1,1,1,0,0,0,0,0,2
../kbl_data/2023-2024,S43G01N163,안양 정관장,Home,정준원,4,1,1,100.0,0,2,0.0,1,3,33.3,2,2,100.0,1,1,2,0,0,0,0,0,0,3
../kbl_data/2023-2024,S43G01N163,안양 정관장,Home,김상규,0,0,1,0.0,0,1,0.0,0,2,0.0,0,0,0.0,0,0,0,0,0,0,0,0,0,0
../kbl_data/2023-2024,S43G01N163,안양 정관장,Home,배병준,11,4,7,57.1,1,2,50.0,5,9,55.6,0,0,0.0,1,3,4,2,3,0,0,0,0,1
../kbl_data/2023-2024,S43G01N163,안양 정관장,Home,이종현,13,4,6,66.7,1,4,25.0,5,10,50.0,2,2,100.0,2,8,10,2,0,2,0,0,2,4
../kbl_data/2023-2024,S43G01N163,안양 정관장,Home,김철욱,0,0,0,0.0,0,0,0.0,0,0,0.0,0,0,0.0,0,2,2,0,0,0,0,0,0,4
../kbl_data/2023-2024,S43G01N163,안양 정관장,Home,박지훈,29,11,15,73.3,1,1,100.0,12,16,75.0,4,4,100.0,2,4,6,5,2,0,0,0,3,3
../kbl_data/2023-2024,S43G01N163,안양 정관장,Home,최성원,26,2,4,50.0,5,8,62.5,7,12,58.3,7,7,100.0,1,1,2,10,3,0,0,0,3,3
../kbl_data/2023-2024,S43G01N163,안양 정관장,Home,이우정,0,0,1,0.0,0,0,0.0,0,1,0.0,0,0,0.0,0,0,0,0,1,0,0,0,0,2
../kbl_data/2023-2024,S43G01N163,안양 정관장,Home,장태빈,0,0,0,0.0,0,0,0.0,0,0,0.0,0,0,0.0,0,0,0,0,0,0,0,0,0,0
../kbl_data/2023-2024,S43G01N163,안양 정관장,Home,고찬혁,7,0,0,0.0,1,2,50.0,1,2,50.0,4,4,100.0,1,3,4,0,0,0,0,0,0,0
../kbl_data/2023-2024,S43G01N163,안양 정관장,Home,유진,0,0,0,0.0,0,2,0.0,0,2,0.0,0,0,0.0,0,0,0,0,0,0,0,0,0,0
../kbl_data/2023-2024,S43G01N163,안양 정관장,Home,로버트 카터,24,7,12,58.3,3,6,50.0,10,18,55.6,1,2,50.0,0,8,8,1,3,0,1,0,1,1
../kbl_data/2023-2024,S43G01N163,울산 현대모비스,Away,함지훈,4,2,3,66.7,0,0,0.0,2,3,66.7,0,0,0.0,1,1,2,0,0,0,0,0,0,1
../kbl_data/2023-2024,S43G01N163,울산 현대모비스,Away,최진수,9,3,7,42.9,1,3,33.3,4,10,40.0,0,0,0.0,1,1,2,2,2,1,0,1,1,0
../kbl_data/2023-2024,S43G01N163,울산 현대모비스,Away,김현수,0,0,1,0.0,0,1,0.0,0,2,0.0,0,0,0.0,0,2,2,2,0,0,0,0,1,0
../kbl_data/2023-2024,S43G01N163,울산 현대모비스,Away,장재석,8,3,6,50.0,0,0,0.0,3,6,50.0,2,2,100.0,0,1,1,1,2,0,0,0,0,3
../kbl_data/2023-2024,S43G01N163,울산 현대모비스,Away,김지완,0,0,1,0.0,0,1,0.0,0,2,0.0,0,0,0.0,0,0,0,1,0,0,0,0,1,2
../kbl_data/2023-2024,S43G01N163,울산 현대모비스,Away,김준일,8,4,8,50.0,0,0,0.0,4,8,50.0,0,0,0.0,2,3,5,2,0,0,0,0,1,4
../kbl_data/2023-2024,S43G01N163,울산 현대모비스,Away,김국찬,8,1,2,50.0,2,4,50.0,3,6,50.0,0,0,0.0,1,5,6,0,1,0,1,0,2,3
../kbl_data/2023-2024,S43G01N163,울산 현대모비스,Away,이우석,6,3,6,50.0,0,1,0.0,3,7,42.9,0,0,0.0,1,4,5,5,0,0,0,0,3,1
../kbl_data/2023-2024,S43G01N163,울산 현대모비스,Away,게이지 프림,16,7,9,77.8,0,0,0.0,7,9,77.8,2,2,100.0,3,2,5,1,0,0,0,1,2,0
../kbl_data/2023-2024,S43G01N163,울산 현대모비스,Away,박무빈,3,1,2,50.0,0,0,0.0,1,2,50.0,1,2,50.0,1,0,1,2,0,0,0,0,1,2
../kbl_data/2023-2024,S43G01N163,울산 현대모비스,Away,케베 알루마,17,5,8,62.5,2,6,33.3,7,14,50.0,1,2,50.0,3,5,8,0,0,0,0,3,1,2
../kbl_data/2023-2024,S43G01N163,울산 현대모비스,Away,미구엘 안드레 옥존,11,2,5,40.0,1,6,16.7,3,11,27.3,4,6,66.7,0,1,1,5,0,1,0,0,2,4
../kbl_data/2023-2024,S43G01N164,서울 SK,Home,양우섭,9,0,0,0.0,3,3,100.0,3,3,100.0,0,0,0.0,0,1,1,1,1,0,1,0,0,2
../kbl_data/2023-2024,S43G01N164,서울 SK,Home,송창용,8,1,1,100.0,2,3,66.7,3,4,75.0,0,0,0.0,0,1,1,0,0,1,0,0,2,4
../kbl_data/2023-2024,S43G01N164,서울 SK,Home,오세근,8,3,8,37.5,0,0,0.0,3,8,37.5,2,2,100.0,1,3,4,2,0,0,0,0,2,4
../kbl_data/2023-2024,S43G01N164,서울 SK,Home,최부경,9,2,7,28.6,0,0,0.0,2,7,28.6,5,6,83.3,3,3,6,1,1,0,0,0,1,2
../kbl_data/2023-2024,S43G01N164,서울 SK,Home,리온 윌리엄스,2,1,3,33.3,0,2,0.0,1,5,20.0,0,0,0.0,1,2,3,0,1,0,0,0,1,1
../kbl_data/2023-2024,S43G01N164,서울 SK,Home,최원혁,2,1,3,33.3,0,1,0.0,1,4,25.0,0,0,0.0,0,2,2,3,1,0,0,0,0,2
../kbl_data/2023-2024,S43G01N164,서울 SK,Home,자밀 워니,21,10,14,71.4,0,1,0.0,10,15,66.7,1,3,33.3,2,5,7,5,1,0,0,1,2,3
../kbl_data/2023-2024,S43G01N164,서울 SK,Home,김형빈,5,1,1,100.0,1,1,100.0,2,2,100.0,0,0,0.0,0,0,0,0,0,0,0,0,0,0
../kbl_data/2023-2024,S43G01N164,서울 SK,Home,박민우,0,0,0,0.0,0,0,0.0,0,0,0.0,0,0,0.0,0,1,1,0,0,0,0,0,0,0
../kbl_data/2023-2024,S43G01N164,서울 SK,Home,오재현,9,4,9,44.4,0,2,0.0,4,11,36.4,1,2,50.0,0,2,2,3,0,0,0,0,0,1
../kbl_data/2023-2024,S43G01N164,서울 SK,Home,문가온,0,0,0,0.0,0,0,0.0,0,0,0.0,0,0,0.0,0,0,0,0,0,0,0,0,0,0
../kbl_data/2023-2024,S43G01N164,서울 SK,Home,고메즈 딜 리아노,2,1,1,100.0,0,0,0.0,1,1,100.0,0,0,0.0,0,1,1,2,0,0,0,0,0,1
../kbl_data/2023-2024,S43G01N164,대구 한국가스공사,Away,김동량,0,0,0,0.0,0,0,0.0,0,0,0.0,0,0,0.0,0,0,0,0,0,0,0,0,0,2
../kbl_data/2023-2024,S43G01N164,대구 한국가스공사,Away,차바위,8,0,1,0.0,1,3,33.3,1,4,25.0,5,6,83.3,3,0,3,2,1,0,0,0,0,3
../kbl_data/2023-2024,S43G01N164,대구 한국가스공사,Away,박지훈,13,2,4,50.0,3,4,75.0,5,8,62.5,0,1,0.0,0,2,2,0,1,1,0,0,2,3
../kbl_data/2023-2024,S43G01N164,대구 한국가스공사,Away,조상열,0,0,0,0.0,0,2,0.0,0,2,0.0,0,0,0.0,0,0,0,0,0,0,0,0,0,0
../kbl_data/2023-2024,S43G01N164,대구 한국가스공사,Away,박봉진,0,0,0,0.0,0,2,0.0,0,2,0.0,0,0,0.0,0,1,1,0,0,0,0,0,0,0
../kbl_data/2023-2024,S43G01N164,대구 한국가스공사,Away,양준우,0,0,0,0.0,0,0,0.0,0,0,0.0,0,0,0.0,0,0,0,0,0,0,0,0,1,1
../kbl_data/2023-2024,S43G01N164,대구 한국가스공사,Away,앤드류 니콜슨,33,9,12,75.0,4,8,50.0,13,20,65.0,3,4,75.0,2,7,9,3,0,1,0,1,0,2
../kbl_data/2023-2024,S43G01N164,대구 한국가스공사,Away,신승민,7,3,4,75.0,0,2,0.0,3,6,50.0,1,2,50.0,1,4,5,1,2,0,1,0,1,2
../kbl_data/2023-2024,S43G01N164,대구 한국가스공사,Away,샘조세프 벨란겔,17,3,8,37.5,2,4,50.0,5,12,41.7,5,6,83.3,1,0,1,5,2,0,0,0,2,2
../kbl_data/2023-2024,S43G01N164,대구 한국가스공사,Away,안세영,0,0,0,0.0,0,0,0.0,0,0,0.0,0,0,0.0,0,1,1,0,0,0,0,0,0,1
../kbl_data/2023-2024,S43G01N164,대구 한국가스공사,Away,신주영,2,1,2,50.0,0,1,0.0,1,3,33.3,0,0,0.0,2,3,5,1,0,1,0,0,1,4
../kbl_data/2023-2024,S43G01N164,대구 한국가스공사,Away,듀반 맥스웰,8,4,5,80.0,0,0,0.0,4,5,80.0,0,0,0.0,1,3,4,2,1,0,0,0,1,0
../kbl_data/2023-2024,S43G01N165,원주 DB,Home,박찬희,0,0,0,0.0,0,0,0.0,0,0,0.0,0,0,0.0,0,0,0,0,0,0,0,0,0,0
../kbl_data/2023-2024,S43G01N165,원주 DB,Home,서민수,0,0,0,0.0,0,0,0.0,0,0,0.0,0,0,0.0,0,1,1,0,0,0,0,0,0,2
../kbl_data/2023-2024,S43G01N165,원주 DB,Home,김영현,8,1,2,50.0,2,3,66.7,3,5,60.0,0,0,0.0,1,0,1,1,0,0,0,0,2,2
../kbl_data/2023-2024,S43G01N165,원주 DB,Home,김종규,19,5,10,50.0,1,3,33.3,6,13,46.2,6,6,100.0,3,3,6,3,1,0,0,1,3,3
../kbl_data/2023-2024,S43G01N165,원주 DB,Home,최승욱,1,0,2,0.0,0,0,0.0,0,2,0.0,1,2,50.0,0,0,0,0,1,0,0,0,0,0
../kbl_data/2023-2024,S43G01N165,원주 DB,Home,강상재,17,7,14,50.0,0,3,0.0,7,17,41.2,3,5,60.0,2,4,6,4,0,0,0,0,2,3
../kbl_data/2023-2024,S43G01N165,원주 DB,Home,김훈,0,0,0,0.0,0,0,0.0,0,0,0.0,0,0,0.0,0,0,0,0,0,0,0,0,0,0
../kbl_data/2023-2024,S43G01N165,원주 DB,Home,디드릭 로슨,8,3,5,60.0,0,2,0.0,3,7,42.9,2,3,66.7,1,7,8,4,1,0,0,0,3,1
../kbl_data/2023-2024,S43G01N165,원주 DB,Home,이용우,8,1,2,50.0,2,4,50.0,3,6,50.0,0,0,0.0,1,0,1,0,0,0,0,0,0,0
../kbl_data/2023-2024,S43G01N165,원주 DB,Home,이선 알바노,17,4,7,57.1,2,6,33.3,6,13,46.2,3,4,75.0,0,4,4,8,1,1,0,0,0,2
../kbl_data/2023-2024,S43G01N165,원주 DB,Home,박인웅,8,1,2,50.0,2,2,100.0,3,4,75.0,0,0,0.0,0,1,1,0,0,0,0,0,0,4
../kbl_data/2023-2024,S43G01N165,원주 DB,Home,제프 위디,5,1,1,100.0,1,2,50.0,2,3,66.7,0,0,0.0,1,5,6,1,0,1,0,0,0,0
../kbl_data/2023-2024,S43G01N165,울산 현대모비스,Away,함지훈,2,1,5,20.0,0,1,0.0,1,6,16.7,0,0,0.0,2,1,3,3,0,0,0,0,1,1
../kbl_data/2023-2024,S43G01N165,울산 현대모비스,Away,최진수,8,1,2,50.0,2,4,50.0,3,6,50.0,0,0,0.0,2,1,3,4,1,0,0,0,0,3
../kbl_data/2023-2024,S43G01N165,울산 현대모비스,Away,장재석,2,1,4,25.0,0,0,0.0,1,4,25.0,0,0,0.0,1,1,2,0,1,1,0,0,0,2
../kbl_data/2023-2024,S43G01N165,울산 현대모비스,Away,김지완,17,0,0,0.0,5,7,71.4,5,7,71.4,2,2,100.0,1,0,1,2,0,0,0,0,2,3
../kbl_data/2023-2024,S43G01N165,울산 현대모비스,Away,김준일,0,0,1,0.0,0,0,0.0,0,1,0.0,0,0,0.0,1,0,1,1,0,0,0,0,0,0
../kbl_data/2023-2024,S43G01N165,울산 현대모비스,Away,김국찬,5,1,2,50.0,0,3,0.0,1,5,20.0,3,4,75.0,1,2,3,0,0,0,0,0,0,1
../kbl_data/2023-2024,S43G01N165,울산 현대모비스,Away,이우석,8,1,1,100.0,2,3,66.7,3,4,75.0,0,0,0.0,0,4,4,1,0,0,0,0,1,3
../kbl_data/2023-2024,S43G01N165,울산 현대모비스,Away,신민석,0,0,1,0.0,0,0,0.0,0,1,0.0,0,0,0.0,0,0,0,1,0,0,0,0,0,0
../kbl_data/2023-2024,S43G01N165,울산 현대모비스,Away,게이지 프림,31,12,21,57.1,2,2,100.0,14,23,60.9,1,1,100.0,6,10,16,0,1,0,0,2,3,1
../kbl_data/2023-2024,S43G01N165,울산 현대모비스,Away,박무빈,13,1,3,33.3,3,9,33.3,4,12,33.3,2,2,100.0,0,3,3,6,1,0,1,0,0,2
../kbl_data/2023-2024,S43G01N165,울산 현대모비스,Away,케베 알루마,8,4,9,44.4,0,2,0.0,4,11,36.4,0,2,0.0,4,6,10,2,1,0,0,2,2,4
../kbl_data/2023-2024,S43G01N165,울산 현대모비스,Away,미구엘 안드레 옥존,5,1,2,50.0,1,2,50.0,2,4,50.0,0,0,0.0,0,0,0,1,2,0,0,0,2,1
../kbl_data/2023-2024,S43G01N166,고양 소노,Home,김강선,2,0,0,0.0,0,1,0.0,0,1,0.0,2,2,100.0,0,0,0,1,0,0,0,0,0,2
../kbl_data/2023-2024,S43G01N166,고양 소노,Home,함준후,0,0,0,0.0,0,0,0.0,0,0,0.0,0,0,0.0,0,0,0,0,0,0,0,0,0,0
../kbl_data/2023-2024,S43G01N166,고양 소노,Home,최현민,0,0,0,0.0,0,1,0.0,0,1,0.0,0,0,0.0,1,2,3,0,0,0,0,0,1,1
../kbl_data/2023-2024,S43G01N166,고양 소노,Home,김민욱,28,5,7,71.4,6,12,50.0,11,19,57.9,0,0,0.0,1,2,3,2,0,1,0,0,0,3
../kbl_data/2023-2024,S43G01N166,고양 소노,Home,한호빈,0,0,1,0.0,0,0,0.0,0,1,0.0,0,0,0.0,0,0,0,0,0,0,0,0,0,0
../kbl_data/2023-2024,S43G01N166,고양 소노,Home,김지후,0,0,0,0.0,0,0,0.0,0,0,0.0,0,0,0.0,0,0,0,0,0,0,0,0,0,0
../kbl_data/2023-2024,S43G01N166,고양 소노,Home,김진유,6,1,1,100.0,1,1,100.0,2,2,100.0,1,2,50.0,6,5,11,3,1,0,0,0,0,4
../kbl_data/2023-2024,S43G01N166,고양 소노,Home,다후안 서머스,2,1,2,50.0,0,2,0.0,1,4,25.0,0,0,0.0,0,1,1,0,0,0,0,0,1,0
../kbl_data/2023-2024,S43G01N166,고양 소노,Home,치나누 오누아쿠,12,6,14,42.9,0,0,0.0,6,14,42.9,0,1,0.0,4,11,15,4,0,1,0,0,2,4
../kbl_data/2023-2024,S43G01N166,고양 소노,Home,이정현,40,6,18,33.3,8,32,25.0,14,50,28.0,4,6,66.7,2,4,6,34,4,0,0,0,4,10
../kbl_data/2023-2024,S43G01N166,고양 소노,Home,조재우,0,0,0,0.0,0,0,0.0,0,0,0.0,0,2,0.0,0,0,0,0,0,0,0,0,0,4
../kbl_data/2023-2024,S43G01N166,고양 소노,Home,박종하,17,1,4,25.0,4,8,50.0,5,12,41.7,3,5,60.0,0,1,1,2,1,0,0,0,0,1
../kbl_data/2023-2024,S43G01N166,서울 삼성,Away,이정현,40,6,18,33.3,8,32,25.0,14,50,28.0,4,6,66.7,2,4,6,34,4,0,0,0,4,10
../kbl_data/2023-2024,S43G01N166,서울 삼성,Away,홍경기,0,0,0,0.0,0,0,0.0,0,0,0.0,0,0,0.0,0,0,0,0,0,0,0,0,0,0
../kbl_data/2023-2024,S43G01N166,서울 삼성,Away,김시래,5,1,3,33.3,1,6,16.7,2,9,22.2,0,0,0.0,1,3,4,4,1,0,0,0,1,4
../kbl_data/2023-2024,S43G01N166,서울 삼성,Away,이동엽,3,0,1,0.0,1,6,16.7,1,7,14.3,0,0,0.0,0,1,1,3,0,1,0,0,0,1
../kbl_data/2023-2024,S43G01N166,서울 삼성,Away,최승욱,9,3,4,75.0,0,0,0.0,3,4,75.0,3,4,75.0,0,1,1,0,1,1,0,0,0,3
../kbl_data/2023-2024,S43G01N166,서울 삼성,Away,윤성원,8,1,2,50.0,2,5,40.0,3,7,42.9,0,0,0.0,1,0,1,0,1,0,0,0,0,3
../kbl_data/2023-2024,S43G01N166,서울 삼성,Away,차민석,6,3,3,100.0,0,1,0.0,3,4,75.0,0,0,0.0,1,3,4,0,0,0,0,0,0,3
../kbl_data/2023-2024,S43G01N166,서울 삼성,Away,이원석,3,1,4,25.0,0,0,0.0,1,4,25.0,1,2,50.0,0,2,2,0,1,1,0,0,1,3
../kbl_data/2023-2024,S43G01N166,서울 삼성,Away,신동혁,13,1,3,33.3,3,8,37.5,4,11,36.4,2,2,100.0,1,3,4,4,1,0,0,0,0,2
../kbl_data/2023-2024,S43G01N166,서울 삼성,Away,아반 나바,0,0,0,0.0,0,0,0.0,0,0,0.0,0,0,0.0,0,0,0,0,0,0,0,0,0,0
../kbl_data/2023-2024,S43G01N166,서울 삼성,Away,이스마엘 레인,8,4,4,100.0,0,1,0.0,4,5,80.0,0,0,0.0,1,4,5,3,0,0,0,1,2,0
../kbl_data/2023-2024,S43G01N166,서울 삼성,Away,코피 코번,24,7,11,63.6,0,0,0.0,7,11,63.6,10,14,71.4,7,11,18,0,1,2,0,1,2,1
../kbl_data/2023-2024,S43G01N167,수원 KT,Home,한희원,11,1,2,50.0,3,4,75.0,4,6,66.7,0,0,0.0,1,4,5,0,0,0,0,0,2,4
../kbl_data/2023-2024,S43G01N167,수원 KT,Home,최창진,0,0,1,0.0,0,1,0.0,0,2,0.0,0,0,0.0,0,2,2,1,0,0,0,0,0,1
../kbl_data/2023-2024,S43G01N167,수원 KT,Home,문성곤,0,0,3,0.0,0,0,0.0,0,3,0.0,0,0,0.0,2,1,3,1,2,0,1,0,1,3
../kbl_data/2023-2024,S43G01N167,수원 KT,Home,이현석,0,0,0,0.0,0,0,0.0,0,0,0.0,0,0,0.0,0,0,0,0,0,0,0,0,0,0
../kbl_data/2023-2024,S43G01N167,수원 KT,Home,정성우,6,2,5,40.0,0,4,0.0,2,9,22.2,2,2,100.0,0,0,0,9,0,0,0,0,2,2
../kbl_data/2023-2024,S43G01N167,수원 KT,Home,최성모,5,1,1,100.0,1,1,100.0,2,2,100.0,0,0,0.0,0,1,1,1,0,0,0,0,0,1
../kbl_data/2023-2024,S43G01N167,수원 KT,Home,이윤기,0,0,0,0.0,0,0,0.0,0,0,0.0,0,0,0.0,0,0,0,0,0,0,0,0,0,0
../kbl_data/2023-2024,S43G01N167,수원 KT,Home,하윤기,19,7,13,53.8,0,0,0.0,7,13,53.8,5,9,55.6,5,5,10,0,2,1,0,0,1,1
../kbl_data/2023-2024,S43G01N167,수원 KT,Home,이두원,0,0,0,0.0,0,0,0.0,0,0,0.0,0,0,0.0,0,0,0,0,0,0,0,0,0,0
../kbl_data/2023-2024,S43G01N167,수원 KT,Home,문정현,10,3,5,60.0,1,2,50.0,4,7,57.1,1,4,25.0,0,4,4,0,4,0,0,2,0,3
../kbl_data/2023-2024,S43G01N167,수원 KT,Home,마이클 에릭,0,0,0,0.0,0,0,0.0,0,0,0.0,0,0,0.0,1,0,1,0,0,0,0,0,0,0
../kbl_data/2023-2024,S43G01N167,수원 KT,Home,패리스 배스,17,7,14,50.0,1,7,14.3,8,21,38.1,0,1,0.0,0,9,9,4,3,0,0,0,3,2
../kbl_data/2023-2024,S43G01N167,서울 SK,Away,양우섭,6,0,2,0.0,2,3,66.7,2,5,40.0,0,0,0.0,0,1,1,2,1,0,0,0,4,0
../kbl_data/2023-2024,S43G01N167,서울 SK,Away,송창용,9,1,3,33.3,1,5,20.0,2,8,25.0,4,4,100.0,1,1,2,0,2,0,0,0,1,4
../kbl_data/2023-2024,S43G01N167,서울 SK,Away,오세근,6,3,5,60.0,0,1,0.0,3,6,50.0,0,1,0.0,0,8,8,3,1,0,0,0,1,3
../kbl_data/2023-2024,S43G01N167,서울 SK,Away,최부경,6,2,3,66.7,0,0,0.0,2,3,66.7,2,2,100.0,2,3,5,1,0,0,0,0,1,2
../kbl_data/2023-2024,S43G01N167,서울 SK,Away,리온 윌리엄스,0,0,0,0.0,0,0,0.0,0,0,0.0,0,0,0.0,0,0,0,0,0,0,0,0,0,0
../kbl_data/2023-2024,S43G01N167,서울 SK,Away,최원혁,0,0,1,0.0,0,1,0.0,0,2,0.0,0,0,0.0,1,0,1,3,0,0,0,0,1,4
../kbl_data/2023-2024,S43G01N167,서울 SK,Away,자밀 워니,20,8,15,53.3,1,5,20.0,9,20,45.0,1,5,20.0,4,10,14,5,2,0,0,0,2,1
../kbl_data/2023-2024,S43G01N167,서울 SK,Away,전성환,0,0,0,0.0,0,0,0.0,0,0,0.0,0,0,0.0,0,0,0,0,0,0,0,0,0,0
../kbl_data/2023-2024,S43G01N167,서울 SK,Away,김형빈,0,0,1,0.0,0,1,0.0,0,2,0.0,0,0,0.0,0,0,0,0,0,0,0,0,0,1
../kbl_data/2023-2024,S43G01N167,서울 SK,Away,박민우,0,0,0,0.0,0,0,0.0,0,0,0.0,0,0,0.0,0,0,0,0,0,0,0,0,0,0
../kbl_data/2023-2024,S43G01N167,서울 SK,Away,오재현,18,2,8,25.0,3,5,60.0,5,13,38.5,5,7,71.4,1,4,5,2,1,0,0,0,3,4
../kbl_data/2023-2024,S43G01N167,서울 SK,Away,문가온,0,0,0,0.0,0,0,0.0,0,0,0.0,0,0,0.0,0,0,0,0,0,0,0,0,0,0
../kbl_data/2023-2024,S43G01N168,대구 한국가스공사,Home,김동량,8,2,3,66.7,1,1,100.0,3,4,75.0,1,1,100.0,0,3,3,3,1,0,0,0,0,4
../kbl_data/2023-2024,S43G01N168,대구 한국가스공사,Home,차바위,3,0,1,0.0,1,2,50.0,1,3,33.3,0,0,0.0,1,3,4,6,0,0,0,0,0,5
../kbl_data/2023-2024,S43G01N168,대구 한국가스공사,Home,박지훈,7,2,3,66.7,1,2,50.0,3,5,60.0,0,0,0.0,2,3,5,1,0,0,1,0,3,4
../kbl_data/2023-2024,S43G01N168,대구 한국가스공사,Home,박봉진,0,0,0,0.0,0,0,0.0,0,0,0.0,0,0,0.0,0,0,0,0,0,0,0,0,0,1
../kbl_data/2023-2024,S43G01N168,대구 한국가스공사,Home,양준우,0,0,0,0.0,0,0,0.0,0,0,0.0,0,0,0.0,0,0,0,1,0,0,0,0,0,0
../kbl_data/2023-2024,S43G01N168,대구 한국가스공사,Home,이도헌,0,0,0,0.0,0,0,0.0,0,0,0.0,0,0,0.0,0,0,0,0,0,0,0,0,0,0
../kbl_data/2023-2024,S43G01N168,대구 한국가스공사,Home,앤드류 니콜슨,36,7,17,41.2,5,8,62.5,12,25,48.0,7,7,100.0,4,9,13,1,1,1,0,0,6,1
../kbl_data/2023-2024,S43G01N168,대구 한국가스공사,Home,신승민,12,3,4,75.0,2,6,33.3,5,10,50.0,0,2,0.0,0,4,4,0,0,0,0,0,0,4
../kbl_data/2023-2024,S43G01N168,대구 한국가스공사,Home,샘조세프 벨란겔,26,8,11,72.7,2,6,33.3,10,17,58.8,4,5,80.0,0,0,0,5,2,0,1,0,1,4
../kbl_data/2023-2024,S43G01N168,대구 한국가스공사,Home,안세영,0,0,0,0.0,0,0,0.0,0,0,0.0,0,0,0.0,0,0,0,0,0,0,0,0,0,0
../kbl_data/2023-2024,S43G01N168,대구 한국가스공사,Home,신주영,6,2,3,66.7,0,1,0.0,2,4,50.0,2,2,100.0,0,2,2,2,1,0,0,0,0,1
../kbl_data/2023-2024,S43G01N168,대구 한국가스공사,Home,듀반 맥스웰,2,1,2,50.0,0,1,0.0,1,3,33.3,0,0,0.0,0,1,1,1,0,1,0,0,0,1
../kbl_data/2023-2024,S43G01N168,부산 KCC,Away,라건아,9,4,8,50.0,0,1,0.0,4,9,44.4,1,1,100.0,3,3,6,4,0,0,0,0,0,1
../kbl_data/2023-2024,S43G01N168,부산 KCC,Away,전준범,0,0,0,0.0,0,0,0.0,0,0,0.0,0,0,0.0,0,0,0,0,0,0,0,0,0,1
../kbl_data/2023-2024,S43G01N168,부산 KCC,Away,허웅,15,5,6,83.3,1,6,16.7,6,12,50.0,2,2,100.0,0,2,2,4,1,0,2,0,2,3
../kbl_data/2023-2024,S43G01N168,부산 KCC,Away,이승현,15,5,8,62.5,1,3,33.3,6,11,54.5,2,2,100.0,2,3,5,1,1,4,0,0,2,3
../kbl_data/2023-2024,S43G01N168,부산 KCC,Away,최준용,32,9,19,47.4,3,6,50.0,12,25,48.0,5,7,71.4,1,6,7,3,1,2,0,1,4,2
../kbl_data/2023-2024,S43G01N168,부산 KCC,Away,이진욱,0,0,0,0.0,0,0,0.0,0,0,0.0,0,0,0.0,0,0,0,0,0,0,0,0,0,0
../kbl_data/2023-2024,S43G01N168,부산 KCC,Away,곽정훈,0,0,1,0.0,0,0,0.0,0,1,0.0,0,0,0.0,0,0,0,0,0,0,0,0,0,0
../kbl_data/2023-2024,S43G01N168,부산 KCC,Away,이근휘,3,0,2,0.0,1,4,25.0,1,6,16.7,0,0,0.0,0,1,1,0,1,0,0,0,0,1
../kbl_data/2023-2024,S43G01N168,부산 KCC,Away,김동현,0,0,0,0.0,0,1,0.0,0,1,0.0,0,0,0.0,0,2,2,0,1,0,0,0,0,3
../kbl_data/2023-2024,S43G01N168,부산 KCC,Away,여준형,0,0,1,0.0,0,0,0.0,0,1,0.0,0,0,0.0,0,0,0,0,0,0,0,0,0,0
../kbl_data/2023-2024,S43G01N168,부산 KCC,Away,캘빈 제프리 에피스톨라,10,2,2,100.0,2,2,100.0,4,4,100.0,0,0,0.0,0,1,1,2,2,0,0,0,0,2
../kbl_data/2023-2024,S43G01N168,부산 KCC,Away,알리제 드숀 존슨,14,3,8,37.5,0,1,0.0,3,9,33.3,8,8,100.0,10,3,13,2,0,0,0,0,0,3
../kbl_data/2023-2024,S43G01N169,창원 LG,Home,이관희,15,2,3,66.7,3,9,33.3,5,12,41.7,2,2,100.0,0,4,4,1,3,0,1,0,1,0
../kbl_data/2023-2024,S43G01N169,창원 LG,Home,정희재,9,2,4,50.0,1,2,50.0,3,6,50.0,2,2,100.0,2,1,3,1,1,1,0,0,0,4
../kbl_data/2023-2024,S43G01N169,창원 LG,Home,임동섭,3,1,1,100.0,0,1,0.0,1,2,50.0,1,1,100.0,0,0,0,0,0,0,0,0,0,0
../kbl_data/2023-2024,S43G01N169,창원 LG,Home,한상혁,2,1,1,100.0,0,0,0.0,1,1,100.0,0,0,0.0,0,0,0,1,0,0,0,0,0,0
../kbl_data/2023-2024,S43G01N169,창원 LG,Home,이재도,11,1,3,33.3,3,4,75.0,4,7,57.1,0,0,0.0,0,1,1,8,0,0,0,0,2,1
../kbl_data/2023-2024,S43G01N169,창원 LG,Home,정인덕,4,2,2,100.0,0,0,0.0,2,2,100.0,0,2,0.0,0,1,1,1,1,0,1,0,1,3
../kbl_data/2023-2024,S43G01N169,창원 LG,Home,양홍석,28,6,10,60.0,4,5,80.0,10,15,66.7,4,4,100.0,0,4,4,2,0,0,0,0,1,3
../kbl_data/2023-2024,S43G01N169,창원 LG,Home,박정현,0,0,4,0.0,0,0,0.0,0,4,0.0,0,0,0.0,0,1,1,1,0,0,0,0,3,4
../kbl_data/2023-2024,S43G01N169,창원 LG,Home,이승우,3,1,1,100.0,0,1,0.0,1,2,50.0,1,2,50.0,0,5,5,1,1,0,0,0,0,1
../kbl_data/2023-2024,S43G01N169,창원 LG,Home,양준석,4,2,3,66.7,0,0,0.0,2,3,66.7,0,0,0.0,0,2,2,4,1,0,0,0,1,2
../kbl_data/2023-2024,S43G01N169,창원 LG,Home,유기상,5,1,2,50.0,1,2,50.0,2,4,50.0,0,0,0.0,0,4,4,1,2,0,0,0,0,3
../kbl_data/2023-2024,S43G01N169,창원 LG,Home,후안 텔로,16,5,11,45.5,2,2,100.0,7,13,53.8,0,2,0.0,3,6,9,7,2,0,0,1,1,1
../kbl_data/2023-2024,S43G01N169,서울 삼성,Away,이정현,0,0,4,0.0,0,1,0.0,0,5,0.0,0,0,0.0,0,1,1,5,0,0,0,0,3,2
../kbl_data/2023-2024,S43G01N169,서울 삼성,Away,김시래,9,1,4,25.0,1,2,50.0,2,6,33.3,4,4,100.0,0,2,2,1,1,0,0,0,0,2
../kbl_data/2023-2024,S43G01N169,서울 삼성,Away,이동엽,4,0,0,0.0,0,3,0.0,0,3,0.0,4,4,100.0,1,1,2,3,1,0,0,0,1,3
../kbl_data/2023-2024,S43G01N169,서울 삼성,Away,최승욱,5,2,4,50.0,0,0,0.0,2,4,50.0,1,2,50.0,0,1,1,1,1,1,0,0,1,2
../kbl_data/2023-2024,S43G01N169,서울 삼성,Away,윤성원,0,0,0,0.0,0,0,0.0,0,0,0.0,0,0,0.0,0,2,2,0,0,0,0,0,0,1
../kbl_data/2023-2024,S43G01N169,서울 삼성,Away,차민석,13,4,5,80.0,0,0,0.0,4,5,80.0,5,6,83.3,1,5,6,0,0,0,0,0,0,3
../kbl_data/2023-2024,S43G01N169,서울 삼성,Away,이원석,0,0,2,0.0,0,0,0.0,0,2,0.0,0,0,0.0,2,1,3,0,0,0,0,0,0,2
../kbl_data/2023-2024,S43G01N169,서울 삼성,Away,신동혁,8,1,2,50.0,2,5,40.0,3,7,42.9,0,0,0.0,0,2,2,1,0,0,0,0,3,1
../kbl_data/2023-2024,S43G01N169,서울 삼성,Away,조준희,3,1,2,50.0,0,1,0.0,1,3,33.3,1,2,50.0,1,0,1,0,2,0,0,0,0,2
../kbl_data/2023-2024,S43G01N169,서울 삼성,Away,아반 나바,3,1,2,50.0,0,1,0.0,1,3,33.3,1,2,50.0,0,1,1,4,0,0,0,0,3,0
../kbl_data/2023-2024,S43G01N169,서울 삼성,Away,이스마엘 레인,19,5,6,83.3,3,9,33.3,8,15,53.3,0,1,0.0,1,6,7,0,2,0,0,1,2,2
../kbl_data/2023-2024,S43G01N169,서울 삼성,Away,코피 코번,10,4,10,40.0,0,0,0.0,4,10,40.0,2,2,100.0,1,5,6,1,1,0,0,0,2,1
../kbl_data/2023-2024,S43G01N170,울산 현대모비스,Home,함지훈,6,1,4,25.0,0,0,0.0,1,4,25.0,4,6,66.7,1,0,1,2,1,0,0,0,0,1
../kbl_data/2023-2024,S43G01N170,울산 현대모비스,Home,최진수,0,0,0,0.0,0,1,0.0,0,1,0.0,0,0,0.0,0,0,0,0,0,0,0,0,0,2
../kbl_data/2023-2024,S43G01N170,울산 현대모비스,Home,김현수,0,0,0,0.0,0,0,0.0,0,0,0.0,0,0,0.0,0,0,0,0,0,0,0,0,0,0
../kbl_data/2023-2024,S43G01N170,울산 현대모비스,Home,장재석,11,5,10,50.0,0,0,0.0,5,10,50.0,1,2,50.0,4,2,6,1,1,0,0,0,2,2
../kbl_data/2023-2024,S43G01N170,울산 현대모비스,Home,김지완,9,0,1,0.0,3,7,42.9,3,8,37.5,0,0,0.0,1,1,2,2,1,0,0,0,0,5
../kbl_data/2023-2024,S43G01N170,울산 현대모비스,Home,김준일,0,0,0,0.0,0,0,0.0,0,0,0.0,0,0,0.0,0,0,0,0,0,0,0,0,0,0
../kbl_data/2023-2024,S43G01N170,울산 현대모비스,Home,김국찬,0,0,1,0.0,0,2,0.0,0,3,0.0,0,0,0.0,0,0,0,1,0,0,0,0,1,2
../kbl_data/2023-2024,S43G01N170,울산 현대모비스,Home,이우석,18,6,9,66.7,2,6,33.3,8,15,53.3,0,0,0.0,1,10,11,7,2,1,0,1,1,3
../kbl_data/2023-2024,S43G01N170,울산 현대모비스,Home,게이지 프림,19,5,10,50.0,1,1,100.0,6,11,54.5,6,8,75.0,5,5,10,2,0,0,0,0,1,0
../kbl_data/2023-2024,S43G01N170,울산 현대모비스,Home,박무빈,0,0,1,0.0,0,1,0.0,0,2,0.0,0,0,0.0,1,1,2,3,2,0,0,0,2,3
../kbl_data/2023-2024,S43G01N170,울산 현대모비스,Home,케베 알루마,21,6,8,75.0,1,2,50.0,7,10,70.0,6,6,100.0,5,4,9,2,0,0,0,1,3,2
../kbl_data/2023-2024,S43G01N170,울산 현대모비스,Home,미구엘 안드레 옥존,9,0,1,0.0,3,7,42.9,3,8,37.5,0,0,0.0,0,2,2,2,0,0,0,0,3,2
../kbl_data/2023-2024,S43G01N170,고양 소노,Away,김강선,5,1,1,100.0,1,2,50.0,2,3,66.7,0,0,0.0,0,1,1,0,0,0,1,0,2,1
../kbl_data/2023-2024,S43G01N170,고양 소노,Away,함준후,0,0,0,0.0,0,0,0.0,0,0,0.0,0,0,0.0,0,0,0,0,0,0,0,0,1,0
../kbl_data/2023-2024,S43G01N170,고양 소노,Away,최현민,3,0,2,0.0,1,4,25.0,1,6,16.7,0,0,0.0,0,0,0,0,0,1,0,0,0,3
../kbl_data/2023-2024,S43G01N170,고양 소노,Away,김민욱,16,2,4,50.0,4,6,66.7,6,10,60.0,0,0,0.0,0,1,1,2,0,0,0,0,0,4
../kbl_data/2023-2024,S43G01N170,고양 소노,Away,한호빈,7,2,2,100.0,1,2,50.0,3,4,75.0,0,0,0.0,0,2,2,2,2,0,1,0,0,2
../kbl_data/2023-2024,S43G01N170,고양 소노,Away,김지후,0,0,0,0.0,0,0,0.0,0,0,0.0,0,0,0.0,0,0,0,0,0,0,0,0,0,1
../kbl_data/2023-2024,S43G01N170,고양 소노,Away,다후안 서머스,12,3,5,60.0,2,6,33.3,5,11,45.5,0,0,0.0,0,2,2,0,1,1,0,1,2,1
../kbl_data/2023-2024,S43G01N170,고양 소노,Away,치나누 오누아쿠,17,8,11,72.7,0,0,0.0,8,11,72.7,1,1,100.0,2,7,9,4,2,1,0,2,3,5
../kbl_data/2023-2024,S43G01N170,고양 소노,Away,이정현,25,5,7,71.4,2,9,22.2,7,16,43.8,9,13,69.2,1,3,4,8,2,0,0,0,2,2
../kbl_data/2023-2024,S43G01N170,고양 소노,Away,백지웅,0,0,0,0.0,0,0,0.0,0,0,0.0,0,0,0.0,0,0,0,0,0,0,0,0,0,1
../kbl_data/2023-2024,S43G01N170,고양 소노,Away,조재우,0,0,0,0.0,0,0,0.0,0,0,0.0,0,0,0.0,0,0,0,0,0,0,0,0,0,1
../kbl_data/2023-2024,S43G01N170,고양 소노,Away,박종하,0,0,0,0.0,0,2,0.0,0,2,0.0,0,0,0.0,0,0,0,0,1,0,0,0,1,3
../kbl_data/2023-2024,S43G01N171,수원 KT,Home,한희원,5,2,2,100.0,0,2,0.0,2,4,50.0,1,2,50.0,1,1,2,0,0,0,0,0,0,4
../kbl_data/2023-2024,S43G01N171,수원 KT,Home,최창진,0,0,0,0.0,0,0,0.0,0,0,0.0,0,0,0.0,0,0,0,0,0,0,0,0,0,0
../kbl_data/2023-2024,S43G01N171,수원 KT,Home,문성곤,2,1,3,33.3,0,3,0.0,1,6,16.7,0,1,0.0,0,2,2,1,2,0,0,0,0,2
../kbl_data/2023-2024,S43G01N171,수원 KT,Home,이현석,0,0,0,0.0,0,1,0.0,0,1,0.0,0,0,0.0,0,3,3,0,0,0,0,0,0,2
../kbl_data/2023-2024,S43G01N171,수원 KT,Home,정성우,11,4,5,80.0,1,4,25.0,5,9,55.6,0,0,0.0,1,1,2,4,0,0,0,0,0,4
../kbl_data/2023-2024,S43G01N171,수원 KT,Home,최성모,2,1,2,50.0,0,3,0.0,1,5,20.0,0,0,0.0,1,4,5,2,0,0,0,0,0,1
../kbl_data/2023-2024,S43G01N171,수원 KT,Home,이윤기,0,0,1,0.0,0,1,0.0,0,2,0.0,0,0,0.0,1,0,1,0,0,0,0,0,0,1
../kbl_data/2023-2024,S43G01N171,수원 KT,Home,하윤기,23,8,15,53.3,0,0,0.0,8,15,53.3,7,8,87.5,6,2,8,2,0,0,0,0,0,0
../kbl_data/2023-2024,S43G01N171,수원 KT,Home,이두원,1,0,0,0.0,0,0,0.0,0,0,0.0,1,2,50.0,0,0,0,0,0,0,0,0,0,1
../kbl_data/2023-2024,S43G01N171,수원 KT,Home,문정현,18,5,8,62.5,1,2,50.0,6,10,60.0,5,6,83.3,4,5,9,0,1,0,0,1,1,4
../kbl_data/2023-2024,S43G01N171,수원 KT,Home,마이클 에릭,2,1,1,100.0,0,0,0.0,1,1,100.0,0,0,0.0,1,1,2,0,0,0,0,0,1,0
../kbl_data/2023-2024,S43G01N171,수원 KT,Home,패리스 배스,30,9,15,60.0,3,7,42.9,12,22,54.5,3,3,100.0,1,10,11,5,1,0,0,2,3,2
../kbl_data/2023-2024,S43G01N171,안양 정관장,Away,정준원,4,2,5,40.0,0,1,0.0,2,6,33.3,0,0,0.0,4,3,7,0,1,0,0,0,0,3
../kbl_data/2023-2024,S43G01N171,안양 정관장,Away,김상규,0,0,0,0.0,0,0,0.0,0,0,0.0,0,0,0.0,0,0,0,0,0,0,0,0,0,0
../kbl_data/2023-2024,S43G01N171,안양 정관장,Away,배병준,14,1,2,50.0,4,6,66.7,5,8,62.5,0,0,0.0,0,0,0,1,0,0,0,0,2,2
../kbl_data/2023-2024,S43G01N171,안양 정관장,Away,정효근,3,0,1,0.0,1,2,50.0,1,3,33.3,0,0,0.0,0,0,0,0,0,0,0,0,1,2
../kbl_data/2023-2024,S43G01N171,안양 정관장,Away,이종현,6,2,4,50.0,0,1,0.0,2,5,40.0,2,4,50.0,1,8,9,5,1,0,0,0,2,2
../kbl_data/2023-2024,S43G01N171,안양 정관장,Away,김철욱,0,0,1,0.0,0,0,0.0,0,1,0.0,0,0,0.0,1,2,3,0,0,0,0,0,0,2
../kbl_data/2023-2024,S43G01N171,안양 정관장,Away,박지훈,14,4,5,80.0,0,2,0.0,4,7,57.1,6,8,75.0,1,3,4,2,0,0,0,0,2,4
../kbl_data/2023-2024,S43G01N171,안양 정관장,Away,최성원,21,2,2,100.0,4,10,40.0,6,12,50.0,5,5,100.0,0,2,2,4,2,0,1,0,0,1
../kbl_data/2023-2024,S43G01N171,안양 정관장,Away,이우정,0,0,0,0.0,0,0,0.0,0,0,0.0,0,0,0.0,0,1,1,0,0,0,0,0,0,1
../kbl_data/2023-2024,S43G01N171,안양 정관장,Away,고찬혁,0,0,0,0.0,0,1,0.0,0,1,0.0,0,0,0.0,0,0,0,0,0,0,0,0,0,0
../kbl_data/2023-2024,S43G01N171,안양 정관장,Away,로버트 카터,2,1,4,25.0,0,4,0.0,1,8,12.5,0,0,0.0,0,2,2,0,0,0,0,0,1,2
../kbl_data/2023-2024,S43G01N171,안양 정관장,Away,자밀 윌슨,14,3,9,33.3,2,6,33.3,5,15,33.3,2,2,100.0,2,1,3,1,0,1,0,0,0,2
../kbl_data/2023-2024,S43G01N172,대구 한국가스공사,Home,차바위,0,0,0,0.0,0,0,0.0,0,0,0.0,0,0,0.0,0,0,0,0,0,0,0,0,0,0
../kbl_data/2023-2024,S43G01N172,대구 한국가스공사,Home,박지훈,8,1,3,33.3,2,3,66.7,3,6,50.0,0,0,0.0,0,2,2,1,2,0,0,0,0,3
../kbl_data/2023-2024,S43G01N172,대구 한국가스공사,Home,박봉진,9,0,0,0.0,3,7,42.9,3,7,42.9,0,0,0.0,0,4,4,1,1,0,1,0,0,4
../kbl_data/2023-2024,S43G01N172,대구 한국가스공사,Home,양준우,3,1,4,25.0,0,0,0.0,1,4,25.0,1,2,50.0,0,1,1,2,0,0,0,0,2,0
../kbl_data/2023-2024,S43G01N172,대구 한국가스공사,Home,이도헌,5,1,2,50.0,1,2,50.0,2,4,50.0,0,0,0.0,1,0,1,0,1,0,0,0,1,2
../kbl_data/2023-2024,S43G01N172,대구 한국가스공사,Home,앤드류 니콜슨,10,5,6,83.3,0,1,0.0,5,7,71.4,0,0,0.0,0,6,6,1,0,1,0,2,0,0
../kbl_data/2023-2024,S43G01N172,대구 한국가스공사,Home,신승민,20,3,4,75.0,4,5,80.0,7,9,77.8,2,2,100.0,0,2,2,2,0,0,1,0,1,2
../kbl_data/2023-2024,S43G01N172,대구 한국가스공사,Home,김진모,3,0,0,0.0,1,1,100.0,1,1,100.0,0,0,0.0,0,0,0,0,0,0,0,0,0,1
../kbl_data/2023-2024,S43G01N172,대구 한국가스공사,Home,샘조세프 벨란겔,21,4,8,50.0,4,6,66.7,8,14,57.1,1,2,50.0,0,6,6,8,1,0,1,0,2,3
../kbl_data/2023-2024,S43G01N172,대구 한국가스공사,Home,안세영,7,2,2,100.0,1,2,50.0,3,4,75.0,0,0,0.0,0,2,2,2,0,0,0,0,0,5
../kbl_data/2023-2024,S43G01N172,대구 한국가스공사,Home,신주영,0,0,0,0.0,0,1,0.0,0,1,0.0,0,0,0.0,2,1,3,1,0,1,0,0,0,2
../kbl_data/2023-2024,S43G01N172,대구 한국가스공사,Home,듀반 맥스웰,12,6,10,60.0,0,0,0.0,6,10,60.0,0,0,0.0,2,5,7,3,1,1,1,2,2,1
../kbl_data/2023-2024,S43G01N172,원주 DB,Away,김현호,2,0,0,0.0,0,1,0.0,0,1,0.0,2,2,100.0,0,2,2,1,0,0,1,0,2,1
../kbl_data/2023-2024,S43G01N172,원주 DB,Away,서민수,13,3,4,75.0,2,3,66.7,5,7,71.4,1,3,33.3,0,4,4,2,1,1,0,0,0,2
../kbl_data/2023-2024,S43G01N172,원주 DB,Away,김영현,0,0,0,0.0,0,0,0.0,0,0,0.0,0,0,0.0,0,0,0,1,0,0,0,0,1,2
../kbl_data/2023-2024,S43G01N172,원주 DB,Away,김종규,5,1,3,33.3,0,0,0.0,1,3,33.3,3,4,75.0,5,3,8,0,0,0,0,0,2,1
../kbl_data/2023-2024,S43G01N172,원주 DB,Away,최승욱,6,3,4,75.0,0,0,0.0,3,4,75.0,0,0,0.0,0,1,1,0,1,0,0,0,0,3
../kbl_data/2023-2024,S43G01N172,원주 DB,Away,강상재,6,0,4,0.0,2,3,66.7,2,7,28.6,0,0,0.0,1,2,3,3,0,0,0,0,0,1
../kbl_data/2023-2024,S43G01N172,원주 DB,Away,유현준,6,0,2,0.0,2,8,25.0,2,10,20.0,0,0,0.0,0,0,0,4,1,0,0,0,2,2
../kbl_data/2023-2024,S43G01N172,원주 DB,Away,디드릭 로슨,15,1,7,14.3,3,6,50.0,4,13,30.8,4,8,50.0,3,3,6,6,1,1,0,0,2,1
../kbl_data/2023-2024,S43G01N172,원주 DB,Away,이용우,3,0,0,0.0,1,5,20.0,1,5,20.0,0,0,0.0,0,0,0,0,0,0,0,0,2,1
../kbl_data/2023-2024,S43G01N172,원주 DB,Away,이선 알바노,3,0,2,0.0,1,2,50.0,1,4,25.0,0,0,0.0,1,2,3,1,0,1,0,0,1,1
../kbl_data/2023-2024,S43G01N172,원주 DB,Away,박인웅,5,1,1,100.0,1,5,20.0,2,6,33.3,0,0,0.0,0,0,0,1,0,0,0,0,0,3
../kbl_data/2023-2024,S43G01N172,원주 DB,Away,제프 위디,9,3,4,75.0,0,0,0.0,3,4,75.0,3,3,100.0,1,3,4,1,0,0,0,1,1,0
../kbl_data/2023-2024,S43G01N173,서울 SK,Home,양우섭,15,3,4,75.0,3,10,30.0,6,14,42.9,0,0,0.0,2,4,6,1,2,0,0,0,0,4
../kbl_data/2023-2024,S43G01N173,서울 SK,Home,송창용,1,0,1,0.0,0,1,0.0,0,2,0.0,1,2,50.0,0,2,2,0,0,0,0,0,1,2
../kbl_data/2023-2024,S43G01N173,서울 SK,Home,오세근,8,4,8,50.0,0,3,0.0,4,11,36.4,0,0,0.0,1,1,2,0,1,0,0,0,1,4
../kbl_data/2023-2024,S43G01N173,서울 SK,Home,최부경,10,4,9,44.4,0,0,0.0,4,9,44.4,2,2,100.0,5,3,8,0,1,0,0,0,1,4
../kbl_data/2023-2024,S43G01N173,서울 SK,Home,리온 윌리엄스,0,0,0,0.0,0,0,0.0,0,0,0.0,0,0,0.0,0,0,0,0,0,0,0,0,0,0
../kbl_data/2023-2024,S43G01N173,서울 SK,Home,최원혁,0,0,0,0.0,0,0,0.0,0,0,0.0,0,0,0.0,1,0,1,0,0,0,0,0,0,1
../kbl_data/2023-2024,S43G01N173,서울 SK,Home,자밀 워니,21,6,17,35.3,2,6,33.3,8,23,34.8,3,7,42.9,5,13,18,11,3,2,0,1,2,0
../kbl_data/2023-2024,S43G01N173,서울 SK,Home,전성환,0,0,0,0.0,0,0,0.0,0,0,0.0,0,0,0.0,0,0,0,0,0,0,0,0,0,0
../kbl_data/2023-2024,S43G01N173,서울 SK,Home,김형빈,3,0,0,0.0,1,2,50.0,1,2,50.0,0,0,0.0,0,2,2,0,0,0,0,0,0,2
../kbl_data/2023-2024,S43G01N173,서울 SK,Home,박민우,0,0,0,0.0,0,0,0.0,0,0,0.0,0,0,0.0,0,0,0,0,0,0,0,0,0,0
../kbl_data/2023-2024,S43G01N173,서울 SK,Home,오재현,29,6,10,60.0,5,11,45.5,11,21,52.4,2,2,100.0,1,1,2,7,1,0,0,0,2,5
../kbl_data/2023-2024,S43G01N173,서울 SK,Home,문가온,0,0,0,0.0,0,0,0.0,0,0,0.0,0,0,0.0,0,0,0,0,0,0,0,0,0,0
../kbl_data/2023-2024,S43G01N173,부산 KCC,Away,라건아,19,5,12,41.7,1,1,100.0,6,13,46.2,6,6,100.0,2,9,11,2,0,3,0,0,1,3
../kbl_data/2023-2024,S43G01N173,부산 KCC,Away,전준범,0,0,0,0.0,0,0,0.0,0,0,0.0,0,0,0.0,0,0,0,0,0,0,0,0,0,0
../kbl_data/2023-2024,S43G01N173,부산 KCC,Away,허웅,31,5,6,83.3,5,11,45.5,10,17,58.8,6,6,100.0,0,2,2,5,0,0,0,0,2,3
../kbl_data/2023-2024,S43G01N173,부산 KCC,Away,이승현,4,2,4,50.0,0,0,0.0,2,4,50.0,0,0,0.0,1,3,4,0,0,0,0,0,1,3
../kbl_data/2023-2024,S43G01N173,부산 KCC,Away,최준용,22,8,15,53.3,2,6,33.3,10,21,47.6,0,0,0.0,0,6,6,8,2,2,0,0,3,1
../kbl_data/2023-2024,S43G01N173,부산 KCC,Away,이진욱,0,0,0,0.0,0,0,0.0,0,0,0.0,0,0,0.0,0,0,0,0,0,0,0,0,0,0
../kbl_data/2023-2024,S43G01N173,부산 KCC,Away,곽정훈,0,0,0,0.0,0,0,0.0,0,0,0.0,0,0,0.0,0,0,0,0,0,0,0,0,0,0
../kbl_data/2023-2024,S43G01N173,부산 KCC,Away,이근휘,2,0,1,0.0,0,0,0.0,0,1,0.0,2,2,100.0,2,2,4,0,0,0,0,0,0,2
../kbl_data/2023-2024,S43G01N173,부산 KCC,Away,김동현,0,0,0,0.0,0,0,0.0,0,0,0.0,0,0,0.0,0,0,0,0,0,0,0,0,0,0
../kbl_data/2023-2024,S43G01N173,부산 KCC,Away,여준형,0,0,0,0.0,0,0,0.0,0,0,0.0,0,0,0.0,1,0,1,0,0,0,0,0,0,1
../kbl_data/2023-2024,S43G01N173,부산 KCC,Away,캘빈 제프리 에피스톨라,10,3,4,75.0,0,1,0.0,3,5,60.0,4,4,100.0,0,4,4,2,2,0,0,0,1,3
../kbl_data/2023-2024,S43G01N173,부산 KCC,Away,알리제 드숀 존슨,4,2,3,66.7,0,1,0.0,2,4,50.0,0,0,0.0,1,2,3,3,0,0,0,0,0,1
../kbl_data/2023-2024,S43G01N174,수원 KT,Home,한희원,3,0,2,0.0,1,3,33.3,1,5,20.0,0,0,0.0,0,1,1,0,0,0,0,0,0,2
../kbl_data/2023-2024,S43G01N174,수원 KT,Home,최창진,0,0,0,0.0,0,1,0.0,0,1,0.0,0,0,0.0,0,0,0,0,0,0,0,0,0,1
../kbl_data/2023-2024,S43G01N174,수원 KT,Home,문성곤,6,0,0,0.0,2,2,100.0,2,2,100.0,0,0,0.0,2,1,3,2,1,0,0,0,0,5
../kbl_data/2023-2024,S43G01N174,수원 KT,Home,이현석,0,0,0,0.0,0,0,0.0,0,0,0.0,0,0,0.0,0,0,0,0,0,0,0,0,0,1
../kbl_data/2023-2024,S43G01N174,수원 KT,Home,정성우,13,2,8,25.0,3,8,37.5,5,16,31.2,0,2,0.0,2,3,5,3,1,0,0,0,1,5
../kbl_data/2023-2024,S43G01N174,수원 KT,Home,최성모,8,2,2,100.0,1,3,33.3,3,5,60.0,1,1,100.0,0,2,2,2,1,1,0,0,0,3
../kbl_data/2023-2024,S43G01N174,수원 KT,Home,이윤기,0,0,0,0.0,0,0,0.0,0,0,0.0,0,0,0.0,0,0,0,0,0,0,0,0,0,0
../kbl_data/2023-2024,S43G01N174,수원 KT,Home,하윤기,25,12,17,70.6,0,0,0.0,12,17,70.6,1,1,100.0,3,4,7,1,1,0,0,1,1,1
../kbl_data/2023-2024,S43G01N174,수원 KT,Home,이두원,0,0,0,0.0,0,0,0.0,0,0,0.0,0,0,0.0,0,0,0,0,0,0,0,0,0,0
../kbl_data/2023-2024,S43G01N174,수원 KT,Home,문정현,0,0,2,0.0,0,0,0.0,0,2,0.0,0,0,0.0,0,1,1,0,0,0,0,0,1,3
../kbl_data/2023-2024,S43G01N174,수원 KT,Home,마이클 에릭,2,1,1,100.0,0,0,0.0,1,1,100.0,0,0,0.0,1,0,1,0,0,0,0,1,0,0
../kbl_data/2023-2024,S43G01N174,수원 KT,Home,패리스 배스,11,4,13,30.8,0,4,0.0,4,17,23.5,3,4,75.0,1,14,15,4,1,1,0,1,8,4
../kbl_data/2023-2024,S43G01N174,창원 LG,Away,이관희,8,1,2,50.0,1,7,14.3,2,9,22.2,3,4,75.0,0,3,3,1,0,1,0,0,0,0
../kbl_data/2023-2024,S43G01N174,창원 LG,Away,정희재,3,0,1,0.0,0,0,0.0,0,1,0.0,3,4,75.0,0,5,5,1,0,0,1,0,0,4
../kbl_data/2023-2024,S43G01N174,창원 LG,Away,임동섭,0,0,0,0.0,0,0,0.0,0,0,0.0,0,0,0.0,0,0,0,0,0,0,0,0,0,0
../kbl_data/2023-2024,S43G01N174,창원 LG,Away,이재도,11,5,7,71.4,0,1,0.0,5,8,62.5,1,2,50.0,0,4,4,2,1,0,0,0,1,2
../kbl_data/2023-2024,S43G01N174,창원 LG,Away,정인덕,0,0,0,0.0,0,0,0.0,0,0,0.0,0,0,0.0,0,0,0,0,0,0,0,0,0,0
../kbl_data/2023-2024,S43G01N174,창원 LG,Away,양홍석,12,4,6,66.7,1,4,25.0,5,10,50.0,1,3,33.3,3,3,6,3,0,0,0,0,1,3
../kbl_data/2023-2024,S43G01N174,창원 LG,Away,박정현,1,0,1,0.0,0,0,0.0,0,1,0.0,1,2,50.0,1,1,2,0,0,0,0,0,0,0
../kbl_data/2023-2024,S43G01N174,창원 LG,Away,이승우,11,1,2,50.0,2,3,66.7,3,5,60.0,3,4,75.0,0,1,1,1,1,0,1,0,1,3
../kbl_data/2023-2024,S43G01N174,창원 LG,Away,저스틴 구탕,2,1,1,100.0,0,1,0.0,1,2,50.0,0,0,0.0,0,1,1,0,0,0,0,0,0,0
../kbl_data/2023-2024,S43G01N174,창원 LG,Away,양준석,4,2,5,40.0,0,1,0.0,2,6,33.3,0,0,0.0,0,0,0,0,1,0,0,0,1,1
../kbl_data/2023-2024,S43G01N174,창원 LG,Away,유기상,5,2,2,100.0,0,3,0.0,2,5,40.0,1,2,50.0,1,1,2,1,2,0,0,0,2,0
../kbl_data/2023-2024,S43G01N174,창원 LG,Away,후안 텔로,14,5,10,50.0,1,1,100.0,6,11,54.5,1,4,25.0,5,6,11,1,2,1,0,0,2,5
../kbl_data/2023-2024,S43G01N175,울산 현대모비스,Home,함지훈,0,0,0,0.0,0,0,0.0,0,0,0.0,0,0,0.0,0,0,0,0,0,0,0,0,0,0
../kbl_data/2023-2024,S43G01N175,울산 현대모비스,Home,최진수,12,3,4,75.0,2,3,66.7,5,7,71.4,0,0,0.0,0,2,2,2,3,0,0,1,1,2
../kbl_data/2023-2024,S43G01N175,울산 현대모비스,Home,김현수,2,1,1,100.0,0,2,0.0,1,3,33.3,0,0,0.0,0,0,0,0,0,0,0,0,0,1
../kbl_data/2023-2024,S43G01N175,울산 현대모비스,Home,장재석,7,2,4,50.0,0,0,0.0,2,4,50.0,3,4,75.0,2,1,3,4,2,1,0,0,1,4
../kbl_data/2023-2024,S43G01N175,울산 현대모비스,Home,김지완,0,0,0,0.0,0,0,0.0,0,0,0.0,0,0,0.0,0,2,2,5,1,0,0,0,0,1
../kbl_data/2023-2024,S43G01N175,울산 현대모비스,Home,김준일,6,1,4,25.0,0,0,0.0,1,4,25.0,4,6,66.7,3,0,3,2,0,0,0,0,1,3
../kbl_data/2023-2024,S43G01N175,울산 현대모비스,Home,김국찬,9,0,2,0.0,3,3,100.0,3,5,60.0,0,0,0.0,2,3,5,1,1,0,0,0,0,3
../kbl_data/2023-2024,S43G01N175,울산 현대모비스,Home,이우석,13,3,5,60.0,2,3,66.7,5,8,62.5,1,2,50.0,1,2,3,1,0,1,0,0,0,1
../kbl_data/2023-2024,S43G01N175,울산 현대모비스,Home,게이지 프림,26,8,11,72.7,1,3,33.3,9,14,64.3,7,8,87.5,0,6,6,3,1,0,0,0,0,1
../kbl_data/2023-2024,S43G01N175,울산 현대모비스,Home,박무빈,7,1,1,100.0,1,2,50.0,2,3,66.7,2,2,100.0,0,1,1,7,0,0,0,0,2,1
../kbl_data/2023-2024,S43G01N175,울산 현대모비스,Home,케베 알루마,19,5,5,100.0,2,2,100.0,7,7,100.0,3,4,75.0,0,1,1,1,3,0,0,1,1,2
../kbl_data/2023-2024,S43G01N175,울산 현대모비스,Home,미구엘 안드레 옥존,15,6,7,85.7,0,4,0.0,6,11,54.5,3,4,75.0,1,2,3,3,1,0,0,0,2,1
../kbl_data/2023-2024,S43G01N175,서울 삼성,Away,이정현,3,1,2,50.0,0,2,0.0,1,4,25.0,1,1,100.0,0,1,1,0,1,0,0,0,2,1
../kbl_data/2023-2024,S43G01N175,서울 삼성,Away,김시래,0,0,0,0.0,0,1,0.0,0,1,0.0,0,0,0.0,0,2,2,1,0,0,0,0,4,3
../kbl_data/2023-2024,S43G01N175,서울 삼성,Away,이동엽,2,0,1,0.0,0,1,0.0,0,2,0.0,2,2,100.0,0,0,0,3,1,0,0,0,1,3
../kbl_data/2023-2024,S43G01N175,서울 삼성,Away,최승욱,6,3,4,75.0,0,0,0.0,3,4,75.0,0,0,0.0,2,1,3,1,0,0,0,0,0,4
../kbl_data/2023-2024,S43G01N175,서울 삼성,Away,윤성원,4,2,2,100.0,0,0,0.0,2,2,100.0,0,0,0.0,0,1,1,0,0,0,0,0,0,0
../kbl_data/2023-2024,S43G01N175,서울 삼성,Away,차민석,5,1,6,16.7,0,1,0.0,1,7,14.3,3,4,75.0,1,0,1,0,0,1,1,0,1,4
../kbl_data/2023-2024,S43G01N175,서울 삼성,Away,이원석,7,2,3,66.7,1,1,100.0,3,4,75.0,0,0,0.0,2,3,5,0,0,0,0,0,0,1
../kbl_data/2023-2024,S43G01N175,서울 삼성,Away,신동혁,7,2,3,66.7,1,8,12.5,3,11,27.3,0,0,0.0,1,0,1,2,1,0,0,0,2,1
../kbl_data/2023-2024,S43G01N175,서울 삼성,Away,조준희,2,1,3,33.3,0,4,0.0,1,7,14.3,0,0,0.0,2,2,4,2,0,0,0,0,0,2
../kbl_data/2023-2024,S43G01N175,서울 삼성,Away,아반 나바,8,3,4,75.0,0,1,0.0,3,5,60.0,2,2,100.0,0,0,0,2,0,0,0,0,2,0
../kbl_data/2023-2024,S43G01N175,서울 삼성,Away,이스마엘 레인,18,3,6,50.0,4,6,66.7,7,12,58.3,0,0,0.0,1,3,4,0,1,0,0,0,2,3
../kbl_data/2023-2024,S43G01N175,서울 삼성,Away,코피 코번,16,5,8,62.5,0,0,0.0,5,8,62.5,6,7,85.7,4,2,6,1,0,0,0,1,3,1
../kbl_data/2023-2024,S43G01N176,고양 소노,Home,함준후,0,0,0,0.0,0,2,0.0,0,2,0.0,0,0,0.0,0,0,0,0,0,0,0,0,0,1
../kbl_data/2023-2024,S43G01N176,고양 소노,Home,김민욱,7,1,2,50.0,1,5,20.0,2,7,28.6,2,4,50.0,1,6,7,1,0,2,0,0,1,3
../kbl_data/2023-2024,S43G01N176,고양 소노,Home,한호빈,3,0,1,0.0,1,5,20.0,1,6,16.7,0,0,0.0,0,1,1,2,1,0,1,0,0,3
../kbl_data/2023-2024,S43G01N176,고양 소노,Home,김지후,0,0,0,0.0,0,0,0.0,0,0,0.0,0,0,0.0,0,0,0,0,0,0,0,0,1,0
../kbl_data/2023-2024,S43G01N176,고양 소노,Home,다후안 서머스,14,5,5,100.0,1,3,33.3,6,8,75.0,1,1,100.0,0,2,2,0,0,0,0,0,0,2
../kbl_data/2023-2024,S43G01N176,고양 소노,Home,치나누 오누아쿠,22,8,10,80.0,1,2,50.0,9,12,75.0,3,4,75.0,3,11,14,2,4,0,0,1,1,3
../kbl_data/2023-2024,S43G01N176,고양 소노,Home,이정현,9,3,7,42.9,1,8,12.5,4,15,26.7,0,0,0.0,0,2,2,4,0,1,0,0,3,4
../kbl_data/2023-2024,S43G01N176,고양 소노,Home,조은후,0,0,0,0.0,0,0,0.0,0,0,0.0,0,0,0.0,0,0,0,0,0,0,0,0,0,0
../kbl_data/2023-2024,S43G01N176,고양 소노,Home,백지웅,9,0,0,0.0,3,6,50.0,3,6,50.0,0,0,0.0,1,0,1,0,0,0,0,0,0,2
../kbl_data/2023-2024,S43G01N176,고양 소노,Home,안정욱,3,0,0,0.0,1,3,33.3,1,3,33.3,0,0,0.0,0,0,0,0,0,0,0,0,1,1
../kbl_data/2023-2024,S43G01N176,고양 소노,Home,박종하,7,1,2,50.0,1,3,33.3,2,5,40.0,2,2,100.0,1,0,1,2,0,0,0,0,0,1
../kbl_data/2023-2024,S43G01N176,고양 소노,Home,민기남,3,0,0,0.0,1,3,33.3,1,3,33.3,0,0,0.0,0,0,0,0,0,0,0,0,0,1
../kbl_data/2023-2024,S43G01N176,대구 한국가스공사,Away,차바위,0,0,0,0.0,0,0,0.0,0,0,0.0,0,0,0.0,0,0,0,0,0,0,0,0,0,0
../kbl_data/2023-2024,S43G01N176,대구 한국가스공사,Away,박봉진,3,0,0,0.0,1,3,33.3,1,3,33.3,0,0,0.0,2,5,7,0,1,0,0,0,2,4
../kbl_data/2023-2024,S43G01N176,대구 한국가스공사,Away,양준우,1,0,0,0.0,0,0,0.0,0,0,0.0,1,2,50.0,0,1,1,0,1,0,0,0,1,2
../kbl_data/2023-2024,S43G01N176,대구 한국가스공사,Away,이도헌,0,0,0,0.0,0,0,0.0,0,0,0.0,0,0,0.0,0,0,0,0,0,0,0,0,0,0
../kbl_data/2023-2024,S43G01N176,대구 한국가스공사,Away,앤드류 니콜슨,34,6,14,42.9,5,10,50.0,11,24,45.8,7,8,87.5,1,12,13,0,0,0,0,1,7,4
../kbl_data/2023-2024,S43G01N176,대구 한국가스공사,Away,신승민,13,0,2,0.0,3,3,100.0,3,5,60.0,4,4,100.0,3,5,8,1,0,0,0,0,0,2
../kbl_data/2023-2024,S43G01N176,대구 한국가스공사,Away,김진모,0,0,0,0.0,0,0,0.0,0,0,0.0,0,0,0.0,0,0,0,0,0,0,0,0,0,0
../kbl_data/2023-2024,S43G01N176,대구 한국가스공사,Away,최주영,0,0,0,0.0,0,0,0.0,0,0,0.0,0,0,0.0,0,0,0,0,0,0,0,0,0,0
../kbl_data/2023-2024,S43G01N176,대구 한국가스공사,Away,샘조세프 벨란겔,20,6,10,60.0,2,9,22.2,8,19,42.1,2,2,100.0,0,2,2,7,2,0,1,0,1,2
../kbl_data/2023-2024,S43G01N176,대구 한국가스공사,Away,안세영,5,1,2,50.0,1,3,33.3,2,5,40.0,0,0,0.0,1,4,5,4,1,1,0,0,0,5
../kbl_data/2023-2024,S43G01N176,대구 한국가스공사,Away,김태호,0,0,0,0.0,0,0,0.0,0,0,0.0,0,0,0.0,0,0,0,0,0,0,0,0,0,0
../kbl_data/2023-2024,S43G01N176,대구 한국가스공사,Away,듀반 맥스웰,0,0,0,0.0,0,0,0.0,0,0,0.0,0,0,0.0,0,0,0,0,0,0,0,0,0,1
../kbl_data/2023-2024,S43G01N177,부산 KCC,Home,라건아,23,7,8,87.5,2,3,66.7,9,11,81.8,3,3,100.0,0,4,4,4,0,0,0,0,1,0
../kbl_data/2023-2024,S43G01N177,부산 KCC,Home,전준범,3,0,0,0.0,1,3,33.3,1,3,33.3,0,0,0.0,0,0,0,0,0,0,0,0,0,1
../kbl_data/2023-2024,S43G01N177,부산 KCC,Home,허웅,32,0,1,0.0,10,15,66.7,10,16,62.5,2,2,100.0,0,0,0,5,0,0,0,0,2,2
../kbl_data/2023-2024,S43G01N177,부산 KCC,Home,이승현,6,2,3,66.7,0,1,0.0,2,4,50.0,2,2,100.0,1,5,6,5,2,1,0,0,0,1
../kbl_data/2023-2024,S43G01N177,부산 KCC,Home,송교창,10,4,5,80.0,0,5,0.0,4,10,40.0,2,3,66.7,0,6,6,6,1,1,0,0,0,1
../kbl_data/2023-2024,S43G01N177,부산 KCC,Home,최준용,12,4,7,57.1,1,4,25.0,5,11,45.5,1,2,50.0,1,6,7,7,0,0,0,0,1,3
../kbl_data/2023-2024,S43G01N177,부산 KCC,Home,곽정훈,0,0,0,0.0,0,1,0.0,0,1,0.0,0,0,0.0,0,0,0,0,0,0,0,0,1,0
../kbl_data/2023-2024,S43G01N177,부산 KCC,Home,이근휘,0,0,0,0.0,0,0,0.0,0,0,0.0,0,0,0.0,0,1,1,0,0,0,0,0,1,0
../kbl_data/2023-2024,S43G01N177,부산 KCC,Home,김동현,3,0,0,0.0,1,2,50.0,1,2,50.0,0,0,0.0,0,0,0,0,0,0,0,0,1,1
../kbl_data/2023-2024,S43G01N177,부산 KCC,Home,여준형,0,0,0,0.0,0,0,0.0,0,0,0.0,0,0,0.0,0,0,0,0,0,0,0,0,0,0
../kbl_data/2023-2024,S43G01N177,부산 KCC,Home,캘빈 제프리 에피스톨라,3,0,0,0.0,1,3,33.3,1,3,33.3,0,0,0.0,0,1,1,0,0,0,0,0,0,5
../kbl_data/2023-2024,S43G01N177,부산 KCC,Home,알리제 드숀 존슨,16,6,8,75.0,1,2,50.0,7,10,70.0,1,2,50.0,2,6,8,1,1,0,0,0,0,1
../kbl_data/2023-2024,S43G01N177,안양 정관장,Away,정준원,5,2,8,25.0,0,0,0.0,2,8,25.0,1,1,100.0,1,2,3,1,0,0,0,0,0,1
../kbl_data/2023-2024,S43G01N177,안양 정관장,Away,김상규,7,2,2,100.0,1,2,50.0,3,4,75.0,0,0,0.0,1,2,3,3,1,0,0,0,0,3
../kbl_data/2023-2024,S43G01N177,안양 정관장,Away,배병준,17,1,2,50.0,4,8,50.0,5,10,50.0,3,3,100.0,0,1,1,2,1,0,0,0,0,0
../kbl_data/2023-2024,S43G01N177,안양 정관장,Away,정효근,17,3,7,42.9,3,6,50.0,6,13,46.2,2,2,100.0,0,1,1,1,1,0,0,0,0,2
../kbl_data/2023-2024,S43G01N177,안양 정관장,Away,이종현,12,6,9,66.7,0,1,0.0,6,10,60.0,0,0,0.0,3,4,7,1,1,0,0,1,2,1
../kbl_data/2023-2024,S43G01N177,안양 정관장,Away,김철욱,0,0,0,0.0,0,0,0.0,0,0,0.0,0,0,0.0,0,0,0,0,0,0,0,0,0,0
../kbl_data/2023-2024,S43G01N177,안양 정관장,Away,박지훈,9,3,3,100.0,1,3,33.3,4,6,66.7,0,1,0.0,0,2,2,4,0,0,0,0,3,2
../kbl_data/2023-2024,S43G01N177,안양 정관장,Away,최성원,10,1,3,33.3,2,5,40.0,3,8,37.5,2,2,100.0,0,1,1,3,1,0,0,0,2,2
../kbl_data/2023-2024,S43G01N177,안양 정관장,Away,이우정,0,0,0,0.0,0,0,0.0,0,0,0.0,0,0,0.0,0,0,0,0,0,0,0,0,0,0
../kbl_data/2023-2024,S43G01N177,안양 정관장,Away,고찬혁,0,0,0,0.0,0,0,0.0,0,0,0.0,0,0,0.0,0,0,0,0,0,0,0,0,0,0
../kbl_data/2023-2024,S43G01N177,안양 정관장,Away,로버트 카터,17,4,7,57.1,3,7,42.9,7,14,50.0,0,0,0.0,2,6,8,4,0,1,0,0,0,1
../kbl_data/2023-2024,S43G01N177,안양 정관장,Away,자밀 윌슨,5,1,2,50.0,1,3,33.3,2,5,40.0,0,0,0.0,1,2,3,1,0,0,0,0,0,2
../kbl_data/2023-2024,S43G01N178,고양 소노,Home,김강선,2,0,0,0.0,0,1,0.0,0,1,0.0,2,2,100.0,1,1,2,0,1,0,0,0,0,1
../kbl_data/2023-2024,S43G01N178,고양 소노,Home,함준후,7,1,2,50.0,1,2,50.0,2,4,50.0,2,2,100.0,2,4,6,2,1,0,0,0,2,4
../kbl_data/2023-2024,S43G01N178,고양 소노,Home,김민욱,11,4,6,66.7,1,2,50.0,5,8,62.5,0,1,0.0,3,0,3,0,0,0,0,0,0,3
../kbl_data/2023-2024,S43G01N178,고양 소노,Home,한호빈,0,0,0,0.0,0,1,0.0,0,1,0.0,0,0,0.0,0,0,0,1,0,0,0,0,2,0
../kbl_data/2023-2024,S43G01N178,고양 소노,Home,김지후,0,0,1,0.0,0,0,0.0,0,1,0.0,0,0,0.0,0,0,0,0,1,0,0,0,0,1
../kbl_data/2023-2024,S43G01N178,고양 소노,Home,김진유,0,0,0,0.0,0,0,0.0,0,0,0.0,0,0,0.0,0,1,1,0,0,0,0,0,1,0
../kbl_data/2023-2024,S43G01N178,고양 소노,Home,다후안 서머스,3,0,2,0.0,1,4,25.0,1,6,16.7,0,0,0.0,0,3,3,0,0,0,0,0,2,1
../kbl_data/2023-2024,S43G01N178,고양 소노,Home,치나누 오누아쿠,28,9,13,69.2,2,2,100.0,11,15,73.3,4,8,50.0,4,7,11,3,4,1,0,1,3,0
../kbl_data/2023-2024,S43G01N178,고양 소노,Home,이정현,13,5,10,50.0,0,4,0.0,5,14,35.7,3,3,100.0,0,1,1,6,2,0,1,0,1,3
../kbl_data/2023-2024,S43G01N178,고양 소노,Home,백지웅,0,0,0,0.0,0,3,0.0,0,3,0.0,0,2,0.0,0,1,1,0,0,0,0,0,0,0
../kbl_data/2023-2024,S43G01N178,고양 소노,Home,안정욱,0,0,0,0.0,0,0,0.0,0,0,0.0,0,0,0.0,0,0,0,0,0,0,0,0,0,2
../kbl_data/2023-2024,S43G01N178,고양 소노,Home,박종하,6,0,1,0.0,2,5,40.0,2,6,33.3,0,0,0.0,0,1,1,0,0,0,0,0,1,3
../kbl_data/2023-2024,S43G01N178,창원 LG,Away,이관희,10,0,4,0.0,3,6,50.0,3,10,30.0,1,2,50.0,2,3,5,1,0,0,0,0,0,1
../kbl_data/2023-2024,S43G01N178,창원 LG,Away,정희재,2,1,4,25.0,0,3,0.0,1,7,14.3,0,0,0.0,0,5,5,3,0,2,0,0,2,3
../kbl_data/2023-2024,S43G01N178,창원 LG,Away,임동섭,0,0,0,0.0,0,0,0.0,0,0,0.0,0,0,0.0,0,0,0,0,0,0,0,0,0,0
../kbl_data/2023-2024,S43G01N178,창원 LG,Away,한상혁,0,0,0,0.0,0,1,0.0,0,1,0.0,0,0,0.0,0,0,0,0,0,0,0,0,1,1
../kbl_data/2023-2024,S43G01N178,창원 LG,Away,이재도,7,2,3,66.7,1,5,20.0,3,8,37.5,0,0,0.0,1,2,3,8,3,0,0,0,2,1
../kbl_data/2023-2024,S43G01N178,창원 LG,Away,정인덕,0,0,1,0.0,0,0,0.0,0,1,0.0,0,0,0.0,0,0,0,0,1,0,0,0,0,0
../kbl_data/2023-2024,S43G01N178,창원 LG,Away,양홍석,19,8,10,80.0,1,2,50.0,9,12,75.0,0,0,0.0,2,2,4,5,1,0,0,0,1,3
../kbl_data/2023-2024,S43G01N178,창원 LG,Away,박정현,0,0,0,0.0,0,0,0.0,0,0,0.0,0,0,0.0,1,1,2,0,0,0,0,0,1,3
../kbl_data/2023-2024,S43G01N178,창원 LG,Away,이승우,0,0,0,0.0,0,0,0.0,0,0,0.0,0,0,0.0,0,0,0,0,0,0,0,0,0,0
../kbl_data/2023-2024,S43G01N178,창원 LG,Away,저스틴 구탕,7,2,3,66.7,1,1,100.0,3,4,75.0,0,0,0.0,0,2,2,1,0,1,0,0,0,4
../kbl_data/2023-2024,S43G01N178,창원 LG,Away,유기상,18,3,3,100.0,4,7,57.1,7,10,70.0,0,0,0.0,1,0,1,0,0,1,0,0,0,2
../kbl_data/2023-2024,S43G01N178,창원 LG,Away,후안 텔로,11,4,6,66.7,1,2,50.0,5,8,62.5,0,1,0.0,3,4,7,4,1,0,0,0,4,5
../kbl_data/2023-2024,S43G01N179,서울 삼성,Home,이정현,9,2,5,40.0,1,3,33.3,3,8,37.5,2,2,100.0,1,1,2,6,1,0,0,0,1,3
../kbl_data/2023-2024,S43G01N179,서울 삼성,Home,김시래,2,1,2,50.0,0,1,0.0,1,3,33.3,0,0,0.0,0,1,1,1,0,0,0,0,0,1
../kbl_data/2023-2024,S43G01N179,서울 삼성,Home,이동엽,5,1,3,33.3,1,4,25.0,2,7,28.6,0,0,0.0,0,0,0,2,2,0,0,0,1,3
../kbl_data/2023-2024,S43G01N179,서울 삼성,Home,최승욱,8,4,6,66.7,0,0,0.0,4,6,66.7,0,0,0.0,0,2,2,0,6,0,0,0,2,2
../kbl_data/2023-2024,S43G01N179,서울 삼성,Home,윤성원,0,0,0,0.0,0,0,0.0,0,0,0.0,0,0,0.0,0,0,0,0,0,0,0,0,0,0
../kbl_data/2023-2024,S43G01N179,서울 삼성,Home,차민석,8,2,7,28.6,1,1,100.0,3,8,37.5,1,1,100.0,5,4,9,0,1,0,1,0,0,5
../kbl_data/2023-2024,S43G01N179,서울 삼성,Home,이원석,5,2,6,33.3,0,3,0.0,2,9,22.2,1,2,50.0,0,3,3,0,2,0,0,0,2,1
../kbl_data/2023-2024,S43G01N179,서울 삼성,Home,신동혁,7,2,3,66.7,1,5,20.0,3,8,37.5,0,0,0.0,1,0,1,2,0,0,0,0,0,3
../kbl_data/2023-2024,S43G01N179,서울 삼성,Home,조준희,0,0,2,0.0,0,1,0.0,0,3,0.0,0,0,0.0,1,1,2,1,0,0,0,0,0,2
../kbl_data/2023-2024,S43G01N179,서울 삼성,Home,아반 나바,0,0,4,0.0,0,5,0.0,0,9,0.0,0,0,0.0,0,1,1,1,0,0,0,0,0,0
../kbl_data/2023-2024,S43G01N179,서울 삼성,Home,이스마엘 레인,10,3,7,42.9,1,4,25.0,4,11,36.4,1,3,33.3,3,1,4,1,1,1,0,1,2,0
../kbl_data/2023-2024,S43G01N179,서울 삼성,Home,코피 코번,25,11,13,84.6,0,0,0.0,11,13,84.6,3,3,100.0,3,5,8,2,0,0,0,0,2,2
../kbl_data/2023-2024,S43G01N179,원주 DB,Away,서민수,0,0,0,0.0,0,0,0.0,0,0,0.0,0,0,0.0,0,0,0,0,0,0,0,0,0,1
../kbl_data/2023-2024,S43G01N179,원주 DB,Away,김영현,3,0,0,0.0,1,2,50.0,1,2,50.0,0,0,0.0,1,0,1,0,0,0,0,0,0,5
../kbl_data/2023-2024,S43G01N179,원주 DB,Away,김종규,24,6,10,60.0,2,4,50.0,8,14,57.1,6,7,85.7,2,5,7,2,0,2,0,2,3,4
../kbl_data/2023-2024,S43G01N179,원주 DB,Away,최승욱,8,4,6,66.7,0,0,0.0,4,6,66.7,0,0,0.0,0,2,2,0,6,0,0,0,2,2
../kbl_data/2023-2024,S43G01N179,원주 DB,Away,강상재,15,4,5,80.0,2,2,100.0,6,7,85.7,1,2,50.0,1,4,5,10,1,0,0,0,2,1
../kbl_data/2023-2024,S43G01N179,원주 DB,Away,김훈,2,1,2,50.0,0,1,0.0,1,3,33.3,0,0,0.0,0,5,5,0,0,0,0,0,0,0
../kbl_data/2023-2024,S43G01N179,원주 DB,Away,디드릭 로슨,24,7,9,77.8,2,4,50.0,9,13,69.2,4,5,80.0,1,10,11,10,3,2,0,2,1,3
../kbl_data/2023-2024,S43G01N179,원주 DB,Away,이용우,0,0,0,0.0,0,0,0.0,0,0,0.0,0,0,0.0,0,0,0,0,0,0,0,0,0,0
../kbl_data/2023-2024,S43G01N179,원주 DB,Away,이선 알바노,16,3,5,60.0,3,5,60.0,6,10,60.0,1,2,50.0,0,1,1,9,1,0,0,0,3,3
../kbl_data/2023-2024,S43G01N179,원주 DB,Away,박인웅,5,1,1,100.0,1,1,100.0,2,2,100.0,0,0,0.0,0,2,2,0,0,0,0,0,0,2
../kbl_data/2023-2024,S43G01N179,원주 DB,Away,박승재,8,1,5,20.0,2,3,66.7,3,8,37.5,0,0,0.0,1,0,1,2,0,0,0,0,1,0
../kbl_data/2023-2024,S43G01N179,원주 DB,Away,제프 위디,9,3,5,60.0,0,0,0.0,3,5,60.0,3,4,75.0,1,1,2,0,1,1,0,0,1,1
../kbl_data/2023-2024,S43G01N180,수원 KT,Home,한희원,4,1,2,50.0,0,2,0.0,1,4,25.0,2,2,100.0,0,4,4,3,2,0,1,0,1,3
../kbl_data/2023-2024,S43G01N180,수원 KT,Home,최창진,0,0,0,0.0,0,0,0.0,0,0,0.0,0,0,0.0,0,0,0,0,0,0,0,0,0,0
../kbl_data/2023-2024,S43G01N180,수원 KT,Home,문성곤,8,1,1,100.0,2,6,33.3,3,7,42.9,0,0,0.0,0,1,1,4,0,0,0,0,1,4
../kbl_data/2023-2024,S43G01N180,수원 KT,Home,이현석,0,0,0,0.0,0,0,0.0,0,0,0.0,0,0,0.0,0,0,0,0,0,0,0,0,0,0
../kbl_data/2023-2024,S43G01N180,수원 KT,Home,정성우,11,1,2,50.0,2,7,28.6,3,9,33.3,3,6,50.0,0,1,1,4,2,0,0,0,1,3
../kbl_data/2023-2024,S43G01N180,수원 KT,Home,최성모,2,1,1,100.0,0,1,0.0,1,2,50.0,0,0,0.0,0,1,1,0,0,0,0,0,1,3
../kbl_data/2023-2024,S43G01N180,수원 KT,Home,이윤기,0,0,0,0.0,0,0,0.0,0,0,0.0,0,0,0.0,0,0,0,0,0,0,0,0,0,0
../kbl_data/2023-2024,S43G01N180,수원 KT,Home,하윤기,16,6,10,60.0,0,0,0.0,6,10,60.0,4,4,100.0,2,4,6,3,0,2,0,2,1,3
../kbl_data/2023-2024,S43G01N180,수원 KT,Home,이두원,0,0,0,0.0,0,0,0.0,0,0,0.0,0,0,0.0,0,0,0,0,0,1,0,0,0,0
../kbl_data/2023-2024,S43G01N180,수원 KT,Home,문정현,17,4,4,100.0,3,5,60.0,7,9,77.8,0,0,0.0,0,5,5,3,1,0,0,0,0,1
../kbl_data/2023-2024,S43G01N180,수원 KT,Home,마이클 에릭,11,5,7,71.4,0,0,0.0,5,7,71.4,1,2,50.0,3,2,5,0,0,0,0,0,1,3
../kbl_data/2023-2024,S43G01N180,수원 KT,Home,패리스 배스,29,11,16,68.8,1,4,25.0,12,20,60.0,4,6,66.7,4,6,10,4,5,0,0,2,1,4
../kbl_data/2023-2024,S43G01N180,대구 한국가스공사,Away,김동량,3,0,0,0.0,1,2,50.0,1,2,50.0,0,0,0.0,0,0,0,0,0,0,0,0,1,2
../kbl_data/2023-2024,S43G01N180,대구 한국가스공사,Away,조상열,0,0,0,0.0,0,1,0.0,0,1,0.0,0,0,0.0,0,0,0,2,0,0,1,0,0,0
../kbl_data/2023-2024,S43G01N180,대구 한국가스공사,Away,이대헌,12,5,8,62.5,0,1,0.0,5,9,55.6,2,2,100.0,2,3,5,3,0,0,0,0,1,2
../kbl_data/2023-2024,S43G01N180,대구 한국가스공사,Away,박봉진,0,0,0,0.0,0,0,0.0,0,0,0.0,0,0,0.0,0,0,0,0,0,0,0,0,0,1
../kbl_data/2023-2024,S43G01N180,대구 한국가스공사,Away,김낙현,9,1,2,50.0,1,5,20.0,2,7,28.6,4,6,66.7,2,0,2,1,1,0,1,0,3,2
../kbl_data/2023-2024,S43G01N180,대구 한국가스공사,Away,양준우,0,0,0,0.0,0,0,0.0,0,0,0.0,0,0,0.0,0,1,1,0,0,0,0,0,0,0
../kbl_data/2023-2024,S43G01N180,대구 한국가스공사,Away,앤드류 니콜슨,32,12,19,63.2,2,6,33.3,14,25,56.0,2,4,50.0,3,8,11,2,0,0,0,3,4,3
../kbl_data/2023-2024,S43G01N180,대구 한국가스공사,Away,신승민,15,4,7,57.1,1,3,33.3,5,10,50.0,4,7,57.1,2,8,10,1,0,1,2,0,2,4
../kbl_data/2023-2024,S43G01N180,대구 한국가스공사,Away,김진모,0,0,0,0.0,0,1,0.0,0,1,0.0,0,0,0.0,0,0,0,0,0,0,0,0,0,0
../kbl_data/2023-2024,S43G01N180,대구 한국가스공사,Away,샘조세프 벨란겔,16,4,7,57.1,2,3,66.7,6,10,60.0,2,3,66.7,1,0,1,6,0,0,0,0,3,3
../kbl_data/2023-2024,S43G01N180,대구 한국가스공사,Away,안세영,0,0,0,0.0,0,0,0.0,0,0,0.0,0,0,0.0,1,0,1,2,0,0,0,0,0,0
../kbl_data/2023-2024,S43G01N180,대구 한국가스공사,Away,듀반 맥스웰,0,0,2,0.0,0,0,0.0,0,2,0.0,0,0,0.0,1,0,1,1,0,0,0,0,0,1
../kbl_data/2023-2024,S43G01N181,고양 소노,Home,김강선,5,1,2,50.0,1,9,11.1,2,11,18.2,0,0,0.0,2,1,3,0,3,0,1,0,2,4
../kbl_data/2023-2024,S43G01N181,고양 소노,Home,함준후,0,0,0,0.0,0,0,0.0,0,0,0.0,0,0,0.0,0,0,0,0,0,0,0,0,0,1
../kbl_data/2023-2024,S43G01N181,고양 소노,Home,김민욱,9,1,5,20.0,2,7,28.6,3,12,25.0,1,2,50.0,4,4,8,4,1,0,0,0,1,1
../kbl_data/2023-2024,S43G01N181,고양 소노,Home,한호빈,8,1,3,33.3,2,9,22.2,3,12,25.0,0,0,0.0,1,1,2,6,0,0,0,0,2,4
../kbl_data/2023-2024,S43G01N181,고양 소노,Home,김진유,11,5,6,83.3,0,2,0.0,5,8,62.5,1,1,100.0,4,6,10,2,0,0,0,0,0,4
../kbl_data/2023-2024,S43G01N181,고양 소노,Home,다후안 서머스,9,0,2,0.0,3,5,60.0,3,7,42.9,0,1,0.0,1,0,1,0,0,0,0,0,1,0
../kbl_data/2023-2024,S43G01N181,고양 소노,Home,치나누 오누아쿠,27,6,9,66.7,3,7,42.9,9,16,56.2,6,6,100.0,2,5,7,5,5,0,0,0,4,2
../kbl_data/2023-2024,S43G01N181,고양 소노,Home,조은후,0,0,0,0.0,0,0,0.0,0,0,0.0,0,0,0.0,0,0,0,0,0,0,0,0,0,0
../kbl_data/2023-2024,S43G01N181,고양 소노,Home,백지웅,0,0,0,0.0,0,2,0.0,0,2,0.0,0,0,0.0,1,0,1,0,0,0,0,0,0,1
../kbl_data/2023-2024,S43G01N181,고양 소노,Home,안정욱,0,0,0,0.0,0,0,0.0,0,0,0.0,0,0,0.0,0,0,0,0,0,0,0,0,0,1
../kbl_data/2023-2024,S43G01N181,고양 소노,Home,박종하,8,2,2,100.0,0,2,0.0,2,4,50.0,4,5,80.0,1,0,1,0,0,0,0,0,0,2
../kbl_data/2023-2024,S43G01N181,고양 소노,Home,알렉스 카바노,0,0,1,0.0,0,0,0.0,0,1,0.0,0,0,0.0,0,0,0,0,0,0,0,0,1,0
../kbl_data/2023-2024,S43G01N181,창원 LG,Away,이관희,7,2,7,28.6,1,3,33.3,3,10,30.0,0,0,0.0,0,0,0,2,1,0,0,0,1,0
../kbl_data/2023-2024,S43G01N181,창원 LG,Away,정희재,5,0,0,0.0,1,1,100.0,1,1,100.0,2,4,50.0,1,2,3,0,1,0,0,0,0,3
../kbl_data/2023-2024,S43G01N181,창원 LG,Away,이재도,10,2,4,50.0,1,2,50.0,3,6,50.0,3,3,100.0,1,5,6,2,1,0,0,0,3,0
../kbl_data/2023-2024,S43G01N181,창원 LG,Away,정인덕,0,0,0,0.0,0,0,0.0,0,0,0.0,0,0,0.0,0,0,0,0,0,0,0,0,0,0
../kbl_data/2023-2024,S43G01N181,창원 LG,Away,양홍석,16,3,7,42.9,3,5,60.0,6,12,50.0,1,2,50.0,2,0,2,3,1,0,0,0,3,3
../kbl_data/2023-2024,S43G01N181,창원 LG,Away,박정현,0,0,0,0.0,0,0,0.0,0,0,0.0,0,0,0.0,0,0,0,0,0,0,0,0,0,0
../kbl_data/2023-2024,S43G01N181,창원 LG,Away,이승우,0,0,0,0.0,0,0,0.0,0,0,0.0,0,0,0.0,0,2,2,1,0,0,0,0,1,1
../kbl_data/2023-2024,S43G01N181,창원 LG,Away,저스틴 구탕,5,1,1,100.0,1,2,50.0,2,3,66.7,0,0,0.0,0,0,0,0,0,0,0,1,1,0
../kbl_data/2023-2024,S43G01N181,창원 LG,Away,양준석,4,2,3,66.7,0,2,0.0,2,5,40.0,0,0,0.0,0,2,2,4,0,0,0,0,3,1
../kbl_data/2023-2024,S43G01N181,창원 LG,Away,유기상,15,3,4,75.0,2,3,66.7,5,7,71.4,3,3,100.0,0,8,8,1,1,1,0,0,2,3
../kbl_data/2023-2024,S43G01N181,창원 LG,Away,후안 텔로,9,3,5,60.0,1,3,33.3,4,8,50.0,0,0,0.0,3,8,11,0,2,0,0,0,1,3
../kbl_data/2023-2024,S43G01N181,창원 LG,Away,조쉬 이바라,9,4,5,80.0,0,0,0.0,4,5,80.0,1,2,50.0,0,0,0,1,1,0,0,0,0,5
../kbl_data/2023-2024,S43G01N182,울산 현대모비스,Home,함지훈,6,3,6,50.0,0,1,0.0,3,7,42.9,0,0,0.0,5,0,5,2,0,0,0,0,0,1
../kbl_data/2023-2024,S43G01N182,울산 현대모비스,Home,최진수,11,2,3,66.7,2,3,66.7,4,6,66.7,1,2,50.0,1,3,4,0,0,1,0,0,0,2
../kbl_data/2023-2024,S43G01N182,울산 현대모비스,Home,김현수,0,0,1,0.0,0,1,0.0,0,2,0.0,0,0,0.0,1,0,1,0,0,0,0,0,0,1
../kbl_data/2023-2024,S43G01N182,울산 현대모비스,Home,장재석,2,1,2,50.0,0,0,0.0,1,2,50.0,0,0,0.0,1,1,2,1,1,1,0,0,1,4
../kbl_data/2023-2024,S43G01N182,울산 현대모비스,Home,김준일,5,2,3,66.7,0,0,0.0,2,3,66.7,1,2,50.0,1,0,1,1,0,0,0,0,1,2
../kbl_data/2023-2024,S43G01N182,울산 현대모비스,Home,김국찬,0,0,0,0.0,0,3,0.0,0,3,0.0,0,0,0.0,0,1,1,1,0,0,0,0,3,2
../kbl_data/2023-2024,S43G01N182,울산 현대모비스,Home,이우석,5,2,6,33.3,0,2,0.0,2,8,25.0,1,2,50.0,1,3,4,2,0,0,0,0,0,3
../kbl_data/2023-2024,S43G01N182,울산 현대모비스,Home,신민석,2,1,2,50.0,0,2,0.0,1,4,25.0,0,0,0.0,1,1,2,0,0,0,0,0,0,2
../kbl_data/2023-2024,S43G01N182,울산 현대모비스,Home,게이지 프림,8,4,6,66.7,0,0,0.0,4,6,66.7,0,0,0.0,0,2,2,1,0,0,0,1,2,3
../kbl_data/2023-2024,S43G01N182,울산 현대모비스,Home,박무빈,11,5,6,83.3,0,1,0.0,5,7,71.4,1,2,50.0,1,2,3,3,0,0,0,0,1,1
../kbl_data/2023-2024,S43G01N182,울산 현대모비스,Home,케베 알루마,25,7,14,50.0,2,7,28.6,9,21,42.9,5,6,83.3,8,9,17,1,1,0,1,0,3,1
../kbl_data/2023-2024,S43G01N182,울산 현대모비스,Home,미구엘 안드레 옥존,7,3,8,37.5,0,4,0.0,3,12,25.0,1,2,50.0,1,1,2,10,0,2,0,0,1,3
../kbl_data/2023-2024,S43G01N182,원주 DB,Away,서민수,0,0,0,0.0,0,0,0.0,0,0,0.0,0,0,0.0,0,0,0,0,0,0,0,0,0,0
../kbl_data/2023-2024,S43G01N182,원주 DB,Away,김영현,0,0,0,0.0,0,3,0.0,0,3,0.0,0,0,0.0,0,1,1,0,0,0,0,0,0,2
../kbl_data/2023-2024,S43G01N182,원주 DB,Away,김종규,22,9,13,69.2,0,0,0.0,9,13,69.2,4,4,100.0,3,2,5,0,0,3,0,2,1,5
../kbl_data/2023-2024,S43G01N182,원주 DB,Away,최승욱,4,2,2,100.0,0,1,0.0,2,3,66.7,0,0,0.0,0,0,0,0,0,0,0,0,0,1
../kbl_data/2023-2024,S43G01N182,원주 DB,Away,강상재,13,5,8,62.5,0,4,0.0,5,12,41.7,3,6,50.0,2,4,6,6,3,0,0,0,1,1
../kbl_data/2023-2024,S43G01N182,원주 DB,Away,유현준,2,0,0,0.0,0,0,0.0,0,0,0.0,2,2,100.0,0,0,0,2,2,0,0,0,0,1
../kbl_data/2023-2024,S43G01N182,원주 DB,Away,디드릭 로슨,30,9,13,69.2,3,7,42.9,12,20,60.0,3,7,42.9,4,11,15,5,2,0,0,2,5,2
../kbl_data/2023-2024,S43G01N182,원주 DB,Away,이용우,0,0,0,0.0,0,0,0.0,0,0,0.0,0,0,0.0,0,0,0,0,0,0,0,0,0,0
../kbl_data/2023-2024,S43G01N182,원주 DB,Away,이선 알바노,11,4,8,50.0,1,3,33.3,5,11,45.5,0,1,0.0,0,2,2,6,0,1,1,0,0,4
../kbl_data/2023-2024,S43G01N182,원주 DB,Away,박인웅,5,1,2,50.0,1,3,33.3,2,5,40.0,0,0,0.0,0,2,2,0,1,0,0,0,2,4
../kbl_data/2023-2024,S43G01N182,원주 DB,Away,박승재,0,0,0,0.0,0,0,0.0,0,0,0.0,0,0,0.0,0,0,0,0,0,0,0,0,0,0
../kbl_data/2023-2024,S43G01N182,원주 DB,Away,제프 위디,4,2,3,66.7,0,0,0.0,2,3,66.7,0,0,0.0,1,2,3,0,0,2,0,0,1,0
../kbl_data/2023-2024,S43G01N183,부산 KCC,Home,라건아,23,8,13,61.5,1,2,50.0,9,15,60.0,4,6,66.7,2,7,9,2,1,1,0,1,1,0
../kbl_data/2023-2024,S43G01N183,부산 KCC,Home,전준범,0,0,0,0.0,0,0,0.0,0,0,0.0,0,0,0.0,0,0,0,0,0,0,0,0,0,0
../kbl_data/2023-2024,S43G01N183,부산 KCC,Home,허웅,4,2,3,66.7,0,6,0.0,2,9,22.2,0,0,0.0,0,3,3,9,1,0,1,0,0,3
../kbl_data/2023-2024,S43G01N183,부산 KCC,Home,이승현,8,4,7,57.1,0,0,0.0,4,7,57.1,0,0,0.0,2,4,6,0,0,0,0,0,0,4
../kbl_data/2023-2024,S43G01N183,부산 KCC,Home,송교창,13,2,4,50.0,1,6,16.7,3,10,30.0,6,8,75.0,1,2,3,7,0,0,0,0,1,1
../kbl_data/2023-2024,S43G01N183,부산 KCC,Home,최준용,11,4,6,66.7,1,5,20.0,5,11,45.5,0,0,0.0,0,5,5,2,0,0,0,1,1,1
../kbl_data/2023-2024,S43G01N183,부산 KCC,Home,곽정훈,9,0,0,0.0,3,5,60.0,3,5,60.0,0,0,0.0,1,3,4,0,0,0,1,0,0,2
../kbl_data/2023-2024,S43G01N183,부산 KCC,Home,이근휘,4,2,2,100.0,0,2,0.0,2,4,50.0,0,0,0.0,1,0,1,0,1,0,0,0,0,0
../kbl_data/2023-2024,S43G01N183,부산 KCC,Home,김동현,0,0,0,0.0,0,0,0.0,0,0,0.0,0,0,0.0,0,0,0,0,0,0,0,0,0,0
../kbl_data/2023-2024,S43G01N183,부산 KCC,Home,여준형,0,0,0,0.0,0,0,0.0,0,0,0.0,0,0,0.0,0,0,0,0,0,0,0,0,0,0
../kbl_data/2023-2024,S43G01N183,부산 KCC,Home,캘빈 제프리 에피스톨라,3,0,2,0.0,1,3,33.3,1,5,20.0,0,0,0.0,2,1,3,0,0,0,0,0,1,5
../kbl_data/2023-2024,S43G01N183,부산 KCC,Home,알리제 드숀 존슨,6,3,5,60.0,0,1,0.0,3,6,50.0,0,0,0.0,1,6,7,2,0,0,0,0,1,0
../kbl_data/2023-2024,S43G01N183,안양 정관장,Away,정준원,2,1,2,50.0,0,2,0.0,1,4,25.0,0,0,0.0,0,0,0,0,0,1,0,0,0,3
../kbl_data/2023-2024,S43G01N183,안양 정관장,Away,김상규,11,1,1,100.0,3,3,100.0,4,4,100.0,0,0,0.0,1,0,1,3,0,0,0,0,0,1
../kbl_data/2023-2024,S43G01N183,안양 정관장,Away,배병준,3,0,2,0.0,1,2,50.0,1,4,25.0,0,0,0.0,0,0,0,0,0,0,0,0,0,1
../kbl_data/2023-2024,S43G01N183,안양 정관장,Away,정효근,6,2,6,33.3,0,4,0.0,2,10,20.0,2,2,100.0,0,5,5,5,0,1,0,0,0,5
../kbl_data/2023-2024,S43G01N183,안양 정관장,Away,이종현,6,3,5,60.0,0,1,0.0,3,6,50.0,0,0,0.0,3,5,8,2,1,1,0,0,3,3
../kbl_data/2023-2024,S43G01N183,안양 정관장,Away,김철욱,0,0,0,0.0,0,0,0.0,0,0,0.0,0,0,0.0,0,0,0,0,0,0,0,0,0,0
../kbl_data/2023-2024,S43G01N183,안양 정관장,Away,박지훈,6,3,4,75.0,0,3,0.0,3,7,42.9,0,0,0.0,1,2,3,2,1,0,0,0,2,4
../kbl_data/2023-2024,S43G01N183,안양 정관장,Away,최성원,26,6,9,66.7,4,8,50.0,10,17,58.8,2,2,100.0,1,5,6,4,1,0,0,0,0,1
../kbl_data/2023-2024,S43G01N183,안양 정관장,Away,이우정,0,0,0,0.0,0,0,0.0,0,0,0.0,0,0,0.0,0,0,0,0,0,0,0,0,0,0
../kbl_data/2023-2024,S43G01N183,안양 정관장,Away,고찬혁,0,0,0,0.0,0,0,0.0,0,0,0.0,0,0,0.0,0,0,0,0,0,0,0,0,0,0
../kbl_data/2023-2024,S43G01N183,안양 정관장,Away,로버트 카터,11,3,9,33.3,1,6,16.7,4,15,26.7,2,3,66.7,1,5,6,2,1,0,0,0,2,2
../kbl_data/2023-2024,S43G01N183,안양 정관장,Away,자밀 윌슨,4,0,1,0.0,1,2,50.0,1,3,33.3,1,2,50.0,0,4,4,0,0,0,0,0,0,2
../kbl_data/2023-2024,S43G01N184,서울 SK,Home,양우섭,3,0,0,0.0,1,4,25.0,1,4,25.0,0,0,0.0,1,3,4,5,0,0,0,0,1,2
../kbl_data/2023-2024,S43G01N184,서울 SK,Home,허일영,0,0,0,0.0,0,0,0.0,0,0,0.0,0,0,0.0,0,0,0,1,0,0,0,0,1,2
../kbl_data/2023-2024,S43G01N184,서울 SK,Home,송창용,2,1,1,100.0,0,1,0.0,1,2,50.0,0,0,0.0,0,1,1,0,0,0,0,0,1,2
../kbl_data/2023-2024,S43G01N184,서울 SK,Home,오세근,11,4,6,66.7,0,3,0.0,4,9,44.4,3,4,75.0,0,6,6,0,1,1,0,0,0,3
../kbl_data/2023-2024,S43G01N184,서울 SK,Home,최부경,11,4,13,30.8,0,0,0.0,4,13,30.8,3,4,75.0,2,4,6,1,2,0,1,1,0,5
../kbl_data/2023-2024,S43G01N184,서울 SK,Home,리온 윌리엄스,0,0,0,0.0,0,0,0.0,0,0,0.0,0,0,0.0,0,0,0,0,0,0,0,0,0,0
../kbl_data/2023-2024,S43G01N184,서울 SK,Home,최원혁,2,1,1,100.0,0,0,0.0,1,1,100.0,0,0,0.0,1,0,1,4,5,0,1,0,2,4
../kbl_data/2023-2024,S43G01N184,서울 SK,Home,자밀 워니,16,5,16,31.2,1,3,33.3,6,19,31.6,3,6,50.0,4,9,13,6,0,0,0,0,1,2
../kbl_data/2023-2024,S43G01N184,서울 SK,Home,전성환,0,0,0,0.0,0,0,0.0,0,0,0.0,0,0,0.0,0,0,0,0,0,0,0,0,0,0
../kbl_data/2023-2024,S43G01N184,서울 SK,Home,김형빈,0,0,0,0.0,0,0,0.0,0,0,0.0,0,0,0.0,0,0,0,0,0,0,0,0,0,0
../kbl_data/2023-2024,S43G01N184,서울 SK,Home,오재현,31,8,13,61.5,4,7,57.1,12,20,60.0,3,4,75.0,1,0,1,2,3,0,0,0,3,2
../kbl_data/2023-2024,S43G01N184,서울 SK,Home,김건우,0,0,0,0.0,0,0,0.0,0,0,0.0,0,0,0.0,0,0,0,0,0,0,0,0,0,0
../kbl_data/2023-2024,S43G01N184,수원 KT,Away,한희원,11,0,2,0.0,3,5,60.0,3,7,42.9,2,2,100.0,0,4,4,2,0,1,0,0,0,3
../kbl_data/2023-2024,S43G01N184,수원 KT,Away,최창진,0,0,0,0.0,0,0,0.0,0,0,0.0,0,0,0.0,0,0,0,2,0,0,0,0,2,1
../kbl_data/2023-2024,S43G01N184,수원 KT,Away,문성곤,3,0,0,0.0,1,3,33.3,1,3,33.3,0,0,0.0,0,1,1,0,1,1,0,0,1,2
../kbl_data/2023-2024,S43G01N184,수원 KT,Away,이현석,0,0,0,0.0,0,1,0.0,0,1,0.0,0,0,0.0,0,0,0,0,0,0,0,0,0,0
../kbl_data/2023-2024,S43G01N184,수원 KT,Away,정성우,13,6,7,85.7,0,2,0.0,6,9,66.7,1,1,100.0,0,0,0,2,3,0,0,0,1,3
../kbl_data/2023-2024,S43G01N184,수원 KT,Away,최성모,0,0,1,0.0,0,0,0.0,0,1,0.0,0,2,0.0,0,0,0,0,0,0,0,0,0,0
../kbl_data/2023-2024,S43G01N184,수원 KT,Away,이윤기,0,0,0,0.0,0,0,0.0,0,0,0.0,0,0,0.0,1,0,1,0,0,0,0,0,0,0
../kbl_data/2023-2024,S43G01N184,수원 KT,Away,하윤기,14,5,8,62.5,0,0,0.0,5,8,62.5,4,6,66.7,1,7,8,1,0,0,0,0,3,3
../kbl_data/2023-2024,S43G01N184,수원 KT,Away,이두원,0,0,0,0.0,0,0,0.0,0,0,0.0,0,0,0.0,0,0,0,0,0,0,0,0,0,1
../kbl_data/2023-2024,S43G01N184,수원 KT,Away,문정현,2,1,1,100.0,0,0,0.0,1,1,100.0,0,0,0.0,0,2,2,0,0,0,0,0,0,3
../kbl_data/2023-2024,S43G01N184,수원 KT,Away,마이클 에릭,0,0,1,0.0,0,0,0.0,0,1,0.0,0,0,0.0,0,1,1,0,1,0,0,0,0,0
../kbl_data/2023-2024,S43G01N184,수원 KT,Away,패리스 배스,35,11,19,57.9,3,7,42.9,14,26,53.8,4,6,66.7,5,10,15,7,1,1,0,4,9,3
../kbl_data/2023-2024,S43G01N185,대구 한국가스공사,Home,김동량,0,0,2,0.0,0,0,0.0,0,2,0.0,0,0,0.0,1,0,1,2,0,0,0,0,1,0
../kbl_data/2023-2024,S43G01N185,대구 한국가스공사,Home,차바위,5,1,3,33.3,1,1,100.0,2,4,50.0,0,0,0.0,5,4,9,3,1,0,0,0,1,4
../kbl_data/2023-2024,S43G01N185,대구 한국가스공사,Home,조상열,0,0,0,0.0,0,0,0.0,0,0,0.0,0,0,0.0,0,0,0,0,0,0,0,0,0,1
../kbl_data/2023-2024,S43G01N185,대구 한국가스공사,Home,이대헌,11,3,6,50.0,0,0,0.0,3,6,50.0,5,8,62.5,2,3,5,3,0,0,0,0,1,1
../kbl_data/2023-2024,S43G01N185,대구 한국가스공사,Home,박봉진,0,0,0,0.0,0,0,0.0,0,0,0.0,0,0,0.0,0,1,1,0,0,0,0,0,0,0
../kbl_data/2023-2024,S43G01N185,대구 한국가스공사,Home,김낙현,7,1,2,50.0,1,2,50.0,2,4,50.0,2,2,100.0,0,3,3,0,0,0,0,0,0,2
../kbl_data/2023-2024,S43G01N185,대구 한국가스공사,Home,양준우,0,0,1,0.0,0,0,0.0,0,1,0.0,0,2,0.0,0,1,1,0,0,0,0,0,0,0
../kbl_data/2023-2024,S43G01N185,대구 한국가스공사,Home,앤드류 니콜슨,28,8,11,72.7,4,9,44.4,12,20,60.0,0,1,0.0,0,6,6,1,4,1,0,2,3,0
../kbl_data/2023-2024,S43G01N185,대구 한국가스공사,Home,신승민,8,2,3,66.7,0,1,0.0,2,4,50.0,4,6,66.7,0,3,3,2,2,1,1,0,2,4
../kbl_data/2023-2024,S43G01N185,대구 한국가스공사,Home,샘조세프 벨란겔,13,3,4,75.0,1,8,12.5,4,12,33.3,4,4,100.0,0,3,3,3,1,0,1,0,2,2
../kbl_data/2023-2024,S43G01N185,대구 한국가스공사,Home,안세영,2,1,2,50.0,0,0,0.0,1,2,50.0,0,0,0.0,0,1,1,0,0,0,0,0,1,4
../kbl_data/2023-2024,S43G01N185,대구 한국가스공사,Home,듀반 맥스웰,9,4,4,100.0,0,0,0.0,4,4,100.0,1,2,50.0,2,1,3,0,0,1,0,2,0,2
../kbl_data/2023-2024,S43G01N185,고양 소노,Away,김강선,2,1,1,100.0,0,2,0.0,1,3,33.3,0,0,0.0,0,1,1,0,0,0,0,0,1,4
../kbl_data/2023-2024,S43G01N185,고양 소노,Away,함준후,0,0,0,0.0,0,0,0.0,0,0,0.0,0,0,0.0,0,0,0,0,0,0,0,0,0,0
../kbl_data/2023-2024,S43G01N185,고양 소노,Away,김민욱,5,1,1,100.0,1,2,50.0,2,3,66.7,0,0,0.0,0,2,2,0,0,0,0,0,1,4
../kbl_data/2023-2024,S43G01N185,고양 소노,Away,한호빈,4,2,2,100.0,0,2,0.0,2,4,50.0,0,0,0.0,0,0,0,3,0,0,0,0,0,2
../kbl_data/2023-2024,S43G01N185,고양 소노,Away,김진유,8,4,5,80.0,0,3,0.0,4,8,50.0,0,0,0.0,3,5,8,2,0,0,1,0,0,4
../kbl_data/2023-2024,S43G01N185,고양 소노,Away,다후안 서머스,3,0,3,0.0,1,2,50.0,1,5,20.0,0,0,0.0,2,0,2,0,1,0,0,0,2,1
../kbl_data/2023-2024,S43G01N185,고양 소노,Away,치나누 오누아쿠,12,4,10,40.0,1,4,25.0,5,14,35.7,1,2,50.0,2,5,7,4,3,0,0,0,5,3
../kbl_data/2023-2024,S43G01N185,고양 소노,Away,이정현,25,5,7,71.4,2,8,25.0,7,15,46.7,9,10,90.0,1,4,5,5,3,0,0,0,1,2
../kbl_data/2023-2024,S43G01N185,고양 소노,Away,백지웅,3,0,0,0.0,1,3,33.3,1,3,33.3,0,0,0.0,1,1,2,0,0,0,0,0,1,3
../kbl_data/2023-2024,S43G01N185,고양 소노,Away,안정욱,2,1,1,100.0,0,0,0.0,1,1,100.0,0,0,0.0,0,0,0,1,0,0,0,0,1,1
../kbl_data/2023-2024,S43G01N185,고양 소노,Away,박종하,2,1,2,50.0,0,2,0.0,1,4,25.0,0,0,0.0,1,2,3,1,0,0,0,0,0,1
../kbl_data/2023-2024,S43G01N185,고양 소노,Away,민기남,0,0,0,0.0,0,2,0.0,0,2,0.0,0,0,0.0,0,0,0,0,0,0,0,0,0,2
../kbl_data/2023-2024,S43G01N186,서울 삼성,Home,이정현,14,3,7,42.9,1,5,20.0,4,12,33.3,5,6,83.3,0,2,2,4,0,0,0,0,4,2
../kbl_data/2023-2024,S43G01N186,서울 삼성,Home,홍경기,4,2,2,100.0,0,2,0.0,2,4,50.0,0,0,0.0,0,0,0,4,0,0,1,0,1,2
../kbl_data/2023-2024,S43G01N186,서울 삼성,Home,이동엽,7,2,5,40.0,1,3,33.3,3,8,37.5,0,0,0.0,1,3,4,5,0,0,0,0,1,3
../kbl_data/2023-2024,S43G01N186,서울 삼성,Home,최승욱,0,0,0,0.0,0,1,0.0,0,1,0.0,0,0,0.0,1,1,2,2,1,0,1,0,1,2
../kbl_data/2023-2024,S43G01N186,서울 삼성,Home,윤성원,0,0,0,0.0,0,0,0.0,0,0,0.0,0,0,0.0,0,0,0,0,0,0,0,0,0,0
../kbl_data/2023-2024,S43G01N186,서울 삼성,Home,차민석,5,1,3,33.3,0,0,0.0,1,3,33.3,3,4,75.0,1,2,3,2,0,0,0,0,0,3
../kbl_data/2023-2024,S43G01N186,서울 삼성,Home,이원석,17,5,8,62.5,1,2,50.0,6,10,60.0,4,6,66.7,5,1,6,1,0,2,0,0,0,1
../kbl_data/2023-2024,S43G01N186,서울 삼성,Home,신동혁,8,1,2,50.0,2,2,100.0,3,4,75.0,0,0,0.0,0,2,2,0,1,0,0,0,1,3
../kbl_data/2023-2024,S43G01N186,서울 삼성,Home,조준희,0,0,0,0.0,0,0,0.0,0,0,0.0,0,0,0.0,0,0,0,0,0,0,0,0,0,0
../kbl_data/2023-2024,S43G01N186,서울 삼성,Home,아반 나바,0,0,0,0.0,0,0,0.0,0,0,0.0,0,0,0.0,0,0,0,0,0,0,0,0,0,0
../kbl_data/2023-2024,S43G01N186,서울 삼성,Home,이스마엘 레인,5,1,4,25.0,1,1,100.0,2,5,40.0,0,0,0.0,0,4,4,0,0,0,0,0,1,1
../kbl_data/2023-2024,S43G01N186,서울 삼성,Home,코피 코번,28,11,17,64.7,0,0,0.0,11,17,64.7,6,11,54.5,5,9,14,3,0,0,0,1,2,4
../kbl_data/2023-2024,S43G01N186,창원 LG,Away,이관희,18,6,10,60.0,1,5,20.0,7,15,46.7,3,4,75.0,2,2,4,3,1,0,1,0,1,1
../kbl_data/2023-2024,S43G01N186,창원 LG,Away,정희재,0,0,1,0.0,0,1,0.0,0,2,0.0,0,0,0.0,1,1,2,0,1,0,0,0,0,3
../kbl_data/2023-2024,S43G01N186,창원 LG,Away,이재도,16,2,3,66.7,3,4,75.0,5,7,71.4,3,3,100.0,0,0,0,2,2,0,0,0,0,3
../kbl_data/2023-2024,S43G01N186,창원 LG,Away,정인덕,0,0,0,0.0,0,0,0.0,0,0,0.0,0,0,0.0,0,0,0,0,0,0,0,0,0,0
../kbl_data/2023-2024,S43G01N186,창원 LG,Away,양홍석,15,3,3,100.0,2,6,33.3,5,9,55.6,3,3,100.0,0,4,4,7,0,1,0,0,3,4
../kbl_data/2023-2024,S43G01N186,창원 LG,Away,박정현,0,0,0,0.0,0,0,0.0,0,0,0.0,0,0,0.0,0,0,0,0,0,0,0,0,0,0
../kbl_data/2023-2024,S43G01N186,창원 LG,Away,이승우,2,1,2,50.0,0,0,0.0,1,2,50.0,0,0,0.0,0,0,0,0,0,0,0,0,0,0
../kbl_data/2023-2024,S43G01N186,창원 LG,Away,저스틴 구탕,2,1,1,100.0,0,1,0.0,1,2,50.0,0,0,0.0,0,1,1,0,0,0,0,0,0,0
../kbl_data/2023-2024,S43G01N186,창원 LG,Away,양준석,5,1,4,25.0,1,3,33.3,2,7,28.6,0,0,0.0,0,1,1,2,2,0,0,0,0,2
../kbl_data/2023-2024,S43G01N186,창원 LG,Away,유기상,6,0,1,0.0,2,6,33.3,2,7,28.6,0,0,0.0,0,2,2,0,1,0,0,0,0,3
../kbl_data/2023-2024,S43G01N186,창원 LG,Away,후안 텔로,12,4,7,57.1,1,2,50.0,5,9,55.6,1,2,50.0,3,4,7,4,0,1,0,0,2,4
../kbl_data/2023-2024,S43G01N186,창원 LG,Away,조쉬 이바라,10,4,11,36.4,0,0,0.0,4,11,36.4,2,5,40.0,5,4,9,2,2,2,0,0,0,4
../kbl_data/2023-2024,S43G01N187,안양 정관장,Home,정준원,7,2,3,66.7,0,1,0.0,2,4,50.0,3,5,60.0,2,1,3,0,1,0,0,0,0,3
../kbl_data/2023-2024,S43G01N187,안양 정관장,Home,김상규,2,1,1,100.0,0,1,0.0,1,2,50.0,0,2,0.0,1,2,3,0,0,1,1,0,1,1
../kbl_data/2023-2024,S43G01N187,안양 정관장,Home,정효근,6,1,6,16.7,1,3,33.3,2,9,22.2,1,2,50.0,0,1,1,2,2,0,0,0,0,1
../kbl_data/2023-2024,S43G01N187,안양 정관장,Home,이종현,4,2,3,66.7,0,0,0.0,2,3,66.7,0,0,0.0,3,4,7,3,1,2,0,0,1,3
../kbl_data/2023-2024,S43G01N187,안양 정관장,Home,김철욱,0,0,0,0.0,0,0,0.0,0,0,0.0,0,0,0.0,0,0,0,0,0,0,0,0,0,0
../kbl_data/2023-2024,S43G01N187,안양 정관장,Home,박지훈,9,2,7,28.6,1,6,16.7,3,13,23.1,2,2,100.0,0,3,3,2,0,0,0,0,1,3
../kbl_data/2023-2024,S43G01N187,안양 정관장,Home,최성원,18,6,9,66.7,1,5,20.0,7,14,50.0,3,4,75.0,2,4,6,4,1,0,0,0,2,2
../kbl_data/2023-2024,S43G01N187,안양 정관장,Home,이우정,0,0,0,0.0,0,0,0.0,0,0,0.0,0,0,0.0,0,0,0,1,0,0,0,0,0,0
../kbl_data/2023-2024,S43G01N187,안양 정관장,Home,김경원,2,1,3,33.3,0,1,0.0,1,4,25.0,0,0,0.0,1,1,2,1,0,0,0,0,0,1
../kbl_data/2023-2024,S43G01N187,안양 정관장,Home,고찬혁,4,2,3,66.7,0,1,0.0,2,4,50.0,0,0,0.0,0,0,0,0,0,0,0,0,0,0
../kbl_data/2023-2024,S43G01N187,안양 정관장,Home,로버트 카터,18,6,9,66.7,2,5,40.0,8,14,57.1,0,0,0.0,2,5,7,0,1,0,0,0,3,1
../kbl_data/2023-2024,S43G01N187,안양 정관장,Home,자밀 윌슨,14,5,7,71.4,1,3,33.3,6,10,60.0,1,1,100.0,0,2,2,2,0,1,0,0,2,1
../kbl_data/2023-2024,S43G01N187,원주 DB,Away,서민수,0,0,1,0.0,0,0,0.0,0,1,0.0,0,0,0.0,0,1,1,0,0,0,0,0,0,1
../kbl_data/2023-2024,S43G01N187,원주 DB,Away,김영현,5,1,3,33.3,1,2,50.0,2,5,40.0,0,0,0.0,2,1,3,1,0,0,0,0,0,3
../kbl_data/2023-2024,S43G01N187,원주 DB,Away,김종규,8,4,8,50.0,0,0,0.0,4,8,50.0,0,0,0.0,1,1,2,0,0,1,0,1,1,3
../kbl_data/2023-2024,S43G01N187,원주 DB,Away,최승욱,2,1,2,50.0,0,0,0.0,1,2,50.0,0,0,0.0,2,1,3,1,1,0,1,0,0,0
../kbl_data/2023-2024,S43G01N187,원주 DB,Away,강상재,20,4,5,80.0,4,7,57.1,8,12,66.7,0,0,0.0,1,8,9,7,0,0,0,0,1,2
../kbl_data/2023-2024,S43G01N187,원주 DB,Away,유현준,0,0,0,0.0,0,2,0.0,0,2,0.0,0,0,0.0,0,0,0,1,0,0,0,0,0,1
../kbl_data/2023-2024,S43G01N187,원주 DB,Away,김훈,0,0,0,0.0,0,0,0.0,0,0,0.0,0,0,0.0,0,0,0,0,0,0,0,0,0,3
../kbl_data/2023-2024,S43G01N187,원주 DB,Away,디드릭 로슨,40,9,14,64.3,6,8,75.0,15,22,68.2,4,5,80.0,2,9,11,5,6,0,0,2,4,2
../kbl_data/2023-2024,S43G01N187,원주 DB,Away,이선 알바노,23,7,9,77.8,3,6,50.0,10,15,66.7,0,0,0.0,0,3,3,8,1,0,0,0,1,2
../kbl_data/2023-2024,S43G01N187,원주 DB,Away,박인웅,0,0,0,0.0,0,0,0.0,0,0,0.0,0,0,0.0,0,0,0,0,0,0,0,0,0,1
../kbl_data/2023-2024,S43G01N187,원주 DB,Away,박승재,0,0,1,0.0,0,0,0.0,0,1,0.0,0,0,0.0,0,0,0,0,0,0,0,0,1,0
../kbl_data/2023-2024,S43G01N187,원주 DB,Away,제프 위디,1,0,3,0.0,0,0,0.0,0,3,0.0,1,2,50.0,1,2,3,0,0,1,0,0,1,0
../kbl_data/2023-2024,S43G01N188,울산 현대모비스,Home,함지훈,0,0,2,0.0,0,1,0.0,0,3,0.0,0,0,0.0,1,3,4,2,0,0,0,0,0,3
../kbl_data/2023-2024,S43G01N188,울산 현대모비스,Home,최진수,2,1,3,33.3,0,0,0.0,1,3,33.3,0,0,0.0,2,0,2,1,0,0,0,0,0,2
../kbl_data/2023-2024,S43G01N188,울산 현대모비스,Home,김현수,0,0,0,0.0,0,0,0.0,0,0,0.0,0,0,0.0,0,1,1,0,0,0,0,0,1,0
../kbl_data/2023-2024,S43G01N188,울산 현대모비스,Home,장재석,5,1,5,20.0,1,1,100.0,2,6,33.3,0,0,0.0,0,2,2,4,0,1,0,0,2,1
../kbl_data/2023-2024,S43G01N188,울산 현대모비스,Home,김준일,6,2,4,50.0,0,0,0.0,2,4,50.0,2,2,100.0,2,1,3,2,1,0,0,0,0,0
../kbl_data/2023-2024,S43G01N188,울산 현대모비스,Home,김국찬,3,0,1,0.0,1,2,50.0,1,3,33.3,0,0,0.0,1,0,1,1,0,0,0,0,1,2
../kbl_data/2023-2024,S43G01N188,울산 현대모비스,Home,이우석,24,10,15,66.7,1,1,100.0,11,16,68.8,1,2,50.0,1,6,7,5,3,0,0,0,0,0
../kbl_data/2023-2024,S43G01N188,울산 현대모비스,Home,신민석,0,0,0,0.0,0,0,0.0,0,0,0.0,0,0,0.0,0,0,0,0,0,0,0,0,0,0
../kbl_data/2023-2024,S43G01N188,울산 현대모비스,Home,게이지 프림,23,9,15,60.0,0,3,0.0,9,18,50.0,5,6,83.3,2,10,12,0,1,1,0,0,2,3
../kbl_data/2023-2024,S43G01N188,울산 현대모비스,Home,김태완,4,2,3,66.7,0,0,0.0,2,3,66.7,0,0,0.0,1,1,2,1,2,0,0,0,1,5
../kbl_data/2023-2024,S43G01N188,울산 현대모비스,Home,케베 알루마,11,5,7,71.4,0,2,0.0,5,9,55.6,1,1,100.0,2,8,10,4,0,0,0,0,0,4
../kbl_data/2023-2024,S43G01N188,울산 현대모비스,Home,미구엘 안드레 옥존,14,2,9,22.2,3,8,37.5,5,17,29.4,1,1,100.0,2,0,2,3,1,0,0,0,3,2
../kbl_data/2023-2024,S43G01N188,서울 SK,Away,양우섭,0,0,2,0.0,0,1,0.0,0,3,0.0,0,0,0.0,2,1,3,3,0,0,0,0,0,3
../kbl_data/2023-2024,S43G01N188,서울 SK,Away,허일영,3,0,1,0.0,1,2,50.0,1,3,33.3,0,0,0.0,0,2,2,0,1,0,0,0,0,2
../kbl_data/2023-2024,S43G01N188,서울 SK,Away,송창용,7,2,2,100.0,1,2,50.0,3,4,75.0,0,0,0.0,0,1,1,1,1,0,1,0,0,2
../kbl_data/2023-2024,S43G01N188,서울 SK,Away,오세근,3,1,7,14.3,0,1,0.0,1,8,12.5,1,2,50.0,0,2,2,2,1,0,0,0,0,1
../kbl_data/2023-2024,S43G01N188,서울 SK,Away,최부경,16,6,10,60.0,0,0,0.0,6,10,60.0,4,4,100.0,2,5,7,0,0,0,0,0,2,1
../kbl_data/2023-2024,S43G01N188,서울 SK,Away,리온 윌리엄스,8,4,11,36.4,0,0,0.0,4,11,36.4,0,4,0.0,3,8,11,0,0,2,0,1,0,4
../kbl_data/2023-2024,S43G01N188,서울 SK,Away,최원혁,11,0,2,0.0,3,6,50.0,3,8,37.5,2,2,100.0,3,3,6,3,1,0,0,0,2,3
../kbl_data/2023-2024,S43G01N188,서울 SK,Away,자밀 워니,11,5,13,38.5,0,1,0.0,5,14,35.7,1,2,50.0,2,2,4,3,0,1,0,0,1,1
../kbl_data/2023-2024,S43G01N188,서울 SK,Away,전성환,0,0,0,0.0,0,0,0.0,0,0,0.0,0,0,0.0,0,0,0,0,0,0,0,0,0,0
../kbl_data/2023-2024,S43G01N188,서울 SK,Away,김형빈,0,0,0,0.0,0,0,0.0,0,0,0.0,0,2,0.0,0,0,0,0,0,0,0,0,0,0
../kbl_data/2023-2024,S43G01N188,서울 SK,Away,오재현,21,8,16,50.0,1,1,100.0,9,17,52.9,2,3,66.7,2,5,7,7,5,0,0,0,4,3
../kbl_data/2023-2024,S43G01N188,서울 SK,Away,김건우,0,0,0,0.0,0,0,0.0,0,0,0.0,0,0,0.0,0,0,0,0,0,0,0,0,0,0
../kbl_data/2023-2024,S43G01N189,서울 삼성,Home,이정현,20,7,8,87.5,1,4,25.0,8,12,66.7,3,4,75.0,0,1,1,5,2,1,0,0,5,5
../kbl_data/2023-2024,S43G01N189,서울 삼성,Home,홍경기,17,0,2,0.0,5,8,62.5,5,10,50.0,2,2,100.0,1,1,2,5,3,0,0,0,0,5
../kbl_data/2023-2024,S43G01N189,서울 삼성,Home,이동엽,2,1,2,50.0,0,3,0.0,1,5,20.0,0,0,0.0,0,2,2,1,2,0,0,0,3,3
../kbl_data/2023-2024,S43G01N189,서울 삼성,Home,최승욱,3,1,3,33.3,0,2,0.0,1,5,20.0,1,2,50.0,0,1,1,1,2,0,0,0,1,2
../kbl_data/2023-2024,S43G01N189,서울 삼성,Home,윤성원,0,0,0,0.0,0,0,0.0,0,0,0.0,0,0,0.0,0,0,0,0,0,0,0,0,0,0
../kbl_data/2023-2024,S43G01N189,서울 삼성,Home,차민석,4,2,4,50.0,0,1,0.0,2,5,40.0,0,0,0.0,1,3,4,1,0,0,0,0,0,2
../kbl_data/2023-2024,S43G01N189,서울 삼성,Home,이원석,10,5,9,55.6,0,1,0.0,5,10,50.0,0,0,0.0,2,6,8,2,2,1,0,0,0,3
../kbl_data/2023-2024,S43G01N189,서울 삼성,Home,신동혁,11,2,5,40.0,2,3,66.7,4,8,50.0,1,4,25.0,1,5,6,0,0,0,0,0,0,3
../kbl_data/2023-2024,S43G01N189,서울 삼성,Home,조준희,0,0,0,0.0,0,0,0.0,0,0,0.0,0,0,0.0,0,0,0,0,0,0,0,0,0,0
../kbl_data/2023-2024,S43G01N189,서울 삼성,Home,아반 나바,0,0,0,0.0,0,0,0.0,0,0,0.0,0,0,0.0,0,0,0,0,0,0,0,0,0,0
../kbl_data/2023-2024,S43G01N189,서울 삼성,Home,이스마엘 레인,10,2,5,40.0,2,3,66.7,4,8,50.0,0,0,0.0,0,2,2,0,0,0,0,0,0,0
../kbl_data/2023-2024,S43G01N189,서울 삼성,Home,코피 코번,20,8,20,40.0,0,0,0.0,8,20,40.0,4,7,57.1,9,11,20,5,0,2,0,0,3,3
../kbl_data/2023-2024,S43G01N189,부산 KCC,Away,라건아,24,9,20,45.0,0,2,0.0,9,22,40.9,6,8,75.0,9,9,18,5,1,4,0,0,2,5
../kbl_data/2023-2024,S43G01N189,부산 KCC,Away,전준범,1,0,1,0.0,0,3,0.0,0,4,0.0,1,2,50.0,1,3,4,1,2,0,0,0,1,3
../kbl_data/2023-2024,S43G01N189,부산 KCC,Away,허웅,27,4,9,44.4,5,20,25.0,9,29,31.0,4,7,57.1,1,1,2,6,2,0,0,0,4,1
../kbl_data/2023-2024,S43G01N189,부산 KCC,Away,이승현,12,6,7,85.7,0,1,0.0,6,8,75.0,0,0,0.0,3,8,11,3,2,2,0,0,0,0
../kbl_data/2023-2024,S43G01N189,부산 KCC,Away,송교창,22,4,8,50.0,2,6,33.3,6,14,42.9,8,10,80.0,2,3,5,6,2,1,0,0,4,4
../kbl_data/2023-2024,S43G01N189,부산 KCC,Away,곽정훈,0,0,0,0.0,0,1,0.0,0,1,0.0,0,0,0.0,1,2,3,0,0,0,0,0,0,1
../kbl_data/2023-2024,S43G01N189,부산 KCC,Away,이근휘,0,0,1,0.0,0,0,0.0,0,1,0.0,0,0,0.0,0,0,0,1,0,0,0,0,0,0
../kbl_data/2023-2024,S43G01N189,부산 KCC,Away,김동현,0,0,0,0.0,0,0,0.0,0,0,0.0,0,0,0.0,0,0,0,0,0,0,0,0,0,0
../kbl_data/2023-2024,S43G01N189,부산 KCC,Away,송동훈,0,0,0,0.0,0,1,0.0,0,1,0.0,0,0,0.0,2,0,2,0,0,0,1,0,0,3
../kbl_data/2023-2024,S43G01N189,부산 KCC,Away,여준형,0,0,0,0.0,0,0,0.0,0,0,0.0,0,0,0.0,0,0,0,0,0,0,0,0,0,0
../kbl_data/2023-2024,S43G01N189,부산 KCC,Away,캘빈 제프리 에피스톨라,0,0,0,0.0,0,0,0.0,0,0,0.0,0,0,0.0,0,0,0,0,0,0,0,0,0,0
../kbl_data/2023-2024,S43G01N189,부산 KCC,Away,알리제 드숀 존슨,2,0,1,0.0,0,0,0.0,0,1,0.0,2,2,100.0,1,1,2,0,0,0,0,0,1,0
../kbl_data/2023-2024,S43G01N190,고양 소노,Home,김강선,2,0,0,0.0,0,2,0.0,0,2,0.0,2,2,100.0,0,0,0,0,1,0,0,0,1,3
../kbl_data/2023-2024,S43G01N190,고양 소노,Home,김민욱,12,0,0,0.0,3,6,50.0,3,6,50.0,3,4,75.0,0,4,4,0,0,0,0,0,1,5
../kbl_data/2023-2024,S43G01N190,고양 소노,Home,김지후,0,0,0,0.0,0,1,0.0,0,1,0.0,0,0,0.0,0,0,0,0,0,0,0,0,0,0
../kbl_data/2023-2024,S43G01N190,고양 소노,Home,김진유,11,3,6,50.0,1,4,25.0,4,10,40.0,2,2,100.0,2,6,8,5,0,0,2,0,0,5
../kbl_data/2023-2024,S43G01N190,고양 소노,Home,다후안 서머스,7,1,2,50.0,1,6,16.7,2,8,25.0,2,2,100.0,0,1,1,0,1,0,0,0,2,1
../kbl_data/2023-2024,S43G01N190,고양 소노,Home,치나누 오누아쿠,16,5,10,50.0,2,4,50.0,7,14,50.0,0,2,0.0,7,6,13,2,1,1,0,1,6,3
../kbl_data/2023-2024,S43G01N190,고양 소노,Home,이정현,27,7,11,63.6,3,8,37.5,10,19,52.6,4,5,80.0,1,2,3,9,5,0,0,0,1,1
../kbl_data/2023-2024,S43G01N190,고양 소노,Home,조은후,0,0,0,0.0,0,0,0.0,0,0,0.0,0,0,0.0,0,0,0,0,0,0,0,0,0,0
../kbl_data/2023-2024,S43G01N190,고양 소노,Home,백지웅,6,0,0,0.0,2,4,50.0,2,4,50.0,0,0,0.0,0,2,2,0,0,0,0,0,0,3
../kbl_data/2023-2024,S43G01N190,고양 소노,Home,조재우,0,0,1,0.0,0,0,0.0,0,1,0.0,0,0,0.0,0,0,0,0,0,0,0,0,0,0
../kbl_data/2023-2024,S43G01N190,고양 소노,Home,박종하,8,1,2,50.0,2,3,66.7,3,5,60.0,0,1,0.0,1,1,2,0,0,0,0,0,3,4
../kbl_data/2023-2024,S43G01N190,고양 소노,Home,민기남,0,0,0,0.0,0,0,0.0,0,0,0.0,0,0,0.0,0,0,0,0,0,0,0,0,0,0
../kbl_data/2023-2024,S43G01N190,수원 KT,Away,한희원,2,1,2,50.0,0,1,0.0,1,3,33.3,0,0,0.0,0,2,2,0,0,0,0,0,3,4
../kbl_data/2023-2024,S43G01N190,수원 KT,Away,최창진,0,0,0,0.0,0,0,0.0,0,0,0.0,0,0,0.0,0,0,0,0,0,0,0,0,0,0
../kbl_data/2023-2024,S43G01N190,수원 KT,Away,문성곤,8,3,3,100.0,0,4,0.0,3,7,42.9,2,2,100.0,2,1,3,7,3,0,0,0,0,4
../kbl_data/2023-2024,S43G01N190,수원 KT,Away,이현석,3,1,2,50.0,0,0,0.0,1,2,50.0,1,1,100.0,0,2,2,0,1,0,0,0,0,0
../kbl_data/2023-2024,S43G01N190,수원 KT,Away,정성우,15,4,5,80.0,1,4,25.0,5,9,55.6,4,4,100.0,0,4,4,4,2,0,1,0,0,2
../kbl_data/2023-2024,S43G01N190,수원 KT,Away,최성모,6,0,1,0.0,1,4,25.0,1,5,20.0,3,4,75.0,0,5,5,2,2,0,0,0,0,4
../kbl_data/2023-2024,S43G01N190,수원 KT,Away,이윤기,0,0,0,0.0,0,0,0.0,0,0,0.0,0,0,0.0,0,0,0,0,0,0,0,0,0,0
../kbl_data/2023-2024,S43G01N190,수원 KT,Away,하윤기,25,11,15,73.3,0,0,0.0,11,15,73.3,3,5,60.0,4,4,8,2,0,0,0,2,2,3
../kbl_data/2023-2024,S43G01N190,수원 KT,Away,이두원,0,0,0,0.0,0,0,0.0,0,0,0.0,0,0,0.0,0,0,0,0,0,0,0,0,0,0
../kbl_data/2023-2024,S43G01N190,수원 KT,Away,문정현,2,0,2,0.0,0,1,0.0,0,3,0.0,2,2,100.0,0,1,1,1,0,0,0,0,0,0
../kbl_data/2023-2024,S43G01N190,수원 KT,Away,마이클 에릭,3,1,1,100.0,0,0,0.0,1,1,100.0,1,4,25.0,1,2,3,0,0,0,0,1,0,0
../kbl_data/2023-2024,S43G01N190,수원 KT,Away,패리스 배스,28,9,11,81.8,3,6,50.0,12,17,70.6,1,3,33.3,0,8,8,4,2,0,0,4,6,4
../kbl_data/2023-2024,S43G01N191,창원 LG,Home,이관희,1,0,1,0.0,0,1,0.0,0,2,0.0,1,2,50.0,0,1,1,0,0,0,0,0,0,0
../kbl_data/2023-2024,S43G01N191,창원 LG,Home,정희재,8,1,1,100.0,2,5,40.0,3,6,50.0,0,0,0.0,2,0,2,2,2,0,0,0,2,5
../kbl_data/2023-2024,S43G01N191,창원 LG,Home,이재도,6,3,6,50.0,0,2,0.0,3,8,37.5,0,0,0.0,1,1,2,3,0,0,0,0,2,3
../kbl_data/2023-2024,S43G01N191,창원 LG,Home,정인덕,0,0,0,0.0,0,0,0.0,0,0,0.0,0,0,0.0,0,0,0,0,0,0,0,0,0,0
../kbl_data/2023-2024,S43G01N191,창원 LG,Home,양홍석,10,4,6,66.7,0,1,0.0,4,7,57.1,2,2,100.0,0,0,0,1,0,0,0,0,3,0
../kbl_data/2023-2024,S43G01N191,창원 LG,Home,박정현,0,0,1,0.0,0,0,0.0,0,1,0.0,0,0,0.0,0,0,0,0,0,0,0,0,0,1
../kbl_data/2023-2024,S43G01N191,창원 LG,Home,이승우,0,0,0,0.0,0,0,0.0,0,0,0.0,0,0,0.0,0,0,0,0,0,0,0,0,0,2
../kbl_data/2023-2024,S43G01N191,창원 LG,Home,저스틴 구탕,15,5,7,71.4,1,1,100.0,6,8,75.0,2,4,50.0,1,6,7,4,0,0,0,0,4,3
../kbl_data/2023-2024,S43G01N191,창원 LG,Home,양준석,3,0,3,0.0,1,1,100.0,1,4,25.0,0,0,0.0,0,1,1,3,2,0,0,0,1,1
../kbl_data/2023-2024,S43G01N191,창원 LG,Home,유기상,10,2,3,66.7,2,3,66.7,4,6,66.7,0,0,0.0,1,2,3,1,0,0,0,0,0,2
../kbl_data/2023-2024,S43G01N191,창원 LG,Home,후안 텔로,16,5,8,62.5,2,3,66.7,7,11,63.6,0,0,0.0,0,8,8,1,1,1,0,1,1,3
../kbl_data/2023-2024,S43G01N191,창원 LG,Home,조쉬 이바라,10,4,9,44.4,0,0,0.0,4,9,44.4,2,2,100.0,3,2,5,3,1,0,0,0,1,2
../kbl_data/2023-2024,S43G01N191,원주 DB,Away,김영현,3,0,1,0.0,1,4,25.0,1,5,20.0,0,0,0.0,1,2,3,3,1,0,0,0,0,2
../kbl_data/2023-2024,S43G01N191,원주 DB,Away,김종규,9,4,7,57.1,0,0,0.0,4,7,57.1,1,2,50.0,3,1,4,1,1,0,1,0,1,2
../kbl_data/2023-2024,S43G01N191,원주 DB,Away,최승욱,0,0,0,0.0,0,0,0.0,0,0,0.0,0,0,0.0,0,1,1,1,0,0,0,0,0,1
../kbl_data/2023-2024,S43G01N191,원주 DB,Away,강상재,20,3,6,50.0,4,6,66.7,7,12,58.3,2,4,50.0,4,2,6,5,1,0,0,0,2,1
../kbl_data/2023-2024,S43G01N191,원주 DB,Away,유현준,7,2,3,66.7,1,2,50.0,3,5,60.0,0,0,0.0,0,0,0,0,2,0,0,0,1,0
../kbl_data/2023-2024,S43G01N191,원주 DB,Away,김훈,0,0,0,0.0,0,0,0.0,0,0,0.0,0,0,0.0,0,0,0,0,0,0,0,0,0,0
../kbl_data/2023-2024,S43G01N191,원주 DB,Away,디드릭 로슨,18,4,7,57.1,3,7,42.9,7,14,50.0,1,4,25.0,0,7,7,5,3,0,0,0,4,2
../kbl_data/2023-2024,S43G01N191,원주 DB,Away,이용우,0,0,0,0.0,0,0,0.0,0,0,0.0,0,0,0.0,0,0,0,0,0,0,0,0,0,0
../kbl_data/2023-2024,S43G01N191,원주 DB,Away,이선 알바노,13,5,8,62.5,1,6,16.7,6,14,42.9,0,2,0.0,0,3,3,5,1,0,0,0,4,3
../kbl_data/2023-2024,S43G01N191,원주 DB,Away,박인웅,9,1,2,50.0,1,3,33.3,2,5,40.0,4,4,100.0,2,1,3,0,0,0,0,0,0,3
../kbl_data/2023-2024,S43G01N191,원주 DB,Away,박승재,0,0,0,0.0,0,0,0.0,0,0,0.0,0,0,0.0,0,0,0,0,0,0,0,0,0,0
../kbl_data/2023-2024,S43G01N191,원주 DB,Away,제프 위디,4,0,1,0.0,0,0,0.0,0,1,0.0,4,4,100.0,1,3,4,0,2,0,0,0,0,1
../kbl_data/2023-2024,S43G01N192,대구 한국가스공사,Home,김동량,0,0,0,0.0,0,0,0.0,0,0,0.0,0,0,0.0,0,0,0,0,0,0,0,0,0,0
../kbl_data/2023-2024,S43G01N192,대구 한국가스공사,Home,차바위,2,1,2,50.0,0,4,0.0,1,6,16.7,0,0,0.0,0,5,5,4,0,0,0,0,0,2
../kbl_data/2023-2024,S43G01N192,대구 한국가스공사,Home,조상열,0,0,0,0.0,0,0,0.0,0,0,0.0,0,0,0.0,0,0,0,0,0,0,0,0,0,0
../kbl_data/2023-2024,S43G01N192,대구 한국가스공사,Home,이대헌,17,8,12,66.7,0,1,0.0,8,13,61.5,1,2,50.0,6,2,8,2,1,0,1,0,0,1
../kbl_data/2023-2024,S43G01N192,대구 한국가스공사,Home,박봉진,0,0,0,0.0,0,0,0.0,0,0,0.0,0,0,0.0,0,0,0,0,0,0,0,0,0,0
../kbl_data/2023-2024,S43G01N192,대구 한국가스공사,Home,김낙현,18,1,2,50.0,5,9,55.6,6,11,54.5,1,2,50.0,1,2,3,2,1,0,0,0,1,2
../kbl_data/2023-2024,S43G01N192,대구 한국가스공사,Home,양준우,0,0,0,0.0,0,0,0.0,0,0,0.0,0,0,0.0,0,0,0,0,0,0,0,0,0,0
../kbl_data/2023-2024,S43G01N192,대구 한국가스공사,Home,앤드류 니콜슨,29,9,17,52.9,1,6,16.7,10,23,43.5,8,9,88.9,1,9,10,1,1,0,0,0,3,3
../kbl_data/2023-2024,S43G01N192,대구 한국가스공사,Home,신승민,8,2,4,50.0,1,2,50.0,3,6,50.0,1,1,100.0,2,2,4,2,2,0,0,0,1,4
../kbl_data/2023-2024,S43G01N192,대구 한국가스공사,Home,샘조세프 벨란겔,7,2,6,33.3,0,1,0.0,2,7,28.6,3,4,75.0,0,3,3,3,1,0,0,0,0,1
../kbl_data/2023-2024,S43G01N192,대구 한국가스공사,Home,안세영,2,0,0,0.0,0,0,0.0,0,0,0.0,2,2,100.0,0,0,0,0,0,0,0,0,0,4
../kbl_data/2023-2024,S43G01N192,대구 한국가스공사,Home,듀반 맥스웰,2,1,2,50.0,0,0,0.0,1,2,50.0,0,2,0.0,1,0,1,1,0,2,0,0,0,3
../kbl_data/2023-2024,S43G01N192,서울 삼성,Away,이정현,14,2,4,50.0,3,7,42.9,5,11,45.5,1,2,50.0,0,5,5,5,0,0,0,0,1,2
../kbl_data/2023-2024,S43G01N192,서울 삼성,Away,홍경기,5,1,2,50.0,1,5,20.0,2,7,28.6,0,0,0.0,0,1,1,2,1,0,0,0,1,2
../kbl_data/2023-2024,S43G01N192,서울 삼성,Away,이동엽,6,1,1,100.0,0,5,0.0,1,6,16.7,4,4,100.0,0,2,2,3,2,1,0,0,1,1
../kbl_data/2023-2024,S43G01N192,서울 삼성,Away,최승욱,5,1,1,100.0,1,1,100.0,2,2,100.0,0,0,0.0,0,2,2,1,0,0,0,0,1,4
../kbl_data/2023-2024,S43G01N192,서울 삼성,Away,윤성원,0,0,0,0.0,0,0,0.0,0,0,0.0,0,0,0.0,0,0,0,0,0,0,0,0,0,0
../kbl_data/2023-2024,S43G01N192,서울 삼성,Away,차민석,2,1,2,50.0,0,0,0.0,1,2,50.0,0,0,0.0,1,1,2,0,0,0,0,0,0,2
../kbl_data/2023-2024,S43G01N192,서울 삼성,Away,이원석,4,2,4,50.0,0,2,0.0,2,6,33.3,0,0,0.0,1,5,6,1,0,1,0,0,1,5
../kbl_data/2023-2024,S43G01N192,서울 삼성,Away,신동혁,5,1,3,33.3,1,3,33.3,2,6,33.3,0,0,0.0,0,2,2,0,1,0,0,0,1,3
../kbl_data/2023-2024,S43G01N192,서울 삼성,Away,조준희,0,0,0,0.0,0,0,0.0,0,0,0.0,0,0,0.0,0,0,0,0,0,0,0,0,0,0
../kbl_data/2023-2024,S43G01N192,서울 삼성,Away,아반 나바,0,0,0,0.0,0,0,0.0,0,0,0.0,0,0,0.0,0,0,0,0,0,0,0,0,0,0
../kbl_data/2023-2024,S43G01N192,서울 삼성,Away,이스마엘 레인,10,4,4,100.0,0,1,0.0,4,5,80.0,2,4,50.0,1,0,1,0,0,0,0,0,1,2
../kbl_data/2023-2024,S43G01N192,서울 삼성,Away,코피 코번,28,10,14,71.4,0,0,0.0,10,14,71.4,8,10,80.0,3,5,8,6,0,0,0,1,1,3
../kbl_data/2023-2024,S43G01N193,부산 KCC,Home,정창영,10,1,2,50.0,2,2,100.0,3,4,75.0,2,4,50.0,0,2,2,2,0,0,0,0,0,4
../kbl_data/2023-2024,S43G01N193,부산 KCC,Home,라건아,5,2,4,50.0,0,1,0.0,2,5,40.0,1,1,100.0,1,5,6,1,0,0,0,0,0,1
../kbl_data/2023-2024,S43G01N193,부산 KCC,Home,전준범,0,0,1,0.0,0,1,0.0,0,2,0.0,0,0,0.0,0,0,0,0,0,0,0,0,0,0
../kbl_data/2023-2024,S43G01N193,부산 KCC,Home,허웅,23,4,6,66.7,4,7,57.1,8,13,61.5,3,4,75.0,0,3,3,3,1,0,0,0,2,2
../kbl_data/2023-2024,S43G01N193,부산 KCC,Home,이승현,8,3,8,37.5,0,0,0.0,3,8,37.5,2,2,100.0,0,4,4,2,0,1,0,0,1,1
../kbl_data/2023-2024,S43G01N193,부산 KCC,Home,이호현,13,4,4,100.0,1,2,50.0,5,6,83.3,2,2,100.0,0,0,0,0,0,0,0,0,0,3
../kbl_data/2023-2024,S43G01N193,부산 KCC,Home,송교창,14,5,8,62.5,1,2,50.0,6,10,60.0,1,1,100.0,1,2,3,3,2,1,0,0,1,2
../kbl_data/2023-2024,S43G01N193,부산 KCC,Home,곽정훈,0,0,1,0.0,0,3,0.0,0,4,0.0,0,0,0.0,3,3,6,1,1,0,0,0,0,1
../kbl_data/2023-2024,S43G01N193,부산 KCC,Home,이근휘,3,0,0,0.0,1,3,33.3,1,3,33.3,0,0,0.0,0,1,1,0,0,0,0,0,0,1
../kbl_data/2023-2024,S43G01N193,부산 KCC,Home,여준형,0,0,0,0.0,0,1,0.0,0,1,0.0,0,0,0.0,1,0,1,0,0,0,0,0,0,0
../kbl_data/2023-2024,S43G01N193,부산 KCC,Home,캘빈 제프리 에피스톨라,0,0,0,0.0,0,0,0.0,0,0,0.0,0,0,0.0,0,0,0,0,0,0,0,0,2,1
../kbl_data/2023-2024,S43G01N193,부산 KCC,Home,알리제 드숀 존슨,14,5,8,62.5,0,1,0.0,5,9,55.6,4,4,100.0,1,12,13,7,2,0,0,1,1,3
../kbl_data/2023-2024,S43G01N193,창원 LG,Away,이관희,25,5,7,71.4,2,5,40.0,7,12,58.3,9,10,90.0,0,1,1,1,0,0,0,0,0,0
../kbl_data/2023-2024,S43G01N193,창원 LG,Away,정희재,0,0,2,0.0,0,1,0.0,0,3,0.0,0,0,0.0,0,0,0,0,0,0,0,0,1,2
../kbl_data/2023-2024,S43G01N193,창원 LG,Away,이재도,3,1,1,100.0,0,3,0.0,1,4,25.0,1,2,50.0,1,3,4,2,1,0,0,0,1,1
../kbl_data/2023-2024,S43G01N193,창원 LG,Away,정인덕,0,0,1,0.0,0,1,0.0,0,2,0.0,0,0,0.0,1,1,2,1,0,0,0,0,0,1
../kbl_data/2023-2024,S43G01N193,창원 LG,Away,양홍석,5,2,2,100.0,0,4,0.0,2,6,33.3,1,1,100.0,2,2,4,1,0,0,0,0,1,1
../kbl_data/2023-2024,S43G01N193,창원 LG,Away,박정현,0,0,1,0.0,0,2,0.0,0,3,0.0,0,0,0.0,0,1,1,0,0,0,0,0,0,1
../kbl_data/2023-2024,S43G01N193,창원 LG,Away,이승우,5,1,3,33.3,1,4,25.0,2,7,28.6,0,0,0.0,0,1,1,2,0,0,0,0,0,3
../kbl_data/2023-2024,S43G01N193,창원 LG,Away,저스틴 구탕,6,3,4,75.0,0,1,0.0,3,5,60.0,0,0,0.0,2,2,4,3,0,0,0,0,1,2
../kbl_data/2023-2024,S43G01N193,창원 LG,Away,양준석,5,2,3,66.7,0,5,0.0,2,8,25.0,1,2,50.0,0,0,0,2,0,0,0,0,1,4
../kbl_data/2023-2024,S43G01N193,창원 LG,Away,유기상,3,0,1,0.0,1,3,33.3,1,4,25.0,0,0,0.0,2,0,2,0,0,1,0,0,0,3
../kbl_data/2023-2024,S43G01N193,창원 LG,Away,후안 텔로,10,3,6,50.0,1,4,25.0,4,10,40.0,1,1,100.0,2,7,9,1,4,0,0,0,2,2
../kbl_data/2023-2024,S43G01N193,창원 LG,Away,조쉬 이바라,7,3,7,42.9,0,0,0.0,3,7,42.9,1,2,50.0,4,6,10,0,1,1,0,0,1,2
../kbl_data/2023-2024,S43G01N194,대구 한국가스공사,Home,김동량,6,3,3,100.0,0,0,0.0,3,3,100.0,0,0,0.0,0,0,0,0,1,0,0,0,0,1
../kbl_data/2023-2024,S43G01N194,대구 한국가스공사,Home,차바위,5,1,1,100.0,1,2,50.0,2,3,66.7,0,0,0.0,0,0,0,2,0,0,1,0,1,2
../kbl_data/2023-2024,S43G01N194,대구 한국가스공사,Home,조상열,8,1,1,100.0,2,4,50.0,3,5,60.0,0,0,0.0,1,0,1,1,0,0,0,0,0,1
../kbl_data/2023-2024,S43G01N194,대구 한국가스공사,Home,이대헌,16,6,10,60.0,1,4,25.0,7,14,50.0,1,2,50.0,2,3,5,2,1,0,0,0,0,3
../kbl_data/2023-2024,S43G01N194,대구 한국가스공사,Home,박봉진,0,0,0,0.0,0,0,0.0,0,0,0.0,0,0,0.0,0,0,0,0,0,0,0,0,0,0
../kbl_data/2023-2024,S43G01N194,대구 한국가스공사,Home,김낙현,10,2,4,50.0,1,4,25.0,3,8,37.5,3,4,75.0,0,3,3,3,1,0,0,0,0,3
../kbl_data/2023-2024,S43G01N194,대구 한국가스공사,Home,양준우,0,0,1,0.0,0,0,0.0,0,1,0.0,0,0,0.0,0,0,0,0,0,0,0,0,0,0
../kbl_data/2023-2024,S43G01N194,대구 한국가스공사,Home,앤드류 니콜슨,15,3,7,42.9,1,3,33.3,4,10,40.0,6,6,100.0,1,7,8,2,0,0,0,1,0,3
../kbl_data/2023-2024,S43G01N194,대구 한국가스공사,Home,신승민,8,0,1,0.0,2,7,28.6,2,8,25.0,2,2,100.0,1,2,3,0,0,0,1,0,2,2
../kbl_data/2023-2024,S43G01N194,대구 한국가스공사,Home,샘조세프 벨란겔,7,2,7,28.6,1,3,33.3,3,10,30.0,0,0,0.0,0,1,1,5,4,0,0,0,0,2
../kbl_data/2023-2024,S43G01N194,대구 한국가스공사,Home,안세영,0,0,0,0.0,0,1,0.0,0,1,0.0,0,0,0.0,0,0,0,0,1,0,0,0,0,1
../kbl_data/2023-2024,S43G01N194,대구 한국가스공사,Home,듀반 맥스웰,4,2,5,40.0,0,0,0.0,2,5,40.0,0,0,0.0,0,1,1,2,0,0,0,1,2,3
../kbl_data/2023-2024,S43G01N194,울산 현대모비스,Away,함지훈,2,1,2,50.0,0,0,0.0,1,2,50.0,0,0,0.0,1,1,2,3,0,0,0,0,0,0
../kbl_data/2023-2024,S43G01N194,울산 현대모비스,Away,최진수,14,4,4,100.0,2,5,40.0,6,9,66.7,0,0,0.0,1,4,5,2,0,0,0,0,0,1
../kbl_data/2023-2024,S43G01N194,울산 현대모비스,Away,장재석,2,0,1,0.0,0,0,0.0,0,1,0.0,2,2,100.0,1,4,5,1,0,1,0,0,2,4
../kbl_data/2023-2024,S43G01N194,울산 현대모비스,Away,김준일,3,1,2,50.0,0,0,0.0,1,2,50.0,1,2,50.0,0,3,3,1,2,0,0,0,0,2
../kbl_data/2023-2024,S43G01N194,울산 현대모비스,Away,김국찬,0,0,0,0.0,0,1,0.0,0,1,0.0,0,2,0.0,0,1,1,0,0,0,0,0,1,2
../kbl_data/2023-2024,S43G01N194,울산 현대모비스,Away,이우석,16,7,9,77.8,0,2,0.0,7,11,63.6,2,2,100.0,0,5,5,3,1,1,0,0,4,2
../kbl_data/2023-2024,S43G01N194,울산 현대모비스,Away,신민석,0,0,0,0.0,0,0,0.0,0,0,0.0,0,0,0.0,0,0,0,0,0,0,0,0,0,0
../kbl_data/2023-2024,S43G01N194,울산 현대모비스,Away,게이지 프림,19,7,9,77.8,0,0,0.0,7,9,77.8,5,6,83.3,2,3,5,2,1,0,0,0,3,0
../kbl_data/2023-2024,S43G01N194,울산 현대모비스,Away,김태완,6,0,0,0.0,2,2,100.0,2,2,100.0,0,0,0.0,0,0,0,0,0,0,0,0,0,2
../kbl_data/2023-2024,S43G01N194,울산 현대모비스,Away,박무빈,2,1,3,33.3,0,1,0.0,1,4,25.0,0,0,0.0,1,1,2,3,0,0,0,0,0,1
../kbl_data/2023-2024,S43G01N194,울산 현대모비스,Away,케베 알루마,18,6,8,75.0,1,2,50.0,7,10,70.0,3,4,75.0,1,4,5,0,0,0,0,0,2,2
../kbl_data/2023-2024,S43G01N194,울산 현대모비스,Away,미구엘 안드레 옥존,9,3,5,60.0,1,5,20.0,4,10,40.0,0,0,0.0,0,5,5,3,0,0,0,0,0,2
../kbl_data/2023-2024,S43G01N195,수원 KT,Home,한희원,3,0,0,0.0,1,3,33.3,1,3,33.3,0,0,0.0,0,4,4,0,1,0,0,0,1,1
../kbl_data/2023-2024,S43G01N195,수원 KT,Home,최창진,0,0,1,0.0,0,0,0.0,0,1,0.0,0,0,0.0,0,0,0,0,0,0,0,0,0,1
../kbl_data/2023-2024,S43G01N195,수원 KT,Home,문성곤,17,1,1,100.0,4,12,33.3,5,13,38.5,3,4,75.0,3,0,3,1,2,0,0,0,2,3
../kbl_data/2023-2024,S43G01N195,수원 KT,Home,이현석,0,0,0,0.0,0,0,0.0,0,0,0.0,0,0,0.0,0,0,0,0,0,0,0,0,0,0
../kbl_data/2023-2024,S43G01N195,수원 KT,Home,정성우,7,2,5,40.0,1,4,25.0,3,9,33.3,0,0,0.0,1,4,5,5,1,0,1,0,2,4
../kbl_data/2023-2024,S43G01N195,수원 KT,Home,최성모,5,1,3,33.3,1,3,33.3,2,6,33.3,0,0,0.0,2,4,6,3,0,0,0,0,2,1
../kbl_data/2023-2024,S43G01N195,수원 KT,Home,이윤기,0,0,0,0.0,0,1,0.0,0,1,0.0,0,0,0.0,0,1,1,0,0,0,0,0,0,1
../kbl_data/2023-2024,S43G01N195,수원 KT,Home,하윤기,15,6,13,46.2,0,0,0.0,6,13,46.2,3,5,60.0,3,3,6,1,0,1,0,0,3,2
../kbl_data/2023-2024,S43G01N195,수원 KT,Home,이두원,0,0,0,0.0,0,0,0.0,0,0,0.0,0,0,0.0,0,0,0,0,0,0,0,0,0,0
../kbl_data/2023-2024,S43G01N195,수원 KT,Home,문정현,6,0,0,0.0,2,4,50.0,2,4,50.0,0,0,0.0,1,3,4,3,1,0,0,0,0,3
../kbl_data/2023-2024,S43G01N195,수원 KT,Home,마이클 에릭,2,1,2,50.0,0,0,0.0,1,2,50.0,0,0,0.0,1,3,4,0,0,0,0,0,1,0
../kbl_data/2023-2024,S43G01N195,수원 KT,Home,패리스 배스,24,4,8,50.0,4,9,44.4,8,17,47.1,4,8,50.0,3,6,9,6,2,0,0,1,0,2
../kbl_data/2023-2024,S43G01N195,원주 DB,Away,서민수,0,0,0,0.0,0,0,0.0,0,0,0.0,0,0,0.0,0,0,0,0,0,0,0,0,0,0
../kbl_data/2023-2024,S43G01N195,원주 DB,Away,김영현,3,0,0,0.0,1,2,50.0,1,2,50.0,0,0,0.0,0,1,1,0,0,0,0,0,0,4
../kbl_data/2023-2024,S43G01N195,원주 DB,Away,김종규,12,4,7,57.1,1,2,50.0,5,9,55.6,1,2,50.0,4,2,6,0,0,0,0,0,1,5
../kbl_data/2023-2024,S43G01N195,원주 DB,Away,최승욱,0,0,0,0.0,0,0,0.0,0,0,0.0,0,0,0.0,0,0,0,0,0,0,0,0,0,0
../kbl_data/2023-2024,S43G01N195,원주 DB,Away,강상재,23,7,11,63.6,2,6,33.3,9,17,52.9,3,4,75.0,1,5,6,2,2,0,1,0,5,4
../kbl_data/2023-2024,S43G01N195,원주 DB,Away,유현준,0,0,0,0.0,0,0,0.0,0,0,0.0,0,0,0.0,0,0,0,0,0,0,0,0,0,0
../kbl_data/2023-2024,S43G01N195,원주 DB,Away,김훈,0,0,0,0.0,0,0,0.0,0,0,0.0,0,0,0.0,0,0,0,0,0,0,0,0,0,0
../kbl_data/2023-2024,S43G01N195,원주 DB,Away,디드릭 로슨,12,1,9,11.1,3,10,30.0,4,19,21.1,1,2,50.0,4,9,13,4,3,1,0,0,1,2
../kbl_data/2023-2024,S43G01N195,원주 DB,Away,이선 알바노,17,6,14,42.9,1,5,20.0,7,19,36.8,2,3,66.7,0,6,6,4,1,0,0,0,2,1
../kbl_data/2023-2024,S43G01N195,원주 DB,Away,박인웅,9,3,4,75.0,1,3,33.3,4,7,57.1,0,0,0.0,1,2,3,0,0,0,0,0,0,4
../kbl_data/2023-2024,S43G01N195,원주 DB,Away,박승재,0,0,0,0.0,0,0,0.0,0,0,0.0,0,0,0.0,0,0,0,0,0,0,0,0,0,0
../kbl_data/2023-2024,S43G01N195,원주 DB,Away,제프 위디,0,0,0,0.0,0,0,0.0,0,0,0.0,0,0,0.0,1,0,1,0,0,1,0,0,0,0
../kbl_data/2023-2024,S43G01N196,고양 소노,Home,김강선,10,2,3,66.7,2,4,50.0,4,7,57.1,0,0,0.0,0,4,4,3,4,0,0,0,1,3
../kbl_data/2023-2024,S43G01N196,고양 소노,Home,최현민,0,0,0,0.0,0,0,0.0,0,0,0.0,0,0,0.0,0,0,0,0,0,0,0,0,0,1
../kbl_data/2023-2024,S43G01N196,고양 소노,Home,김민욱,18,4,5,80.0,3,7,42.9,7,12,58.3,1,2,50.0,6,3,9,1,0,0,0,0,0,3
../kbl_data/2023-2024,S43G01N196,고양 소노,Home,한호빈,0,0,0,0.0,0,0,0.0,0,0,0.0,0,0,0.0,0,0,0,1,0,0,0,0,0,1
../kbl_data/2023-2024,S43G01N196,고양 소노,Home,김진유,0,0,0,0.0,0,1,0.0,0,1,0.0,0,0,0.0,0,1,1,0,0,0,0,0,0,0
../kbl_data/2023-2024,S43G01N196,고양 소노,Home,다후안 서머스,0,0,4,0.0,0,2,0.0,0,6,0.0,0,0,0.0,0,2,2,0,0,0,0,0,0,5
../kbl_data/2023-2024,S43G01N196,고양 소노,Home,치나누 오누아쿠,25,9,17,52.9,0,3,0.0,9,20,45.0,7,9,77.8,1,5,6,4,1,1,0,0,3,5
../kbl_data/2023-2024,S43G01N196,고양 소노,Home,이정현,92,18,28,64.3,8,24,33.3,26,52,50.0,32,36,88.9,8,8,16,28,4,0,0,0,14,8
../kbl_data/2023-2024,S43G01N196,고양 소노,Home,조은후,0,0,0,0.0,0,0,0.0,0,0,0.0,0,0,0.0,0,0,0,0,0,0,0,0,0,0
../kbl_data/2023-2024,S43G01N196,고양 소노,Home,백지웅,2,1,1,100.0,0,1,0.0,1,2,50.0,0,0,0.0,0,0,0,0,0,0,0,0,0,2
../kbl_data/2023-2024,S43G01N196,고양 소노,Home,조재우,0,0,0,0.0,0,0,0.0,0,0,0.0,0,0,0.0,0,0,0,0,0,0,0,0,0,0
../kbl_data/2023-2024,S43G01N196,고양 소노,Home,박종하,2,1,1,100.0,0,4,0.0,1,5,20.0,0,0,0.0,0,2,2,1,0,0,0,0,1,1
../kbl_data/2023-2024,S43G01N196,서울 삼성,Away,이정현,92,18,28,64.3,8,24,33.3,26,52,50.0,32,36,88.9,8,8,16,28,4,0,0,0,14,8
../kbl_data/2023-2024,S43G01N196,서울 삼성,Away,홍경기,11,3,4,75.0,1,5,20.0,4,9,44.4,2,3,66.7,0,0,0,5,1,1,0,0,2,2
../kbl_data/2023-2024,S43G01N196,서울 삼성,Away,이동엽,7,0,1,0.0,2,5,40.0,2,6,33.3,1,2,50.0,0,1,1,3,3,0,1,0,0,3
../kbl_data/2023-2024,S43G01N196,서울 삼성,Away,최승욱,2,1,1,100.0,0,1,0.0,1,2,50.0,0,0,0.0,1,2,3,0,0,0,0,0,0,3
../kbl_data/2023-2024,S43G01N196,서울 삼성,Away,윤성원,3,0,0,0.0,1,1,100.0,1,1,100.0,0,0,0.0,0,1,1,0,0,0,0,0,0,0
../kbl_data/2023-2024,S43G01N196,서울 삼성,Away,차민석,6,2,3,66.7,0,0,0.0,2,3,66.7,2,3,66.7,1,0,1,1,0,0,0,0,2,3
../kbl_data/2023-2024,S43G01N196,서울 삼성,Away,이원석,4,1,1,100.0,0,0,0.0,1,1,100.0,2,2,100.0,4,3,7,0,0,2,0,0,0,3
../kbl_data/2023-2024,S43G01N196,서울 삼성,Away,신동혁,16,2,3,66.7,4,4,100.0,6,7,85.7,0,0,0.0,0,5,5,2,0,0,0,0,0,3
../kbl_data/2023-2024,S43G01N196,서울 삼성,Away,조준희,0,0,0,0.0,0,0,0.0,0,0,0.0,0,0,0.0,0,0,0,0,0,0,0,0,0,0
../kbl_data/2023-2024,S43G01N196,서울 삼성,Away,아반 나바,0,0,0,0.0,0,0,0.0,0,0,0.0,0,0,0.0,0,0,0,0,0,0,0,0,0,0
../kbl_data/2023-2024,S43G01N196,서울 삼성,Away,이스마엘 레인,1,0,0,0.0,0,0,0.0,0,0,0.0,1,2,50.0,0,0,0,0,0,0,0,0,0,0
../kbl_data/2023-2024,S43G01N196,서울 삼성,Away,코피 코번,35,16,24,66.7,0,0,0.0,16,24,66.7,3,5,60.0,5,9,14,3,0,2,0,0,1,3
../kbl_data/2023-2024,S43G01N197,서울 SK,Home,양우섭,2,1,1,100.0,0,1,0.0,1,2,50.0,0,0,0.0,0,1,1,1,0,0,0,0,1,1
../kbl_data/2023-2024,S43G01N197,서울 SK,Home,허일영,17,5,8,62.5,2,4,50.0,7,12,58.3,1,1,100.0,2,4,6,0,1,0,0,0,0,1
../kbl_data/2023-2024,S43G01N197,서울 SK,Home,송창용,3,0,1,0.0,1,2,50.0,1,3,33.3,0,0,0.0,0,2,2,1,0,0,0,0,0,1
../kbl_data/2023-2024,S43G01N197,서울 SK,Home,오세근,13,4,6,66.7,0,1,0.0,4,7,57.1,5,6,83.3,2,2,4,1,0,0,0,0,1,2
../kbl_data/2023-2024,S43G01N197,서울 SK,Home,최부경,7,2,6,33.3,0,0,0.0,2,6,33.3,3,3,100.0,5,3,8,1,0,0,0,0,0,5
../kbl_data/2023-2024,S43G01N197,서울 SK,Home,리온 윌리엄스,4,0,0,0.0,1,1,100.0,1,1,100.0,1,2,50.0,2,1,3,1,0,0,0,0,0,0
../kbl_data/2023-2024,S43G01N197,서울 SK,Home,최원혁,0,0,2,0.0,0,0,0.0,0,2,0.0,0,0,0.0,1,1,2,6,1,0,1,0,2,3
../kbl_data/2023-2024,S43G01N197,서울 SK,Home,자밀 워니,22,6,17,35.3,1,5,20.0,7,22,31.8,7,8,87.5,4,5,9,4,0,0,0,0,1,0
../kbl_data/2023-2024,S43G01N197,서울 SK,Home,전성환,0,0,0,0.0,0,0,0.0,0,0,0.0,0,0,0.0,0,0,0,0,0,0,0,0,0,0
../kbl_data/2023-2024,S43G01N197,서울 SK,Home,김형빈,0,0,1,0.0,0,0,0.0,0,1,0.0,0,0,0.0,0,0,0,0,0,0,0,0,0,0
../kbl_data/2023-2024,S43G01N197,서울 SK,Home,오재현,16,7,11,63.6,0,3,0.0,7,14,50.0,2,2,100.0,0,3,3,2,5,0,0,0,0,4
../kbl_data/2023-2024,S43G01N197,서울 SK,Home,문가온,0,0,0,0.0,0,0,0.0,0,0,0.0,0,0,0.0,0,0,0,0,0,0,0,0,1,0
../kbl_data/2023-2024,S43G01N197,안양 정관장,Away,정준원,5,1,2,50.0,1,3,33.3,2,5,40.0,0,0,0.0,1,2,3,1,1,0,0,0,1,4
../kbl_data/2023-2024,S43G01N197,안양 정관장,Away,김상규,0,0,1,0.0,0,0,0.0,0,1,0.0,0,0,0.0,0,0,0,0,0,0,0,0,0,0
../kbl_data/2023-2024,S43G01N197,안양 정관장,Away,정효근,10,1,2,50.0,2,4,50.0,3,6,50.0,2,2,100.0,1,3,4,2,0,2,0,0,1,2
../kbl_data/2023-2024,S43G01N197,안양 정관장,Away,이종현,7,2,4,50.0,1,1,100.0,3,5,60.0,0,0,0.0,3,4,7,0,0,1,0,0,1,2
../kbl_data/2023-2024,S43G01N197,안양 정관장,Away,김철욱,0,0,0,0.0,0,0,0.0,0,0,0.0,0,0,0.0,0,1,1,0,0,0,0,0,0,0
../kbl_data/2023-2024,S43G01N197,안양 정관장,Away,박지훈,6,0,2,0.0,2,5,40.0,2,7,28.6,0,0,0.0,0,3,3,2,1,0,0,0,4,1
../kbl_data/2023-2024,S43G01N197,안양 정관장,Away,최성원,2,1,3,33.3,0,5,0.0,1,8,12.5,0,0,0.0,0,1,1,5,0,0,0,0,2,2
../kbl_data/2023-2024,S43G01N197,안양 정관장,Away,이우정,0,0,1,0.0,0,1,0.0,0,2,0.0,0,0,0.0,0,0,0,1,0,0,0,0,0,1
../kbl_data/2023-2024,S43G01N197,안양 정관장,Away,김경원,3,0,0,0.0,1,1,100.0,1,1,100.0,0,0,0.0,0,0,0,0,0,0,0,0,0,3
../kbl_data/2023-2024,S43G01N197,안양 정관장,Away,고찬혁,6,1,2,50.0,1,1,100.0,2,3,66.7,1,1,100.0,0,1,1,0,0,0,0,0,1,1
../kbl_data/2023-2024,S43G01N197,안양 정관장,Away,로버트 카터,10,3,5,60.0,1,2,50.0,4,7,57.1,1,1,100.0,0,2,2,1,0,1,0,0,1,2
../kbl_data/2023-2024,S43G01N197,안양 정관장,Away,자밀 윌슨,23,6,8,75.0,3,4,75.0,9,12,75.0,2,4,50.0,0,4,4,1,1,1,0,1,3,3
../kbl_data/2023-2024,S43G01N198,대구 한국가스공사,Home,차바위,2,0,1,0.0,0,3,0.0,0,4,0.0,2,2,100.0,1,4,5,1,1,0,0,0,3,1
../kbl_data/2023-2024,S43G01N198,대구 한국가스공사,Home,조상열,2,1,1,100.0,0,2,0.0,1,3,33.3,0,0,0.0,0,0,0,0,0,0,0,0,1,0
../kbl_data/2023-2024,S43G01N198,대구 한국가스공사,Home,이대헌,14,5,8,62.5,1,1,100.0,6,9,66.7,1,2,50.0,1,1,2,2,0,0,1,0,0,3
../kbl_data/2023-2024,S43G01N198,대구 한국가스공사,Home,박봉진,0,0,0,0.0,0,0,0.0,0,0,0.0,0,0,0.0,0,0,0,0,0,0,0,0,0,1
../kbl_data/2023-2024,S43G01N198,대구 한국가스공사,Home,김낙현,19,2,5,40.0,4,7,57.1,6,12,50.0,3,4,75.0,1,1,2,1,1,0,0,0,2,1
../kbl_data/2023-2024,S43G01N198,대구 한국가스공사,Home,양준우,0,0,0,0.0,0,0,0.0,0,0,0.0,0,0,0.0,0,1,1,0,0,0,0,0,0,0
../kbl_data/2023-2024,S43G01N198,대구 한국가스공사,Home,이도헌,0,0,0,0.0,0,0,0.0,0,0,0.0,0,0,0.0,0,0,0,0,0,0,0,0,0,0
../kbl_data/2023-2024,S43G01N198,대구 한국가스공사,Home,앤드류 니콜슨,0,0,1,0.0,0,1,0.0,0,2,0.0,0,0,0.0,0,1,1,1,0,0,0,0,0,0
../kbl_data/2023-2024,S43G01N198,대구 한국가스공사,Home,신승민,11,3,5,60.0,1,4,25.0,4,9,44.4,2,2,100.0,1,1,2,0,2,0,1,0,0,4
../kbl_data/2023-2024,S43G01N198,대구 한국가스공사,Home,샘조세프 벨란겔,9,3,7,42.9,1,3,33.3,4,10,40.0,0,2,0.0,1,0,1,3,0,0,0,0,1,4
../kbl_data/2023-2024,S43G01N198,대구 한국가스공사,Home,안세영,0,0,0,0.0,0,0,0.0,0,0,0.0,0,0,0.0,0,0,0,0,0,0,0,0,0,1
../kbl_data/2023-2024,S43G01N198,대구 한국가스공사,Home,듀반 맥스웰,23,10,16,62.5,0,1,0.0,10,17,58.8,3,8,37.5,4,11,15,3,4,3,0,1,3,3
../kbl_data/2023-2024,S43G01N198,창원 LG,Away,이관희,14,3,3,100.0,2,7,28.6,5,10,50.0,2,2,100.0,0,2,2,2,0,0,0,0,1,3
../kbl_data/2023-2024,S43G01N198,창원 LG,Away,정희재,9,1,1,100.0,2,3,66.7,3,4,75.0,1,1,100.0,1,2,3,2,0,0,0,0,1,5
../kbl_data/2023-2024,S43G01N198,창원 LG,Away,이재도,11,1,2,50.0,3,6,50.0,4,8,50.0,0,0,0.0,0,1,1,1,1,0,0,0,2,3
../kbl_data/2023-2024,S43G01N198,창원 LG,Away,정인덕,0,0,0,0.0,0,0,0.0,0,0,0.0,0,0,0.0,0,0,0,0,0,0,0,0,0,0
../kbl_data/2023-2024,S43G01N198,창원 LG,Away,양홍석,11,2,3,66.7,1,4,25.0,3,7,42.9,4,4,100.0,2,8,10,6,3,0,0,0,2,4
../kbl_data/2023-2024,S43G01N198,창원 LG,Away,박정현,0,0,1,0.0,0,0,0.0,0,1,0.0,0,0,0.0,0,0,0,0,0,0,0,0,0,0
../kbl_data/2023-2024,S43G01N198,창원 LG,Away,이승우,0,0,0,0.0,0,0,0.0,0,0,0.0,0,0,0.0,0,0,0,0,0,0,0,0,0,0
../kbl_data/2023-2024,S43G01N198,창원 LG,Away,저스틴 구탕,14,6,7,85.7,0,1,0.0,6,8,75.0,2,2,100.0,0,6,6,6,0,0,0,1,1,4
../kbl_data/2023-2024,S43G01N198,창원 LG,Away,양준석,0,0,0,0.0,0,0,0.0,0,0,0.0,0,0,0.0,0,0,0,1,0,0,0,0,1,0
../kbl_data/2023-2024,S43G01N198,창원 LG,Away,유기상,3,0,0,0.0,1,2,50.0,1,2,50.0,0,0,0.0,0,0,0,0,0,0,0,0,0,0
../kbl_data/2023-2024,S43G01N198,창원 LG,Away,후안 텔로,9,4,9,44.4,0,1,0.0,4,10,40.0,1,2,50.0,3,5,8,3,0,0,0,0,3,3
../kbl_data/2023-2024,S43G01N198,창원 LG,Away,조쉬 이바라,16,7,10,70.0,0,0,0.0,7,10,70.0,2,2,100.0,0,2,2,2,0,0,0,0,3,3
../kbl_data/2023-2024,S43G01N199,울산 현대모비스,Home,함지훈,4,1,2,50.0,0,0,0.0,1,2,50.0,2,4,50.0,1,2,3,2,0,1,0,0,0,1
../kbl_data/2023-2024,S43G01N199,울산 현대모비스,Home,최진수,0,0,2,0.0,0,2,0.0,0,4,0.0,0,0,0.0,1,0,1,1,0,0,0,0,0,1
../kbl_data/2023-2024,S43G01N199,울산 현대모비스,Home,김현수,3,0,0,0.0,1,1,100.0,1,1,100.0,0,0,0.0,0,0,0,0,0,0,0,0,0,0
../kbl_data/2023-2024,S43G01N199,울산 현대모비스,Home,장재석,8,3,4,75.0,0,0,0.0,3,4,75.0,2,4,50.0,4,5,9,6,1,0,0,1,0,4
../kbl_data/2023-2024,S43G01N199,울산 현대모비스,Home,김준일,5,1,3,33.3,1,1,100.0,2,4,50.0,0,0,0.0,3,1,4,1,0,0,0,0,0,1
../kbl_data/2023-2024,S43G01N199,울산 현대모비스,Home,김국찬,8,1,1,100.0,2,3,66.7,3,4,75.0,0,0,0.0,1,3,4,4,0,0,0,0,0,2
../kbl_data/2023-2024,S43G01N199,울산 현대모비스,Home,이우석,13,5,10,50.0,1,3,33.3,6,13,46.2,0,0,0.0,1,7,8,3,1,0,0,0,0,2
../kbl_data/2023-2024,S43G01N199,울산 현대모비스,Home,신민석,0,0,1,0.0,0,1,0.0,0,2,0.0,0,0,0.0,1,0,1,0,0,0,0,0,0,0
../kbl_data/2023-2024,S43G01N199,울산 현대모비스,Home,게이지 프림,25,11,17,64.7,0,1,0.0,11,18,61.1,3,7,42.9,3,5,8,1,0,1,0,2,4,2
../kbl_data/2023-2024,S43G01N199,울산 현대모비스,Home,김태완,5,1,1,100.0,1,1,100.0,2,2,100.0,0,0,0.0,0,0,0,3,1,0,0,0,0,1
../kbl_data/2023-2024,S43G01N199,울산 현대모비스,Home,박무빈,13,5,9,55.6,1,2,50.0,6,11,54.5,0,0,0.0,1,5,6,8,0,0,1,0,1,3
../kbl_data/2023-2024,S43G01N199,울산 현대모비스,Home,케베 알루마,10,2,6,33.3,1,3,33.3,3,9,33.3,3,3,100.0,0,3,3,2,0,0,0,0,1,3
../kbl_data/2023-2024,S43G01N199,부산 KCC,Away,정창영,0,0,0,0.0,0,0,0.0,0,0,0.0,0,2,0.0,0,1,1,0,0,0,0,0,0,2
../kbl_data/2023-2024,S43G01N199,부산 KCC,Away,라건아,15,6,9,66.7,0,1,0.0,6,10,60.0,3,4,75.0,2,4,6,1,0,0,0,1,1,3
../kbl_data/2023-2024,S43G01N199,부산 KCC,Away,전준범,0,0,0,0.0,0,2,0.0,0,2,0.0,0,0,0.0,0,1,1,1,0,0,0,0,1,1
../kbl_data/2023-2024,S43G01N199,부산 KCC,Away,허웅,18,4,6,66.7,2,6,33.3,6,12,50.0,4,4,100.0,0,0,0,3,0,0,1,0,0,0
../kbl_data/2023-2024,S43G01N199,부산 KCC,Away,이승현,2,0,5,0.0,0,1,0.0,0,6,0.0,2,2,100.0,1,1,2,2,1,0,0,0,0,2
../kbl_data/2023-2024,S43G01N199,부산 KCC,Away,이호현,2,1,4,25.0,0,2,0.0,1,6,16.7,0,0,0.0,0,2,2,2,1,0,0,0,0,4
../kbl_data/2023-2024,S43G01N199,부산 KCC,Away,송교창,13,1,7,14.3,3,4,75.0,4,11,36.4,2,2,100.0,0,4,4,4,0,1,0,0,0,3
../kbl_data/2023-2024,S43G01N199,부산 KCC,Away,곽정훈,0,0,0,0.0,0,0,0.0,0,0,0.0,0,0,0.0,0,0,0,0,0,0,0,0,0,0
../kbl_data/2023-2024,S43G01N199,부산 KCC,Away,이근휘,3,0,1,0.0,1,1,100.0,1,2,50.0,0,0,0.0,1,1,2,0,0,0,0,0,0,0
../kbl_data/2023-2024,S43G01N199,부산 KCC,Away,여준형,5,1,3,33.3,1,1,100.0,2,4,50.0,0,0,0.0,1,0,1,0,0,0,0,0,0,1
../kbl_data/2023-2024,S43G01N199,부산 KCC,Away,캘빈 제프리 에피스톨라,0,0,0,0.0,0,0,0.0,0,0,0.0,0,0,0.0,0,0,0,0,0,0,0,0,0,0
../kbl_data/2023-2024,S43G01N199,부산 KCC,Away,알리제 드숀 존슨,19,9,13,69.2,0,3,0.0,9,16,56.2,1,3,33.3,5,6,11,1,0,0,0,0,3,3
../kbl_data/2023-2024,S43G01N200,서울 삼성,Home,이정현,10,3,5,60.0,0,5,0.0,3,10,30.0,4,4,100.0,0,5,5,4,1,0,0,0,3,2
../kbl_data/2023-2024,S43G01N200,서울 삼성,Home,홍경기,8,1,5,20.0,2,5,40.0,3,10,30.0,0,0,0.0,0,5,5,3,0,0,0,0,4,3
../kbl_data/2023-2024,S43G01N200,서울 삼성,Home,이동엽,1,0,1,0.0,0,1,0.0,0,2,0.0,1,2,50.0,0,1,1,1,0,0,0,0,0,1
../kbl_data/2023-2024,S43G01N200,서울 삼성,Home,윤성원,0,0,0,0.0,0,0,0.0,0,0,0.0,0,0,0.0,0,0,0,0,0,0,0,0,0,0
../kbl_data/2023-2024,S43G01N200,서울 삼성,Home,차민석,6,1,3,33.3,1,3,33.3,2,6,33.3,1,2,50.0,4,4,8,0,0,0,0,0,0,5
../kbl_data/2023-2024,S43G01N200,서울 삼성,Home,이원석,3,1,1,100.0,0,0,0.0,1,1,100.0,1,1,100.0,1,1,2,0,0,0,0,0,0,1
../kbl_data/2023-2024,S43G01N200,서울 삼성,Home,신동혁,5,1,1,100.0,1,7,14.3,2,8,25.0,0,0,0.0,1,1,2,0,1,0,0,0,2,1
../kbl_data/2023-2024,S43G01N200,서울 삼성,Home,김근현,0,0,0,0.0,0,0,0.0,0,0,0.0,0,0,0.0,0,0,0,0,0,0,0,0,0,0
../kbl_data/2023-2024,S43G01N200,서울 삼성,Home,조준희,0,0,0,0.0,0,0,0.0,0,0,0.0,0,0,0.0,0,0,0,0,0,0,0,0,0,0
../kbl_data/2023-2024,S43G01N200,서울 삼성,Home,아반 나바,3,0,0,0.0,1,2,50.0,1,2,50.0,0,0,0.0,0,0,0,1,0,0,0,0,0,3
../kbl_data/2023-2024,S43G01N200,서울 삼성,Home,이스마엘 레인,6,2,4,50.0,0,0,0.0,2,4,50.0,2,2,100.0,1,2,3,0,0,0,0,0,0,0
../kbl_data/2023-2024,S43G01N200,서울 삼성,Home,코피 코번,28,12,18,66.7,0,0,0.0,12,18,66.7,4,4,100.0,5,5,10,3,0,0,0,0,4,1
../kbl_data/2023-2024,S43G01N200,서울 SK,Away,양우섭,2,1,3,33.3,0,1,0.0,1,4,25.0,0,0,0.0,0,0,0,2,1,0,0,0,0,3
../kbl_data/2023-2024,S43G01N200,서울 SK,Away,허일영,28,6,8,75.0,5,9,55.6,11,17,64.7,1,1,100.0,0,3,3,1,1,0,0,0,0,3
../kbl_data/2023-2024,S43G01N200,서울 SK,Away,송창용,0,0,1,0.0,0,1,0.0,0,2,0.0,0,0,0.0,1,1,2,0,2,0,0,0,1,1
../kbl_data/2023-2024,S43G01N200,서울 SK,Away,오세근,14,5,13,38.5,0,1,0.0,5,14,35.7,4,4,100.0,6,2,8,4,0,1,0,0,1,1
../kbl_data/2023-2024,S43G01N200,서울 SK,Away,최부경,2,1,4,25.0,0,0,0.0,1,4,25.0,0,0,0.0,1,2,3,1,0,0,0,0,0,1
../kbl_data/2023-2024,S43G01N200,서울 SK,Away,리온 윌리엄스,0,0,1,0.0,0,0,0.0,0,1,0.0,0,0,0.0,1,1,2,0,0,0,0,0,0,0
../kbl_data/2023-2024,S43G01N200,서울 SK,Away,최원혁,0,0,1,0.0,0,3,0.0,0,4,0.0,0,0,0.0,0,3,3,7,0,0,0,0,1,4
../kbl_data/2023-2024,S43G01N200,서울 SK,Away,자밀 워니,30,7,10,70.0,5,6,83.3,12,16,75.0,1,2,50.0,2,6,8,4,0,3,0,0,0,2
../kbl_data/2023-2024,S43G01N200,서울 SK,Away,김형빈,0,0,0,0.0,0,0,0.0,0,0,0.0,0,0,0.0,0,0,0,0,0,0,0,0,0,0
../kbl_data/2023-2024,S43G01N200,서울 SK,Away,박민우,0,0,0,0.0,0,0,0.0,0,0,0.0,0,0,0.0,0,0,0,0,0,0,0,0,0,0
../kbl_data/2023-2024,S43G01N200,서울 SK,Away,오재현,4,1,6,16.7,0,3,0.0,1,9,11.1,2,2,100.0,0,2,2,1,2,0,0,0,0,2
../kbl_data/2023-2024,S43G01N200,서울 SK,Away,문가온,0,0,0,0.0,0,0,0.0,0,0,0.0,0,0,0.0,0,0,0,0,0,0,0,0,0,0
../kbl_data/2023-2024,S43G01N201,안양 정관장,Home,정준원,7,2,2,100.0,1,2,50.0,3,4,75.0,0,0,0.0,3,2,5,0,1,0,0,0,1,2
../kbl_data/2023-2024,S43G01N201,안양 정관장,Home,김상규,0,0,0,0.0,0,0,0.0,0,0,0.0,0,0,0.0,0,0,0,0,0,0,1,0,0,0
../kbl_data/2023-2024,S43G01N201,안양 정관장,Home,정효근,4,0,1,0.0,1,5,20.0,1,6,16.7,1,2,50.0,1,5,6,2,1,0,1,0,1,4
../kbl_data/2023-2024,S43G01N201,안양 정관장,Home,이종현,4,2,4,50.0,0,0,0.0,2,4,50.0,0,0,0.0,1,3,4,3,0,1,0,0,1,3
../kbl_data/2023-2024,S43G01N201,안양 정관장,Home,김철욱,0,0,0,0.0,0,0,0.0,0,0,0.0,0,0,0.0,0,0,0,0,0,0,0,0,0,0
../kbl_data/2023-2024,S43G01N201,안양 정관장,Home,박지훈,12,3,8,37.5,2,4,50.0,5,12,41.7,0,0,0.0,1,0,1,3,1,0,0,0,3,5
../kbl_data/2023-2024,S43G01N201,안양 정관장,Home,최성원,7,1,5,20.0,1,5,20.0,2,10,20.0,2,2,100.0,0,1,1,7,0,0,0,0,0,3
../kbl_data/2023-2024,S43G01N201,안양 정관장,Home,이우정,0,0,0,0.0,0,0,0.0,0,0,0.0,0,0,0.0,0,0,0,0,0,0,0,0,0,0
../kbl_data/2023-2024,S43G01N201,안양 정관장,Home,김경원,6,3,3,100.0,0,0,0.0,3,3,100.0,0,0,0.0,2,1,3,0,0,0,0,0,0,2
../kbl_data/2023-2024,S43G01N201,안양 정관장,Home,고찬혁,0,0,0,0.0,0,0,0.0,0,0,0.0,0,0,0.0,0,0,0,0,0,0,0,0,0,0
../kbl_data/2023-2024,S43G01N201,안양 정관장,Home,로버트 카터,33,11,19,57.9,2,8,25.0,13,27,48.1,5,6,83.3,0,5,5,2,0,0,1,0,3,3
../kbl_data/2023-2024,S43G01N201,안양 정관장,Home,자밀 윌슨,4,2,4,50.0,0,1,0.0,2,5,40.0,0,0,0.0,0,1,1,0,0,0,0,0,0,2
../kbl_data/2023-2024,S43G01N201,수원 KT,Away,한희원,10,2,3,66.7,2,4,50.0,4,7,57.1,0,2,0.0,0,2,2,0,1,0,0,0,0,1
../kbl_data/2023-2024,S43G01N201,수원 KT,Away,최창진,0,0,0,0.0,0,0,0.0,0,0,0.0,0,0,0.0,1,0,1,1,0,0,0,0,0,1
../kbl_data/2023-2024,S43G01N201,수원 KT,Away,문성곤,3,0,0,0.0,1,5,20.0,1,5,20.0,0,0,0.0,1,2,3,3,2,0,0,0,1,3
../kbl_data/2023-2024,S43G01N201,수원 KT,Away,이현석,0,0,0,0.0,0,0,0.0,0,0,0.0,0,0,0.0,0,0,0,0,0,0,0,0,0,0
../kbl_data/2023-2024,S43G01N201,수원 KT,Away,정성우,11,2,5,40.0,2,4,50.0,4,9,44.4,1,2,50.0,0,3,3,7,1,1,0,0,0,2
../kbl_data/2023-2024,S43G01N201,수원 KT,Away,최성모,0,0,1,0.0,0,1,0.0,0,2,0.0,0,0,0.0,1,4,5,3,0,0,0,0,0,5
../kbl_data/2023-2024,S43G01N201,수원 KT,Away,이윤기,0,0,0,0.0,0,0,0.0,0,0,0.0,0,0,0.0,0,0,0,0,0,0,0,0,0,0
../kbl_data/2023-2024,S43G01N201,수원 KT,Away,하윤기,13,3,5,60.0,0,0,0.0,3,5,60.0,7,9,77.8,1,2,3,1,0,0,0,1,2,3
../kbl_data/2023-2024,S43G01N201,수원 KT,Away,이두원,4,1,2,50.0,0,0,0.0,1,2,50.0,2,4,50.0,0,1,1,0,1,0,0,0,1,2
../kbl_data/2023-2024,S43G01N201,수원 KT,Away,문정현,6,2,4,50.0,0,1,0.0,2,5,40.0,2,2,100.0,2,1,3,0,0,0,0,0,2,1
../kbl_data/2023-2024,S43G01N201,수원 KT,Away,마이클 에릭,2,1,1,100.0,0,0,0.0,1,1,100.0,0,0,0.0,1,1,2,0,0,0,0,0,1,1
../kbl_data/2023-2024,S43G01N201,수원 KT,Away,패리스 배스,41,10,13,76.9,4,9,44.4,14,22,63.6,9,12,75.0,2,14,16,8,2,0,0,3,4,3
../kbl_data/2023-2024,S43G01N202,원주 DB,Home,서민수,2,1,1,100.0,0,1,0.0,1,2,50.0,0,0,0.0,2,2,4,1,1,0,0,0,0,1
../kbl_data/2023-2024,S43G01N202,원주 DB,Home,김영현,11,1,1,100.0,3,4,75.0,4,5,80.0,0,0,0.0,0,1,1,0,0,0,0,0,0,1
../kbl_data/2023-2024,S43G01N202,원주 DB,Home,김종규,2,1,5,20.0,0,0,0.0,1,5,20.0,0,0,0.0,2,1,3,0,0,0,0,0,0,0
../kbl_data/2023-2024,S43G01N202,원주 DB,Home,최승욱,0,0,0,0.0,0,2,0.0,0,2,0.0,0,0,0.0,2,2,4,0,0,0,0,0,0,5
../kbl_data/2023-2024,S43G01N202,원주 DB,Home,강상재,20,5,9,55.6,3,6,50.0,8,15,53.3,1,2,50.0,5,6,11,5,0,0,0,0,2,3
../kbl_data/2023-2024,S43G01N202,원주 DB,Home,유현준,2,1,1,100.0,0,2,0.0,1,3,33.3,0,0,0.0,0,2,2,7,0,0,1,0,1,2
../kbl_data/2023-2024,S43G01N202,원주 DB,Home,디드릭 로슨,21,3,7,42.9,3,7,42.9,6,14,42.9,6,7,85.7,2,5,7,1,0,0,0,1,2,0
../kbl_data/2023-2024,S43G01N202,원주 DB,Home,이용우,2,1,1,100.0,0,2,0.0,1,3,33.3,0,0,0.0,0,0,0,0,1,0,0,0,0,0
../kbl_data/2023-2024,S43G01N202,원주 DB,Home,이선 알바노,4,2,3,66.7,0,2,0.0,2,5,40.0,0,0,0.0,0,3,3,10,1,0,1,0,5,3
../kbl_data/2023-2024,S43G01N202,원주 DB,Home,박인웅,10,2,3,66.7,2,4,50.0,4,7,57.1,0,0,0.0,0,1,1,1,1,0,0,0,2,1
../kbl_data/2023-2024,S43G01N202,원주 DB,Home,박승재,0,0,0,0.0,0,0,0.0,0,0,0.0,0,0,0.0,0,1,1,1,0,0,0,0,0,1
../kbl_data/2023-2024,S43G01N202,원주 DB,Home,제프 위디,15,6,12,50.0,0,0,0.0,6,12,50.0,3,6,50.0,3,11,14,1,0,2,0,2,2,3
../kbl_data/2023-2024,S43G01N202,고양 소노,Away,김강선,0,0,1,0.0,0,0,0.0,0,1,0.0,0,0,0.0,0,1,1,0,0,0,0,0,0,4
../kbl_data/2023-2024,S43G01N202,고양 소노,Away,함준후,0,0,0,0.0,0,0,0.0,0,0,0.0,0,0,0.0,0,0,0,0,0,0,0,0,0,0
../kbl_data/2023-2024,S43G01N202,고양 소노,Away,김민욱,5,2,4,50.0,0,3,0.0,2,7,28.6,1,1,100.0,0,3,3,0,3,0,0,0,0,0
../kbl_data/2023-2024,S43G01N202,고양 소노,Away,한호빈,12,2,3,66.7,2,5,40.0,4,8,50.0,2,3,66.7,2,1,3,4,2,0,0,0,1,4
../kbl_data/2023-2024,S43G01N202,고양 소노,Away,김지후,10,0,1,0.0,3,9,33.3,3,10,30.0,1,2,50.0,1,3,4,0,0,0,0,0,0,1
../kbl_data/2023-2024,S43G01N202,고양 소노,Away,다후안 서머스,4,2,4,50.0,0,6,0.0,2,10,20.0,0,0,0.0,1,3,4,3,0,1,0,2,2,1
../kbl_data/2023-2024,S43G01N202,고양 소노,Away,치나누 오누아쿠,15,5,12,41.7,1,5,20.0,6,17,35.3,2,3,66.7,4,5,9,1,1,1,0,0,4,1
../kbl_data/2023-2024,S43G01N202,고양 소노,Away,이정현,20,4,8,50.0,3,5,60.0,7,13,53.8,3,3,100.0,0,5,5,6,1,0,3,0,2,3
../kbl_data/2023-2024,S43G01N202,고양 소노,Away,백지웅,2,1,1,100.0,0,0,0.0,1,1,100.0,0,0,0.0,1,0,1,0,0,0,0,0,1,2
../kbl_data/2023-2024,S43G01N202,고양 소노,Away,조재우,0,0,0,0.0,0,0,0.0,0,0,0.0,0,0,0.0,0,0,0,0,0,0,0,0,0,0
../kbl_data/2023-2024,S43G01N202,고양 소노,Away,안정욱,6,0,1,0.0,2,5,40.0,2,6,33.3,0,0,0.0,0,0,0,0,1,0,0,0,0,1
../kbl_data/2023-2024,S43G01N202,고양 소노,Away,민기남,0,0,0,0.0,0,0,0.0,0,0,0.0,0,0,0.0,0,0,0,0,0,0,0,0,0,0
../kbl_data/2023-2024,S43G01N203,창원 LG,Home,이관희,2,1,2,50.0,0,0,0.0,1,2,50.0,0,0,0.0,0,1,1,0,0,0,0,0,0,1
../kbl_data/2023-2024,S43G01N203,창원 LG,Home,정희재,5,2,4,50.0,0,2,0.0,2,6,33.3,1,1,100.0,0,1,1,1,0,0,0,0,2,5
../kbl_data/2023-2024,S43G01N203,창원 LG,Home,이재도,11,1,3,33.3,2,6,33.3,3,9,33.3,3,4,75.0,1,0,1,11,3,0,0,0,2,2
../kbl_data/2023-2024,S43G01N203,창원 LG,Home,정인덕,0,0,0,0.0,0,0,0.0,0,0,0.0,0,0,0.0,0,0,0,0,0,0,0,0,0,0
../kbl_data/2023-2024,S43G01N203,창원 LG,Home,양홍석,17,7,13,53.8,0,3,0.0,7,16,43.8,3,3,100.0,4,3,7,5,1,0,0,0,0,4
../kbl_data/2023-2024,S43G01N203,창원 LG,Home,박정현,0,0,0,0.0,0,0,0.0,0,0,0.0,0,0,0.0,0,0,0,0,0,0,0,0,0,0
../kbl_data/2023-2024,S43G01N203,창원 LG,Home,이승우,0,0,0,0.0,0,0,0.0,0,0,0.0,0,0,0.0,0,0,0,0,0,0,0,0,0,1
../kbl_data/2023-2024,S43G01N203,창원 LG,Home,저스틴 구탕,18,7,9,77.8,1,1,100.0,8,10,80.0,1,2,50.0,1,0,1,4,1,0,1,1,3,1
../kbl_data/2023-2024,S43G01N203,창원 LG,Home,양준석,0,0,0,0.0,0,1,0.0,0,1,0.0,0,0,0.0,0,0,0,4,0,0,0,0,1,2
../kbl_data/2023-2024,S43G01N203,창원 LG,Home,유기상,12,1,2,50.0,2,4,50.0,3,6,50.0,4,4,100.0,1,2,3,1,1,0,0,0,0,0
../kbl_data/2023-2024,S43G01N203,창원 LG,Home,후안 텔로,6,3,5,60.0,0,2,0.0,3,7,42.9,0,0,0.0,0,3,3,1,1,0,0,0,0,1
../kbl_data/2023-2024,S43G01N203,창원 LG,Home,조쉬 이바라,24,10,15,66.7,0,0,0.0,10,15,66.7,4,5,80.0,2,7,9,4,1,1,0,0,1,3
../kbl_data/2023-2024,S43G01N203,울산 현대모비스,Away,함지훈,10,0,2,0.0,3,4,75.0,3,6,50.0,1,2,50.0,1,1,2,2,1,0,0,0,0,0
../kbl_data/2023-2024,S43G01N203,울산 현대모비스,Away,최진수,0,0,0,0.0,0,0,0.0,0,0,0.0,0,0,0.0,1,1,2,1,0,0,0,0,1,5
../kbl_data/2023-2024,S43G01N203,울산 현대모비스,Away,김현수,3,0,0,0.0,1,1,100.0,1,1,100.0,0,0,0.0,0,1,1,0,0,0,0,0,1,0
../kbl_data/2023-2024,S43G01N203,울산 현대모비스,Away,장재석,17,8,11,72.7,0,0,0.0,8,11,72.7,1,4,25.0,1,2,3,5,2,1,0,0,0,1
../kbl_data/2023-2024,S43G01N203,울산 현대모비스,Away,김준일,0,0,0,0.0,0,0,0.0,0,0,0.0,0,0,0.0,0,0,0,0,0,0,0,0,0,0
../kbl_data/2023-2024,S43G01N203,울산 현대모비스,Away,김국찬,2,0,1,0.0,0,1,0.0,0,2,0.0,2,2,100.0,0,3,3,4,1,0,0,0,0,3
../kbl_data/2023-2024,S43G01N203,울산 현대모비스,Away,이우석,2,0,3,0.0,0,0,0.0,0,3,0.0,2,2,100.0,1,3,4,4,0,0,0,0,2,2
../kbl_data/2023-2024,S43G01N203,울산 현대모비스,Away,신민석,0,0,0,0.0,0,0,0.0,0,0,0.0,0,0,0.0,0,0,0,0,0,0,0,0,0,0
../kbl_data/2023-2024,S43G01N203,울산 현대모비스,Away,게이지 프림,42,18,25,72.0,1,3,33.3,19,28,67.9,3,3,100.0,5,6,11,0,2,0,0,0,3,1
../kbl_data/2023-2024,S43G01N203,울산 현대모비스,Away,김태완,0,0,2,0.0,0,2,0.0,0,4,0.0,0,0,0.0,0,1,1,2,0,0,1,0,0,0
../kbl_data/2023-2024,S43G01N203,울산 현대모비스,Away,박무빈,15,2,2,100.0,2,6,33.3,4,8,50.0,5,6,83.3,1,3,4,8,0,0,0,0,3,4
../kbl_data/2023-2024,S43G01N203,울산 현대모비스,Away,케베 알루마,7,2,7,28.6,1,1,100.0,3,8,37.5,0,0,0.0,2,3,5,1,0,0,0,0,0,2
../kbl_data/2023-2024,S43G01N204,부산 KCC,Home,정창영,2,1,1,100.0,0,2,0.0,1,3,33.3,0,0,0.0,0,1,1,0,0,0,0,0,2,3
../kbl_data/2023-2024,S43G01N204,부산 KCC,Home,라건아,4,2,3,66.7,0,1,0.0,2,4,50.0,0,0,0.0,2,5,7,2,1,0,0,0,0,1
../kbl_data/2023-2024,S43G01N204,부산 KCC,Home,전준범,0,0,0,0.0,0,0,0.0,0,0,0.0,0,0,0.0,0,0,0,0,0,0,0,0,0,0
../kbl_data/2023-2024,S43G01N204,부산 KCC,Home,허웅,23,2,6,33.3,4,12,33.3,6,18,33.3,7,8,87.5,0,0,0,1,0,0,0,0,2,4
../kbl_data/2023-2024,S43G01N204,부산 KCC,Home,이승현,8,4,7,57.1,0,1,0.0,4,8,50.0,0,0,0.0,2,1,3,3,0,0,0,0,3,3
../kbl_data/2023-2024,S43G01N204,부산 KCC,Home,이호현,7,2,7,28.6,1,6,16.7,3,13,23.1,0,1,0.0,1,2,3,1,0,0,1,0,1,3
../kbl_data/2023-2024,S43G01N204,부산 KCC,Home,송교창,11,1,1,100.0,2,4,50.0,3,5,60.0,3,4,75.0,2,3,5,4,1,2,0,0,4,5
../kbl_data/2023-2024,S43G01N204,부산 KCC,Home,곽정훈,0,0,0,0.0,0,0,0.0,0,0,0.0,0,0,0.0,0,0,0,0,0,0,0,0,0,0
../kbl_data/2023-2024,S43G01N204,부산 KCC,Home,이근휘,3,0,0,0.0,1,2,50.0,1,2,50.0,0,0,0.0,0,0,0,0,0,0,0,0,1,2
../kbl_data/2023-2024,S43G01N204,부산 KCC,Home,여준형,0,0,0,0.0,0,0,0.0,0,0,0.0,0,0,0.0,0,0,0,0,0,0,0,0,0,0
../kbl_data/2023-2024,S43G01N204,부산 KCC,Home,캘빈 제프리 에피스톨라,0,0,0,0.0,0,0,0.0,0,0,0.0,0,0,0.0,0,0,0,0,0,0,0,0,0,0
../kbl_data/2023-2024,S43G01N204,부산 KCC,Home,알리제 드숀 존슨,23,10,10,100.0,1,2,50.0,11,12,91.7,0,0,0.0,7,14,21,4,0,0,0,1,1,1
../kbl_data/2023-2024,S43G01N204,대구 한국가스공사,Away,차바위,5,1,1,100.0,1,3,33.3,2,4,50.0,0,0,0.0,1,4,5,2,0,0,0,0,1,5
../kbl_data/2023-2024,S43G01N204,대구 한국가스공사,Away,조상열,0,0,0,0.0,0,0,0.0,0,0,0.0,0,0,0.0,0,0,0,0,0,0,0,0,0,0
../kbl_data/2023-2024,S43G01N204,대구 한국가스공사,Away,이대헌,17,5,8,62.5,2,5,40.0,7,13,53.8,1,2,50.0,2,3,5,1,0,0,0,0,0,3
../kbl_data/2023-2024,S43G01N204,대구 한국가스공사,Away,박봉진,3,0,0,0.0,1,3,33.3,1,3,33.3,0,0,0.0,2,1,3,3,1,0,1,0,0,1
../kbl_data/2023-2024,S43G01N204,대구 한국가스공사,Away,김낙현,5,0,2,0.0,1,7,14.3,1,9,11.1,2,2,100.0,2,4,6,1,3,0,0,0,0,2
../kbl_data/2023-2024,S43G01N204,대구 한국가스공사,Away,양준우,0,0,0,0.0,0,2,0.0,0,2,0.0,0,0,0.0,0,0,0,0,1,0,0,0,0,1
../kbl_data/2023-2024,S43G01N204,대구 한국가스공사,Away,이도헌,1,0,0,0.0,0,0,0.0,0,0,0.0,1,2,50.0,0,0,0,0,1,0,0,0,0,0
../kbl_data/2023-2024,S43G01N204,대구 한국가스공사,Away,신승민,10,0,5,0.0,1,4,25.0,1,9,11.1,7,8,87.5,0,1,1,2,0,0,1,0,0,2
../kbl_data/2023-2024,S43G01N204,대구 한국가스공사,Away,최주영,0,0,0,0.0,0,0,0.0,0,0,0.0,0,0,0.0,0,1,1,0,0,0,0,0,0,0
../kbl_data/2023-2024,S43G01N204,대구 한국가스공사,Away,샘조세프 벨란겔,11,5,10,50.0,0,1,0.0,5,11,45.5,1,2,50.0,0,1,1,3,1,0,0,0,1,1
../kbl_data/2023-2024,S43G01N204,대구 한국가스공사,Away,안세영,0,0,0,0.0,0,0,0.0,0,0,0.0,0,0,0.0,0,1,1,0,0,0,0,0,0,0
../kbl_data/2023-2024,S43G01N204,대구 한국가스공사,Away,듀반 맥스웰,20,9,13,69.2,0,1,0.0,9,14,64.3,2,3,66.7,1,3,4,4,2,2,0,1,2,2
../kbl_data/2023-2024,S43G01N205,원주 DB,Home,서민수,2,1,3,33.3,0,0,0.0,1,3,33.3,0,0,0.0,1,1,2,0,0,0,0,0,1,2
../kbl_data/2023-2024,S43G01N205,원주 DB,Home,김영현,0,0,0,0.0,0,0,0.0,0,0,0.0,0,0,0.0,0,1,1,0,1,0,0,0,0,0
../kbl_data/2023-2024,S43G01N205,원주 DB,Home,김종규,2,1,2,50.0,0,0,0.0,1,2,50.0,0,0,0.0,0,4,4,2,0,4,0,0,1,2
../kbl_data/2023-2024,S43G01N205,원주 DB,Home,최승욱,7,2,3,66.7,1,2,50.0,3,5,60.0,0,0,0.0,0,0,0,2,0,0,0,0,0,0
../kbl_data/2023-2024,S43G01N205,원주 DB,Home,강상재,12,5,7,71.4,0,3,0.0,5,10,50.0,2,2,100.0,3,6,9,6,2,0,0,0,2,5
../kbl_data/2023-2024,S43G01N205,원주 DB,Home,유현준,3,0,0,0.0,1,2,50.0,1,2,50.0,0,0,0.0,0,1,1,3,1,0,0,0,1,2
../kbl_data/2023-2024,S43G01N205,원주 DB,Home,김훈,0,0,0,0.0,0,1,0.0,0,1,0.0,0,0,0.0,1,0,1,0,0,0,0,0,0,0
../kbl_data/2023-2024,S43G01N205,원주 DB,Home,디드릭 로슨,18,2,6,33.3,3,9,33.3,5,15,33.3,5,5,100.0,0,5,5,0,1,1,0,0,2,1
../kbl_data/2023-2024,S43G01N205,원주 DB,Home,이선 알바노,12,6,8,75.0,0,2,0.0,6,10,60.0,0,0,0.0,0,1,1,5,0,0,0,0,1,2
../kbl_data/2023-2024,S43G01N205,원주 DB,Home,박인웅,13,2,2,100.0,3,6,50.0,5,8,62.5,0,0,0.0,0,2,2,0,0,0,0,0,0,3
../kbl_data/2023-2024,S43G01N205,원주 DB,Home,박승재,0,0,1,0.0,0,0,0.0,0,1,0.0,0,0,0.0,2,0,2,1,0,0,0,0,1,1
../kbl_data/2023-2024,S43G01N205,원주 DB,Home,제프 위디,13,4,5,80.0,1,1,100.0,5,6,83.3,2,4,50.0,1,11,12,0,0,1,0,1,0,2
../kbl_data/2023-2024,S43G01N205,서울 SK,Away,양우섭,8,2,2,100.0,1,2,50.0,3,4,75.0,1,2,50.0,0,1,1,0,3,0,0,0,0,2
../kbl_data/2023-2024,S43G01N205,서울 SK,Away,허일영,2,1,3,33.3,0,0,0.0,1,3,33.3,0,0,0.0,2,0,2,2,0,0,0,0,0,3
../kbl_data/2023-2024,S43G01N205,서울 SK,Away,송창용,0,0,0,0.0,0,0,0.0,0,0,0.0,0,0,0.0,0,0,0,0,0,0,0,0,0,1
../kbl_data/2023-2024,S43G01N205,서울 SK,Away,오세근,9,4,9,44.4,0,0,0.0,4,9,44.4,1,3,33.3,1,3,4,0,1,0,0,0,0,0
../kbl_data/2023-2024,S43G01N205,서울 SK,Away,최부경,9,3,7,42.9,0,0,0.0,3,7,42.9,3,5,60.0,0,3,3,1,1,0,0,0,0,2
../kbl_data/2023-2024,S43G01N205,서울 SK,Away,리온 윌리엄스,4,1,2,50.0,0,2,0.0,1,4,25.0,2,2,100.0,1,2,3,1,1,0,0,0,0,2
../kbl_data/2023-2024,S43G01N205,서울 SK,Away,최원혁,6,0,4,0.0,2,4,50.0,2,8,25.0,0,0,0.0,0,2,2,1,0,0,0,0,2,3
../kbl_data/2023-2024,S43G01N205,서울 SK,Away,자밀 워니,10,3,9,33.3,1,2,50.0,4,11,36.4,1,4,25.0,1,5,6,6,0,2,0,1,1,0
../kbl_data/2023-2024,S43G01N205,서울 SK,Away,김형빈,7,2,2,100.0,0,0,0.0,2,2,100.0,3,3,100.0,0,2,2,0,0,0,0,0,0,0
../kbl_data/2023-2024,S43G01N205,서울 SK,Away,박민우,0,0,0,0.0,0,0,0.0,0,0,0.0,0,0,0.0,0,0,0,0,0,0,0,0,0,0
../kbl_data/2023-2024,S43G01N205,서울 SK,Away,오재현,13,5,11,45.5,1,3,33.3,6,14,42.9,0,0,0.0,0,1,1,1,1,0,0,0,2,4
../kbl_data/2023-2024,S43G01N205,서울 SK,Away,문가온,0,0,0,0.0,0,0,0.0,0,0,0.0,0,0,0.0,0,0,0,0,0,0,0,0,0,0
../kbl_data/2023-2024,S43G01N206,서울 삼성,Home,이정현,10,4,7,57.1,0,4,0.0,4,11,36.4,2,2,100.0,0,6,6,9,4,0,0,0,3,3
../kbl_data/2023-2024,S43G01N206,서울 삼성,Home,홍경기,0,0,0,0.0,0,1,0.0,0,1,0.0,0,0,0.0,0,3,3,2,0,0,0,0,1,3
../kbl_data/2023-2024,S43G01N206,서울 삼성,Home,이동엽,9,3,5,60.0,1,5,20.0,4,10,40.0,0,0,0.0,1,6,7,2,0,0,0,0,3,4
../kbl_data/2023-2024,S43G01N206,서울 삼성,Home,윤성원,0,0,0,0.0,0,0,0.0,0,0,0.0,0,0,0.0,0,0,0,0,0,0,0,0,0,0
../kbl_data/2023-2024,S43G01N206,서울 삼성,Home,차민석,3,0,1,0.0,1,2,50.0,1,3,33.3,0,0,0.0,1,2,3,1,0,0,0,0,0,1
../kbl_data/2023-2024,S43G01N206,서울 삼성,Home,이원석,7,2,4,50.0,0,1,0.0,2,5,40.0,3,6,50.0,3,5,8,0,1,1,1,0,0,3
../kbl_data/2023-2024,S43G01N206,서울 삼성,Home,신동혁,5,1,2,50.0,1,2,50.0,2,4,50.0,0,0,0.0,0,2,2,1,0,0,0,0,1,1
../kbl_data/2023-2024,S43G01N206,서울 삼성,Home,김근현,0,0,0,0.0,0,1,0.0,0,1,0.0,0,0,0.0,0,0,0,0,0,0,0,0,0,0
../kbl_data/2023-2024,S43G01N206,서울 삼성,Home,조준희,2,0,0,0.0,0,0,0.0,0,0,0.0,2,2,100.0,0,2,2,0,0,0,0,0,1,2
../kbl_data/2023-2024,S43G01N206,서울 삼성,Home,아반 나바,0,0,0,0.0,0,0,0.0,0,0,0.0,0,0,0.0,0,0,0,0,0,0,0,0,0,0
../kbl_data/2023-2024,S43G01N206,서울 삼성,Home,이스마엘 레인,12,3,7,42.9,2,3,66.7,5,10,50.0,0,0,0.0,1,1,2,1,0,0,0,3,1,2
../kbl_data/2023-2024,S43G01N206,서울 삼성,Home,코피 코번,25,9,17,52.9,0,0,0.0,9,17,52.9,7,10,70.0,4,6,10,0,0,0,0,1,5,2
../kbl_data/2023-2024,S43G01N206,안양 정관장,Away,정준원,8,3,6,50.0,0,1,0.0,3,7,42.9,2,4,50.0,1,1,2,1,2,1,0,0,1,0
../kbl_data/2023-2024,S43G01N206,안양 정관장,Away,김상규,0,0,0,0.0,0,0,0.0,0,0,0.0,0,0,0.0,0,0,0,0,0,0,0,0,0,0
../kbl_data/2023-2024,S43G01N206,안양 정관장,Away,정효근,3,0,2,0.0,0,3,0.0,0,5,0.0,3,4,75.0,1,3,4,2,1,0,1,0,1,2
../kbl_data/2023-2024,S43G01N206,안양 정관장,Away,이종현,6,3,6,50.0,0,1,0.0,3,7,42.9,0,0,0.0,2,8,10,3,0,4,0,0,0,4
../kbl_data/2023-2024,S43G01N206,안양 정관장,Away,김철욱,0,0,0,0.0,0,0,0.0,0,0,0.0,0,0,0.0,0,0,0,0,0,0,0,0,0,0
../kbl_data/2023-2024,S43G01N206,안양 정관장,Away,박지훈,13,4,6,66.7,1,4,25.0,5,10,50.0,2,2,100.0,0,3,3,1,3,1,0,0,0,2
../kbl_data/2023-2024,S43G01N206,안양 정관장,Away,최성원,3,1,4,25.0,0,4,0.0,1,8,12.5,1,2,50.0,0,2,2,2,1,0,0,0,1,3
../kbl_data/2023-2024,S43G01N206,안양 정관장,Away,이우정,0,0,0,0.0,0,0,0.0,0,0,0.0,0,0,0.0,0,0,0,1,0,0,0,0,0,0
../kbl_data/2023-2024,S43G01N206,안양 정관장,Away,김경원,0,0,1,0.0,0,1,0.0,0,2,0.0,0,0,0.0,1,2,3,0,0,0,0,0,0,1
../kbl_data/2023-2024,S43G01N206,안양 정관장,Away,고찬혁,4,2,3,66.7,0,3,0.0,2,6,33.3,0,0,0.0,0,0,0,0,0,0,0,0,0,3
../kbl_data/2023-2024,S43G01N206,안양 정관장,Away,로버트 카터,12,2,4,50.0,1,3,33.3,3,7,42.9,5,6,83.3,2,2,4,2,1,1,0,0,3,3
../kbl_data/2023-2024,S43G01N206,안양 정관장,Away,자밀 윌슨,11,3,8,37.5,1,5,20.0,4,13,30.8,2,2,100.0,1,2,3,1,1,0,0,0,3,3
../kbl_data/2023-2024,S43G01N207,수원 KT,Home,한희원,5,0,1,0.0,1,3,33.3,1,4,25.0,2,3,66.7,0,2,2,1,0,1,0,0,0,2
../kbl_data/2023-2024,S43G01N207,수원 KT,Home,최창진,5,2,2,100.0,0,0,0.0,2,2,100.0,1,2,50.0,0,1,1,2,0,0,0,0,0,1
../kbl_data/2023-2024,S43G01N207,수원 KT,Home,문성곤,9,3,3,100.0,1,4,25.0,4,7,57.1,0,0,0.0,3,3,6,2,2,0,0,0,0,1
../kbl_data/2023-2024,S43G01N207,수원 KT,Home,이현석,0,0,0,0.0,0,0,0.0,0,0,0.0,0,0,0.0,0,0,0,0,0,0,0,0,0,0
../kbl_data/2023-2024,S43G01N207,수원 KT,Home,정성우,18,4,5,80.0,3,7,42.9,7,12,58.3,1,1,100.0,1,1,2,8,0,0,0,0,1,3
../kbl_data/2023-2024,S43G01N207,수원 KT,Home,최성모,0,0,0,0.0,0,1,0.0,0,1,0.0,0,0,0.0,0,0,0,0,0,0,0,0,0,0
../kbl_data/2023-2024,S43G01N207,수원 KT,Home,이윤기,0,0,0,0.0,0,0,0.0,0,0,0.0,0,0,0.0,0,0,0,0,0,0,0,0,0,0
../kbl_data/2023-2024,S43G01N207,수원 KT,Home,하윤기,11,5,10,50.0,0,0,0.0,5,10,50.0,1,1,100.0,1,3,4,0,0,0,1,0,0,4
../kbl_data/2023-2024,S43G01N207,수원 KT,Home,이두원,5,2,6,33.3,0,0,0.0,2,6,33.3,1,2,50.0,0,2,2,1,0,0,1,0,1,1
../kbl_data/2023-2024,S43G01N207,수원 KT,Home,문정현,16,2,4,50.0,4,5,80.0,6,9,66.7,0,1,0.0,3,1,4,1,1,0,0,0,0,3
../kbl_data/2023-2024,S43G01N207,수원 KT,Home,마이클 에릭,2,1,2,50.0,0,0,0.0,1,2,50.0,0,0,0.0,1,0,1,0,0,0,0,0,0,0
../kbl_data/2023-2024,S43G01N207,수원 KT,Home,패리스 배스,32,13,20,65.0,0,5,0.0,13,25,52.0,6,8,75.0,4,7,11,7,2,0,0,2,4,4
../kbl_data/2023-2024,S43G01N207,울산 현대모비스,Away,함지훈,6,0,0,0.0,2,3,66.7,2,3,66.7,0,0,0.0,0,5,5,4,0,0,0,0,0,2
../kbl_data/2023-2024,S43G01N207,울산 현대모비스,Away,최진수,2,1,2,50.0,0,2,0.0,1,4,25.0,0,0,0.0,1,0,1,2,0,0,0,0,0,4
../kbl_data/2023-2024,S43G01N207,울산 현대모비스,Away,김현수,0,0,0,0.0,0,0,0.0,0,0,0.0,0,0,0.0,0,0,0,0,0,0,0,0,0,0
../kbl_data/2023-2024,S43G01N207,울산 현대모비스,Away,장재석,2,1,2,50.0,0,0,0.0,1,2,50.0,0,0,0.0,2,2,4,1,0,0,0,0,1,1
../kbl_data/2023-2024,S43G01N207,울산 현대모비스,Away,김준일,0,0,0,0.0,0,0,0.0,0,0,0.0,0,0,0.0,0,0,0,0,0,0,0,0,0,0
../kbl_data/2023-2024,S43G01N207,울산 현대모비스,Away,김국찬,0,0,0,0.0,0,0,0.0,0,0,0.0,0,0,0.0,0,0,0,0,0,0,0,0,0,0
../kbl_data/2023-2024,S43G01N207,울산 현대모비스,Away,이우석,18,6,9,66.7,2,6,33.3,8,15,53.3,0,0,0.0,1,4,5,4,1,0,0,0,0,0
../kbl_data/2023-2024,S43G01N207,울산 현대모비스,Away,신민석,16,2,5,40.0,4,10,40.0,6,15,40.0,0,0,0.0,2,3,5,3,2,1,0,0,0,3
../kbl_data/2023-2024,S43G01N207,울산 현대모비스,Away,게이지 프림,36,14,17,82.4,0,0,0.0,14,17,82.4,8,10,80.0,5,5,10,1,0,0,0,2,4,4
../kbl_data/2023-2024,S43G01N207,울산 현대모비스,Away,김태완,2,1,2,50.0,0,1,0.0,1,3,33.3,0,0,0.0,0,0,0,0,0,0,0,0,0,2
../kbl_data/2023-2024,S43G01N207,울산 현대모비스,Away,박무빈,10,2,4,50.0,2,6,33.3,4,10,40.0,0,0,0.0,1,1,2,5,0,0,0,0,2,2
../kbl_data/2023-2024,S43G01N207,울산 현대모비스,Away,케베 알루마,7,2,3,66.7,0,1,0.0,2,4,50.0,3,3,100.0,0,2,2,1,0,0,0,0,2,3
../kbl_data/2023-2024,S43G01N208,고양 소노,Home,김강선,9,2,3,66.7,1,5,20.0,3,8,37.5,2,2,100.0,2,3,5,0,2,0,0,0,1,3
../kbl_data/2023-2024,S43G01N208,고양 소노,Home,함준후,0,0,0,0.0,0,0,0.0,0,0,0.0,0,0,0.0,0,0,0,0,0,0,0,0,0,0
../kbl_data/2023-2024,S43G01N208,고양 소노,Home,최현민,9,0,1,0.0,3,5,60.0,3,6,50.0,0,0,0.0,0,1,1,1,0,0,0,0,0,3
../kbl_data/2023-2024,S43G01N208,고양 소노,Home,김민욱,0,0,1,0.0,0,1,0.0,0,2,0.0,0,0,0.0,0,3,3,1,0,0,0,0,0,4
../kbl_data/2023-2024,S43G01N208,고양 소노,Home,한호빈,13,2,4,50.0,3,6,50.0,5,10,50.0,0,1,0.0,0,1,1,5,3,0,0,0,2,3
../kbl_data/2023-2024,S43G01N208,고양 소노,Home,김지후,0,0,0,0.0,0,1,0.0,0,1,0.0,0,0,0.0,0,0,0,0,0,0,0,0,0,0
../kbl_data/2023-2024,S43G01N208,고양 소노,Home,다후안 서머스,3,0,0,0.0,1,2,50.0,1,2,50.0,0,0,0.0,0,1,1,0,0,0,0,0,1,0
../kbl_data/2023-2024,S43G01N208,고양 소노,Home,치나누 오누아쿠,13,5,6,83.3,0,2,0.0,5,8,62.5,3,4,75.0,5,12,17,4,2,3,0,0,0,4
../kbl_data/2023-2024,S43G01N208,고양 소노,Home,이정현,42,8,13,61.5,6,13,46.2,14,26,53.8,8,8,100.0,0,4,4,11,1,1,0,0,3,2
../kbl_data/2023-2024,S43G01N208,고양 소노,Home,조은후,0,0,0,0.0,0,0,0.0,0,0,0.0,0,0,0.0,0,0,0,0,0,0,0,0,0,0
../kbl_data/2023-2024,S43G01N208,고양 소노,Home,백지웅,6,0,0,0.0,2,4,50.0,2,4,50.0,0,0,0.0,0,2,2,0,0,0,0,0,0,3
../kbl_data/2023-2024,S43G01N208,고양 소노,Home,안정욱,0,0,0,0.0,0,0,0.0,0,0,0.0,0,0,0.0,0,0,0,0,0,0,0,0,0,0
../kbl_data/2023-2024,S43G01N208,부산 KCC,Away,정창영,1,0,1,0.0,0,0,0.0,0,1,0.0,1,2,50.0,1,1,2,0,0,0,0,0,2,0
../kbl_data/2023-2024,S43G01N208,부산 KCC,Away,라건아,15,3,5,60.0,2,4,50.0,5,9,55.6,3,4,75.0,2,2,4,0,0,1,0,0,0,2
../kbl_data/2023-2024,S43G01N208,부산 KCC,Away,전준범,0,0,0,0.0,0,2,0.0,0,2,0.0,0,0,0.0,0,2,2,0,0,0,0,0,1,1
../kbl_data/2023-2024,S43G01N208,부산 KCC,Away,허웅,5,1,2,50.0,0,3,0.0,1,5,20.0,3,3,100.0,0,2,2,1,0,0,0,0,3,2
../kbl_data/2023-2024,S43G01N208,부산 KCC,Away,이승현,9,4,6,66.7,0,0,0.0,4,6,66.7,1,2,50.0,0,1,1,2,0,1,0,0,0,2
../kbl_data/2023-2024,S43G01N208,부산 KCC,Away,이호현,2,0,3,0.0,0,0,0.0,0,3,0.0,2,2,100.0,0,1,1,0,0,0,0,0,0,1
../kbl_data/2023-2024,S43G01N208,부산 KCC,Away,송교창,12,3,8,37.5,1,4,25.0,4,12,33.3,3,3,100.0,1,3,4,4,0,1,0,0,0,1
../kbl_data/2023-2024,S43G01N208,부산 KCC,Away,곽정훈,10,1,1,100.0,2,5,40.0,3,6,50.0,2,2,100.0,2,2,4,0,0,0,0,0,0,3
../kbl_data/2023-2024,S43G01N208,부산 KCC,Away,이근휘,10,2,3,66.7,2,7,28.6,4,10,40.0,0,0,0.0,0,0,0,0,4,0,0,0,0,1
../kbl_data/2023-2024,S43G01N208,부산 KCC,Away,여준형,0,0,0,0.0,0,0,0.0,0,0,0.0,0,0,0.0,0,0,0,0,0,0,0,0,0,0
../kbl_data/2023-2024,S43G01N208,부산 KCC,Away,캘빈 제프리 에피스톨라,4,2,3,66.7,0,0,0.0,2,3,66.7,0,0,0.0,0,2,2,1,0,0,0,0,0,1
../kbl_data/2023-2024,S43G01N208,부산 KCC,Away,알리제 드숀 존슨,9,4,6,66.7,0,0,0.0,4,6,66.7,1,1,100.0,2,6,8,3,0,0,0,0,2,4
../kbl_data/2023-2024,S43G01N209,안양 정관장,Home,정준원,2,1,2,50.0,0,1,0.0,1,3,33.3,0,0,0.0,0,1,1,0,1,0,0,0,0,2
../kbl_data/2023-2024,S43G01N209,안양 정관장,Home,김상규,1,0,0,0.0,0,0,0.0,0,0,0.0,1,2,50.0,0,0,0,0,0,0,0,0,0,2
../kbl_data/2023-2024,S43G01N209,안양 정관장,Home,정효근,2,1,3,33.3,0,6,0.0,1,9,11.1,0,0,0.0,0,6,6,1,2,0,0,0,0,3
../kbl_data/2023-2024,S43G01N209,안양 정관장,Home,이종현,6,2,4,50.0,0,1,0.0,2,5,40.0,2,2,100.0,1,0,1,0,0,0,0,0,2,1
../kbl_data/2023-2024,S43G01N209,안양 정관장,Home,박지훈,38,10,16,62.5,4,12,33.3,14,28,50.0,6,8,75.0,2,10,12,14,4,2,0,0,6,14
../kbl_data/2023-2024,S43G01N209,안양 정관장,Home,최성원,15,1,3,33.3,2,4,50.0,3,7,42.9,7,8,87.5,0,0,0,4,0,0,0,0,1,2
../kbl_data/2023-2024,S43G01N209,안양 정관장,Home,이우정,0,0,0,0.0,0,0,0.0,0,0,0.0,0,0,0.0,0,0,0,0,0,0,0,0,0,0
../kbl_data/2023-2024,S43G01N209,안양 정관장,Home,김경원,4,2,3,66.7,0,1,0.0,2,4,50.0,0,1,0.0,0,4,4,0,0,0,0,0,2,1
../kbl_data/2023-2024,S43G01N209,안양 정관장,Home,고찬혁,0,0,0,0.0,0,2,0.0,0,2,0.0,0,0,0.0,0,0,0,0,0,0,1,0,0,2
../kbl_data/2023-2024,S43G01N209,안양 정관장,Home,나성호,0,0,0,0.0,0,0,0.0,0,0,0.0,0,0,0.0,0,0,0,0,0,0,0,0,0,1
../kbl_data/2023-2024,S43G01N209,안양 정관장,Home,로버트 카터,20,4,7,57.1,2,4,50.0,6,11,54.5,6,6,100.0,0,7,7,1,1,0,0,0,2,1
../kbl_data/2023-2024,S43G01N209,안양 정관장,Home,자밀 윌슨,3,1,3,33.3,0,1,0.0,1,4,25.0,1,2,50.0,1,4,5,1,0,0,0,0,0,2
../kbl_data/2023-2024,S43G01N209,대구 한국가스공사,Away,차바위,10,2,2,100.0,2,5,40.0,4,7,57.1,0,0,0.0,3,2,5,0,0,0,1,0,3,3
../kbl_data/2023-2024,S43G01N209,대구 한국가스공사,Away,박지훈,38,10,16,62.5,4,12,33.3,14,28,50.0,6,8,75.0,2,10,12,14,4,2,0,0,6,14
../kbl_data/2023-2024,S43G01N209,대구 한국가스공사,Away,조상열,0,0,0,0.0,0,0,0.0,0,0,0.0,0,0,0.0,0,0,0,0,0,0,0,0,0,0
../kbl_data/2023-2024,S43G01N209,대구 한국가스공사,Away,이대헌,16,4,7,57.1,1,4,25.0,5,11,45.5,5,6,83.3,1,1,2,3,2,0,0,0,2,3
../kbl_data/2023-2024,S43G01N209,대구 한국가스공사,Away,박봉진,9,0,0,0.0,3,6,50.0,3,6,50.0,0,0,0.0,0,1,1,0,0,0,0,0,0,3
../kbl_data/2023-2024,S43G01N209,대구 한국가스공사,Away,김낙현,8,1,2,50.0,2,7,28.6,3,9,33.3,0,0,0.0,1,3,4,5,1,0,0,0,0,3
../kbl_data/2023-2024,S43G01N209,대구 한국가스공사,Away,양준우,0,0,0,0.0,0,0,0.0,0,0,0.0,0,0,0.0,0,0,0,0,0,0,0,0,0,0
../kbl_data/2023-2024,S43G01N209,대구 한국가스공사,Away,신승민,4,0,4,0.0,1,2,50.0,1,6,16.7,1,2,50.0,4,4,8,1,0,1,0,0,0,2
../kbl_data/2023-2024,S43G01N209,대구 한국가스공사,Away,최주영,0,0,0,0.0,0,0,0.0,0,0,0.0,0,0,0.0,0,0,0,0,0,0,0,0,0,0
../kbl_data/2023-2024,S43G01N209,대구 한국가스공사,Away,샘조세프 벨란겔,9,2,4,50.0,1,1,100.0,3,5,60.0,2,4,50.0,0,1,1,2,1,0,0,0,1,4
../kbl_data/2023-2024,S43G01N209,대구 한국가스공사,Away,안세영,0,0,0,0.0,0,0,0.0,0,0,0.0,0,0,0.0,0,0,0,0,0,0,0,0,0,0
../kbl_data/2023-2024,S43G01N209,대구 한국가스공사,Away,듀반 맥스웰,15,7,10,70.0,0,0,0.0,7,10,70.0,1,5,20.0,0,12,12,2,2,2,0,0,6,4
../kbl_data/2023-2024,S43G01N210,서울 SK,Home,양우섭,5,1,1,100.0,1,4,25.0,2,5,40.0,0,0,0.0,0,1,1,4,1,1,0,0,0,2
../kbl_data/2023-2024,S43G01N210,서울 SK,Home,허일영,12,2,3,66.7,2,3,66.7,4,6,66.7,2,2,100.0,2,3,5,1,1,0,0,0,1,3
../kbl_data/2023-2024,S43G01N210,서울 SK,Home,송창용,0,0,1,0.0,0,1,0.0,0,2,0.0,0,2,0.0,0,0,0,0,2,0,0,0,0,0
../kbl_data/2023-2024,S43G01N210,서울 SK,Home,오세근,6,2,5,40.0,0,0,0.0,2,5,40.0,2,2,100.0,1,1,2,1,0,0,0,0,0,3
../kbl_data/2023-2024,S43G01N210,서울 SK,Home,최부경,6,1,6,16.7,0,0,0.0,1,6,16.7,4,4,100.0,2,5,7,1,1,0,0,1,0,2
../kbl_data/2023-2024,S43G01N210,서울 SK,Home,리온 윌리엄스,0,0,0,0.0,0,0,0.0,0,0,0.0,0,0,0.0,0,0,0,0,0,0,0,0,0,0
../kbl_data/2023-2024,S43G01N210,서울 SK,Home,최원혁,5,1,3,33.3,1,3,33.3,2,6,33.3,0,0,0.0,3,0,3,4,0,0,0,0,3,2
../kbl_data/2023-2024,S43G01N210,서울 SK,Home,자밀 워니,19,7,14,50.0,1,6,16.7,8,20,40.0,2,4,50.0,3,6,9,2,1,0,0,0,2,0
../kbl_data/2023-2024,S43G01N210,서울 SK,Home,김형빈,0,0,0,0.0,0,0,0.0,0,0,0.0,0,0,0.0,0,0,0,0,0,0,0,0,0,0
../kbl_data/2023-2024,S43G01N210,서울 SK,Home,박민우,0,0,0,0.0,0,0,0.0,0,0,0.0,0,0,0.0,0,0,0,0,0,0,0,0,0,0
../kbl_data/2023-2024,S43G01N210,서울 SK,Home,오재현,14,4,10,40.0,1,5,20.0,5,15,33.3,3,3,100.0,0,4,4,4,0,0,0,0,3,4
../kbl_data/2023-2024,S43G01N210,서울 SK,Home,문가온,0,0,0,0.0,0,0,0.0,0,0,0.0,0,0,0.0,0,0,0,0,0,0,0,0,0,0
../kbl_data/2023-2024,S43G01N210,창원 LG,Away,이관희,3,0,0,0.0,0,2,0.0,0,2,0.0,3,3,100.0,0,2,2,3,0,2,0,0,2,0
../kbl_data/2023-2024,S43G01N210,창원 LG,Away,정희재,0,0,0,0.0,0,3,0.0,0,3,0.0,0,0,0.0,1,2,3,1,1,1,0,0,0,3
../kbl_data/2023-2024,S43G01N210,창원 LG,Away,이재도,8,4,8,50.0,0,3,0.0,4,11,36.4,0,0,0.0,1,2,3,5,0,0,0,0,1,1
../kbl_data/2023-2024,S43G01N210,창원 LG,Away,정인덕,0,0,0,0.0,0,0,0.0,0,0,0.0,0,0,0.0,0,0,0,0,0,0,0,0,0,0
../kbl_data/2023-2024,S43G01N210,창원 LG,Away,양홍석,12,3,5,60.0,2,7,28.6,5,12,41.7,0,0,0.0,0,6,6,7,1,0,0,0,2,4
../kbl_data/2023-2024,S43G01N210,창원 LG,Away,박정현,0,0,0,0.0,0,0,0.0,0,0,0.0,0,0,0.0,0,0,0,0,0,0,0,0,0,0
../kbl_data/2023-2024,S43G01N210,창원 LG,Away,이승우,0,0,0,0.0,0,0,0.0,0,0,0.0,0,0,0.0,0,0,0,0,0,0,0,0,0,0
../kbl_data/2023-2024,S43G01N210,창원 LG,Away,저스틴 구탕,14,4,5,80.0,2,2,100.0,6,7,85.7,0,1,0.0,0,1,1,4,1,0,0,0,1,2
../kbl_data/2023-2024,S43G01N210,창원 LG,Away,양준석,8,4,5,80.0,0,0,0.0,4,5,80.0,0,0,0.0,0,2,2,2,1,0,0,0,1,1
../kbl_data/2023-2024,S43G01N210,창원 LG,Away,유기상,15,1,4,25.0,4,7,57.1,5,11,45.5,1,2,50.0,3,3,6,0,1,0,0,0,1,2
../kbl_data/2023-2024,S43G01N210,창원 LG,Away,후안 텔로,6,3,6,50.0,0,1,0.0,3,7,42.9,0,0,0.0,3,4,7,2,0,0,0,0,0,1
../kbl_data/2023-2024,S43G01N210,창원 LG,Away,조쉬 이바라,10,5,6,83.3,0,0,0.0,5,6,83.3,0,0,0.0,3,5,8,0,0,0,0,1,0,4
../kbl_data/2023-2024,S43G01N211,울산 현대모비스,Home,함지훈,6,0,0,0.0,2,2,100.0,2,2,100.0,0,0,0.0,2,2,4,4,0,0,0,0,0,0
../kbl_data/2023-2024,S43G01N211,울산 현대모비스,Home,최진수,7,2,6,33.3,1,3,33.3,3,9,33.3,0,0,0.0,0,0,0,4,0,0,0,0,0,3
../kbl_data/2023-2024,S43G01N211,울산 현대모비스,Home,장재석,15,6,6,100.0,0,0,0.0,6,6,100.0,3,4,75.0,3,4,7,2,1,0,0,0,1,3
../kbl_data/2023-2024,S43G01N211,울산 현대모비스,Home,김준일,0,0,0,0.0,0,0,0.0,0,0,0.0,0,0,0.0,0,0,0,0,0,0,0,0,0,0
../kbl_data/2023-2024,S43G01N211,울산 현대모비스,Home,김국찬,6,0,0,0.0,2,2,100.0,2,2,100.0,0,0,0.0,0,1,1,1,1,0,0,0,1,2
../kbl_data/2023-2024,S43G01N211,울산 현대모비스,Home,이우석,14,4,7,57.1,2,4,50.0,6,11,54.5,0,0,0.0,1,8,9,6,1,0,0,0,0,3
../kbl_data/2023-2024,S43G01N211,울산 현대모비스,Home,신민석,0,0,0,0.0,0,0,0.0,0,0,0.0,0,0,0.0,0,0,0,0,0,0,0,0,0,0
../kbl_data/2023-2024,S43G01N211,울산 현대모비스,Home,게이지 프림,12,5,10,50.0,0,1,0.0,5,11,45.5,2,3,66.7,0,4,4,1,0,1,0,0,1,1
../kbl_data/2023-2024,S43G01N211,울산 현대모비스,Home,김태완,0,0,1,0.0,0,0,0.0,0,1,0.0,0,0,0.0,0,0,0,1,1,0,0,0,1,0
../kbl_data/2023-2024,S43G01N211,울산 현대모비스,Home,박무빈,6,3,6,50.0,0,2,0.0,3,8,37.5,0,0,0.0,0,3,3,5,2,0,0,0,2,2
../kbl_data/2023-2024,S43G01N211,울산 현대모비스,Home,케베 알루마,26,8,16,50.0,2,7,28.6,10,23,43.5,4,4,100.0,9,6,15,0,0,1,0,4,1,1
../kbl_data/2023-2024,S43G01N211,울산 현대모비스,Home,미구엘 안드레 옥존,6,0,2,0.0,2,3,66.7,2,5,40.0,0,0,0.0,0,1,1,2,0,0,1,0,2,3
../kbl_data/2023-2024,S43G01N211,안양 정관장,Away,김상규,0,0,0,0.0,0,0,0.0,0,0,0.0,0,0,0.0,0,0,0,0,0,0,0,0,0,0
../kbl_data/2023-2024,S43G01N211,안양 정관장,Away,배병준,4,1,2,50.0,0,5,0.0,1,7,14.3,2,2,100.0,1,0,1,2,0,1,0,0,1,0
../kbl_data/2023-2024,S43G01N211,안양 정관장,Away,정효근,6,2,4,50.0,0,1,0.0,2,5,40.0,2,2,100.0,0,3,3,3,0,0,0,0,0,3
../kbl_data/2023-2024,S43G01N211,안양 정관장,Away,이종현,14,7,9,77.8,0,1,0.0,7,10,70.0,0,0,0.0,4,5,9,1,2,0,0,1,0,1
../kbl_data/2023-2024,S43G01N211,안양 정관장,Away,박지훈,9,3,5,60.0,1,2,50.0,4,7,57.1,0,0,0.0,1,4,5,3,0,0,0,0,5,3
../kbl_data/2023-2024,S43G01N211,안양 정관장,Away,최성원,13,3,5,60.0,2,7,28.6,5,12,41.7,1,1,100.0,0,0,0,7,1,0,0,0,1,1
../kbl_data/2023-2024,S43G01N211,안양 정관장,Away,이우정,3,0,2,0.0,1,1,100.0,1,3,33.3,0,0,0.0,1,1,2,0,0,0,0,0,1,3
../kbl_data/2023-2024,S43G01N211,안양 정관장,Away,김경원,5,1,3,33.3,1,2,50.0,2,5,40.0,0,1,0.0,1,0,1,0,0,0,0,1,0,1
../kbl_data/2023-2024,S43G01N211,안양 정관장,Away,고찬혁,3,0,0,0.0,1,1,100.0,1,1,100.0,0,0,0.0,0,1,1,0,0,0,0,0,0,0
../kbl_data/2023-2024,S43G01N211,안양 정관장,Away,표승빈,0,0,1,0.0,0,0,0.0,0,1,0.0,0,0,0.0,0,0,0,0,1,0,0,0,0,0
../kbl_data/2023-2024,S43G01N211,안양 정관장,Away,로버트 카터,16,4,5,80.0,2,4,50.0,6,9,66.7,2,4,50.0,0,4,4,1,0,0,0,0,0,3
../kbl_data/2023-2024,S43G01N211,안양 정관장,Away,자밀 윌슨,8,2,8,25.0,1,1,100.0,3,9,33.3,1,2,50.0,0,2,2,2,1,0,0,0,0,2
../kbl_data/2023-2024,S43G01N212,서울 SK,Home,양우섭,1,0,0,0.0,0,1,0.0,0,1,0.0,1,2,50.0,2,5,7,2,1,0,0,0,1,0
../kbl_data/2023-2024,S43G01N212,서울 SK,Home,허일영,15,4,6,66.7,2,6,33.3,6,12,50.0,1,1,100.0,2,1,3,2,0,1,0,0,1,1
../kbl_data/2023-2024,S43G01N212,서울 SK,Home,송창용,3,0,1,0.0,1,2,50.0,1,3,33.3,0,0,0.0,0,0,0,0,0,0,0,0,0,2
../kbl_data/2023-2024,S43G01N212,서울 SK,Home,오세근,12,5,5,100.0,0,0,0.0,5,5,100.0,2,2,100.0,0,3,3,0,1,0,0,0,0,3
../kbl_data/2023-2024,S43G01N212,서울 SK,Home,최부경,10,2,4,50.0,0,0,0.0,2,4,50.0,6,6,100.0,0,5,5,3,0,0,0,0,0,4
../kbl_data/2023-2024,S43G01N212,서울 SK,Home,리온 윌리엄스,4,2,3,66.7,0,1,0.0,2,4,50.0,0,0,0.0,0,3,3,0,1,0,0,0,1,4
../kbl_data/2023-2024,S43G01N212,서울 SK,Home,최원혁,11,4,4,100.0,1,2,50.0,5,6,83.3,0,1,0.0,0,4,4,6,1,0,0,0,3,1
../kbl_data/2023-2024,S43G01N212,서울 SK,Home,자밀 워니,23,11,19,57.9,0,1,0.0,11,20,55.0,1,3,33.3,5,10,15,6,0,0,0,4,4,1
../kbl_data/2023-2024,S43G01N212,서울 SK,Home,김형빈,2,1,3,33.3,0,0,0.0,1,3,33.3,0,0,0.0,1,0,1,0,0,0,0,0,0,0
../kbl_data/2023-2024,S43G01N212,서울 SK,Home,오재현,11,3,3,100.0,1,2,50.0,4,5,80.0,2,2,100.0,0,5,5,7,3,0,0,0,5,3
../kbl_data/2023-2024,S43G01N212,서울 SK,Home,문가온,4,1,2,50.0,0,0,0.0,1,2,50.0,2,2,100.0,1,0,1,0,0,0,0,0,0,0
../kbl_data/2023-2024,S43G01N212,서울 SK,Home,이경도,2,1,1,100.0,0,0,0.0,1,1,100.0,0,0,0.0,1,0,1,0,0,0,0,0,0,1
../kbl_data/2023-2024,S43G01N212,고양 소노,Away,김강선,0,0,0,0.0,0,0,0.0,0,0,0.0,0,0,0.0,0,0,0,0,0,0,0,0,0,0
../kbl_data/2023-2024,S43G01N212,고양 소노,Away,최현민,0,0,2,0.0,0,2,0.0,0,4,0.0,0,0,0.0,1,0,1,1,0,0,1,0,0,2
../kbl_data/2023-2024,S43G01N212,고양 소노,Away,김민욱,2,1,2,50.0,0,2,0.0,1,4,25.0,0,0,0.0,1,4,5,0,0,0,0,0,0,1
../kbl_data/2023-2024,S43G01N212,고양 소노,Away,한호빈,7,1,2,50.0,0,4,0.0,1,6,16.7,5,5,100.0,0,3,3,4,1,0,0,0,0,2
../kbl_data/2023-2024,S43G01N212,고양 소노,Away,전성현,11,1,2,50.0,3,7,42.9,4,9,44.4,0,0,0.0,0,0,0,1,0,0,0,0,1,1
../kbl_data/2023-2024,S43G01N212,고양 소노,Away,김지후,10,2,2,100.0,2,6,33.3,4,8,50.0,0,0,0.0,0,1,1,0,2,0,0,0,2,1
../kbl_data/2023-2024,S43G01N212,고양 소노,Away,다후안 서머스,21,4,10,40.0,4,8,50.0,8,18,44.4,1,3,33.3,0,4,4,3,1,0,0,0,3,4
../kbl_data/2023-2024,S43G01N212,고양 소노,Away,치나누 오누아쿠,0,0,0,0.0,0,0,0.0,0,0,0.0,0,0,0.0,0,0,0,0,0,0,0,0,0,0
../kbl_data/2023-2024,S43G01N212,고양 소노,Away,이진석,0,0,0,0.0,0,0,0.0,0,0,0.0,0,0,0.0,0,1,1,1,0,0,0,0,2,0
../kbl_data/2023-2024,S43G01N212,고양 소노,Away,이정현,14,5,8,62.5,1,6,16.7,6,14,42.9,1,2,50.0,0,1,1,2,3,0,0,0,3,1
../kbl_data/2023-2024,S43G01N212,고양 소노,Away,백지웅,1,0,0,0.0,0,1,0.0,0,1,0.0,1,2,50.0,1,0,1,0,1,0,1,0,0,3
../kbl_data/2023-2024,S43G01N212,고양 소노,Away,안정욱,0,0,0,0.0,0,0,0.0,0,0,0.0,0,0,0.0,0,0,0,0,0,0,0,0,0,2
../kbl_data/2023-2024,S43G01N213,부산 KCC,Home,정창영,0,0,2,0.0,0,0,0.0,0,2,0.0,0,0,0.0,0,2,2,0,0,0,0,0,1,2
../kbl_data/2023-2024,S43G01N213,부산 KCC,Home,라건아,12,6,12,50.0,0,0,0.0,6,12,50.0,0,0,0.0,8,0,8,0,1,0,0,0,2,0
../kbl_data/2023-2024,S43G01N213,부산 KCC,Home,전준범,0,0,0,0.0,0,1,0.0,0,1,0.0,0,0,0.0,0,0,0,1,0,0,0,0,0,0
../kbl_data/2023-2024,S43G01N213,부산 KCC,Home,허웅,2,1,4,25.0,0,2,0.0,1,6,16.7,0,0,0.0,0,0,0,1,0,0,1,0,2,4
../kbl_data/2023-2024,S43G01N213,부산 KCC,Home,이승현,8,4,8,50.0,0,0,0.0,4,8,50.0,0,0,0.0,0,2,2,1,1,0,0,0,0,1
../kbl_data/2023-2024,S43G01N213,부산 KCC,Home,이호현,6,2,5,40.0,0,1,0.0,2,6,33.3,2,2,100.0,0,0,0,0,1,0,0,0,0,2
../kbl_data/2023-2024,S43G01N213,부산 KCC,Home,송교창,17,5,6,83.3,2,7,28.6,7,13,53.8,1,2,50.0,2,6,8,4,1,2,0,0,0,1
../kbl_data/2023-2024,S43G01N213,부산 KCC,Home,최준용,9,2,7,28.6,1,6,16.7,3,13,23.1,2,2,100.0,0,4,4,3,1,2,0,0,4,4
../kbl_data/2023-2024,S43G01N213,부산 KCC,Home,곽정훈,0,0,0,0.0,0,0,0.0,0,0,0.0,0,0,0.0,0,0,0,0,0,0,0,0,0,0
../kbl_data/2023-2024,S43G01N213,부산 KCC,Home,이근휘,6,0,0,0.0,2,3,66.7,2,3,66.7,0,0,0.0,0,0,0,1,0,0,0,0,0,1
../kbl_data/2023-2024,S43G01N213,부산 KCC,Home,캘빈 제프리 에피스톨라,0,0,0,0.0,0,0,0.0,0,0,0.0,0,0,0.0,0,0,0,0,0,0,0,0,0,0
../kbl_data/2023-2024,S43G01N213,부산 KCC,Home,알리제 드숀 존슨,18,6,8,75.0,1,3,33.3,7,11,63.6,3,4,75.0,3,5,8,3,1,0,0,0,0,2
../kbl_data/2023-2024,S43G01N213,원주 DB,Away,김현호,3,0,0,0.0,1,1,100.0,1,1,100.0,0,0,0.0,0,0,0,0,0,0,0,0,0,0
../kbl_data/2023-2024,S43G01N213,원주 DB,Away,서민수,0,0,0,0.0,0,0,0.0,0,0,0.0,0,0,0.0,0,1,1,0,0,0,0,0,0,1
../kbl_data/2023-2024,S43G01N213,원주 DB,Away,김영현,3,0,0,0.0,1,3,33.3,1,3,33.3,0,0,0.0,1,1,2,0,1,0,0,0,0,3
../kbl_data/2023-2024,S43G01N213,원주 DB,Away,김종규,10,5,13,38.5,0,0,0.0,5,13,38.5,0,0,0.0,6,3,9,2,0,1,0,0,2,3
../kbl_data/2023-2024,S43G01N213,원주 DB,Away,최승욱,0,0,0,0.0,0,0,0.0,0,0,0.0,0,0,0.0,1,0,1,0,0,0,0,0,0,0
../kbl_data/2023-2024,S43G01N213,원주 DB,Away,강상재,5,2,3,66.7,0,4,0.0,2,7,28.6,1,1,100.0,1,7,8,5,2,1,0,0,2,1
../kbl_data/2023-2024,S43G01N213,원주 DB,Away,유현준,0,0,0,0.0,0,1,0.0,0,1,0.0,0,0,0.0,0,0,0,0,0,0,0,0,0,0
../kbl_data/2023-2024,S43G01N213,원주 DB,Away,디드릭 로슨,32,6,10,60.0,5,11,45.5,11,21,52.4,5,6,83.3,4,10,14,3,1,1,0,1,1,2
../kbl_data/2023-2024,S43G01N213,원주 DB,Away,이선 알바노,25,5,11,45.5,5,8,62.5,10,19,52.6,0,0,0.0,1,2,3,8,3,0,0,0,3,3
../kbl_data/2023-2024,S43G01N213,원주 DB,Away,박인웅,12,1,1,100.0,3,5,60.0,4,6,66.7,1,2,50.0,1,0,1,0,1,0,1,0,1,2
../kbl_data/2023-2024,S43G01N213,원주 DB,Away,박승재,0,0,0,0.0,0,0,0.0,0,0,0.0,0,0,0.0,0,1,1,0,0,0,0,0,0,1
../kbl_data/2023-2024,S43G01N213,원주 DB,Away,제프 위디,2,1,3,33.3,0,0,0.0,1,3,33.3,0,0,0.0,2,2,4,0,0,1,0,0,1,0
../kbl_data/2023-2024,S43G01N214,서울 삼성,Home,이정현,12,4,5,80.0,0,4,0.0,4,9,44.4,4,4,100.0,0,1,1,6,1,0,0,0,8,3
../kbl_data/2023-2024,S43G01N214,서울 삼성,Home,홍경기,2,0,0,0.0,0,1,0.0,0,1,0.0,2,2,100.0,0,2,2,1,0,0,0,0,2,1
../kbl_data/2023-2024,S43G01N214,서울 삼성,Home,이동엽,2,0,1,0.0,0,5,0.0,0,6,0.0,2,2,100.0,0,0,0,3,2,0,0,0,0,2
../kbl_data/2023-2024,S43G01N214,서울 삼성,Home,최승욱,6,0,0,0.0,2,3,66.7,2,3,66.7,0,0,0.0,2,1,3,4,0,1,0,0,0,2
../kbl_data/2023-2024,S43G01N214,서울 삼성,Home,윤성원,0,0,0,0.0,0,0,0.0,0,0,0.0,0,0,0.0,0,0,0,0,0,0,0,0,0,0
../kbl_data/2023-2024,S43G01N214,서울 삼성,Home,차민석,9,2,2,100.0,0,2,0.0,2,4,50.0,5,7,71.4,1,1,2,1,0,0,0,0,2,4
../kbl_data/2023-2024,S43G01N214,서울 삼성,Home,이원석,9,3,5,60.0,0,0,0.0,3,5,60.0,3,6,50.0,1,4,5,2,0,0,0,0,1,5
../kbl_data/2023-2024,S43G01N214,서울 삼성,Home,신동혁,11,1,2,50.0,3,5,60.0,4,7,57.1,0,0,0.0,1,2,3,2,0,0,0,0,0,1
../kbl_data/2023-2024,S43G01N214,서울 삼성,Home,김근현,0,0,0,0.0,0,1,0.0,0,1,0.0,0,0,0.0,0,0,0,0,0,0,0,0,0,0
../kbl_data/2023-2024,S43G01N214,서울 삼성,Home,조준희,0,0,0,0.0,0,0,0.0,0,0,0.0,0,0,0.0,0,0,0,0,0,0,0,0,0,0
../kbl_data/2023-2024,S43G01N214,서울 삼성,Home,이스마엘 레인,5,2,4,50.0,0,1,0.0,2,5,40.0,1,2,50.0,2,3,5,1,0,0,0,1,0,0
../kbl_data/2023-2024,S43G01N214,서울 삼성,Home,코피 코번,30,11,17,64.7,0,0,0.0,11,17,64.7,8,12,66.7,3,4,7,2,1,1,0,1,0,3
../kbl_data/2023-2024,S43G01N214,수원 KT,Away,한희원,10,5,7,71.4,0,4,0.0,5,11,45.5,0,0,0.0,0,2,2,4,1,0,0,0,1,4
../kbl_data/2023-2024,S43G01N214,수원 KT,Away,최창진,0,0,0,0.0,0,0,0.0,0,0,0.0,0,0,0.0,0,1,1,0,1,0,0,0,1,1
../kbl_data/2023-2024,S43G01N214,수원 KT,Away,문성곤,9,0,0,0.0,3,4,75.0,3,4,75.0,0,0,0.0,0,2,2,2,0,1,0,0,0,5
../kbl_data/2023-2024,S43G01N214,수원 KT,Away,정성우,15,3,3,100.0,2,2,100.0,5,5,100.0,3,5,60.0,0,0,0,5,2,0,0,0,0,3
../kbl_data/2023-2024,S43G01N214,수원 KT,Away,최성모,5,2,3,66.7,0,1,0.0,2,4,50.0,1,2,50.0,1,2,3,4,0,0,0,0,0,1
../kbl_data/2023-2024,S43G01N214,수원 KT,Away,허훈,11,1,2,50.0,2,2,100.0,3,4,75.0,3,3,100.0,0,0,0,0,0,0,0,0,0,0
../kbl_data/2023-2024,S43G01N214,수원 KT,Away,이윤기,0,0,0,0.0,0,1,0.0,0,1,0.0,0,0,0.0,0,0,0,0,0,0,0,0,0,0
../kbl_data/2023-2024,S43G01N214,수원 KT,Away,하윤기,21,10,15,66.7,0,0,0.0,10,15,66.7,1,2,50.0,5,4,9,4,0,0,0,1,1,3
../kbl_data/2023-2024,S43G01N214,수원 KT,Away,이두원,2,1,1,100.0,0,0,0.0,1,1,100.0,0,0,0.0,0,2,2,0,0,0,0,0,0,2
../kbl_data/2023-2024,S43G01N214,수원 KT,Away,문정현,5,1,2,50.0,1,3,33.3,2,5,40.0,0,0,0.0,3,2,5,1,1,0,0,0,2,1
../kbl_data/2023-2024,S43G01N214,수원 KT,Away,마이클 에릭,7,3,5,60.0,0,0,0.0,3,5,60.0,1,4,25.0,1,2,3,0,1,1,0,0,2,3
../kbl_data/2023-2024,S43G01N214,수원 KT,Away,패리스 배스,21,5,12,41.7,3,7,42.9,8,19,42.1,2,3,66.7,0,6,6,7,2,0,0,0,1,4
../kbl_data/2023-2024,S43G01N215,서울 SK,Home,양우섭,0,0,1,0.0,0,0,0.0,0,1,0.0,0,0,0.0,0,0,0,0,0,0,0,0,0,0
../kbl_data/2023-2024,S43G01N215,서울 SK,Home,허일영,3,0,1,0.0,1,3,33.3,1,4,25.0,0,0,0.0,2,2,4,2,1,0,0,0,1,2
../kbl_data/2023-2024,S43G01N215,서울 SK,Home,송창용,0,0,0,0.0,0,2,0.0,0,2,0.0,0,0,0.0,0,1,1,1,0,0,1,0,0,1
../kbl_data/2023-2024,S43G01N215,서울 SK,Home,오세근,5,1,6,16.7,0,0,0.0,1,6,16.7,3,4,75.0,2,2,4,2,2,0,0,0,0,0
../kbl_data/2023-2024,S43G01N215,서울 SK,Home,최부경,6,3,5,60.0,0,0,0.0,3,5,60.0,0,0,0.0,0,3,3,0,1,0,0,0,0,4
../kbl_data/2023-2024,S43G01N215,서울 SK,Home,리온 윌리엄스,0,0,1,0.0,0,0,0.0,0,1,0.0,0,0,0.0,0,0,0,0,0,0,0,0,0,1
../kbl_data/2023-2024,S43G01N215,서울 SK,Home,최원혁,2,1,4,25.0,0,2,0.0,1,6,16.7,0,0,0.0,0,0,0,2,1,0,0,0,0,2
../kbl_data/2023-2024,S43G01N215,서울 SK,Home,안영준,13,2,2,100.0,2,5,40.0,4,7,57.1,3,4,75.0,0,4,4,2,5,0,0,0,5,2
../kbl_data/2023-2024,S43G01N215,서울 SK,Home,자밀 워니,20,10,23,43.5,0,1,0.0,10,24,41.7,0,0,0.0,4,3,7,3,0,0,0,0,1,2
../kbl_data/2023-2024,S43G01N215,서울 SK,Home,김형빈,0,0,0,0.0,0,0,0.0,0,0,0.0,0,0,0.0,0,0,0,0,0,0,0,0,0,0
../kbl_data/2023-2024,S43G01N215,서울 SK,Home,오재현,17,6,12,50.0,1,5,20.0,7,17,41.2,2,2,100.0,3,1,4,2,2,0,0,0,2,2
../kbl_data/2023-2024,S43G01N215,서울 SK,Home,이경도,0,0,0,0.0,0,0,0.0,0,0,0.0,0,0,0.0,0,0,0,0,0,0,0,0,0,0
../kbl_data/2023-2024,S43G01N215,대구 한국가스공사,Away,차바위,10,2,3,66.7,2,4,50.0,4,7,57.1,0,0,0.0,3,5,8,4,1,0,0,0,1,3
../kbl_data/2023-2024,S43G01N215,대구 한국가스공사,Away,박지훈,0,0,1,0.0,0,1,0.0,0,2,0.0,0,0,0.0,1,2,3,0,0,0,0,0,0,3
../kbl_data/2023-2024,S43G01N215,대구 한국가스공사,Away,이대헌,6,3,6,50.0,0,1,0.0,3,7,42.9,0,0,0.0,2,7,9,0,2,1,0,0,3,1
../kbl_data/2023-2024,S43G01N215,대구 한국가스공사,Away,박봉진,0,0,0,0.0,0,1,0.0,0,1,0.0,0,0,0.0,0,0,0,0,0,0,0,0,0,1
../kbl_data/2023-2024,S43G01N215,대구 한국가스공사,Away,김낙현,4,2,4,50.0,0,1,0.0,2,5,40.0,0,0,0.0,0,0,0,0,0,0,0,0,2,0
../kbl_data/2023-2024,S43G01N215,대구 한국가스공사,Away,이도헌,3,0,0,0.0,1,1,100.0,1,1,100.0,0,0,0.0,0,0,0,0,0,0,0,0,0,0
../kbl_data/2023-2024,S43G01N215,대구 한국가스공사,Away,앤드류 니콜슨,31,7,14,50.0,4,7,57.1,11,21,52.4,5,7,71.4,2,10,12,1,0,2,0,1,6,3
../kbl_data/2023-2024,S43G01N215,대구 한국가스공사,Away,신승민,14,2,3,66.7,2,3,66.7,4,6,66.7,4,5,80.0,1,2,3,5,2,1,0,0,1,3
../kbl_data/2023-2024,S43G01N215,대구 한국가스공사,Away,최주영,0,0,0,0.0,0,0,0.0,0,0,0.0,0,0,0.0,0,0,0,0,0,0,0,0,0,0
../kbl_data/2023-2024,S43G01N215,대구 한국가스공사,Away,샘조세프 벨란겔,7,3,4,75.0,0,6,0.0,3,10,30.0,1,1,100.0,0,4,4,8,2,0,0,0,1,2
../kbl_data/2023-2024,S43G01N215,대구 한국가스공사,Away,안세영,0,0,0,0.0,0,0,0.0,0,0,0.0,0,0,0.0,0,0,0,1,0,0,0,0,1,1
../kbl_data/2023-2024,S43G01N215,대구 한국가스공사,Away,듀반 맥스웰,4,2,2,100.0,0,0,0.0,2,2,100.0,0,2,0.0,1,2,3,1,0,1,0,0,0,1
../kbl_data/2023-2024,S43G01N216,울산 현대모비스,Home,함지훈,0,0,2,0.0,0,0,0.0,0,2,0.0,0,0,0.0,3,1,4,0,2,0,0,0,4,2
../kbl_data/2023-2024,S43G01N216,울산 현대모비스,Home,최진수,5,1,1,100.0,1,5,20.0,2,6,33.3,0,0,0.0,2,0,2,4,1,1,0,0,4,4
../kbl_data/2023-2024,S43G01N216,울산 현대모비스,Home,김현수,0,0,0,0.0,0,0,0.0,0,0,0.0,0,0,0.0,0,0,0,0,0,0,0,0,0,0
../kbl_data/2023-2024,S43G01N216,울산 현대모비스,Home,장재석,4,2,4,50.0,0,0,0.0,2,4,50.0,0,0,0.0,2,0,2,1,0,1,1,0,1,2
../kbl_data/2023-2024,S43G01N216,울산 현대모비스,Home,김준일,0,0,0,0.0,0,0,0.0,0,0,0.0,0,0,0.0,0,0,0,0,0,0,0,0,0,0
../kbl_data/2023-2024,S43G01N216,울산 현대모비스,Home,김국찬,8,2,3,66.7,1,3,33.3,3,6,50.0,1,2,50.0,0,1,1,2,0,0,0,0,0,0
../kbl_data/2023-2024,S43G01N216,울산 현대모비스,Home,이우석,11,4,8,50.0,0,4,0.0,4,12,33.3,3,4,75.0,0,4,4,2,1,0,0,0,1,1
../kbl_data/2023-2024,S43G01N216,울산 현대모비스,Home,신민석,0,0,1,0.0,0,0,0.0,0,1,0.0,0,0,0.0,0,1,1,0,0,0,0,0,0,0
../kbl_data/2023-2024,S43G01N216,울산 현대모비스,Home,게이지 프림,34,11,15,73.3,0,1,0.0,11,16,68.8,12,14,85.7,5,11,16,2,2,0,0,2,3,4
../kbl_data/2023-2024,S43G01N216,울산 현대모비스,Home,김태완,0,0,0,0.0,0,1,0.0,0,1,0.0,0,0,0.0,1,0,1,0,2,0,0,0,1,1
../kbl_data/2023-2024,S43G01N216,울산 현대모비스,Home,박무빈,6,2,7,28.6,0,3,0.0,2,10,20.0,2,2,100.0,2,4,6,5,2,0,0,0,4,2
../kbl_data/2023-2024,S43G01N216,울산 현대모비스,Home,케베 알루마,5,2,2,100.0,0,1,0.0,2,3,66.7,1,1,100.0,0,3,3,2,1,0,0,1,2,3
../kbl_data/2023-2024,S43G01N216,고양 소노,Away,김강선,0,0,0,0.0,0,1,0.0,0,1,0.0,0,0,0.0,0,2,2,0,1,0,0,0,0,1
../kbl_data/2023-2024,S43G01N216,고양 소노,Away,함준후,0,0,0,0.0,0,0,0.0,0,0,0.0,0,0,0.0,0,0,0,0,1,0,0,0,0,0
../kbl_data/2023-2024,S43G01N216,고양 소노,Away,최현민,8,2,3,66.7,1,4,25.0,3,7,42.9,1,2,50.0,5,2,7,3,0,0,0,0,2,3
../kbl_data/2023-2024,S43G01N216,고양 소노,Away,김민욱,13,5,5,100.0,1,3,33.3,6,8,75.0,0,0,0.0,2,2,4,0,1,0,0,0,0,5
../kbl_data/2023-2024,S43G01N216,고양 소노,Away,한호빈,6,2,2,100.0,0,4,0.0,2,6,33.3,2,2,100.0,0,4,4,6,1,0,0,0,3,2
../kbl_data/2023-2024,S43G01N216,고양 소노,Away,김지후,13,0,2,0.0,4,7,57.1,4,9,44.4,1,2,50.0,0,2,2,2,2,0,0,0,0,2
../kbl_data/2023-2024,S43G01N216,고양 소노,Away,다후안 서머스,0,0,0,0.0,0,0,0.0,0,0,0.0,0,0,0.0,0,0,0,0,0,0,0,0,0,0
../kbl_data/2023-2024,S43G01N216,고양 소노,Away,치나누 오누아쿠,14,3,6,50.0,2,3,66.7,5,9,55.6,2,2,100.0,3,5,8,0,1,0,0,0,2,5
../kbl_data/2023-2024,S43G01N216,고양 소노,Away,이진석,0,0,0,0.0,0,0,0.0,0,0,0.0,0,0,0.0,0,0,0,0,0,0,0,0,0,0
../kbl_data/2023-2024,S43G01N216,고양 소노,Away,이정현,29,4,12,33.3,4,11,36.4,8,23,34.8,9,10,90.0,0,4,4,5,3,0,1,0,8,3
../kbl_data/2023-2024,S43G01N216,고양 소노,Away,백지웅,0,0,0,0.0,0,0,0.0,0,0,0.0,0,0,0.0,0,0,0,0,0,0,0,0,0,0
../kbl_data/2023-2024,S43G01N216,고양 소노,Away,안정욱,0,0,0,0.0,0,1,0.0,0,1,0.0,0,0,0.0,0,1,1,0,0,0,0,0,1,0
../kbl_data/2023-2024,S43G01N217,창원 LG,Home,이관희,9,0,1,0.0,3,3,100.0,3,4,75.0,0,0,0.0,0,1,1,1,0,1,0,0,0,0
../kbl_data/2023-2024,S43G01N217,창원 LG,Home,정희재,10,1,1,100.0,1,3,33.3,2,4,50.0,5,5,100.0,1,1,2,2,0,0,0,0,0,2
../kbl_data/2023-2024,S43G01N217,창원 LG,Home,이재도,8,1,4,25.0,2,3,66.7,3,7,42.9,0,0,0.0,1,1,2,6,0,0,0,0,1,1
../kbl_data/2023-2024,S43G01N217,창원 LG,Home,정인덕,7,2,2,100.0,1,2,50.0,3,4,75.0,0,0,0.0,0,1,1,0,1,1,0,0,0,2
../kbl_data/2023-2024,S43G01N217,창원 LG,Home,양홍석,6,2,2,100.0,0,2,0.0,2,4,50.0,2,4,50.0,0,2,2,1,0,0,0,0,2,1
../kbl_data/2023-2024,S43G01N217,창원 LG,Home,박정현,6,3,4,75.0,0,0,0.0,3,4,75.0,0,0,0.0,1,1,2,0,0,0,0,0,0,0
../kbl_data/2023-2024,S43G01N217,창원 LG,Home,아셈 마레이,12,5,6,83.3,0,0,0.0,5,6,83.3,2,6,33.3,3,2,5,1,0,0,0,0,3,1
../kbl_data/2023-2024,S43G01N217,창원 LG,Home,이승우,2,0,1,0.0,0,0,0.0,0,1,0.0,2,2,100.0,0,3,3,0,0,0,0,0,0,2
../kbl_data/2023-2024,S43G01N217,창원 LG,Home,저스틴 구탕,15,6,7,85.7,1,1,100.0,7,8,87.5,0,0,0.0,1,7,8,5,2,0,1,1,0,1
../kbl_data/2023-2024,S43G01N217,창원 LG,Home,양준석,2,1,1,100.0,0,1,0.0,1,2,50.0,0,0,0.0,0,4,4,7,0,0,0,0,2,3
../kbl_data/2023-2024,S43G01N217,창원 LG,Home,유기상,11,0,2,0.0,3,5,60.0,3,7,42.9,2,2,100.0,2,0,2,1,2,0,0,0,1,3
../kbl_data/2023-2024,S43G01N217,창원 LG,Home,후안 텔로,9,2,5,40.0,1,3,33.3,3,8,37.5,2,4,50.0,3,5,8,1,0,1,0,0,2,1
../kbl_data/2023-2024,S43G01N217,안양 정관장,Away,김상규,0,0,0,0.0,0,0,0.0,0,0,0.0,0,0,0.0,0,0,0,0,0,0,0,0,0,2
../kbl_data/2023-2024,S43G01N217,안양 정관장,Away,배병준,3,0,2,0.0,1,4,25.0,1,6,16.7,0,0,0.0,0,2,2,0,0,0,0,0,1,0
../kbl_data/2023-2024,S43G01N217,안양 정관장,Away,정효근,8,4,9,44.4,0,1,0.0,4,10,40.0,0,1,0.0,0,2,2,2,1,0,0,0,2,4
../kbl_data/2023-2024,S43G01N217,안양 정관장,Away,이종현,0,0,2,0.0,0,2,0.0,0,4,0.0,0,0,0.0,1,5,6,0,0,0,0,0,1,2
../kbl_data/2023-2024,S43G01N217,안양 정관장,Away,박지훈,18,6,9,66.7,1,3,33.3,7,12,58.3,3,3,100.0,1,3,4,4,1,0,0,0,0,3
../kbl_data/2023-2024,S43G01N217,안양 정관장,Away,최성원,8,1,3,33.3,2,4,50.0,3,7,42.9,0,0,0.0,0,0,0,1,1,0,0,0,1,2
../kbl_data/2023-2024,S43G01N217,안양 정관장,Away,이우정,0,0,0,0.0,0,2,0.0,0,2,0.0,0,0,0.0,0,0,0,0,0,0,0,0,0,0
../kbl_data/2023-2024,S43G01N217,안양 정관장,Away,김경원,4,2,3,66.7,0,1,0.0,2,4,50.0,0,0,0.0,3,0,3,1,0,0,0,0,0,2
../kbl_data/2023-2024,S43G01N217,안양 정관장,Away,고찬혁,2,1,3,33.3,0,2,0.0,1,5,20.0,0,0,0.0,0,3,3,0,0,0,0,0,0,2
../kbl_data/2023-2024,S43G01N217,안양 정관장,Away,표승빈,0,0,1,0.0,0,0,0.0,0,1,0.0,0,0,0.0,0,0,0,0,0,0,0,0,0,0
../kbl_data/2023-2024,S43G01N217,안양 정관장,Away,로버트 카터,2,1,1,100.0,0,1,0.0,1,2,50.0,0,0,0.0,0,0,0,0,1,0,0,0,0,3
../kbl_data/2023-2024,S43G01N217,안양 정관장,Away,자밀 윌슨,19,4,7,57.1,3,5,60.0,7,12,58.3,2,3,66.7,1,2,3,4,2,0,0,0,3,2
../kbl_data/2023-2024,S43G01N218,부산 KCC,Home,정창영,0,0,0,0.0,0,0,0.0,0,0,0.0,0,0,0.0,0,0,0,0,0,0,0,0,0,0
../kbl_data/2023-2024,S43G01N218,부산 KCC,Home,라건아,16,7,15,46.7,0,0,0.0,7,15,46.7,2,3,66.7,9,5,14,1,0,1,0,0,0,1
../kbl_data/2023-2024,S43G01N218,부산 KCC,Home,전준범,0,0,0,0.0,0,0,0.0,0,0,0.0,0,0,0.0,0,0,0,0,0,0,0,0,0,0
../kbl_data/2023-2024,S43G01N218,부산 KCC,Home,허웅,22,2,10,20.0,5,9,55.6,7,19,36.8,3,4,75.0,1,2,3,4,0,1,0,0,4,4
../kbl_data/2023-2024,S43G01N218,부산 KCC,Home,이승현,4,2,3,66.7,0,0,0.0,2,3,66.7,0,0,0.0,1,3,4,2,0,0,0,0,0,4
../kbl_data/2023-2024,S43G01N218,부산 KCC,Home,이호현,11,4,7,57.1,1,2,50.0,5,9,55.6,0,0,0.0,1,0,1,1,1,0,1,0,0,1
../kbl_data/2023-2024,S43G01N218,부산 KCC,Home,송교창,6,3,6,50.0,0,3,0.0,3,9,33.3,0,0,0.0,0,5,5,5,1,1,0,0,2,3
../kbl_data/2023-2024,S43G01N218,부산 KCC,Home,최준용,26,4,7,57.1,4,9,44.4,8,16,50.0,6,6,100.0,0,4,4,5,0,1,0,0,1,4
../kbl_data/2023-2024,S43G01N218,부산 KCC,Home,곽정훈,0,0,0,0.0,0,0,0.0,0,0,0.0,0,0,0.0,0,0,0,0,0,0,0,0,0,0
../kbl_data/2023-2024,S43G01N218,부산 KCC,Home,이근휘,1,0,0,0.0,0,2,0.0,0,2,0.0,1,2,50.0,0,0,0,0,0,0,0,0,1,0
../kbl_data/2023-2024,S43G01N218,부산 KCC,Home,캘빈 제프리 에피스톨라,0,0,0,0.0,0,0,0.0,0,0,0.0,0,0,0.0,0,0,0,0,0,0,0,0,0,0
../kbl_data/2023-2024,S43G01N218,부산 KCC,Home,알리제 드숀 존슨,15,6,6,100.0,0,2,0.0,6,8,75.0,3,6,50.0,7,5,12,2,0,0,0,0,1,4
../kbl_data/2023-2024,S43G01N218,수원 KT,Away,한희원,3,0,0,0.0,1,3,33.3,1,3,33.3,0,0,0.0,0,2,2,1,0,1,0,0,1,0
../kbl_data/2023-2024,S43G01N218,수원 KT,Away,최창진,0,0,0,0.0,0,0,0.0,0,0,0.0,0,0,0.0,0,1,1,1,1,0,0,0,0,1
../kbl_data/2023-2024,S43G01N218,수원 KT,Away,문성곤,6,0,1,0.0,2,5,40.0,2,6,33.3,0,0,0.0,2,1,3,4,1,0,0,0,2,3
../kbl_data/2023-2024,S43G01N218,수원 KT,Away,정성우,16,5,7,71.4,2,3,66.7,7,10,70.0,0,0,0.0,0,1,1,5,2,0,0,0,1,2
../kbl_data/2023-2024,S43G01N218,수원 KT,Away,최성모,0,0,0,0.0,0,2,0.0,0,2,0.0,0,0,0.0,0,0,0,1,0,0,0,0,0,1
../kbl_data/2023-2024,S43G01N218,수원 KT,Away,허훈,12,0,2,0.0,4,7,57.1,4,9,44.4,0,0,0.0,0,1,1,1,1,0,0,0,2,3
../kbl_data/2023-2024,S43G01N218,수원 KT,Away,이윤기,0,0,0,0.0,0,0,0.0,0,0,0.0,0,0,0.0,0,0,0,0,0,0,0,0,0,0
../kbl_data/2023-2024,S43G01N218,수원 KT,Away,하윤기,19,7,17,41.2,0,0,0.0,7,17,41.2,5,7,71.4,3,9,12,2,0,0,0,0,1,2
../kbl_data/2023-2024,S43G01N218,수원 KT,Away,이두원,2,1,2,50.0,0,0,0.0,1,2,50.0,0,0,0.0,0,1,1,1,0,0,1,0,1,1
../kbl_data/2023-2024,S43G01N218,수원 KT,Away,문정현,2,0,2,0.0,0,0,0.0,0,2,0.0,2,2,100.0,1,0,1,0,1,0,0,0,0,5
../kbl_data/2023-2024,S43G01N218,수원 KT,Away,마이클 에릭,2,1,1,100.0,0,0,0.0,1,1,100.0,0,0,0.0,2,1,3,1,0,0,0,0,0,0
../kbl_data/2023-2024,S43G01N218,수원 KT,Away,패리스 배스,32,10,19,52.6,1,8,12.5,11,27,40.7,9,13,69.2,7,9,16,4,0,0,0,1,2,3
../kbl_data/2023-2024,S43G01N219,원주 DB,Home,김현호,0,0,0,0.0,0,1,0.0,0,1,0.0,0,0,0.0,0,0,0,0,0,0,0,0,0,0
../kbl_data/2023-2024,S43G01N219,원주 DB,Home,서민수,3,0,0,0.0,1,1,100.0,1,1,100.0,0,0,0.0,1,1,2,0,1,0,0,0,1,0
../kbl_data/2023-2024,S43G01N219,원주 DB,Home,김영현,0,0,0,0.0,0,1,0.0,0,1,0.0,0,0,0.0,0,1,1,0,0,0,1,0,0,1
../kbl_data/2023-2024,S43G01N219,원주 DB,Home,김종규,12,5,6,83.3,0,1,0.0,5,7,71.4,2,2,100.0,3,3,6,1,0,3,0,0,1,2
../kbl_data/2023-2024,S43G01N219,원주 DB,Home,최승욱,0,0,0,0.0,0,0,0.0,0,0,0.0,0,0,0.0,0,0,0,0,0,0,0,0,0,0
../kbl_data/2023-2024,S43G01N219,원주 DB,Home,강상재,7,1,2,50.0,1,4,25.0,2,6,33.3,2,2,100.0,1,3,4,4,0,1,0,0,3,4
../kbl_data/2023-2024,S43G01N219,원주 DB,Home,유현준,6,0,0,0.0,2,6,33.3,2,6,33.3,0,0,0.0,0,1,1,3,1,0,0,0,1,3
../kbl_data/2023-2024,S43G01N219,원주 DB,Home,디드릭 로슨,22,4,7,57.1,3,8,37.5,7,15,46.7,5,7,71.4,2,4,6,6,1,0,0,0,3,3
../kbl_data/2023-2024,S43G01N219,원주 DB,Home,이선 알바노,5,1,3,33.3,1,5,20.0,2,8,25.0,0,0,0.0,0,1,1,4,0,0,0,0,3,3
../kbl_data/2023-2024,S43G01N219,원주 DB,Home,박인웅,17,4,4,100.0,3,10,30.0,7,14,50.0,0,0,0.0,4,1,5,1,0,0,0,0,1,3
../kbl_data/2023-2024,S43G01N219,원주 DB,Home,최승빈,0,0,0,0.0,0,0,0.0,0,0,0.0,0,0,0.0,0,0,0,0,0,0,0,0,0,0
../kbl_data/2023-2024,S43G01N219,원주 DB,Home,제프 위디,3,1,1,100.0,0,0,0.0,1,1,100.0,1,2,50.0,2,4,6,1,1,2,0,0,1,1
../kbl_data/2023-2024,S43G01N219,대구 한국가스공사,Away,차바위,5,1,1,100.0,0,3,0.0,1,4,25.0,3,3,100.0,1,2,3,0,1,0,0,0,1,2
../kbl_data/2023-2024,S43G01N219,대구 한국가스공사,Away,박지훈,0,0,0,0.0,0,0,0.0,0,0,0.0,0,0,0.0,0,3,3,0,0,1,0,0,0,1
../kbl_data/2023-2024,S43G01N219,대구 한국가스공사,Away,이대헌,5,1,4,25.0,1,2,50.0,2,6,33.3,0,0,0.0,1,3,4,0,1,0,2,0,1,3
../kbl_data/2023-2024,S43G01N219,대구 한국가스공사,Away,박봉진,3,0,1,0.0,1,1,100.0,1,2,50.0,0,0,0.0,4,2,6,3,1,0,2,0,0,2
../kbl_data/2023-2024,S43G01N219,대구 한국가스공사,Away,김낙현,0,0,0,0.0,0,2,0.0,0,2,0.0,0,0,0.0,0,0,0,0,0,0,0,0,0,0
../kbl_data/2023-2024,S43G01N219,대구 한국가스공사,Away,이도헌,0,0,0,0.0,0,0,0.0,0,0,0.0,0,0,0.0,0,0,0,0,0,0,0,0,0,0
../kbl_data/2023-2024,S43G01N219,대구 한국가스공사,Away,앤드류 니콜슨,16,5,13,38.5,2,4,50.0,7,17,41.2,0,0,0.0,3,4,7,0,1,0,0,0,2,2
../kbl_data/2023-2024,S43G01N219,대구 한국가스공사,Away,신승민,6,1,3,33.3,1,3,33.3,2,6,33.3,1,2,50.0,2,1,3,2,1,0,1,0,2,5
../kbl_data/2023-2024,S43G01N219,대구 한국가스공사,Away,최주영,0,0,0,0.0,0,0,0.0,0,0,0.0,0,0,0.0,0,0,0,0,0,0,0,0,0,0
../kbl_data/2023-2024,S43G01N219,대구 한국가스공사,Away,샘조세프 벨란겔,29,5,10,50.0,4,8,50.0,9,18,50.0,7,7,100.0,0,1,1,6,2,0,0,0,1,4
../kbl_data/2023-2024,S43G01N219,대구 한국가스공사,Away,안세영,0,0,0,0.0,0,0,0.0,0,0,0.0,0,0,0.0,0,0,0,0,0,0,0,0,0,0
../kbl_data/2023-2024,S43G01N219,대구 한국가스공사,Away,듀반 맥스웰,10,5,6,83.3,0,0,0.0,5,6,83.3,0,0,0.0,1,4,5,0,1,0,0,1,3,2
../kbl_data/2023-2024,S43G01N220,서울 삼성,Home,이정현,10,3,7,42.9,1,1,100.0,4,8,50.0,1,1,100.0,0,2,2,10,1,0,0,0,0,4
../kbl_data/2023-2024,S43G01N220,서울 삼성,Home,홍경기,9,2,3,66.7,1,3,33.3,3,6,50.0,2,2,100.0,0,1,1,0,0,0,1,0,1,3
../kbl_data/2023-2024,S43G01N220,서울 삼성,Home,이동엽,5,0,5,0.0,1,1,100.0,1,6,16.7,2,2,100.0,1,0,1,2,1,0,0,0,1,1
../kbl_data/2023-2024,S43G01N220,서울 삼성,Home,최승욱,7,3,3,100.0,0,0,0.0,3,3,100.0,1,4,25.0,2,5,7,1,2,1,0,0,1,4
../kbl_data/2023-2024,S43G01N220,서울 삼성,Home,윤성원,0,0,0,0.0,0,0,0.0,0,0,0.0,0,0,0.0,0,0,0,0,0,0,0,0,0,0
../kbl_data/2023-2024,S43G01N220,서울 삼성,Home,차민석,7,3,4,75.0,0,1,0.0,3,5,60.0,1,2,50.0,2,3,5,1,1,0,0,0,1,3
../kbl_data/2023-2024,S43G01N220,서울 삼성,Home,이원석,11,4,7,57.1,0,0,0.0,4,7,57.1,3,4,75.0,2,2,4,2,0,0,0,0,2,1
../kbl_data/2023-2024,S43G01N220,서울 삼성,Home,신동혁,7,2,3,66.7,1,5,20.0,3,8,37.5,0,0,0.0,0,2,2,2,2,0,0,0,1,2
../kbl_data/2023-2024,S43G01N220,서울 삼성,Home,김근현,0,0,0,0.0,0,0,0.0,0,0,0.0,0,0,0.0,0,0,0,0,0,0,0,0,0,0
../kbl_data/2023-2024,S43G01N220,서울 삼성,Home,조준희,1,0,0,0.0,0,0,0.0,0,0,0.0,1,2,50.0,1,0,1,0,0,0,0,0,1,0
../kbl_data/2023-2024,S43G01N220,서울 삼성,Home,이스마엘 레인,5,1,3,33.3,0,2,0.0,1,5,20.0,3,4,75.0,1,4,5,2,1,0,0,1,0,3
../kbl_data/2023-2024,S43G01N220,서울 삼성,Home,코피 코번,30,14,22,63.6,0,0,0.0,14,22,63.6,2,8,25.0,8,9,17,0,0,0,0,1,1,3
../kbl_data/2023-2024,S43G01N220,울산 현대모비스,Away,함지훈,0,0,0,0.0,0,0,0.0,0,0,0.0,0,0,0.0,0,0,0,1,1,0,0,0,0,0
../kbl_data/2023-2024,S43G01N220,울산 현대모비스,Away,최진수,0,0,2,0.0,0,1,0.0,0,3,0.0,0,0,0.0,0,0,0,1,0,0,0,0,0,2
../kbl_data/2023-2024,S43G01N220,울산 현대모비스,Away,장재석,11,5,11,45.5,0,0,0.0,5,11,45.5,1,3,33.3,3,4,7,2,0,0,0,0,1,3
../kbl_data/2023-2024,S43G01N220,울산 현대모비스,Away,김준일,2,1,4,25.0,0,0,0.0,1,4,25.0,0,0,0.0,2,0,2,0,0,0,0,0,0,2
../kbl_data/2023-2024,S43G01N220,울산 현대모비스,Away,김국찬,9,2,3,66.7,1,5,20.0,3,8,37.5,2,2,100.0,3,0,3,2,2,0,2,0,2,2
../kbl_data/2023-2024,S43G01N220,울산 현대모비스,Away,이우석,15,6,9,66.7,1,5,20.0,7,14,50.0,0,0,0.0,1,7,8,7,0,0,0,0,1,2
../kbl_data/2023-2024,S43G01N220,울산 현대모비스,Away,신민석,3,0,0,0.0,1,2,50.0,1,2,50.0,0,0,0.0,0,1,1,0,0,0,0,0,1,0
../kbl_data/2023-2024,S43G01N220,울산 현대모비스,Away,게이지 프림,18,6,9,66.7,0,0,0.0,6,9,66.7,6,8,75.0,3,5,8,0,1,0,0,0,3,3
../kbl_data/2023-2024,S43G01N220,울산 현대모비스,Away,김태완,0,0,0,0.0,0,0,0.0,0,0,0.0,0,0,0.0,0,0,0,0,0,0,0,0,0,0
../kbl_data/2023-2024,S43G01N220,울산 현대모비스,Away,박무빈,7,2,4,50.0,0,2,0.0,2,6,33.3,3,5,60.0,2,2,4,2,0,0,0,0,5,2
../kbl_data/2023-2024,S43G01N220,울산 현대모비스,Away,케베 알루마,8,3,6,50.0,0,3,0.0,3,9,33.3,2,2,100.0,1,4,5,0,0,0,0,1,1,5
../kbl_data/2023-2024,S43G01N220,울산 현대모비스,Away,미구엘 안드레 옥존,4,0,2,0.0,1,3,33.3,1,5,20.0,1,2,50.0,1,0,1,1,0,2,0,0,1,3
../kbl_data/2023-2024,S43G01N221,수원 KT,Home,한희원,10,2,3,66.7,2,8,25.0,4,11,36.4,0,2,0.0,0,3,3,2,1,1,0,0,1,2
../kbl_data/2023-2024,S43G01N221,수원 KT,Home,최창진,0,0,0,0.0,0,0,0.0,0,0,0.0,0,0,0.0,0,0,0,0,0,0,0,0,0,0
../kbl_data/2023-2024,S43G01N221,수원 KT,Home,문성곤,2,1,1,100.0,0,1,0.0,1,2,50.0,0,0,0.0,0,1,1,1,1,0,0,0,1,3
../kbl_data/2023-2024,S43G01N221,수원 KT,Home,정성우,0,0,3,0.0,0,3,0.0,0,6,0.0,0,0,0.0,0,6,6,5,1,0,0,0,6,3
../kbl_data/2023-2024,S43G01N221,수원 KT,Home,최성모,0,0,2,0.0,0,0,0.0,0,2,0.0,0,0,0.0,0,0,0,0,0,0,0,0,0,2
../kbl_data/2023-2024,S43G01N221,수원 KT,Home,허훈,12,3,5,60.0,2,7,28.6,5,12,41.7,0,0,0.0,3,1,4,4,0,0,0,0,2,2
../kbl_data/2023-2024,S43G01N221,수원 KT,Home,이윤기,0,0,0,0.0,0,1,0.0,0,1,0.0,0,0,0.0,0,0,0,0,0,0,0,0,0,2
../kbl_data/2023-2024,S43G01N221,수원 KT,Home,하윤기,16,6,8,75.0,0,0,0.0,6,8,75.0,4,4,100.0,0,5,5,2,0,0,0,0,1,1
../kbl_data/2023-2024,S43G01N221,수원 KT,Home,이두원,0,0,2,0.0,0,0,0.0,0,2,0.0,0,0,0.0,2,1,3,0,1,0,0,0,0,0
../kbl_data/2023-2024,S43G01N221,수원 KT,Home,문정현,2,1,2,50.0,0,0,0.0,1,2,50.0,0,0,0.0,1,1,2,1,1,0,0,0,0,1
../kbl_data/2023-2024,S43G01N221,수원 KT,Home,마이클 에릭,10,5,8,62.5,0,0,0.0,5,8,62.5,0,0,0.0,1,6,7,0,2,2,0,3,2,4
../kbl_data/2023-2024,S43G01N221,수원 KT,Home,패리스 배스,8,3,7,42.9,0,1,0.0,3,8,37.5,2,4,50.0,0,4,4,2,1,0,0,0,2,1
../kbl_data/2023-2024,S43G01N221,창원 LG,Away,이관희,6,0,4,0.0,2,8,25.0,2,12,16.7,0,0,0.0,0,2,2,2,2,0,0,0,1,1
../kbl_data/2023-2024,S43G01N221,창원 LG,Away,정희재,5,0,0,0.0,1,2,50.0,1,2,50.0,2,2,100.0,0,0,0,1,0,0,0,0,0,2
../kbl_data/2023-2024,S43G01N221,창원 LG,Away,이재도,14,2,6,33.3,2,7,28.6,4,13,30.8,4,4,100.0,0,3,3,9,2,0,0,0,5,2
../kbl_data/2023-2024,S43G01N221,창원 LG,Away,정인덕,0,0,1,0.0,0,0,0.0,0,1,0.0,0,0,0.0,1,1,2,0,0,0,0,0,0,0
../kbl_data/2023-2024,S43G01N221,창원 LG,Away,양홍석,20,4,10,40.0,3,9,33.3,7,19,36.8,3,5,60.0,4,4,8,2,2,0,0,0,2,3
../kbl_data/2023-2024,S43G01N221,창원 LG,Away,박정현,0,0,0,0.0,0,0,0.0,0,0,0.0,0,0,0.0,0,0,0,0,0,0,0,0,0,0
../kbl_data/2023-2024,S43G01N221,창원 LG,Away,아셈 마레이,6,3,6,50.0,0,0,0.0,3,6,50.0,0,0,0.0,2,7,9,2,1,0,0,0,0,2
../kbl_data/2023-2024,S43G01N221,창원 LG,Away,이승우,0,0,0,0.0,0,0,0.0,0,0,0.0,0,0,0.0,0,1,1,0,0,0,0,0,0,2
../kbl_data/2023-2024,S43G01N221,창원 LG,Away,저스틴 구탕,7,2,6,33.3,1,1,100.0,3,7,42.9,0,0,0.0,0,1,1,1,0,1,0,0,2,2
../kbl_data/2023-2024,S43G01N221,창원 LG,Away,양준석,2,1,1,100.0,0,1,0.0,1,2,50.0,0,0,0.0,0,1,1,1,0,0,0,0,0,1
../kbl_data/2023-2024,S43G01N221,창원 LG,Away,유기상,10,0,0,0.0,2,3,66.7,2,3,66.7,4,6,66.7,3,1,4,1,2,0,0,0,0,1
../kbl_data/2023-2024,S43G01N221,창원 LG,Away,후안 텔로,5,1,4,25.0,1,2,50.0,2,6,33.3,0,0,0.0,4,7,11,1,0,0,0,0,1,0
../kbl_data/2023-2024,S43G01N222,안양 정관장,Home,배병준,14,4,8,50.0,2,3,66.7,6,11,54.5,0,0,0.0,1,1,2,1,0,0,0,0,1,4
../kbl_data/2023-2024,S43G01N222,안양 정관장,Home,정효근,10,4,6,66.7,0,1,0.0,4,7,57.1,2,4,50.0,2,6,8,1,0,0,0,0,0,0
../kbl_data/2023-2024,S43G01N222,안양 정관장,Home,이종현,10,5,6,83.3,0,0,0.0,5,6,83.3,0,1,0.0,3,5,8,1,2,1,0,0,1,2
../kbl_data/2023-2024,S43G01N222,안양 정관장,Home,박지훈,12,3,6,50.0,2,4,50.0,5,10,50.0,0,0,0.0,1,2,3,8,2,1,0,0,0,5
../kbl_data/2023-2024,S43G01N222,안양 정관장,Home,최성원,7,2,4,50.0,0,4,0.0,2,8,25.0,3,3,100.0,0,1,1,4,0,0,0,0,0,1
../kbl_data/2023-2024,S43G01N222,안양 정관장,Home,이우정,0,0,0,0.0,0,0,0.0,0,0,0.0,0,0,0.0,0,0,0,0,0,0,0,0,0,0
../kbl_data/2023-2024,S43G01N222,안양 정관장,Home,김경원,0,0,0,0.0,0,0,0.0,0,0,0.0,0,0,0.0,0,0,0,0,0,0,0,0,0,0
../kbl_data/2023-2024,S43G01N222,안양 정관장,Home,렌즈 아반도,17,5,9,55.6,1,3,33.3,6,12,50.0,4,5,80.0,2,2,4,3,4,1,0,0,1,2
../kbl_data/2023-2024,S43G01N222,안양 정관장,Home,고찬혁,0,0,1,0.0,0,1,0.0,0,2,0.0,0,0,0.0,1,0,1,0,0,0,0,0,0,0
../kbl_data/2023-2024,S43G01N222,안양 정관장,Home,나성호,0,0,0,0.0,0,0,0.0,0,0,0.0,0,0,0.0,0,0,0,0,0,0,0,0,0,0
../kbl_data/2023-2024,S43G01N222,안양 정관장,Home,로버트 카터,19,5,7,71.4,3,8,37.5,8,15,53.3,0,0,0.0,1,6,7,3,0,0,0,2,2,1
../kbl_data/2023-2024,S43G01N222,안양 정관장,Home,자밀 윌슨,3,0,1,0.0,1,1,100.0,1,2,50.0,0,0,0.0,0,1,1,1,0,0,0,0,0,1
../kbl_data/2023-2024,S43G01N222,고양 소노,Away,김강선,0,0,0,0.0,0,0,0.0,0,0,0.0,0,0,0.0,0,0,0,0,0,0,0,0,0,0
../kbl_data/2023-2024,S43G01N222,고양 소노,Away,함준후,0,0,0,0.0,0,0,0.0,0,0,0.0,0,0,0.0,0,0,0,0,0,0,0,0,0,0
../kbl_data/2023-2024,S43G01N222,고양 소노,Away,최현민,0,0,2,0.0,0,1,0.0,0,3,0.0,0,0,0.0,0,1,1,1,0,0,0,0,0,2
../kbl_data/2023-2024,S43G01N222,고양 소노,Away,김민욱,8,1,3,33.3,2,7,28.6,3,10,30.0,0,0,0.0,2,5,7,2,1,1,1,0,0,2
../kbl_data/2023-2024,S43G01N222,고양 소노,Away,한호빈,8,1,2,50.0,1,5,20.0,2,7,28.6,3,3,100.0,1,2,3,3,0,0,0,0,0,3
../kbl_data/2023-2024,S43G01N222,고양 소노,Away,전성현,9,0,2,0.0,3,4,75.0,3,6,50.0,0,0,0.0,0,0,0,0,0,0,0,0,1,1
../kbl_data/2023-2024,S43G01N222,고양 소노,Away,김지후,18,0,0,0.0,5,11,45.5,5,11,45.5,3,5,60.0,1,4,5,2,0,0,0,0,1,4
../kbl_data/2023-2024,S43G01N222,고양 소노,Away,치나누 오누아쿠,26,9,12,75.0,2,4,50.0,11,16,68.8,2,4,50.0,3,10,13,1,0,1,0,3,2,3
../kbl_data/2023-2024,S43G01N222,고양 소노,Away,이정현,18,5,10,50.0,1,5,20.0,6,15,40.0,5,5,100.0,2,2,4,8,1,0,0,0,5,3
../kbl_data/2023-2024,S43G01N222,고양 소노,Away,조은후,0,0,0,0.0,0,0,0.0,0,0,0.0,0,0,0.0,0,0,0,0,0,0,0,0,0,0
../kbl_data/2023-2024,S43G01N222,고양 소노,Away,백지웅,0,0,0,0.0,0,0,0.0,0,0,0.0,0,0,0.0,0,0,0,0,0,0,0,0,0,0
../kbl_data/2023-2024,S43G01N222,고양 소노,Away,안정욱,0,0,0,0.0,0,0,0.0,0,0,0.0,0,0,0.0,0,0,0,0,0,0,0,0,0,0
../kbl_data/2023-2024,S43G01N223,서울 SK,Home,양우섭,0,0,1,0.0,0,1,0.0,0,2,0.0,0,0,0.0,0,1,1,0,0,0,0,0,0,0
../kbl_data/2023-2024,S43G01N223,서울 SK,Home,허일영,6,3,4,75.0,0,0,0.0,3,4,75.0,0,0,0.0,0,0,0,1,0,0,0,0,0,4
../kbl_data/2023-2024,S43G01N223,서울 SK,Home,송창용,4,2,2,100.0,0,2,0.0,2,4,50.0,0,0,0.0,2,2,4,1,1,0,0,0,1,4
../kbl_data/2023-2024,S43G01N223,서울 SK,Home,오세근,12,3,5,60.0,2,3,66.7,5,8,62.5,0,0,0.0,0,6,6,2,1,0,0,0,1,3
../kbl_data/2023-2024,S43G01N223,서울 SK,Home,최부경,4,2,7,28.6,0,1,0.0,2,8,25.0,0,0,0.0,0,2,2,0,0,0,0,0,2,2
../kbl_data/2023-2024,S43G01N223,서울 SK,Home,리온 윌리엄스,6,3,3,100.0,0,0,0.0,3,3,100.0,0,2,0.0,0,0,0,0,1,1,0,0,0,2
../kbl_data/2023-2024,S43G01N223,서울 SK,Home,최원혁,5,0,0,0.0,1,2,50.0,1,2,50.0,2,2,100.0,0,2,2,1,0,0,0,0,2,3
../kbl_data/2023-2024,S43G01N223,서울 SK,Home,안영준,19,3,7,42.9,4,6,66.7,7,13,53.8,1,2,50.0,1,5,6,2,1,2,0,0,2,1
../kbl_data/2023-2024,S43G01N223,서울 SK,Home,자밀 워니,21,8,12,66.7,1,6,16.7,9,18,50.0,2,3,66.7,4,11,15,7,2,1,0,3,1,1
../kbl_data/2023-2024,S43G01N223,서울 SK,Home,김형빈,0,0,1,0.0,0,0,0.0,0,1,0.0,0,0,0.0,0,0,0,0,0,1,0,0,0,0
../kbl_data/2023-2024,S43G01N223,서울 SK,Home,오재현,13,3,5,60.0,2,3,66.7,5,8,62.5,1,2,50.0,0,5,5,9,2,1,0,0,0,4
../kbl_data/2023-2024,S43G01N223,서울 SK,Home,이경도,0,0,0,0.0,0,0,0.0,0,0,0.0,0,0,0.0,0,0,0,0,0,1,0,0,0,0
../kbl_data/2023-2024,S43G01N223,부산 KCC,Away,정창영,6,3,3,100.0,0,4,0.0,3,7,42.9,0,0,0.0,1,1,2,2,1,0,0,0,2,3
../kbl_data/2023-2024,S43G01N223,부산 KCC,Away,라건아,6,3,5,60.0,0,1,0.0,3,6,50.0,0,0,0.0,0,4,4,0,0,1,0,0,2,0
../kbl_data/2023-2024,S43G01N223,부산 KCC,Away,전준범,4,0,0,0.0,0,2,0.0,0,2,0.0,4,4,100.0,0,2,2,2,0,1,0,0,2,4
../kbl_data/2023-2024,S43G01N223,부산 KCC,Away,허웅,18,1,3,33.3,3,7,42.9,4,10,40.0,7,7,100.0,1,2,3,2,0,0,1,0,2,1
../kbl_data/2023-2024,S43G01N223,부산 KCC,Away,이승현,6,3,5,60.0,0,0,0.0,3,5,60.0,0,0,0.0,0,3,3,1,0,0,0,0,0,1
../kbl_data/2023-2024,S43G01N223,부산 KCC,Away,이호현,6,3,7,42.9,0,2,0.0,3,9,33.3,0,0,0.0,1,0,1,0,0,0,0,0,1,1
../kbl_data/2023-2024,S43G01N223,부산 KCC,Away,최준용,5,2,10,20.0,0,2,0.0,2,12,16.7,1,1,100.0,0,7,7,3,0,2,1,0,3,2
../kbl_data/2023-2024,S43G01N223,부산 KCC,Away,곽정훈,0,0,0,0.0,0,0,0.0,0,0,0.0,0,0,0.0,0,0,0,0,0,0,0,0,0,0
../kbl_data/2023-2024,S43G01N223,부산 KCC,Away,이근휘,6,0,0,0.0,2,5,40.0,2,5,40.0,0,0,0.0,1,1,2,0,0,0,1,0,1,0
../kbl_data/2023-2024,S43G01N223,부산 KCC,Away,여준형,0,0,0,0.0,0,0,0.0,0,0,0.0,0,0,0.0,0,0,0,0,0,0,0,0,0,1
../kbl_data/2023-2024,S43G01N223,부산 KCC,Away,캘빈 제프리 에피스톨라,0,0,0,0.0,0,0,0.0,0,0,0.0,0,0,0.0,0,0,0,0,0,0,0,0,0,0
../kbl_data/2023-2024,S43G01N223,부산 KCC,Away,알리제 드숀 존슨,12,0,6,0.0,3,6,50.0,3,12,25.0,3,6,50.0,3,7,10,2,0,0,0,0,0,3
../kbl_data/2023-2024,S43G01N224,서울 삼성,Home,이정현,20,2,3,66.7,4,6,66.7,6,9,66.7,4,9,44.4,1,3,4,10,1,0,0,0,3,3
../kbl_data/2023-2024,S43G01N224,서울 삼성,Home,홍경기,8,1,2,50.0,2,4,50.0,3,6,50.0,0,0,0.0,0,1,1,1,1,0,0,0,1,3
../kbl_data/2023-2024,S43G01N224,서울 삼성,Home,이동엽,3,0,1,0.0,1,5,20.0,1,6,16.7,0,0,0.0,0,1,1,0,0,0,0,0,1,2
../kbl_data/2023-2024,S43G01N224,서울 삼성,Home,최승욱,0,0,1,0.0,0,0,0.0,0,1,0.0,0,0,0.0,0,1,1,0,2,0,0,0,0,1
../kbl_data/2023-2024,S43G01N224,서울 삼성,Home,윤성원,0,0,0,0.0,0,0,0.0,0,0,0.0,0,0,0.0,0,0,0,0,0,0,0,0,0,0
../kbl_data/2023-2024,S43G01N224,서울 삼성,Home,차민석,4,1,5,20.0,0,1,0.0,1,6,16.7,2,2,100.0,0,1,1,0,1,0,0,0,1,2
../kbl_data/2023-2024,S43G01N224,서울 삼성,Home,이원석,14,6,11,54.5,0,0,0.0,6,11,54.5,2,2,100.0,3,8,11,3,0,0,0,0,4,5
../kbl_data/2023-2024,S43G01N224,서울 삼성,Home,신동혁,7,1,1,100.0,1,3,33.3,2,4,50.0,2,2,100.0,0,2,2,0,1,0,0,0,0,4
../kbl_data/2023-2024,S43G01N224,서울 삼성,Home,김근현,0,0,0,0.0,0,0,0.0,0,0,0.0,0,0,0.0,0,0,0,0,0,0,0,0,0,0
../kbl_data/2023-2024,S43G01N224,서울 삼성,Home,조준희,0,0,0,0.0,0,0,0.0,0,0,0.0,0,0,0.0,0,0,0,0,0,0,0,0,0,0
../kbl_data/2023-2024,S43G01N224,서울 삼성,Home,이스마엘 레인,5,2,2,100.0,0,0,0.0,2,2,100.0,1,2,50.0,1,1,2,0,0,1,0,0,0,1
../kbl_data/2023-2024,S43G01N224,서울 삼성,Home,코피 코번,14,5,16,31.2,0,0,0.0,5,16,31.2,4,6,66.7,7,8,15,3,0,1,0,0,5,0
../kbl_data/2023-2024,S43G01N224,대구 한국가스공사,Away,차바위,0,0,0,0.0,0,5,0.0,0,5,0.0,0,0,0.0,2,4,6,0,0,0,0,0,0,4
../kbl_data/2023-2024,S43G01N224,대구 한국가스공사,Away,박지훈,3,0,0,0.0,1,2,50.0,1,2,50.0,0,2,0.0,0,1,1,0,0,0,0,0,0,3
../kbl_data/2023-2024,S43G01N224,대구 한국가스공사,Away,이대헌,2,1,2,50.0,0,1,0.0,1,3,33.3,0,0,0.0,1,1,2,0,0,0,0,0,1,2
../kbl_data/2023-2024,S43G01N224,대구 한국가스공사,Away,박봉진,11,1,2,50.0,3,7,42.9,4,9,44.4,0,0,0.0,3,1,4,3,3,1,0,0,1,4
../kbl_data/2023-2024,S43G01N224,대구 한국가스공사,Away,김낙현,18,1,3,33.3,4,8,50.0,5,11,45.5,4,4,100.0,1,1,2,2,0,0,0,0,1,2
../kbl_data/2023-2024,S43G01N224,대구 한국가스공사,Away,이도헌,0,0,0,0.0,0,0,0.0,0,0,0.0,0,0,0.0,0,0,0,0,0,0,0,0,0,0
../kbl_data/2023-2024,S43G01N224,대구 한국가스공사,Away,신승민,6,1,2,50.0,1,4,25.0,2,6,33.3,1,1,100.0,1,2,3,1,1,0,0,0,1,5
../kbl_data/2023-2024,S43G01N224,대구 한국가스공사,Away,최주영,0,0,0,0.0,0,0,0.0,0,0,0.0,0,0,0.0,0,0,0,0,0,0,0,0,0,0
../kbl_data/2023-2024,S43G01N224,대구 한국가스공사,Away,샘조세프 벨란겔,24,6,11,54.5,2,9,22.2,8,20,40.0,6,6,100.0,0,5,5,6,0,0,2,0,3,2
../kbl_data/2023-2024,S43G01N224,대구 한국가스공사,Away,염유성,0,0,0,0.0,0,0,0.0,0,0,0.0,0,0,0.0,0,0,0,0,0,0,0,0,0,0
../kbl_data/2023-2024,S43G01N224,대구 한국가스공사,Away,안세영,0,0,0,0.0,0,0,0.0,0,0,0.0,0,0,0.0,0,0,0,0,0,0,0,0,0,0
../kbl_data/2023-2024,S43G01N224,대구 한국가스공사,Away,듀반 맥스웰,17,8,14,57.1,0,1,0.0,8,15,53.3,1,2,50.0,5,8,13,3,2,4,1,0,0,4
../kbl_data/2023-2024,S43G01N225,고양 소노,Home,김강선,0,0,1,0.0,0,0,0.0,0,1,0.0,0,0,0.0,0,0,0,0,0,0,0,0,0,0
../kbl_data/2023-2024,S43G01N225,고양 소노,Home,함준후,0,0,0,0.0,0,0,0.0,0,0,0.0,0,0,0.0,0,0,0,0,0,0,0,0,0,0
../kbl_data/2023-2024,S43G01N225,고양 소노,Home,최현민,12,4,5,80.0,1,5,20.0,5,10,50.0,1,2,50.0,1,3,4,1,1,0,1,0,0,2
../kbl_data/2023-2024,S43G01N225,고양 소노,Home,김민욱,9,4,4,100.0,0,4,0.0,4,8,50.0,1,1,100.0,2,1,3,1,1,1,0,0,2,4
../kbl_data/2023-2024,S43G01N225,고양 소노,Home,한호빈,13,4,7,57.1,1,3,33.3,5,10,50.0,2,2,100.0,0,3,3,4,1,0,0,0,0,0
../kbl_data/2023-2024,S43G01N225,고양 소노,Home,전성현,14,2,3,66.7,3,7,42.9,5,10,50.0,1,2,50.0,0,1,1,2,0,0,0,0,0,1
../kbl_data/2023-2024,S43G01N225,고양 소노,Home,김지후,16,2,4,50.0,4,8,50.0,6,12,50.0,0,0,0.0,1,4,5,0,0,0,0,0,0,3
../kbl_data/2023-2024,S43G01N225,고양 소노,Home,치나누 오누아쿠,11,3,8,37.5,0,4,0.0,3,12,25.0,5,6,83.3,0,3,3,5,2,0,0,1,2,3
../kbl_data/2023-2024,S43G01N225,고양 소노,Home,이진석,1,0,0,0.0,0,0,0.0,0,0,0.0,1,2,50.0,0,0,0,0,0,0,0,0,1,0
../kbl_data/2023-2024,S43G01N225,고양 소노,Home,이정현,9,3,6,50.0,1,4,25.0,4,10,40.0,0,2,0.0,1,1,2,5,0,0,0,0,0,2
../kbl_data/2023-2024,S43G01N225,고양 소노,Home,백지웅,0,0,0,0.0,0,1,0.0,0,1,0.0,0,0,0.0,0,0,0,1,0,0,0,0,0,1
../kbl_data/2023-2024,S43G01N225,고양 소노,Home,안정욱,0,0,0,0.0,0,0,0.0,0,0,0.0,0,0,0.0,0,0,0,0,0,0,0,0,0,0
../kbl_data/2023-2024,S43G01N225,부산 KCC,Away,정창영,12,3,4,75.0,2,2,100.0,5,6,83.3,0,0,0.0,0,4,4,5,0,0,0,0,2,1
../kbl_data/2023-2024,S43G01N225,부산 KCC,Away,라건아,26,10,11,90.9,2,3,66.7,12,14,85.7,0,0,0.0,2,12,14,2,0,1,0,0,0,2
../kbl_data/2023-2024,S43G01N225,부산 KCC,Away,전준범,0,0,1,0.0,0,1,0.0,0,2,0.0,0,0,0.0,0,2,2,0,0,0,0,0,0,1
../kbl_data/2023-2024,S43G01N225,부산 KCC,Away,허웅,31,6,11,54.5,5,11,45.5,11,22,50.0,4,4,100.0,0,1,1,10,1,0,0,0,5,2
../kbl_data/2023-2024,S43G01N225,부산 KCC,Away,이승현,20,8,9,88.9,1,3,33.3,9,12,75.0,1,1,100.0,3,1,4,4,0,1,0,0,1,4
../kbl_data/2023-2024,S43G01N225,부산 KCC,Away,이호현,10,3,5,60.0,1,2,50.0,4,7,57.1,1,2,50.0,1,5,6,5,0,0,2,0,1,3
../kbl_data/2023-2024,S43G01N225,부산 KCC,Away,곽정훈,12,0,0,0.0,4,4,100.0,4,4,100.0,0,0,0.0,0,6,6,0,0,0,0,0,0,3
../kbl_data/2023-2024,S43G01N225,부산 KCC,Away,이근휘,0,0,1,0.0,0,2,0.0,0,3,0.0,0,0,0.0,1,0,1,1,0,0,0,0,1,1
../kbl_data/2023-2024,S43G01N225,부산 KCC,Away,여준형,2,1,2,50.0,0,0,0.0,1,2,50.0,0,0,0.0,0,0,0,0,0,0,0,0,0,0
../kbl_data/2023-2024,S43G01N225,부산 KCC,Away,캘빈 제프리 에피스톨라,2,1,1,100.0,0,0,0.0,1,1,100.0,0,0,0.0,0,2,2,4,1,0,0,0,0,1
../kbl_data/2023-2024,S43G01N225,부산 KCC,Away,이주영,2,1,2,50.0,0,0,0.0,1,2,50.0,0,0,0.0,0,0,0,0,1,0,0,0,0,0
../kbl_data/2023-2024,S43G01N225,부산 KCC,Away,알리제 드숀 존슨,0,0,0,0.0,0,0,0.0,0,0,0.0,0,0,0.0,1,2,3,1,0,0,0,0,1,2
../kbl_data/2023-2024,S43G01N226,서울 SK,Home,양우섭,0,0,1,0.0,0,0,0.0,0,1,0.0,0,0,0.0,0,0,0,0,0,0,0,0,0,0
../kbl_data/2023-2024,S43G01N226,서울 SK,Home,허일영,9,1,3,33.3,2,2,100.0,3,5,60.0,1,1,100.0,0,2,2,3,1,1,0,0,0,1
../kbl_data/2023-2024,S43G01N226,서울 SK,Home,송창용,0,0,0,0.0,0,1,0.0,0,1,0.0,0,0,0.0,0,2,2,1,1,0,0,0,0,1
../kbl_data/2023-2024,S43G01N226,서울 SK,Home,오세근,16,5,8,62.5,2,2,100.0,7,10,70.0,0,0,0.0,0,6,6,5,2,0,0,0,0,2
../kbl_data/2023-2024,S43G01N226,서울 SK,Home,최부경,8,3,4,75.0,0,0,0.0,3,4,75.0,2,2,100.0,0,4,4,0,0,0,1,0,0,3
../kbl_data/2023-2024,S43G01N226,서울 SK,Home,리온 윌리엄스,13,4,6,66.7,1,2,50.0,5,8,62.5,2,2,100.0,3,5,8,0,1,0,0,0,1,4
../kbl_data/2023-2024,S43G01N226,서울 SK,Home,최원혁,5,1,2,50.0,1,3,33.3,2,5,40.0,0,0,0.0,0,2,2,4,0,0,0,0,1,3
../kbl_data/2023-2024,S43G01N226,서울 SK,Home,안영준,15,5,7,71.4,1,3,33.3,6,10,60.0,2,2,100.0,1,1,2,1,1,0,0,0,0,1
../kbl_data/2023-2024,S43G01N226,서울 SK,Home,자밀 워니,24,9,17,52.9,2,3,66.7,11,20,55.0,0,0,0.0,3,5,8,4,1,1,0,1,1,1
../kbl_data/2023-2024,S43G01N226,서울 SK,Home,김형빈,2,1,2,50.0,0,0,0.0,1,2,50.0,0,0,0.0,0,0,0,0,0,0,0,0,0,0
../kbl_data/2023-2024,S43G01N226,서울 SK,Home,오재현,10,5,10,50.0,0,1,0.0,5,11,45.5,0,0,0.0,2,3,5,7,1,0,0,0,2,2
../kbl_data/2023-2024,S43G01N226,서울 SK,Home,이경도,3,0,0,0.0,1,1,100.0,1,1,100.0,0,0,0.0,0,0,0,1,0,0,0,0,1,1
../kbl_data/2023-2024,S43G01N226,울산 현대모비스,Away,함지훈,9,2,2,100.0,1,2,50.0,3,4,75.0,2,2,100.0,2,0,2,3,1,0,0,0,1,1
../kbl_data/2023-2024,S43G01N226,울산 현대모비스,Away,최진수,3,0,1,0.0,1,2,50.0,1,3,33.3,0,0,0.0,1,1,2,0,0,0,0,0,0,1
../kbl_data/2023-2024,S43G01N226,울산 현대모비스,Away,김현수,3,1,1,100.0,0,0,0.0,1,1,100.0,1,1,100.0,0,0,0,0,1,0,0,0,0,0
../kbl_data/2023-2024,S43G01N226,울산 현대모비스,Away,장재석,12,5,5,100.0,0,0,0.0,5,5,100.0,2,2,100.0,0,2,2,0,0,0,0,0,0,3
../kbl_data/2023-2024,S43G01N226,울산 현대모비스,Away,김준일,0,0,0,0.0,0,0,0.0,0,0,0.0,0,0,0.0,0,0,0,0,0,0,0,0,0,0
../kbl_data/2023-2024,S43G01N226,울산 현대모비스,Away,김국찬,3,0,1,0.0,1,2,50.0,1,3,33.3,0,0,0.0,0,1,1,1,1,0,0,0,0,3
../kbl_data/2023-2024,S43G01N226,울산 현대모비스,Away,이우석,2,1,4,25.0,0,4,0.0,1,8,12.5,0,0,0.0,0,6,6,4,0,0,0,0,0,2
../kbl_data/2023-2024,S43G01N226,울산 현대모비스,Away,신민석,0,0,0,0.0,0,2,0.0,0,2,0.0,0,0,0.0,0,1,1,0,0,0,0,0,0,0
../kbl_data/2023-2024,S43G01N226,울산 현대모비스,Away,게이지 프림,19,8,16,50.0,0,1,0.0,8,17,47.1,3,3,100.0,4,4,8,1,1,0,0,0,3,3
../kbl_data/2023-2024,S43G01N226,울산 현대모비스,Away,박무빈,4,2,5,40.0,0,1,0.0,2,6,33.3,0,0,0.0,2,0,2,5,0,0,1,0,3,2
../kbl_data/2023-2024,S43G01N226,울산 현대모비스,Away,케베 알루마,10,5,8,62.5,0,4,0.0,5,12,41.7,0,0,0.0,0,3,3,1,0,2,0,1,2,0
../kbl_data/2023-2024,S43G01N226,울산 현대모비스,Away,미구엘 안드레 옥존,11,3,6,50.0,1,2,50.0,4,8,50.0,2,3,66.7,0,1,1,3,0,1,0,0,1,1
../kbl_data/2023-2024,S43G01N227,창원 LG,Home,이관희,5,1,2,50.0,1,5,20.0,2,7,28.6,0,0,0.0,0,1,1,0,1,1,0,0,1,1
../kbl_data/2023-2024,S43G01N227,창원 LG,Home,정희재,7,2,2,100.0,1,3,33.3,3,5,60.0,0,0,0.0,1,2,3,2,1,0,0,0,0,3
../kbl_data/2023-2024,S43G01N227,창원 LG,Home,이재도,10,2,3,66.7,2,5,40.0,4,8,50.0,0,0,0.0,1,1,2,3,0,0,1,0,2,1
../kbl_data/2023-2024,S43G01N227,창원 LG,Home,정인덕,5,1,1,100.0,1,2,50.0,2,3,66.7,0,0,0.0,0,3,3,0,0,0,0,0,0,3
../kbl_data/2023-2024,S43G01N227,창원 LG,Home,양홍석,12,6,8,75.0,0,6,0.0,6,14,42.9,0,0,0.0,2,5,7,6,1,2,0,0,1,2
../kbl_data/2023-2024,S43G01N227,창원 LG,Home,박정현,0,0,0,0.0,0,0,0.0,0,0,0.0,0,2,0.0,0,2,2,0,0,0,0,0,0,0
../kbl_data/2023-2024,S43G01N227,창원 LG,Home,아셈 마레이,10,4,7,57.1,0,0,0.0,4,7,57.1,2,2,100.0,8,7,15,2,2,0,0,0,3,2
../kbl_data/2023-2024,S43G01N227,창원 LG,Home,이승우,0,0,0,0.0,0,2,0.0,0,2,0.0,0,0,0.0,0,1,1,2,0,0,0,0,0,1
../kbl_data/2023-2024,S43G01N227,창원 LG,Home,저스틴 구탕,10,4,5,80.0,0,1,0.0,4,6,66.7,2,2,100.0,1,0,1,3,1,0,0,1,1,0
../kbl_data/2023-2024,S43G01N227,창원 LG,Home,양준석,10,2,3,66.7,2,4,50.0,4,7,57.1,0,0,0.0,0,1,1,3,0,0,0,0,0,0
../kbl_data/2023-2024,S43G01N227,창원 LG,Home,유기상,9,0,1,0.0,3,8,37.5,3,9,33.3,0,0,0.0,1,0,1,1,1,1,0,0,0,3
../kbl_data/2023-2024,S43G01N227,창원 LG,Home,후안 텔로,4,2,4,50.0,0,1,0.0,2,5,40.0,0,0,0.0,1,8,9,0,0,0,0,0,0,4
../kbl_data/2023-2024,S43G01N227,대구 한국가스공사,Away,박지훈,3,0,2,0.0,1,3,33.3,1,5,20.0,0,0,0.0,1,2,3,2,0,0,0,0,2,3
../kbl_data/2023-2024,S43G01N227,대구 한국가스공사,Away,이대헌,14,4,7,57.1,2,3,66.7,6,10,60.0,0,0,0.0,1,1,2,1,0,0,0,0,0,4
../kbl_data/2023-2024,S43G01N227,대구 한국가스공사,Away,박봉진,5,1,1,100.0,1,3,33.3,2,4,50.0,0,0,0.0,1,2,3,0,0,0,0,0,0,1
../kbl_data/2023-2024,S43G01N227,대구 한국가스공사,Away,이도헌,11,2,3,66.7,2,4,50.0,4,7,57.1,1,1,100.0,0,2,2,0,1,0,0,0,0,0
../kbl_data/2023-2024,S43G01N227,대구 한국가스공사,Away,앤드류 니콜슨,0,0,0,0.0,0,0,0.0,0,0,0.0,0,0,0.0,0,0,0,0,0,0,0,0,0,0
../kbl_data/2023-2024,S43G01N227,대구 한국가스공사,Away,신승민,10,1,5,20.0,1,1,100.0,2,6,33.3,5,5,100.0,1,6,7,2,0,0,0,0,2,3
../kbl_data/2023-2024,S43G01N227,대구 한국가스공사,Away,최주영,0,0,0,0.0,0,0,0.0,0,0,0.0,0,0,0.0,0,1,1,0,0,0,0,0,0,1
../kbl_data/2023-2024,S43G01N227,대구 한국가스공사,Away,샘조세프 벨란겔,6,2,8,25.0,0,3,0.0,2,11,18.2,2,4,50.0,1,2,3,4,2,0,1,0,3,3
../kbl_data/2023-2024,S43G01N227,대구 한국가스공사,Away,염유성,0,0,0,0.0,0,0,0.0,0,0,0.0,0,0,0.0,0,0,0,0,0,0,0,0,0,0
../kbl_data/2023-2024,S43G01N227,대구 한국가스공사,Away,안세영,0,0,1,0.0,0,2,0.0,0,3,0.0,0,0,0.0,0,0,0,2,1,0,0,0,2,1
../kbl_data/2023-2024,S43G01N227,대구 한국가스공사,Away,김태호,0,0,0,0.0,0,0,0.0,0,0,0.0,0,0,0.0,0,0,0,0,0,0,0,0,0,0
../kbl_data/2023-2024,S43G01N227,대구 한국가스공사,Away,듀반 맥스웰,10,4,12,33.3,0,0,0.0,4,12,33.3,2,4,50.0,2,6,8,3,2,3,0,1,1,1
../kbl_data/2023-2024,S43G01N228,서울 삼성,Home,이정현,2,0,2,0.0,0,3,0.0,0,5,0.0,2,2,100.0,0,1,1,9,0,0,0,0,1,3
../kbl_data/2023-2024,S43G01N228,서울 삼성,Home,홍경기,10,2,3,66.7,2,4,50.0,4,7,57.1,0,0,0.0,0,0,0,3,1,0,0,0,1,3
../kbl_data/2023-2024,S43G01N228,서울 삼성,Home,이동엽,6,0,2,0.0,2,3,66.7,2,5,40.0,0,0,0.0,0,0,0,3,0,0,1,0,1,4
../kbl_data/2023-2024,S43G01N228,서울 삼성,Home,최승욱,10,4,8,50.0,0,2,0.0,4,10,40.0,2,4,50.0,0,6,6,2,0,0,0,0,2,4
../kbl_data/2023-2024,S43G01N228,서울 삼성,Home,윤성원,0,0,0,0.0,0,0,0.0,0,0,0.0,0,0,0.0,1,0,1,1,0,0,0,0,0,0
../kbl_data/2023-2024,S43G01N228,서울 삼성,Home,차민석,8,2,7,28.6,1,1,100.0,3,8,37.5,1,1,100.0,2,3,5,0,0,0,0,0,1,5
../kbl_data/2023-2024,S43G01N228,서울 삼성,Home,이원석,8,4,12,33.3,0,1,0.0,4,13,30.8,0,0,0.0,7,3,10,1,2,0,1,0,3,2
../kbl_data/2023-2024,S43G01N228,서울 삼성,Home,신동혁,10,4,6,66.7,0,1,0.0,4,7,57.1,2,2,100.0,1,1,2,0,2,0,0,0,2,4
../kbl_data/2023-2024,S43G01N228,서울 삼성,Home,조준희,4,2,2,100.0,0,0,0.0,2,2,100.0,0,0,0.0,0,0,0,0,1,1,0,0,0,0
../kbl_data/2023-2024,S43G01N228,서울 삼성,Home,아반 나바,2,0,1,0.0,0,1,0.0,0,2,0.0,2,2,100.0,0,0,0,0,0,0,1,0,1,0
../kbl_data/2023-2024,S43G01N228,서울 삼성,Home,이스마엘 레인,3,0,1,0.0,1,2,50.0,1,3,33.3,0,2,0.0,1,3,4,0,0,2,0,0,0,0
../kbl_data/2023-2024,S43G01N228,서울 삼성,Home,코피 코번,31,13,21,61.9,0,0,0.0,13,21,61.9,5,6,83.3,10,5,15,1,0,1,0,1,4,0
../kbl_data/2023-2024,S43G01N228,원주 DB,Away,서민수,2,1,1,100.0,0,0,0.0,1,1,100.0,0,0,0.0,0,0,0,0,0,0,0,0,0,1
../kbl_data/2023-2024,S43G01N228,원주 DB,Away,김영현,0,0,0,0.0,0,0,0.0,0,0,0.0,0,0,0.0,0,1,1,1,0,0,0,0,0,1
../kbl_data/2023-2024,S43G01N228,원주 DB,Away,김종규,19,7,11,63.6,0,1,0.0,7,12,58.3,5,7,71.4,2,3,5,1,0,1,0,0,0,3
../kbl_data/2023-2024,S43G01N228,원주 DB,Away,최승욱,10,4,8,50.0,0,2,0.0,4,10,40.0,2,4,50.0,0,6,6,2,0,0,0,0,2,4
../kbl_data/2023-2024,S43G01N228,원주 DB,Away,강상재,16,3,4,75.0,2,2,100.0,5,6,83.3,4,4,100.0,0,1,1,9,0,0,0,0,5,4
../kbl_data/2023-2024,S43G01N228,원주 DB,Away,유현준,5,1,1,100.0,1,1,100.0,2,2,100.0,0,0,0.0,1,0,1,1,1,0,0,0,1,0
../kbl_data/2023-2024,S43G01N228,원주 DB,Away,이윤수,2,1,2,50.0,0,0,0.0,1,2,50.0,0,0,0.0,2,1,3,0,0,0,0,0,1,1
../kbl_data/2023-2024,S43G01N228,원주 DB,Away,디드릭 로슨,15,1,2,50.0,3,7,42.9,4,9,44.4,4,6,66.7,2,6,8,4,2,2,0,0,2,2
../kbl_data/2023-2024,S43G01N228,원주 DB,Away,이선 알바노,17,6,9,66.7,1,2,50.0,7,11,63.6,2,2,100.0,0,0,0,6,2,0,0,0,1,1
../kbl_data/2023-2024,S43G01N228,원주 DB,Away,박인웅,15,3,3,100.0,3,5,60.0,6,8,75.0,0,0,0.0,0,1,1,0,0,0,0,0,0,3
../kbl_data/2023-2024,S43G01N228,원주 DB,Away,박승재,0,0,0,0.0,0,0,0.0,0,0,0.0,0,0,0.0,0,0,0,0,0,0,0,0,1,0
../kbl_data/2023-2024,S43G01N228,원주 DB,Away,제프 위디,4,2,5,40.0,0,0,0.0,2,5,40.0,0,0,0.0,0,2,2,1,1,3,0,0,0,1
../kbl_data/2023-2024,S43G01N229,수원 KT,Home,한희원,20,3,5,60.0,4,9,44.4,7,14,50.0,2,3,66.7,1,0,1,1,0,1,1,0,0,4
../kbl_data/2023-2024,S43G01N229,수원 KT,Home,최창진,0,0,0,0.0,0,0,0.0,0,0,0.0,0,0,0.0,0,2,2,1,0,0,0,0,0,0
../kbl_data/2023-2024,S43G01N229,수원 KT,Home,문성곤,2,1,1,100.0,0,3,0.0,1,4,25.0,0,0,0.0,3,0,3,0,1,1,1,0,0,3
../kbl_data/2023-2024,S43G01N229,수원 KT,Home,이현석,0,0,0,0.0,0,0,0.0,0,0,0.0,0,0,0.0,0,0,0,0,0,0,0,0,0,0
../kbl_data/2023-2024,S43G01N229,수원 KT,Home,정성우,0,0,1,0.0,0,4,0.0,0,5,0.0,0,0,0.0,2,1,3,4,0,1,0,0,1,5
../kbl_data/2023-2024,S43G01N229,수원 KT,Home,최성모,0,0,0,0.0,0,0,0.0,0,0,0.0,0,0,0.0,0,0,0,0,0,0,0,0,0,0
../kbl_data/2023-2024,S43G01N229,수원 KT,Home,허훈,17,5,9,55.6,2,5,40.0,7,14,50.0,1,4,25.0,1,1,2,6,0,0,0,0,1,4
../kbl_data/2023-2024,S43G01N229,수원 KT,Home,하윤기,13,3,8,37.5,0,0,0.0,3,8,37.5,7,9,77.8,8,9,17,3,0,1,0,1,2,2
../kbl_data/2023-2024,S43G01N229,수원 KT,Home,이두원,0,0,0,0.0,0,0,0.0,0,0,0.0,0,0,0.0,0,0,0,0,0,0,0,0,0,0
../kbl_data/2023-2024,S43G01N229,수원 KT,Home,문정현,13,2,4,50.0,3,7,42.9,5,11,45.5,0,0,0.0,2,1,3,1,0,0,0,0,0,3
../kbl_data/2023-2024,S43G01N229,수원 KT,Home,마이클 에릭,0,0,0,0.0,0,0,0.0,0,0,0.0,0,0,0.0,0,3,3,0,0,0,0,0,0,1
../kbl_data/2023-2024,S43G01N229,수원 KT,Home,패리스 배스,29,11,17,64.7,2,9,22.2,13,26,50.0,1,2,50.0,3,11,14,4,3,0,0,1,4,4
../kbl_data/2023-2024,S43G01N229,부산 KCC,Away,정창영,10,2,3,66.7,1,4,25.0,3,7,42.9,3,4,75.0,0,3,3,1,2,0,0,0,1,3
../kbl_data/2023-2024,S43G01N229,부산 KCC,Away,라건아,18,7,10,70.0,0,0,0.0,7,10,70.0,4,5,80.0,8,7,15,3,1,0,0,1,1,3
../kbl_data/2023-2024,S43G01N229,부산 KCC,Away,전준범,8,1,1,100.0,1,2,50.0,2,3,66.7,3,4,75.0,1,1,2,0,0,1,1,0,0,3
../kbl_data/2023-2024,S43G01N229,부산 KCC,Away,허웅,18,4,12,33.3,2,10,20.0,6,22,27.3,4,6,66.7,0,3,3,8,0,0,0,0,0,2
../kbl_data/2023-2024,S43G01N229,부산 KCC,Away,이승현,15,4,9,44.4,1,4,25.0,5,13,38.5,4,5,80.0,2,3,5,5,0,1,0,0,0,4
../kbl_data/2023-2024,S43G01N229,부산 KCC,Away,이호현,13,2,4,50.0,3,7,42.9,5,11,45.5,0,0,0.0,0,4,4,3,0,0,0,0,3,3
../kbl_data/2023-2024,S43G01N229,부산 KCC,Away,곽정훈,0,0,0,0.0,0,0,0.0,0,0,0.0,0,0,0.0,0,0,0,0,0,0,0,0,0,0
../kbl_data/2023-2024,S43G01N229,부산 KCC,Away,이근휘,0,0,0,0.0,0,0,0.0,0,0,0.0,0,0,0.0,0,0,0,0,0,0,0,0,0,0
../kbl_data/2023-2024,S43G01N229,부산 KCC,Away,여준형,0,0,0,0.0,0,0,0.0,0,0,0.0,0,0,0.0,0,0,0,0,0,0,0,0,0,0
../kbl_data/2023-2024,S43G01N229,부산 KCC,Away,캘빈 제프리 에피스톨라,0,0,0,0.0,0,0,0.0,0,0,0.0,0,2,0.0,0,0,0,0,1,0,0,0,0,0
../kbl_data/2023-2024,S43G01N229,부산 KCC,Away,이주영,0,0,0,0.0,0,0,0.0,0,0,0.0,0,0,0.0,0,0,0,0,0,0,0,0,0,0
../kbl_data/2023-2024,S43G01N229,부산 KCC,Away,알리제 드숀 존슨,14,6,10,60.0,0,0,0.0,6,10,60.0,2,3,66.7,4,5,9,1,0,0,1,1,1,4
../kbl_data/2023-2024,S43G01N230,수원 KT,Home,한희원,9,2,3,66.7,1,4,25.0,3,7,42.9,2,2,100.0,0,2,2,0,1,0,0,0,0,2
../kbl_data/2023-2024,S43G01N230,수원 KT,Home,최창진,0,0,0,0.0,0,0,0.0,0,0,0.0,0,0,0.0,0,0,0,0,0,0,0,0,0,0
../kbl_data/2023-2024,S43G01N230,수원 KT,Home,문성곤,0,0,1,0.0,0,0,0.0,0,1,0.0,0,0,0.0,0,3,3,3,1,0,0,0,1,2
../kbl_data/2023-2024,S43G01N230,수원 KT,Home,이현석,0,0,0,0.0,0,0,0.0,0,0,0.0,0,0,0.0,0,0,0,0,0,0,0,0,0,0
../kbl_data/2023-2024,S43G01N230,수원 KT,Home,정성우,13,5,9,55.6,1,3,33.3,6,12,50.0,0,0,0.0,1,1,2,6,5,0,0,0,0,2
../kbl_data/2023-2024,S43G01N230,수원 KT,Home,최성모,0,0,0,0.0,0,0,0.0,0,0,0.0,0,0,0.0,0,0,0,0,0,0,0,0,0,0
../kbl_data/2023-2024,S43G01N230,수원 KT,Home,허훈,20,4,5,80.0,3,10,30.0,7,15,46.7,3,4,75.0,2,3,5,5,0,0,0,0,7,2
../kbl_data/2023-2024,S43G01N230,수원 KT,Home,하윤기,23,10,14,71.4,0,0,0.0,10,14,71.4,3,4,75.0,1,2,3,2,2,0,0,1,3,1
../kbl_data/2023-2024,S43G01N230,수원 KT,Home,이두원,0,0,0,0.0,0,0,0.0,0,0,0.0,0,0,0.0,0,0,0,0,0,0,0,0,0,0
../kbl_data/2023-2024,S43G01N230,수원 KT,Home,문정현,2,1,1,100.0,0,0,0.0,1,1,100.0,0,0,0.0,1,2,3,1,0,0,0,0,0,2
../kbl_data/2023-2024,S43G01N230,수원 KT,Home,마이클 에릭,2,1,5,20.0,0,0,0.0,1,5,20.0,0,1,0.0,3,3,6,0,0,1,0,1,0,2
../kbl_data/2023-2024,S43G01N230,수원 KT,Home,패리스 배스,29,11,17,64.7,1,5,20.0,12,22,54.5,4,5,80.0,3,4,7,4,4,0,0,3,1,4
../kbl_data/2023-2024,S43G01N230,울산 현대모비스,Away,함지훈,4,2,3,66.7,0,1,0.0,2,4,50.0,0,0,0.0,0,0,0,4,0,1,0,0,1,1
../kbl_data/2023-2024,S43G01N230,울산 현대모비스,Away,김현수,0,0,0,0.0,0,0,0.0,0,0,0.0,0,0,0.0,0,0,0,0,0,0,0,0,0,0
../kbl_data/2023-2024,S43G01N230,울산 현대모비스,Away,장재석,10,4,6,66.7,0,1,0.0,4,7,57.1,2,2,100.0,2,3,5,4,3,1,0,2,1,4
../kbl_data/2023-2024,S43G01N230,울산 현대모비스,Away,김준일,0,0,0,0.0,0,0,0.0,0,0,0.0,0,0,0.0,0,0,0,0,0,0,0,0,0,0
../kbl_data/2023-2024,S43G01N230,울산 현대모비스,Away,김국찬,5,1,1,100.0,1,3,33.3,2,4,50.0,0,0,0.0,0,2,2,1,0,0,0,0,2,3
../kbl_data/2023-2024,S43G01N230,울산 현대모비스,Away,박준은,0,0,0,0.0,0,0,0.0,0,0,0.0,0,0,0.0,0,0,0,0,0,0,0,0,0,0
../kbl_data/2023-2024,S43G01N230,울산 현대모비스,Away,이우석,24,7,13,53.8,2,4,50.0,9,17,52.9,4,4,100.0,4,5,9,10,1,0,0,0,3,0
../kbl_data/2023-2024,S43G01N230,울산 현대모비스,Away,신민석,2,1,1,100.0,0,1,0.0,1,2,50.0,0,0,0.0,0,1,1,0,0,0,0,0,1,2
../kbl_data/2023-2024,S43G01N230,울산 현대모비스,Away,게이지 프림,17,6,9,66.7,0,0,0.0,6,9,66.7,5,7,71.4,2,4,6,0,1,0,0,0,0,1
../kbl_data/2023-2024,S43G01N230,울산 현대모비스,Away,박무빈,4,2,4,50.0,0,0,0.0,2,4,50.0,0,0,0.0,1,3,4,0,0,0,0,0,2,4
../kbl_data/2023-2024,S43G01N230,울산 현대모비스,Away,케베 알루마,18,2,5,40.0,3,6,50.0,5,11,45.5,5,8,62.5,3,5,8,2,2,1,0,0,4,2
../kbl_data/2023-2024,S43G01N230,울산 현대모비스,Away,미구엘 안드레 옥존,10,3,4,75.0,1,6,16.7,4,10,40.0,1,3,33.3,1,3,4,4,3,0,0,0,2,1
../kbl_data/2023-2024,S43G01N231,원주 DB,Home,김현호,0,0,0,0.0,0,0,0.0,0,0,0.0,0,0,0.0,0,0,0,0,0,0,0,0,1,0
../kbl_data/2023-2024,S43G01N231,원주 DB,Home,서민수,0,0,0,0.0,0,0,0.0,0,0,0.0,0,0,0.0,0,0,0,0,0,0,0,0,0,1
../kbl_data/2023-2024,S43G01N231,원주 DB,Home,김영현,0,0,0,0.0,0,1,0.0,0,1,0.0,0,0,0.0,0,0,0,1,0,0,0,0,0,2
../kbl_data/2023-2024,S43G01N231,원주 DB,Home,김종규,12,5,9,55.6,0,1,0.0,5,10,50.0,2,2,100.0,3,2,5,0,2,4,0,0,0,2
../kbl_data/2023-2024,S43G01N231,원주 DB,Home,최승욱,4,2,3,66.7,0,1,0.0,2,4,50.0,0,0,0.0,0,0,0,0,0,0,0,0,0,2
../kbl_data/2023-2024,S43G01N231,원주 DB,Home,강상재,20,6,9,66.7,2,5,40.0,8,14,57.1,2,4,50.0,0,10,10,4,0,1,0,0,3,3
../kbl_data/2023-2024,S43G01N231,원주 DB,Home,유현준,5,0,0,0.0,1,1,100.0,1,1,100.0,2,2,100.0,0,0,0,3,0,1,0,0,0,1
../kbl_data/2023-2024,S43G01N231,원주 DB,Home,디드릭 로슨,31,4,8,50.0,6,8,75.0,10,16,62.5,5,6,83.3,2,4,6,5,2,4,0,1,3,2
../kbl_data/2023-2024,S43G01N231,원주 DB,Home,이선 알바노,28,8,10,80.0,3,6,50.0,11,16,68.8,3,6,50.0,1,4,5,9,1,0,0,0,2,3
../kbl_data/2023-2024,S43G01N231,원주 DB,Home,박인웅,8,1,2,50.0,2,2,100.0,3,4,75.0,0,0,0.0,0,2,2,0,1,0,0,0,0,1
../kbl_data/2023-2024,S43G01N231,원주 DB,Home,박승재,0,0,0,0.0,0,0,0.0,0,0,0.0,0,0,0.0,0,0,0,0,0,0,0,0,0,0
../kbl_data/2023-2024,S43G01N231,원주 DB,Home,제프 위디,7,2,2,100.0,1,2,50.0,3,4,75.0,0,0,0.0,0,6,6,4,0,1,0,0,2,1
../kbl_data/2023-2024,S43G01N231,부산 KCC,Away,정창영,15,4,6,66.7,2,2,100.0,6,8,75.0,1,2,50.0,2,2,4,5,0,0,0,0,0,2
../kbl_data/2023-2024,S43G01N231,부산 KCC,Away,라건아,8,4,9,44.4,0,0,0.0,4,9,44.4,0,0,0.0,4,4,8,1,0,0,0,0,2,0
../kbl_data/2023-2024,S43G01N231,부산 KCC,Away,전준범,0,0,1,0.0,0,2,0.0,0,3,0.0,0,0,0.0,0,0,0,0,1,0,0,0,0,1
../kbl_data/2023-2024,S43G01N231,부산 KCC,Away,허웅,15,4,9,44.4,1,8,12.5,5,17,29.4,4,5,80.0,0,0,0,6,1,0,0,0,2,3
../kbl_data/2023-2024,S43G01N231,부산 KCC,Away,이승현,24,5,12,41.7,4,7,57.1,9,19,47.4,2,2,100.0,2,2,4,4,3,1,0,0,1,3
../kbl_data/2023-2024,S43G01N231,부산 KCC,Away,이호현,5,1,5,20.0,1,2,50.0,2,7,28.6,0,0,0.0,0,0,0,0,0,0,1,0,0,2
../kbl_data/2023-2024,S43G01N231,부산 KCC,Away,곽정훈,15,1,2,50.0,4,6,66.7,5,8,62.5,1,3,33.3,2,1,3,0,0,0,0,0,1,5
../kbl_data/2023-2024,S43G01N231,부산 KCC,Away,이근휘,2,1,1,100.0,0,1,0.0,1,2,50.0,0,0,0.0,0,1,1,0,0,0,0,0,0,1
../kbl_data/2023-2024,S43G01N231,부산 KCC,Away,여준형,0,0,0,0.0,0,0,0.0,0,0,0.0,0,0,0.0,0,0,0,0,1,0,0,0,0,0
../kbl_data/2023-2024,S43G01N231,부산 KCC,Away,캘빈 제프리 에피스톨라,0,0,0,0.0,0,0,0.0,0,0,0.0,0,0,0.0,0,1,1,0,0,0,0,0,0,0
../kbl_data/2023-2024,S43G01N231,부산 KCC,Away,이주영,0,0,0,0.0,0,0,0.0,0,0,0.0,0,0,0.0,0,0,0,0,0,0,0,0,0,0
../kbl_data/2023-2024,S43G01N231,부산 KCC,Away,알리제 드숀 존슨,20,10,16,62.5,0,1,0.0,10,17,58.8,0,0,0.0,6,8,14,7,1,0,0,2,1,3
../kbl_data/2023-2024,S43G01N232,서울 삼성,Home,이정현,104,28,44,63.6,10,28,35.7,38,72,52.8,18,20,90.0,0,6,6,30,4,0,4,0,8,12
../kbl_data/2023-2024,S43G01N232,서울 삼성,Home,홍경기,6,0,0,0.0,2,3,66.7,2,3,66.7,0,0,0.0,0,1,1,3,0,0,0,0,0,2
../kbl_data/2023-2024,S43G01N232,서울 삼성,Home,이동엽,11,3,4,75.0,0,5,0.0,3,9,33.3,5,5,100.0,0,3,3,8,0,0,0,0,2,4
../kbl_data/2023-2024,S43G01N232,서울 삼성,Home,최승욱,5,2,3,66.7,0,1,0.0,2,4,50.0,1,1,100.0,2,0,2,0,2,1,0,0,0,2
../kbl_data/2023-2024,S43G01N232,서울 삼성,Home,윤성원,16,2,2,100.0,4,5,80.0,6,7,85.7,0,0,0.0,1,5,6,0,1,0,0,0,1,2
../kbl_data/2023-2024,S43G01N232,서울 삼성,Home,차민석,2,0,3,0.0,0,0,0.0,0,3,0.0,2,2,100.0,1,3,4,0,0,0,0,0,2,3
../kbl_data/2023-2024,S43G01N232,서울 삼성,Home,이원석,2,1,1,100.0,0,0,0.0,1,1,100.0,0,0,0.0,0,0,0,1,0,0,0,1,0,1
../kbl_data/2023-2024,S43G01N232,서울 삼성,Home,신동혁,0,0,1,0.0,0,2,0.0,0,3,0.0,0,0,0.0,0,2,2,1,1,0,0,0,0,1
../kbl_data/2023-2024,S43G01N232,서울 삼성,Home,조준희,0,0,0,0.0,0,0,0.0,0,0,0.0,0,0,0.0,0,1,1,0,0,0,0,0,0,0
../kbl_data/2023-2024,S43G01N232,서울 삼성,Home,아반 나바,0,0,0,0.0,0,0,0.0,0,0,0.0,0,0,0.0,0,0,0,0,0,0,0,0,0,0
../kbl_data/2023-2024,S43G01N232,서울 삼성,Home,이스마엘 레인,4,2,3,66.7,0,1,0.0,2,4,50.0,0,0,0.0,0,1,1,0,0,1,0,0,0,0
../kbl_data/2023-2024,S43G01N232,서울 삼성,Home,코피 코번,31,12,20,60.0,0,0,0.0,12,20,60.0,7,9,77.8,5,10,15,2,0,1,0,0,1,4
../kbl_data/2023-2024,S43G01N232,고양 소노,Away,김강선,0,0,0,0.0,0,2,0.0,0,2,0.0,0,0,0.0,0,2,2,0,0,0,0,0,0,0
../kbl_data/2023-2024,S43G01N232,고양 소노,Away,함준후,0,0,1,0.0,0,0,0.0,0,1,0.0,0,0,0.0,1,2,3,0,0,0,0,0,1,3
../kbl_data/2023-2024,S43G01N232,고양 소노,Away,김민욱,3,0,1,0.0,1,3,33.3,1,4,25.0,0,0,0.0,1,1,2,0,0,1,0,0,1,3
../kbl_data/2023-2024,S43G01N232,고양 소노,Away,한호빈,2,1,4,25.0,0,3,0.0,1,7,14.3,0,0,0.0,1,1,2,6,1,0,1,0,1,5
../kbl_data/2023-2024,S43G01N232,고양 소노,Away,전성현,8,1,2,50.0,2,6,33.3,3,8,37.5,0,0,0.0,0,2,2,0,1,0,0,0,0,2
../kbl_data/2023-2024,S43G01N232,고양 소노,Away,김지후,8,1,2,50.0,2,5,40.0,3,7,42.9,0,0,0.0,0,1,1,1,0,0,0,0,0,0
../kbl_data/2023-2024,S43G01N232,고양 소노,Away,치나누 오누아쿠,28,9,15,60.0,0,0,0.0,9,15,60.0,10,13,76.9,4,6,10,3,1,3,0,0,1,4
../kbl_data/2023-2024,S43G01N232,고양 소노,Away,이진석,0,0,0,0.0,0,0,0.0,0,0,0.0,0,0,0.0,0,0,0,0,0,0,0,0,0,0
../kbl_data/2023-2024,S43G01N232,고양 소노,Away,이정현,104,28,44,63.6,10,28,35.7,38,72,52.8,18,20,90.0,0,6,6,30,4,0,4,0,8,12
../kbl_data/2023-2024,S43G01N232,고양 소노,Away,백지웅,0,0,0,0.0,0,0,0.0,0,0,0.0,0,0,0.0,1,0,1,0,0,0,0,0,1,1
../kbl_data/2023-2024,S43G01N232,고양 소노,Away,조재우,0,0,0,0.0,0,0,0.0,0,0,0.0,0,0,0.0,0,0,0,0,0,0,0,0,0,0
../kbl_data/2023-2024,S43G01N232,고양 소노,Away,안정욱,0,0,0,0.0,0,0,0.0,0,0,0.0,0,0,0.0,0,3,3,0,0,0,0,0,0,0
../kbl_data/2023-2024,S43G01N233,창원 LG,Home,이관희,5,0,0,0.0,1,3,33.3,1,3,33.3,2,2,100.0,0,0,0,0,1,0,0,0,1,1
../kbl_data/2023-2024,S43G01N233,창원 LG,Home,정희재,3,0,0,0.0,1,3,33.3,1,3,33.3,0,0,0.0,0,0,0,2,0,0,0,0,0,3
../kbl_data/2023-2024,S43G01N233,창원 LG,Home,이재도,22,6,10,60.0,2,6,33.3,8,16,50.0,4,5,80.0,0,4,4,9,1,0,0,0,2,1
../kbl_data/2023-2024,S43G01N233,창원 LG,Home,정인덕,4,1,4,25.0,0,1,0.0,1,5,20.0,2,2,100.0,0,1,1,1,0,0,0,0,0,3
../kbl_data/2023-2024,S43G01N233,창원 LG,Home,양홍석,17,7,9,77.8,1,7,14.3,8,16,50.0,0,0,0.0,4,3,7,2,1,0,1,0,1,2
../kbl_data/2023-2024,S43G01N233,창원 LG,Home,박정현,0,0,0,0.0,0,0,0.0,0,0,0.0,0,0,0.0,0,0,0,0,0,0,0,0,0,0
../kbl_data/2023-2024,S43G01N233,창원 LG,Home,아셈 마레이,16,7,9,77.8,0,0,0.0,7,9,77.8,2,3,66.7,2,8,10,3,1,0,0,1,1,2
../kbl_data/2023-2024,S43G01N233,창원 LG,Home,이승우,0,0,0,0.0,0,0,0.0,0,0,0.0,0,0,0.0,1,0,1,0,0,0,0,0,0,0
../kbl_data/2023-2024,S43G01N233,창원 LG,Home,저스틴 구탕,4,1,4,25.0,0,1,0.0,1,5,20.0,2,2,100.0,3,1,4,2,1,0,0,1,1,1
../kbl_data/2023-2024,S43G01N233,창원 LG,Home,양준석,0,0,0,0.0,0,1,0.0,0,1,0.0,0,0,0.0,0,1,1,1,0,0,0,0,1,1
../kbl_data/2023-2024,S43G01N233,창원 LG,Home,유기상,10,2,2,100.0,2,3,66.7,4,5,80.0,0,0,0.0,1,2,3,1,3,1,0,0,0,4
../kbl_data/2023-2024,S43G01N233,창원 LG,Home,후안 텔로,6,3,6,50.0,0,1,0.0,3,7,42.9,0,0,0.0,0,1,1,0,1,0,0,0,2,1
../kbl_data/2023-2024,S43G01N233,수원 KT,Away,최창진,1,0,0,0.0,0,0,0.0,0,0,0.0,1,2,50.0,0,0,0,2,0,0,0,0,0,0
../kbl_data/2023-2024,S43G01N233,수원 KT,Away,문성곤,0,0,0,0.0,0,3,0.0,0,3,0.0,0,0,0.0,3,1,4,5,0,0,0,0,0,1
../kbl_data/2023-2024,S43G01N233,수원 KT,Away,이현석,3,0,0,0.0,1,3,33.3,1,3,33.3,0,0,0.0,1,2,3,0,0,0,1,0,0,3
../kbl_data/2023-2024,S43G01N233,수원 KT,Away,정성우,7,2,6,33.3,1,3,33.3,3,9,33.3,0,0,0.0,0,1,1,4,3,0,1,0,3,3
../kbl_data/2023-2024,S43G01N233,수원 KT,Away,최성모,2,1,2,50.0,0,0,0.0,1,2,50.0,0,0,0.0,0,0,0,4,0,0,0,0,0,0
../kbl_data/2023-2024,S43G01N233,수원 KT,Away,허훈,5,0,4,0.0,1,4,25.0,1,8,12.5,2,2,100.0,0,0,0,0,0,0,0,0,3,3
../kbl_data/2023-2024,S43G01N233,수원 KT,Away,김준환,2,1,1,100.0,0,1,0.0,1,2,50.0,0,0,0.0,0,1,1,0,0,0,0,0,0,0
../kbl_data/2023-2024,S43G01N233,수원 KT,Away,하윤기,13,6,9,66.7,0,0,0.0,6,9,66.7,1,2,50.0,4,2,6,0,0,0,0,0,3,1
../kbl_data/2023-2024,S43G01N233,수원 KT,Away,이두원,0,0,0,0.0,0,0,0.0,0,0,0.0,0,0,0.0,0,0,0,0,0,0,0,0,0,0
../kbl_data/2023-2024,S43G01N233,수원 KT,Away,문정현,9,1,4,25.0,2,4,50.0,3,8,37.5,1,2,50.0,2,3,5,1,1,0,0,0,1,4
../kbl_data/2023-2024,S43G01N233,수원 KT,Away,마이클 에릭,8,4,7,57.1,0,0,0.0,4,7,57.1,0,0,0.0,1,2,3,0,0,0,0,0,0,0
../kbl_data/2023-2024,S43G01N233,수원 KT,Away,패리스 배스,26,6,13,46.2,3,6,50.0,9,19,47.4,5,8,62.5,1,6,7,3,1,2,0,1,2,3
../kbl_data/2023-2024,S43G01N234,안양 정관장,Home,정준원,0,0,0,0.0,0,0,0.0,0,0,0.0,0,0,0.0,1,0,1,0,0,1,0,0,0,1
../kbl_data/2023-2024,S43G01N234,안양 정관장,Home,배병준,11,1,2,50.0,3,10,30.0,4,12,33.3,0,0,0.0,0,1,1,3,0,0,0,0,1,2
../kbl_data/2023-2024,S43G01N234,안양 정관장,Home,정효근,8,1,3,33.3,1,3,33.3,2,6,33.3,3,4,75.0,1,4,5,1,0,0,0,0,2,3
../kbl_data/2023-2024,S43G01N234,안양 정관장,Home,이종현,2,1,2,50.0,0,1,0.0,1,3,33.3,0,0,0.0,1,5,6,3,0,3,0,0,0,2
../kbl_data/2023-2024,S43G01N234,안양 정관장,Home,박지훈,10,5,7,71.4,0,2,0.0,5,9,55.6,0,0,0.0,0,1,1,5,1,0,0,0,0,2
../kbl_data/2023-2024,S43G01N234,안양 정관장,Home,최성원,17,1,3,33.3,5,9,55.6,6,12,50.0,0,1,0.0,0,1,1,0,0,0,0,0,1,0
../kbl_data/2023-2024,S43G01N234,안양 정관장,Home,이우정,10,2,2,100.0,2,4,50.0,4,6,66.7,0,0,0.0,1,0,1,3,0,1,0,0,0,2
../kbl_data/2023-2024,S43G01N234,안양 정관장,Home,김경원,4,2,5,40.0,0,0,0.0,2,5,40.0,0,1,0.0,3,1,4,0,0,0,0,0,1,1
../kbl_data/2023-2024,S43G01N234,안양 정관장,Home,고찬혁,0,0,0,0.0,0,5,0.0,0,5,0.0,0,0,0.0,0,1,1,1,0,0,1,0,1,2
../kbl_data/2023-2024,S43G01N234,안양 정관장,Home,나성호,2,1,3,33.3,0,0,0.0,1,3,33.3,0,0,0.0,1,1,2,0,1,0,0,0,0,1
../kbl_data/2023-2024,S43G01N234,안양 정관장,Home,로버트 카터,16,6,8,75.0,1,6,16.7,7,14,50.0,1,2,50.0,1,9,10,1,3,1,0,0,2,4
../kbl_data/2023-2024,S43G01N234,안양 정관장,Home,자밀 윌슨,0,0,0,0.0,0,0,0.0,0,0,0.0,0,0,0.0,0,0,0,0,0,0,0,0,0,0
../kbl_data/2023-2024,S43G01N234,고양 소노,Away,김강선,5,1,2,50.0,1,3,33.3,2,5,40.0,0,0,0.0,0,1,1,1,2,0,0,0,1,4
../kbl_data/2023-2024,S43G01N234,고양 소노,Away,함준후,0,0,1,0.0,0,0,0.0,0,1,0.0,0,0,0.0,0,0,0,0,0,0,0,0,0,1
../kbl_data/2023-2024,S43G01N234,고양 소노,Away,김민욱,7,3,4,75.0,0,6,0.0,3,10,30.0,1,2,50.0,1,8,9,3,0,2,0,0,1,2
../kbl_data/2023-2024,S43G01N234,고양 소노,Away,한호빈,3,0,1,0.0,1,5,20.0,1,6,16.7,0,0,0.0,0,3,3,7,1,0,0,0,0,4
../kbl_data/2023-2024,S43G01N234,고양 소노,Away,전성현,17,4,7,57.1,3,9,33.3,7,16,43.8,0,0,0.0,0,0,0,2,1,0,0,0,1,0
../kbl_data/2023-2024,S43G01N234,고양 소노,Away,김지후,0,0,0,0.0,0,0,0.0,0,0,0.0,0,0,0.0,1,0,1,0,0,0,0,0,0,0
../kbl_data/2023-2024,S43G01N234,고양 소노,Away,치나누 오누아쿠,40,15,20,75.0,0,0,0.0,15,20,75.0,10,11,90.9,6,15,21,5,1,1,0,2,1,2
../kbl_data/2023-2024,S43G01N234,고양 소노,Away,이진석,0,0,0,0.0,0,0,0.0,0,0,0.0,0,0,0.0,0,0,0,0,0,0,0,0,0,0
../kbl_data/2023-2024,S43G01N234,고양 소노,Away,이정현,22,5,7,71.4,3,6,50.0,8,13,61.5,3,3,100.0,0,3,3,8,1,1,1,0,3,4
../kbl_data/2023-2024,S43G01N234,고양 소노,Away,조은후,0,0,0,0.0,0,0,0.0,0,0,0.0,0,0,0.0,0,0,0,0,0,0,0,0,0,0
../kbl_data/2023-2024,S43G01N234,고양 소노,Away,백지웅,0,0,0,0.0,0,0,0.0,0,0,0.0,0,0,0.0,0,0,0,0,0,0,0,0,0,0
../kbl_data/2023-2024,S43G01N234,고양 소노,Away,조재우,0,0,0,0.0,0,0,0.0,0,0,0.0,0,0,0.0,0,0,0,0,0,0,0,0,0,0
../kbl_data/2023-2024,S43G01N235,서울 SK,Home,양우섭,1,0,0,0.0,0,2,0.0,0,2,0.0,1,2,50.0,0,1,1,0,0,0,0,0,0,0
../kbl_data/2023-2024,S43G01N235,서울 SK,Home,허일영,10,1,2,50.0,2,6,33.3,3,8,37.5,2,2,100.0,2,3,5,0,0,0,0,0,3,2
../kbl_data/2023-2024,S43G01N235,서울 SK,Home,김선형,3,0,1,0.0,0,2,0.0,0,3,0.0,3,4,75.0,0,0,0,4,0,1,0,0,1,1
../kbl_data/2023-2024,S43G01N235,서울 SK,Home,오세근,6,3,6,50.0,0,2,0.0,3,8,37.5,0,0,0.0,1,2,3,0,3,0,0,0,0,2
../kbl_data/2023-2024,S43G01N235,서울 SK,Home,리온 윌리엄스,4,1,2,50.0,0,1,0.0,1,3,33.3,2,2,100.0,2,1,3,0,0,0,0,0,1,2
../kbl_data/2023-2024,S43G01N235,서울 SK,Home,최원혁,0,0,0,0.0,0,0,0.0,0,0,0.0,0,0,0.0,0,1,1,0,0,0,0,0,1,0
../kbl_data/2023-2024,S43G01N235,서울 SK,Home,안영준,19,0,2,0.0,6,11,54.5,6,13,46.2,1,2,50.0,4,4,8,2,3,1,0,0,3,3
../kbl_data/2023-2024,S43G01N235,서울 SK,Home,자밀 워니,23,9,16,56.2,1,3,33.3,10,19,52.6,2,4,50.0,7,6,13,8,1,2,0,2,1,1
../kbl_data/2023-2024,S43G01N235,서울 SK,Home,김형빈,2,1,2,50.0,0,1,0.0,1,3,33.3,0,0,0.0,0,1,1,0,1,0,0,0,1,3
../kbl_data/2023-2024,S43G01N235,서울 SK,Home,오재현,13,6,10,60.0,0,2,0.0,6,12,50.0,1,1,100.0,2,4,6,9,4,1,0,0,0,3
../kbl_data/2023-2024,S43G01N235,서울 SK,Home,문가온,0,0,0,0.0,0,1,0.0,0,1,0.0,0,0,0.0,0,1,1,0,0,0,0,0,0,0
../kbl_data/2023-2024,S43G01N235,서울 SK,Home,이경도,1,0,0,0.0,0,0,0.0,0,0,0.0,1,2,50.0,0,0,0,0,0,0,0,0,1,0
../kbl_data/2023-2024,S43G01N235,대구 한국가스공사,Away,차바위,2,0,0,0.0,0,2,0.0,0,2,0.0,2,4,50.0,0,4,4,3,0,0,0,0,3,4
../kbl_data/2023-2024,S43G01N235,대구 한국가스공사,Away,박지훈,7,2,3,66.7,1,3,33.3,3,6,50.0,0,0,0.0,0,0,0,1,3,0,0,0,0,2
../kbl_data/2023-2024,S43G01N235,대구 한국가스공사,Away,이대헌,8,2,5,40.0,1,2,50.0,3,7,42.9,1,1,100.0,1,3,4,2,1,0,0,0,1,2
../kbl_data/2023-2024,S43G01N235,대구 한국가스공사,Away,박봉진,0,0,1,0.0,0,2,0.0,0,3,0.0,0,0,0.0,3,0,3,0,1,0,1,0,0,3
../kbl_data/2023-2024,S43G01N235,대구 한국가스공사,Away,양준우,8,1,1,100.0,2,2,100.0,3,3,100.0,0,0,0.0,0,0,0,0,0,0,0,0,1,3
../kbl_data/2023-2024,S43G01N235,대구 한국가스공사,Away,이도헌,0,0,0,0.0,0,0,0.0,0,0,0.0,0,0,0.0,0,0,0,0,0,0,0,0,0,0
../kbl_data/2023-2024,S43G01N235,대구 한국가스공사,Away,앤드류 니콜슨,8,1,4,25.0,2,6,33.3,3,10,30.0,0,0,0.0,1,3,4,0,0,0,0,0,0,0
../kbl_data/2023-2024,S43G01N235,대구 한국가스공사,Away,신승민,9,2,10,20.0,1,6,16.7,3,16,18.8,2,4,50.0,1,1,2,3,2,0,0,0,2,2
../kbl_data/2023-2024,S43G01N235,대구 한국가스공사,Away,샘조세프 벨란겔,3,0,0,0.0,1,1,100.0,1,1,100.0,0,0,0.0,0,0,0,1,0,0,0,0,1,0
../kbl_data/2023-2024,S43G01N235,대구 한국가스공사,Away,안세영,3,1,2,50.0,0,0,0.0,1,2,50.0,1,2,50.0,0,2,2,0,0,0,0,0,1,1
../kbl_data/2023-2024,S43G01N235,대구 한국가스공사,Away,신주영,5,1,2,50.0,1,1,100.0,2,3,66.7,0,0,0.0,2,3,5,3,0,2,0,1,2,2
../kbl_data/2023-2024,S43G01N235,대구 한국가스공사,Away,듀반 맥스웰,14,7,10,70.0,0,0,0.0,7,10,70.0,0,0,0.0,5,6,11,3,4,2,0,1,6,0
../kbl_data/2023-2024,S43G01N236,원주 DB,Home,김현호,0,0,0,0.0,0,0,0.0,0,0,0.0,0,0,0.0,0,1,1,1,0,0,0,0,0,2
../kbl_data/2023-2024,S43G01N236,원주 DB,Home,서민수,8,1,2,50.0,2,2,100.0,3,4,75.0,0,0,0.0,0,0,0,0,0,0,0,0,1,2
../kbl_data/2023-2024,S43G01N236,원주 DB,Home,김영현,7,2,2,100.0,1,4,25.0,3,6,50.0,0,0,0.0,0,0,0,0,1,0,0,0,0,1
../kbl_data/2023-2024,S43G01N236,원주 DB,Home,김종규,4,1,3,33.3,0,0,0.0,1,3,33.3,2,2,100.0,3,4,7,2,0,2,0,1,1,3
../kbl_data/2023-2024,S43G01N236,원주 DB,Home,최승욱,2,1,2,50.0,0,0,0.0,1,2,50.0,0,0,0.0,1,1,2,0,1,0,0,0,0,2
../kbl_data/2023-2024,S43G01N236,원주 DB,Home,강상재,8,1,3,33.3,0,5,0.0,1,8,12.5,6,6,100.0,1,13,14,4,1,1,0,0,5,4
../kbl_data/2023-2024,S43G01N236,원주 DB,Home,유현준,9,2,2,100.0,1,3,33.3,3,5,60.0,2,3,66.7,2,1,3,3,1,0,0,0,2,2
../kbl_data/2023-2024,S43G01N236,원주 DB,Home,디드릭 로슨,47,8,17,47.1,7,14,50.0,15,31,48.4,10,13,76.9,1,7,8,4,4,2,0,1,2,1
../kbl_data/2023-2024,S43G01N236,원주 DB,Home,이선 알바노,6,3,5,60.0,0,4,0.0,3,9,33.3,0,0,0.0,1,3,4,5,1,0,0,0,3,2
../kbl_data/2023-2024,S43G01N236,원주 DB,Home,박인웅,12,0,1,0.0,3,8,37.5,3,9,33.3,3,3,100.0,2,3,5,1,1,0,0,0,0,3
../kbl_data/2023-2024,S43G01N236,원주 DB,Home,박승재,0,0,0,0.0,0,0,0.0,0,0,0.0,0,0,0.0,0,0,0,0,0,0,0,0,0,0
../kbl_data/2023-2024,S43G01N236,원주 DB,Home,제프 위디,4,1,4,25.0,0,0,0.0,1,4,25.0,2,2,100.0,3,1,4,0,0,0,0,0,0,0
../kbl_data/2023-2024,S43G01N236,수원 KT,Away,최창진,0,0,0,0.0,0,1,0.0,0,1,0.0,0,0,0.0,0,0,0,0,0,0,0,0,0,0
../kbl_data/2023-2024,S43G01N236,수원 KT,Away,문성곤,9,1,1,100.0,2,5,40.0,3,6,50.0,1,2,50.0,1,3,4,0,1,0,1,0,1,5
../kbl_data/2023-2024,S43G01N236,수원 KT,Away,이현석,0,0,0,0.0,0,1,0.0,0,1,0.0,0,0,0.0,0,0,0,0,0,0,0,0,0,2
../kbl_data/2023-2024,S43G01N236,수원 KT,Away,정성우,4,2,3,66.7,0,1,0.0,2,4,50.0,0,0,0.0,1,1,2,0,0,0,0,0,1,2
../kbl_data/2023-2024,S43G01N236,수원 KT,Away,최성모,9,1,2,50.0,2,2,100.0,3,4,75.0,1,1,100.0,0,7,7,2,1,1,0,0,1,5
../kbl_data/2023-2024,S43G01N236,수원 KT,Away,허훈,29,4,9,44.4,6,15,40.0,10,24,41.7,3,4,75.0,1,1,2,6,3,0,0,0,4,2
../kbl_data/2023-2024,S43G01N236,수원 KT,Away,김준환,0,0,0,0.0,0,0,0.0,0,0,0.0,0,0,0.0,0,0,0,0,0,0,0,0,0,0
../kbl_data/2023-2024,S43G01N236,수원 KT,Away,하윤기,18,8,18,44.4,0,0,0.0,8,18,44.4,2,4,50.0,3,2,5,3,1,2,0,1,1,3
../kbl_data/2023-2024,S43G01N236,수원 KT,Away,이두원,0,0,0,0.0,0,0,0.0,0,0,0.0,0,0,0.0,0,0,0,0,0,0,0,0,0,0
../kbl_data/2023-2024,S43G01N236,수원 KT,Away,문정현,3,0,1,0.0,1,2,50.0,1,3,33.3,0,0,0.0,0,1,1,0,0,0,0,0,0,3
../kbl_data/2023-2024,S43G01N236,수원 KT,Away,마이클 에릭,2,1,3,33.3,0,0,0.0,1,3,33.3,0,0,0.0,2,0,2,0,0,0,0,0,0,0
../kbl_data/2023-2024,S43G01N236,수원 KT,Away,패리스 배스,29,11,18,61.1,2,7,28.6,13,25,52.0,1,1,100.0,5,13,18,8,0,0,0,1,5,3
../kbl_data/2023-2024,S43G01N237,안양 정관장,Home,정준원,0,0,0,0.0,0,0,0.0,0,0,0.0,0,0,0.0,0,0,0,0,0,0,0,0,0,0
../kbl_data/2023-2024,S43G01N237,안양 정관장,Home,배병준,10,3,5,60.0,1,5,20.0,4,10,40.0,1,2,50.0,0,1,1,2,3,0,0,0,1,2
../kbl_data/2023-2024,S43G01N237,안양 정관장,Home,정효근,5,2,4,50.0,0,4,0.0,2,8,25.0,1,2,50.0,1,0,1,4,1,0,0,0,0,4
../kbl_data/2023-2024,S43G01N237,안양 정관장,Home,이종현,10,4,8,50.0,0,0,0.0,4,8,50.0,2,3,66.7,3,7,10,2,0,8,0,0,3,3
../kbl_data/2023-2024,S43G01N237,안양 정관장,Home,박지훈,9,3,4,75.0,1,6,16.7,4,10,40.0,0,0,0.0,3,6,9,4,4,0,0,0,1,4
../kbl_data/2023-2024,S43G01N237,안양 정관장,Home,최성원,12,1,3,33.3,2,6,33.3,3,9,33.3,4,4,100.0,2,1,3,4,3,0,0,0,1,0
../kbl_data/2023-2024,S43G01N237,안양 정관장,Home,이우정,8,0,1,0.0,2,4,50.0,2,5,40.0,2,2,100.0,0,0,0,0,0,0,0,0,0,1
../kbl_data/2023-2024,S43G01N237,안양 정관장,Home,김경원,4,1,4,25.0,0,0,0.0,1,4,25.0,2,2,100.0,1,0,1,0,4,1,0,0,0,2
../kbl_data/2023-2024,S43G01N237,안양 정관장,Home,고찬혁,0,0,0,0.0,0,0,0.0,0,0,0.0,0,0,0.0,0,0,0,0,0,0,0,0,0,0
../kbl_data/2023-2024,S43G01N237,안양 정관장,Home,나성호,0,0,0,0.0,0,0,0.0,0,0,0.0,0,0,0.0,0,0,0,0,0,0,0,0,0,1
../kbl_data/2023-2024,S43G01N237,안양 정관장,Home,로버트 카터,11,4,11,36.4,1,8,12.5,5,19,26.3,0,0,0.0,2,4,6,3,0,2,0,0,4,3
../kbl_data/2023-2024,S43G01N237,안양 정관장,Home,자밀 윌슨,0,0,0,0.0,0,0,0.0,0,0,0.0,0,0,0.0,0,0,0,0,0,0,0,0,0,0
../kbl_data/2023-2024,S43G01N237,서울 삼성,Away,이정현,16,3,8,37.5,2,7,28.6,5,15,33.3,4,4,100.0,0,8,8,9,1,0,0,0,8,3
../kbl_data/2023-2024,S43G01N237,서울 삼성,Away,홍경기,3,0,1,0.0,1,2,50.0,1,3,33.3,0,0,0.0,0,1,1,1,0,0,0,0,2,3
../kbl_data/2023-2024,S43G01N237,서울 삼성,Away,이동엽,5,1,2,50.0,1,2,50.0,2,4,50.0,0,0,0.0,0,2,2,0,1,0,0,0,1,4
../kbl_data/2023-2024,S43G01N237,서울 삼성,Away,최승욱,2,1,3,33.3,0,0,0.0,1,3,33.3,0,0,0.0,0,0,0,0,1,0,0,0,0,1
../kbl_data/2023-2024,S43G01N237,서울 삼성,Away,윤성원,6,1,1,100.0,1,4,25.0,2,5,40.0,1,1,100.0,0,2,2,0,0,0,0,0,0,1
../kbl_data/2023-2024,S43G01N237,서울 삼성,Away,김한솔,0,0,0,0.0,0,0,0.0,0,0,0.0,0,0,0.0,0,0,0,0,0,0,0,0,0,0
../kbl_data/2023-2024,S43G01N237,서울 삼성,Away,차민석,4,2,2,100.0,0,1,0.0,2,3,66.7,0,0,0.0,2,4,6,3,2,0,0,0,2,1
../kbl_data/2023-2024,S43G01N237,서울 삼성,Away,신동혁,4,2,4,50.0,0,3,0.0,2,7,28.6,0,0,0.0,0,5,5,1,0,0,0,0,1,3
../kbl_data/2023-2024,S43G01N237,서울 삼성,Away,조준희,2,1,1,100.0,0,1,0.0,1,2,50.0,0,0,0.0,0,0,0,0,0,0,0,0,0,1
../kbl_data/2023-2024,S43G01N237,서울 삼성,Away,아반 나바,0,0,0,0.0,0,1,0.0,0,1,0.0,0,0,0.0,0,0,0,0,0,0,0,0,0,0
../kbl_data/2023-2024,S43G01N237,서울 삼성,Away,이스마엘 레인,7,2,7,28.6,0,0,0.0,2,7,28.6,3,3,100.0,5,1,6,0,0,1,0,0,0,0
../kbl_data/2023-2024,S43G01N237,서울 삼성,Away,코피 코번,28,11,17,64.7,0,0,0.0,11,17,64.7,6,9,66.7,7,10,17,1,0,0,0,0,3,1
../kbl_data/2023-2024,S43G01N238,대구 한국가스공사,Home,차바위,6,0,3,0.0,2,2,100.0,2,5,40.0,0,0,0.0,2,2,4,0,2,0,0,0,0,2
../kbl_data/2023-2024,S43G01N238,대구 한국가스공사,Home,박지훈,14,1,3,33.3,4,4,100.0,5,7,71.4,0,0,0.0,0,4,4,2,0,0,0,0,0,2
../kbl_data/2023-2024,S43G01N238,대구 한국가스공사,Home,박봉진,3,0,0,0.0,1,4,25.0,1,4,25.0,0,0,0.0,0,2,2,1,1,0,0,0,0,3
../kbl_data/2023-2024,S43G01N238,대구 한국가스공사,Home,김낙현,7,1,1,100.0,1,7,14.3,2,8,25.0,2,2,100.0,1,1,2,9,2,0,0,0,1,4
../kbl_data/2023-2024,S43G01N238,대구 한국가스공사,Home,양준우,0,0,0,0.0,0,0,0.0,0,0,0.0,0,0,0.0,0,0,0,0,0,0,0,0,0,1
../kbl_data/2023-2024,S43G01N238,대구 한국가스공사,Home,앤드류 니콜슨,32,8,13,61.5,3,4,75.0,11,17,64.7,7,7,100.0,1,2,3,0,0,0,0,1,2,2
../kbl_data/2023-2024,S43G01N238,대구 한국가스공사,Home,신승민,14,3,7,42.9,2,4,50.0,5,11,45.5,2,2,100.0,4,1,5,1,0,1,0,0,0,2
../kbl_data/2023-2024,S43G01N238,대구 한국가스공사,Home,샘조세프 벨란겔,10,5,6,83.3,0,2,0.0,5,8,62.5,0,0,0.0,0,1,1,5,1,0,0,0,0,1
../kbl_data/2023-2024,S43G01N238,대구 한국가스공사,Home,염유성,3,0,0,0.0,1,1,100.0,1,1,100.0,0,0,0.0,0,0,0,0,0,0,0,0,0,0
../kbl_data/2023-2024,S43G01N238,대구 한국가스공사,Home,안세영,0,0,0,0.0,0,0,0.0,0,0,0.0,0,0,0.0,0,0,0,0,0,0,0,0,0,0
../kbl_data/2023-2024,S43G01N238,대구 한국가스공사,Home,신주영,5,1,3,33.3,1,2,50.0,2,5,40.0,0,0,0.0,1,3,4,1,1,0,0,0,2,4
../kbl_data/2023-2024,S43G01N238,대구 한국가스공사,Home,듀반 맥스웰,5,2,4,50.0,0,0,0.0,2,4,50.0,1,4,25.0,2,3,5,0,1,0,0,1,1,4
../kbl_data/2023-2024,S43G01N238,부산 KCC,Away,정창영,10,2,2,100.0,1,3,33.3,3,5,60.0,3,4,75.0,1,1,2,1,1,0,1,0,2,5
../kbl_data/2023-2024,S43G01N238,부산 KCC,Away,라건아,24,8,10,80.0,2,3,66.7,10,13,76.9,2,2,100.0,2,5,7,3,0,0,0,0,3,3
../kbl_data/2023-2024,S43G01N238,부산 KCC,Away,전준범,0,0,1,0.0,0,1,0.0,0,2,0.0,0,0,0.0,1,0,1,0,0,0,0,0,1,1
../kbl_data/2023-2024,S43G01N238,부산 KCC,Away,허웅,15,2,3,66.7,3,8,37.5,5,11,45.5,2,2,100.0,0,1,1,0,0,0,1,0,1,2
../kbl_data/2023-2024,S43G01N238,부산 KCC,Away,이승현,13,5,8,62.5,0,1,0.0,5,9,55.6,3,4,75.0,1,5,6,2,0,1,0,0,2,2
../kbl_data/2023-2024,S43G01N238,부산 KCC,Away,이호현,9,2,4,50.0,1,4,25.0,3,8,37.5,2,4,50.0,0,1,1,5,0,0,0,0,1,2
../kbl_data/2023-2024,S43G01N238,부산 KCC,Away,곽정훈,4,0,0,0.0,0,2,0.0,0,2,0.0,4,4,100.0,0,2,2,0,0,0,1,0,0,1
../kbl_data/2023-2024,S43G01N238,부산 KCC,Away,이근휘,6,0,0,0.0,2,5,40.0,2,5,40.0,0,0,0.0,0,1,1,0,0,0,0,0,0,0
../kbl_data/2023-2024,S43G01N238,부산 KCC,Away,여준형,0,0,0,0.0,0,0,0.0,0,0,0.0,0,0,0.0,0,0,0,0,0,0,0,0,0,0
../kbl_data/2023-2024,S43G01N238,부산 KCC,Away,캘빈 제프리 에피스톨라,2,1,1,100.0,0,1,0.0,1,2,50.0,0,0,0.0,0,0,0,0,0,0,0,0,1,0
../kbl_data/2023-2024,S43G01N238,부산 KCC,Away,이주영,0,0,0,0.0,0,0,0.0,0,0,0.0,0,0,0.0,0,0,0,0,0,0,0,0,0,0
../kbl_data/2023-2024,S43G01N238,부산 KCC,Away,알리제 드숀 존슨,2,0,0,0.0,0,1,0.0,0,1,0.0,2,2,100.0,1,4,5,2,1,0,1,0,2,4
../kbl_data/2023-2024,S43G01N239,고양 소노,Home,김강선,5,0,1,0.0,1,5,20.0,1,6,16.7,2,2,100.0,0,2,2,0,1,0,0,0,1,3
../kbl_data/2023-2024,S43G01N239,고양 소노,Home,함준후,7,2,4,50.0,1,2,50.0,3,6,50.0,0,0,0.0,1,1,2,0,2,1,0,0,0,3
../kbl_data/2023-2024,S43G01N239,고양 소노,Home,김민욱,0,0,3,0.0,0,1,0.0,0,4,0.0,0,0,0.0,1,3,4,0,0,0,0,0,1,1
../kbl_data/2023-2024,S43G01N239,고양 소노,Home,전성현,10,2,2,100.0,2,5,40.0,4,7,57.1,0,0,0.0,1,0,1,0,0,0,0,0,1,0
../kbl_data/2023-2024,S43G01N239,고양 소노,Home,김지후,0,0,0,0.0,0,2,0.0,0,2,0.0,0,0,0.0,2,1,3,0,1,0,0,0,1,2
../kbl_data/2023-2024,S43G01N239,고양 소노,Home,치나누 오누아쿠,9,3,5,60.0,0,1,0.0,3,6,50.0,3,3,100.0,0,11,11,3,1,0,0,1,3,5
../kbl_data/2023-2024,S43G01N239,고양 소노,Home,이진석,0,0,0,0.0,0,0,0.0,0,0,0.0,0,0,0.0,0,0,0,0,0,0,0,0,0,1
../kbl_data/2023-2024,S43G01N239,고양 소노,Home,이정현,26,8,11,72.7,2,10,20.0,10,21,47.6,4,5,80.0,1,0,1,3,5,0,0,0,5,3
../kbl_data/2023-2024,S43G01N239,고양 소노,Home,백지웅,3,0,0,0.0,1,2,50.0,1,2,50.0,0,0,0.0,0,0,0,0,0,0,0,0,0,1
../kbl_data/2023-2024,S43G01N239,고양 소노,Home,조재우,2,1,1,100.0,0,1,0.0,1,2,50.0,0,0,0.0,0,0,0,0,0,0,0,0,1,2
../kbl_data/2023-2024,S43G01N239,고양 소노,Home,민기남,0,0,2,0.0,0,5,0.0,0,7,0.0,0,0,0.0,0,0,0,1,0,0,1,0,0,1
../kbl_data/2023-2024,S43G01N239,고양 소노,Home,알렉스 카바노,2,0,2,0.0,0,0,0.0,0,2,0.0,2,2,100.0,0,0,0,0,1,0,0,0,0,0
../kbl_data/2023-2024,S43G01N239,창원 LG,Away,이관희,13,2,7,28.6,3,4,75.0,5,11,45.5,0,0,0.0,0,4,4,0,1,0,0,0,3,3
../kbl_data/2023-2024,S43G01N239,창원 LG,Away,정희재,5,2,2,100.0,0,1,0.0,2,3,66.7,1,1,100.0,0,1,1,4,0,0,0,0,1,3
../kbl_data/2023-2024,S43G01N239,창원 LG,Away,임동섭,4,2,2,100.0,0,2,0.0,2,4,50.0,0,0,0.0,2,1,3,0,0,0,0,0,0,2
../kbl_data/2023-2024,S43G01N239,창원 LG,Away,이재도,5,0,0,0.0,1,2,50.0,1,2,50.0,2,2,100.0,1,0,1,0,0,1,1,0,1,2
../kbl_data/2023-2024,S43G01N239,창원 LG,Away,정인덕,2,0,0,0.0,0,0,0.0,0,0,0.0,2,2,100.0,0,1,1,0,0,0,0,0,0,0
../kbl_data/2023-2024,S43G01N239,창원 LG,Away,양홍석,12,5,7,71.4,0,0,0.0,5,7,71.4,2,3,66.7,4,4,8,4,0,0,0,0,3,1
../kbl_data/2023-2024,S43G01N239,창원 LG,Away,박정현,4,1,1,100.0,0,0,0.0,1,1,100.0,2,2,100.0,0,2,2,0,0,0,0,0,2,1
../kbl_data/2023-2024,S43G01N239,창원 LG,Away,아셈 마레이,13,5,12,41.7,0,0,0.0,5,12,41.7,3,5,60.0,4,6,10,2,2,0,0,0,3,2
../kbl_data/2023-2024,S43G01N239,창원 LG,Away,저스틴 구탕,8,2,5,40.0,1,1,100.0,3,6,50.0,1,2,50.0,1,3,4,6,4,1,0,0,1,0
../kbl_data/2023-2024,S43G01N239,창원 LG,Away,양준석,4,2,2,100.0,0,2,0.0,2,4,50.0,0,0,0.0,0,4,4,2,0,0,1,0,2,2
../kbl_data/2023-2024,S43G01N239,창원 LG,Away,유기상,17,1,2,50.0,5,6,83.3,6,8,75.0,0,0,0.0,0,1,1,1,1,1,0,0,0,1
../kbl_data/2023-2024,S43G01N239,창원 LG,Away,후안 텔로,8,2,5,40.0,1,2,50.0,3,7,42.9,1,1,100.0,1,5,6,1,1,0,0,0,1,3
../kbl_data/2023-2024,S43G01N240,수원 KT,Home,한희원,9,3,5,60.0,1,7,14.3,4,12,33.3,0,0,0.0,0,1,1,2,1,0,1,0,0,4
../kbl_data/2023-2024,S43G01N240,수원 KT,Home,최창진,0,0,0,0.0,0,0,0.0,0,0,0.0,0,0,0.0,0,0,0,0,0,0,0,0,0,0
../kbl_data/2023-2024,S43G01N240,수원 KT,Home,문성곤,3,0,0,0.0,1,3,33.3,1,3,33.3,0,0,0.0,3,3,6,3,2,0,0,0,1,1
../kbl_data/2023-2024,S43G01N240,수원 KT,Home,이현석,0,0,0,0.0,0,0,0.0,0,0,0.0,0,0,0.0,0,0,0,0,0,0,0,0,0,0
../kbl_data/2023-2024,S43G01N240,수원 KT,Home,정성우,0,0,2,0.0,0,1,0.0,0,3,0.0,0,0,0.0,0,1,1,1,0,0,1,0,1,1
../kbl_data/2023-2024,S43G01N240,수원 KT,Home,최성모,3,0,0,0.0,1,1,100.0,1,1,100.0,0,0,0.0,0,0,0,1,0,0,0,0,0,1
../kbl_data/2023-2024,S43G01N240,수원 KT,Home,허훈,9,1,5,20.0,2,7,28.6,3,12,25.0,1,2,50.0,1,2,3,2,2,0,0,0,1,0
../kbl_data/2023-2024,S43G01N240,수원 KT,Home,하윤기,16,7,11,63.6,0,0,0.0,7,11,63.6,2,2,100.0,1,4,5,2,0,0,0,0,1,3
../kbl_data/2023-2024,S43G01N240,수원 KT,Home,이두원,1,0,3,0.0,0,0,0.0,0,3,0.0,1,4,25.0,1,1,2,0,1,0,0,0,0,2
../kbl_data/2023-2024,S43G01N240,수원 KT,Home,문정현,9,1,2,50.0,1,3,33.3,2,5,40.0,4,5,80.0,0,4,4,2,0,0,0,0,1,3
../kbl_data/2023-2024,S43G01N240,수원 KT,Home,마이클 에릭,10,4,4,100.0,0,0,0.0,4,4,100.0,2,2,100.0,1,1,2,0,1,0,0,0,0,2
../kbl_data/2023-2024,S43G01N240,수원 KT,Home,패리스 배스,29,8,12,66.7,2,6,33.3,10,18,55.6,7,9,77.8,5,11,16,8,3,0,0,2,3,4
../kbl_data/2023-2024,S43G01N240,서울 삼성,Away,이정현,13,3,6,50.0,2,6,33.3,5,12,41.7,1,2,50.0,0,3,3,9,0,1,0,0,5,2
../kbl_data/2023-2024,S43G01N240,서울 삼성,Away,홍경기,8,1,3,33.3,2,5,40.0,3,8,37.5,0,0,0.0,0,0,0,1,0,0,0,0,1,2
../kbl_data/2023-2024,S43G01N240,서울 삼성,Away,이동엽,2,1,2,50.0,0,3,0.0,1,5,20.0,0,0,0.0,0,1,1,5,0,0,0,0,1,1
../kbl_data/2023-2024,S43G01N240,서울 삼성,Away,최승욱,8,4,6,66.7,0,1,0.0,4,7,57.1,0,1,0.0,2,4,6,1,1,1,1,0,1,3
../kbl_data/2023-2024,S43G01N240,서울 삼성,Away,윤성원,11,1,2,50.0,2,6,33.3,3,8,37.5,3,4,75.0,2,2,4,1,0,0,0,0,0,4
../kbl_data/2023-2024,S43G01N240,서울 삼성,Away,김한솔,0,0,0,0.0,0,0,0.0,0,0,0.0,0,0,0.0,0,0,0,0,0,0,0,0,0,0
../kbl_data/2023-2024,S43G01N240,서울 삼성,Away,차민석,0,0,0,0.0,0,0,0.0,0,0,0.0,0,0,0.0,0,2,2,1,0,0,0,0,1,5
../kbl_data/2023-2024,S43G01N240,서울 삼성,Away,신동혁,8,1,3,33.3,2,4,50.0,3,7,42.9,0,0,0.0,1,2,3,2,2,1,0,0,1,2
../kbl_data/2023-2024,S43G01N240,서울 삼성,Away,조준희,0,0,0,0.0,0,0,0.0,0,0,0.0,0,0,0.0,0,0,0,0,0,0,0,0,0,0
../kbl_data/2023-2024,S43G01N240,서울 삼성,Away,아반 나바,0,0,0,0.0,0,0,0.0,0,0,0.0,0,0,0.0,0,0,0,0,0,0,0,0,0,0
../kbl_data/2023-2024,S43G01N240,서울 삼성,Away,이스마엘 레인,10,3,3,100.0,1,2,50.0,4,5,80.0,1,3,33.3,1,4,5,1,1,0,0,1,2,3
../kbl_data/2023-2024,S43G01N240,서울 삼성,Away,코피 코번,24,11,16,68.8,0,0,0.0,11,16,68.8,2,7,28.6,8,9,17,3,2,2,0,2,3,4
../kbl_data/2023-2024,S43G01N241,울산 현대모비스,Home,함지훈,12,3,4,75.0,2,3,66.7,5,7,71.4,0,0,0.0,3,1,4,4,2,0,0,0,1,1
../kbl_data/2023-2024,S43G01N241,울산 현대모비스,Home,김현민,0,0,0,0.0,0,0,0.0,0,0,0.0,0,0,0.0,0,0,0,0,0,0,0,0,0,0
../kbl_data/2023-2024,S43G01N241,울산 현대모비스,Home,김현수,0,0,0,0.0,0,0,0.0,0,0,0.0,0,0,0.0,0,0,0,0,0,0,0,0,0,0
../kbl_data/2023-2024,S43G01N241,울산 현대모비스,Home,장재석,2,1,5,20.0,0,0,0.0,1,5,20.0,0,0,0.0,1,2,3,3,0,0,0,0,1,1
../kbl_data/2023-2024,S43G01N241,울산 현대모비스,Home,김지완,3,0,1,0.0,1,3,33.3,1,4,25.0,0,0,0.0,0,1,1,2,0,0,0,0,0,3
../kbl_data/2023-2024,S43G01N241,울산 현대모비스,Home,김준일,0,0,0,0.0,0,0,0.0,0,0,0.0,0,0,0.0,0,0,0,0,0,0,0,0,0,0
../kbl_data/2023-2024,S43G01N241,울산 현대모비스,Home,김국찬,10,1,2,50.0,2,7,28.6,3,9,33.3,2,2,100.0,1,4,5,3,2,0,0,0,2,4
../kbl_data/2023-2024,S43G01N241,울산 현대모비스,Home,박준은,0,0,0,0.0,0,0,0.0,0,0,0.0,0,0,0.0,0,0,0,0,0,0,0,0,0,0
../kbl_data/2023-2024,S43G01N241,울산 현대모비스,Home,이우석,14,5,13,38.5,1,2,50.0,6,15,40.0,1,4,25.0,1,2,3,7,2,0,0,0,1,1
../kbl_data/2023-2024,S43G01N241,울산 현대모비스,Home,신민석,0,0,0,0.0,0,1,0.0,0,1,0.0,0,0,0.0,0,2,2,0,0,0,0,0,0,3
../kbl_data/2023-2024,S43G01N241,울산 현대모비스,Home,게이지 프림,36,16,23,69.6,0,1,0.0,16,24,66.7,4,5,80.0,2,10,12,5,0,0,0,0,0,3
../kbl_data/2023-2024,S43G01N241,울산 현대모비스,Home,박무빈,18,2,3,66.7,4,6,66.7,6,9,66.7,2,4,50.0,2,2,4,5,0,0,1,0,2,2
../kbl_data/2023-2024,S43G01N241,원주 DB,Away,김현호,0,0,1,0.0,0,0,0.0,0,1,0.0,0,0,0.0,0,0,0,0,0,0,0,0,1,1
../kbl_data/2023-2024,S43G01N241,원주 DB,Away,김영현,9,0,0,0.0,3,5,60.0,3,5,60.0,0,0,0.0,1,0,1,1,2,0,0,0,2,4
../kbl_data/2023-2024,S43G01N241,원주 DB,Away,김종규,0,0,0,0.0,0,1,0.0,0,1,0.0,0,0,0.0,0,0,0,1,0,0,0,0,0,1
../kbl_data/2023-2024,S43G01N241,원주 DB,Away,최승욱,7,2,3,66.7,1,1,100.0,3,4,75.0,0,0,0.0,1,1,2,1,0,0,0,0,0,0
../kbl_data/2023-2024,S43G01N241,원주 DB,Away,강상재,7,3,5,60.0,0,0,0.0,3,5,60.0,1,2,50.0,1,5,6,2,0,2,0,0,3,3
../kbl_data/2023-2024,S43G01N241,원주 DB,Away,유현준,7,1,1,100.0,1,3,33.3,2,4,50.0,2,2,100.0,0,0,0,10,0,0,0,0,0,1
../kbl_data/2023-2024,S43G01N241,원주 DB,Away,이윤수,0,0,1,0.0,0,0,0.0,0,1,0.0,0,0,0.0,0,0,0,0,0,0,0,0,0,3
../kbl_data/2023-2024,S43G01N241,원주 DB,Away,디드릭 로슨,14,4,5,80.0,2,9,22.2,6,14,42.9,0,0,0.0,3,6,9,2,1,1,0,0,3,2
../kbl_data/2023-2024,S43G01N241,원주 DB,Away,이선 알바노,13,3,7,42.9,2,4,50.0,5,11,45.5,1,2,50.0,0,2,2,8,0,0,0,0,2,3
../kbl_data/2023-2024,S43G01N241,원주 DB,Away,박인웅,9,4,7,57.1,0,4,0.0,4,11,36.4,1,1,100.0,2,2,4,0,0,0,0,0,0,2
../kbl_data/2023-2024,S43G01N241,원주 DB,Away,박승재,0,0,0,0.0,0,0,0.0,0,0,0.0,0,0,0.0,0,0,0,0,0,0,0,0,0,0
../kbl_data/2023-2024,S43G01N241,원주 DB,Away,제프 위디,23,8,13,61.5,2,2,100.0,10,15,66.7,1,3,33.3,1,7,8,0,1,1,0,2,0,1
../kbl_data/2023-2024,S43G01N242,안양 정관장,Home,정준원,0,0,0,0.0,0,0,0.0,0,0,0.0,0,0,0.0,0,0,0,0,0,0,0,0,0,1
../kbl_data/2023-2024,S43G01N242,안양 정관장,Home,배병준,16,4,8,50.0,2,6,33.3,6,14,42.9,2,2,100.0,0,5,5,4,1,1,0,0,0,2
../kbl_data/2023-2024,S43G01N242,안양 정관장,Home,정효근,5,0,2,0.0,1,2,50.0,1,4,25.0,2,2,100.0,0,2,2,0,0,0,0,0,0,0
../kbl_data/2023-2024,S43G01N242,안양 정관장,Home,이종현,8,3,3,100.0,0,1,0.0,3,4,75.0,2,2,100.0,0,10,10,2,1,1,0,1,2,3
../kbl_data/2023-2024,S43G01N242,안양 정관장,Home,박지훈,10,4,6,66.7,0,4,0.0,4,10,40.0,2,2,100.0,1,2,3,4,1,0,0,0,2,2
../kbl_data/2023-2024,S43G01N242,안양 정관장,Home,최성원,27,4,6,66.7,6,6,100.0,10,12,83.3,1,2,50.0,1,1,2,2,2,0,1,0,3,3
../kbl_data/2023-2024,S43G01N242,안양 정관장,Home,이우정,3,0,0,0.0,1,2,50.0,1,2,50.0,0,0,0.0,0,2,2,1,0,0,0,0,1,1
../kbl_data/2023-2024,S43G01N242,안양 정관장,Home,김경원,2,1,2,50.0,0,0,0.0,1,2,50.0,0,0,0.0,2,0,2,0,0,0,0,0,0,0
../kbl_data/2023-2024,S43G01N242,안양 정관장,Home,고찬혁,0,0,0,0.0,0,0,0.0,0,0,0.0,0,0,0.0,0,0,0,0,0,0,0,0,0,0
../kbl_data/2023-2024,S43G01N242,안양 정관장,Home,나성호,0,0,0,0.0,0,0,0.0,0,0,0.0,0,0,0.0,0,0,0,0,0,0,0,0,0,0
../kbl_data/2023-2024,S43G01N242,안양 정관장,Home,로버트 카터,13,5,8,62.5,1,11,9.1,6,19,31.6,0,0,0.0,0,10,10,9,1,2,0,0,4,3
../kbl_data/2023-2024,S43G01N242,안양 정관장,Home,자밀 윌슨,0,0,0,0.0,0,0,0.0,0,0,0.0,0,0,0.0,0,0,0,0,0,0,0,0,0,0
../kbl_data/2023-2024,S43G01N242,서울 SK,Away,양우섭,10,2,6,33.3,2,2,100.0,4,8,50.0,0,0,0.0,0,1,1,1,0,1,0,0,0,1
../kbl_data/2023-2024,S43G01N242,서울 SK,Away,허일영,0,0,1,0.0,0,1,0.0,0,2,0.0,0,0,0.0,3,1,4,1,1,0,0,0,0,4
../kbl_data/2023-2024,S43G01N242,서울 SK,Away,오세근,6,3,7,42.9,0,2,0.0,3,9,33.3,0,0,0.0,0,4,4,2,1,1,0,0,0,2
../kbl_data/2023-2024,S43G01N242,서울 SK,Away,리온 윌리엄스,0,0,3,0.0,0,0,0.0,0,3,0.0,0,0,0.0,1,0,1,0,1,0,0,0,1,2
../kbl_data/2023-2024,S43G01N242,서울 SK,Away,최원혁,3,0,0,0.0,1,2,50.0,1,2,50.0,0,0,0.0,0,0,0,1,0,0,0,0,1,3
../kbl_data/2023-2024,S43G01N242,서울 SK,Away,안영준,15,3,4,75.0,3,6,50.0,6,10,60.0,0,2,0.0,1,3,4,3,2,1,0,0,3,4
../kbl_data/2023-2024,S43G01N242,서울 SK,Away,자밀 워니,33,12,22,54.5,1,6,16.7,13,28,46.4,6,9,66.7,6,11,17,6,1,1,0,3,3,1
../kbl_data/2023-2024,S43G01N242,서울 SK,Away,전성환,0,0,0,0.0,0,0,0.0,0,0,0.0,0,0,0.0,0,0,0,0,0,0,0,0,0,0
../kbl_data/2023-2024,S43G01N242,서울 SK,Away,김형빈,9,3,5,60.0,1,2,50.0,4,7,57.1,0,0,0.0,1,3,4,2,0,0,1,0,0,1
../kbl_data/2023-2024,S43G01N242,서울 SK,Away,오재현,2,1,5,20.0,0,3,0.0,1,8,12.5,0,0,0.0,0,5,5,3,0,0,0,0,1,0
../kbl_data/2023-2024,S43G01N242,서울 SK,Away,문가온,0,0,0,0.0,0,0,0.0,0,0,0.0,0,0,0.0,0,0,0,0,0,0,0,0,0,0
../kbl_data/2023-2024,S43G01N242,서울 SK,Away,이경도,0,0,0,0.0,0,0,0.0,0,0,0.0,0,0,0.0,0,0,0,0,0,0,0,0,0,0
../kbl_data/2023-2024,S43G01N243,대구 한국가스공사,Home,차바위,5,1,1,100.0,1,2,50.0,2,3,66.7,0,0,0.0,2,1,3,3,0,0,0,0,2,1
../kbl_data/2023-2024,S43G01N243,대구 한국가스공사,Home,박지훈,0,0,0,0.0,0,0,0.0,0,0,0.0,0,0,0.0,0,2,2,1,0,1,0,0,0,5
../kbl_data/2023-2024,S43G01N243,대구 한국가스공사,Home,박봉진,0,0,0,0.0,0,0,0.0,0,0,0.0,0,0,0.0,0,0,0,0,0,0,0,0,0,1
../kbl_data/2023-2024,S43G01N243,대구 한국가스공사,Home,김낙현,13,1,2,50.0,3,6,50.0,4,8,50.0,2,3,66.7,1,0,1,1,1,0,0,0,2,1
../kbl_data/2023-2024,S43G01N243,대구 한국가스공사,Home,양준우,0,0,0,0.0,0,0,0.0,0,0,0.0,0,0,0.0,0,0,0,0,0,0,0,0,0,0
../kbl_data/2023-2024,S43G01N243,대구 한국가스공사,Home,앤드류 니콜슨,36,10,14,71.4,4,7,57.1,14,21,66.7,4,6,66.7,2,7,9,0,2,0,1,1,3,1
../kbl_data/2023-2024,S43G01N243,대구 한국가스공사,Home,신승민,11,1,1,100.0,3,3,100.0,4,4,100.0,0,2,0.0,0,4,4,1,0,0,0,0,1,4
../kbl_data/2023-2024,S43G01N243,대구 한국가스공사,Home,샘조세프 벨란겔,6,2,9,22.2,0,4,0.0,2,13,15.4,2,2,100.0,1,0,1,6,1,0,1,0,0,3
../kbl_data/2023-2024,S43G01N243,대구 한국가스공사,Home,염유성,0,0,0,0.0,0,0,0.0,0,0,0.0,0,0,0.0,0,0,0,0,0,0,0,0,0,0
../kbl_data/2023-2024,S43G01N243,대구 한국가스공사,Home,안세영,0,0,0,0.0,0,0,0.0,0,0,0.0,0,0,0.0,0,0,0,0,0,0,0,0,0,0
../kbl_data/2023-2024,S43G01N243,대구 한국가스공사,Home,신주영,8,1,2,50.0,2,4,50.0,3,6,50.0,0,0,0.0,2,3,5,3,1,2,0,0,1,5
../kbl_data/2023-2024,S43G01N243,대구 한국가스공사,Home,듀반 맥스웰,2,1,1,100.0,0,0,0.0,1,1,100.0,0,0,0.0,0,0,0,1,0,2,0,0,2,3
../kbl_data/2023-2024,S43G01N243,고양 소노,Away,김강선,0,0,0,0.0,0,0,0.0,0,0,0.0,0,0,0.0,0,0,0,0,0,0,0,0,0,0
../kbl_data/2023-2024,S43G01N243,고양 소노,Away,함준후,7,2,3,66.7,1,6,16.7,3,9,33.3,0,0,0.0,0,1,1,0,1,0,0,0,0,3
../kbl_data/2023-2024,S43G01N243,고양 소노,Away,김민욱,10,1,3,33.3,2,4,50.0,3,7,42.9,2,2,100.0,2,1,3,2,0,0,1,0,0,4
../kbl_data/2023-2024,S43G01N243,고양 소노,Away,김지후,2,1,1,100.0,0,3,0.0,1,4,25.0,0,0,0.0,1,2,3,0,0,0,0,0,0,3
../kbl_data/2023-2024,S43G01N243,고양 소노,Away,김진용,0,0,1,0.0,0,0,0.0,0,1,0.0,0,0,0.0,0,0,0,0,1,0,0,0,1,1
../kbl_data/2023-2024,S43G01N243,고양 소노,Away,치나누 오누아쿠,17,7,9,77.8,0,0,0.0,7,9,77.8,3,3,100.0,2,10,12,4,0,2,1,0,1,1
../kbl_data/2023-2024,S43G01N243,고양 소노,Away,이진석,0,0,0,0.0,0,0,0.0,0,0,0.0,0,0,0.0,1,0,1,0,0,0,0,0,0,1
../kbl_data/2023-2024,S43G01N243,고양 소노,Away,이정현,35,7,9,77.8,4,11,36.4,11,20,55.0,9,9,100.0,0,2,2,4,3,0,1,0,3,2
../kbl_data/2023-2024,S43G01N243,고양 소노,Away,백지웅,0,0,0,0.0,0,1,0.0,0,1,0.0,0,0,0.0,1,0,1,0,0,0,0,0,0,1
../kbl_data/2023-2024,S43G01N243,고양 소노,Away,조재우,6,3,5,60.0,0,1,0.0,3,6,50.0,0,0,0.0,2,0,2,1,0,0,0,0,2,4
../kbl_data/2023-2024,S43G01N243,고양 소노,Away,민기남,5,1,1,100.0,1,3,33.3,2,4,50.0,0,0,0.0,0,0,0,2,0,0,0,0,0,1
../kbl_data/2023-2024,S43G01N243,고양 소노,Away,알렉스 카바노,0,0,0,0.0,0,0,0.0,0,0,0.0,0,0,0.0,0,0,0,0,0,0,0,0,0,0
../kbl_data/2023-2024,S43G01N244,부산 KCC,Home,정창영,18,3,5,60.0,4,4,100.0,7,9,77.8,0,0,0.0,0,1,1,1,0,0,0,0,2,2
../kbl_data/2023-2024,S43G01N244,부산 KCC,Home,라건아,5,1,2,50.0,1,1,100.0,2,3,66.7,0,0,0.0,0,0,0,0,0,0,0,0,0,1
../kbl_data/2023-2024,S43G01N244,부산 KCC,Home,전준범,0,0,0,0.0,0,2,0.0,0,2,0.0,0,0,0.0,0,0,0,0,0,0,0,0,0,1
../kbl_data/2023-2024,S43G01N244,부산 KCC,Home,허웅,21,4,6,66.7,3,12,25.0,7,18,38.9,4,5,80.0,0,1,1,5,0,0,0,0,0,0
../kbl_data/2023-2024,S43G01N244,부산 KCC,Home,이승현,14,5,7,71.4,1,2,50.0,6,9,66.7,1,1,100.0,3,8,11,2,0,1,1,0,1,3
../kbl_data/2023-2024,S43G01N244,부산 KCC,Home,이호현,11,4,8,50.0,1,6,16.7,5,14,35.7,0,0,0.0,0,5,5,10,1,0,0,0,1,3
../kbl_data/2023-2024,S43G01N244,부산 KCC,Home,곽정훈,2,0,0,0.0,0,2,0.0,0,2,0.0,2,2,100.0,0,1,1,0,0,0,0,0,0,0
../kbl_data/2023-2024,S43G01N244,부산 KCC,Home,이근휘,8,1,1,100.0,2,3,66.7,3,4,75.0,0,0,0.0,3,2,5,2,0,0,0,0,0,3
../kbl_data/2023-2024,S43G01N244,부산 KCC,Home,여준형,0,0,0,0.0,0,0,0.0,0,0,0.0,0,0,0.0,1,1,2,0,0,0,0,0,0,2
../kbl_data/2023-2024,S43G01N244,부산 KCC,Home,캘빈 제프리 에피스톨라,0,0,0,0.0,0,0,0.0,0,0,0.0,0,0,0.0,0,1,1,1,1,0,0,0,2,0
../kbl_data/2023-2024,S43G01N244,부산 KCC,Home,이주영,3,0,0,0.0,1,1,100.0,1,1,100.0,0,0,0.0,0,0,0,0,0,0,0,0,0,0
../kbl_data/2023-2024,S43G01N244,부산 KCC,Home,알리제 드숀 존슨,37,11,16,68.8,1,6,16.7,12,22,54.5,12,16,75.0,5,10,15,7,3,0,0,0,2,3
../kbl_data/2023-2024,S43G01N244,수원 KT,Away,한희원,4,2,5,40.0,0,1,0.0,2,6,33.3,0,0,0.0,0,0,0,1,1,0,0,0,2,2
../kbl_data/2023-2024,S43G01N244,수원 KT,Away,최창진,8,1,2,50.0,2,3,66.7,3,5,60.0,0,0,0.0,0,1,1,3,1,0,0,0,2,2
../kbl_data/2023-2024,S43G01N244,수원 KT,Away,문성곤,2,0,0,0.0,0,1,0.0,0,1,0.0,2,2,100.0,0,2,2,0,0,0,0,0,0,1
../kbl_data/2023-2024,S43G01N244,수원 KT,Away,이현석,0,0,0,0.0,0,3,0.0,0,3,0.0,0,0,0.0,0,3,3,0,0,0,0,0,0,0
../kbl_data/2023-2024,S43G01N244,수원 KT,Away,정성우,0,0,0,0.0,0,3,0.0,0,3,0.0,0,0,0.0,0,1,1,3,0,0,0,0,1,3
../kbl_data/2023-2024,S43G01N244,수원 KT,Away,최성모,11,4,6,66.7,1,4,25.0,5,10,50.0,0,0,0.0,1,2,3,1,2,1,0,0,0,1
../kbl_data/2023-2024,S43G01N244,수원 KT,Away,허훈,7,0,1,0.0,2,3,66.7,2,4,50.0,1,2,50.0,0,0,0,3,0,0,0,0,3,1
../kbl_data/2023-2024,S43G01N244,수원 KT,Away,하윤기,13,5,6,83.3,0,0,0.0,5,6,83.3,3,4,75.0,3,0,3,3,0,0,0,2,1,4
../kbl_data/2023-2024,S43G01N244,수원 KT,Away,이두원,12,5,7,71.4,0,1,0.0,5,8,62.5,2,4,50.0,3,4,7,0,1,0,0,2,0,2
../kbl_data/2023-2024,S43G01N244,수원 KT,Away,문정현,9,2,3,66.7,1,2,50.0,3,5,60.0,2,2,100.0,1,1,2,1,0,0,0,0,0,3
../kbl_data/2023-2024,S43G01N244,수원 KT,Away,마이클 에릭,4,2,2,100.0,0,0,0.0,2,2,100.0,0,0,0.0,1,2,3,2,0,0,0,1,0,1
../kbl_data/2023-2024,S43G01N244,수원 KT,Away,패리스 배스,31,10,19,52.6,3,6,50.0,13,25,52.0,2,5,40.0,2,11,13,7,1,0,0,1,3,3
../kbl_data/2023-2024,S43G01N245,창원 LG,Home,이관희,13,2,4,50.0,2,4,50.0,4,8,50.0,3,3,100.0,0,0,0,0,0,0,0,0,0,1
../kbl_data/2023-2024,S43G01N245,창원 LG,Home,정희재,5,0,0,0.0,1,5,20.0,1,5,20.0,2,2,100.0,0,0,0,1,0,0,0,0,2,3
../kbl_data/2023-2024,S43G01N245,창원 LG,Home,임동섭,0,0,0,0.0,0,0,0.0,0,0,0.0,0,0,0.0,0,0,0,0,0,0,0,0,0,0
../kbl_data/2023-2024,S43G01N245,창원 LG,Home,이재도,10,3,8,37.5,1,4,25.0,4,12,33.3,1,2,50.0,0,6,6,4,3,0,0,0,4,2
../kbl_data/2023-2024,S43G01N245,창원 LG,Home,정인덕,2,1,2,50.0,0,1,0.0,1,3,33.3,0,0,0.0,0,3,3,1,0,0,0,0,0,4
../kbl_data/2023-2024,S43G01N245,창원 LG,Home,양홍석,2,1,6,16.7,0,0,0.0,1,6,16.7,0,0,0.0,1,3,4,1,3,0,0,0,1,0
../kbl_data/2023-2024,S43G01N245,창원 LG,Home,박정현,0,0,0,0.0,0,0,0.0,0,0,0.0,0,0,0.0,0,0,0,0,0,0,0,0,0,0
../kbl_data/2023-2024,S43G01N245,창원 LG,Home,아셈 마레이,29,13,17,76.5,0,0,0.0,13,17,76.5,3,5,60.0,12,7,19,4,2,0,0,2,2,2
../kbl_data/2023-2024,S43G01N245,창원 LG,Home,저스틴 구탕,17,7,11,63.6,1,2,50.0,8,13,61.5,0,0,0.0,0,3,3,5,0,1,0,1,1,1
../kbl_data/2023-2024,S43G01N245,창원 LG,Home,양준석,4,1,2,50.0,0,0,0.0,1,2,50.0,2,2,100.0,0,1,1,2,1,0,0,0,1,1
../kbl_data/2023-2024,S43G01N245,창원 LG,Home,유기상,10,0,1,0.0,3,6,50.0,3,7,42.9,1,2,50.0,0,3,3,1,1,0,0,0,1,3
../kbl_data/2023-2024,S43G01N245,창원 LG,Home,후안 텔로,0,0,3,0.0,0,0,0.0,0,3,0.0,0,0,0.0,1,1,2,2,0,1,0,0,0,1
../kbl_data/2023-2024,S43G01N245,원주 DB,Away,김현호,0,0,0,0.0,0,0,0.0,0,0,0.0,0,0,0.0,0,0,0,0,0,0,0,0,0,0
../kbl_data/2023-2024,S43G01N245,원주 DB,Away,김영현,8,1,3,33.3,2,5,40.0,3,8,37.5,0,0,0.0,0,1,1,2,0,0,0,0,1,3
../kbl_data/2023-2024,S43G01N245,원주 DB,Away,최승욱,8,4,5,80.0,0,1,0.0,4,6,66.7,0,0,0.0,1,5,6,2,0,0,0,0,0,1
../kbl_data/2023-2024,S43G01N245,원주 DB,Away,강상재,12,3,6,50.0,2,3,66.7,5,9,55.6,0,0,0.0,0,2,2,5,2,0,1,0,6,4
../kbl_data/2023-2024,S43G01N245,원주 DB,Away,유현준,2,1,1,100.0,0,1,0.0,1,2,50.0,0,1,0.0,0,0,0,2,0,1,0,0,1,1
../kbl_data/2023-2024,S43G01N245,원주 DB,Away,이윤수,0,0,0,0.0,0,0,0.0,0,0,0.0,0,0,0.0,0,0,0,0,0,0,0,0,0,0
../kbl_data/2023-2024,S43G01N245,원주 DB,Away,디드릭 로슨,20,8,11,72.7,1,5,20.0,9,16,56.2,1,1,100.0,1,7,8,2,1,2,0,1,0,3
../kbl_data/2023-2024,S43G01N245,원주 DB,Away,이선 알바노,17,3,7,42.9,3,8,37.5,6,15,40.0,2,2,100.0,2,4,6,1,3,0,0,0,2,1
../kbl_data/2023-2024,S43G01N245,원주 DB,Away,박인웅,15,5,5,100.0,1,4,25.0,6,9,66.7,2,2,100.0,1,3,4,2,0,0,0,0,1,4
../kbl_data/2023-2024,S43G01N245,원주 DB,Away,인승찬,0,0,0,0.0,0,0,0.0,0,0,0.0,0,0,0.0,0,0,0,0,0,0,0,0,0,0
../kbl_data/2023-2024,S43G01N245,원주 DB,Away,박승재,0,0,0,0.0,0,0,0.0,0,0,0.0,0,0,0.0,0,0,0,0,0,0,0,0,0,0
../kbl_data/2023-2024,S43G01N245,원주 DB,Away,제프 위디,6,2,3,66.7,0,1,0.0,2,4,50.0,2,2,100.0,1,2,3,0,1,2,0,0,1,1
../kbl_data/2023-2024,S43G01N246,서울 삼성,Home,이정현,26,7,15,46.7,3,8,37.5,10,23,43.5,3,7,42.9,0,3,3,7,0,0,0,0,3,3
../kbl_data/2023-2024,S43G01N246,서울 삼성,Home,홍경기,12,3,4,75.0,2,8,25.0,5,12,41.7,0,0,0.0,3,2,5,3,1,0,0,0,0,3
../kbl_data/2023-2024,S43G01N246,서울 삼성,Home,김승원,0,0,0,0.0,0,0,0.0,0,0,0.0,0,0,0.0,0,0,0,0,0,0,0,0,1,0
../kbl_data/2023-2024,S43G01N246,서울 삼성,Home,이동엽,3,1,5,20.0,0,2,0.0,1,7,14.3,1,2,50.0,1,3,4,4,1,0,1,0,0,2
../kbl_data/2023-2024,S43G01N246,서울 삼성,Home,최승욱,3,0,3,0.0,1,4,25.0,1,7,14.3,0,0,0.0,4,4,8,0,1,1,1,0,0,5
../kbl_data/2023-2024,S43G01N246,서울 삼성,Home,윤성원,1,0,0,0.0,0,1,0.0,0,1,0.0,1,2,50.0,1,0,1,0,0,0,0,0,1,4
../kbl_data/2023-2024,S43G01N246,서울 삼성,Home,차민석,11,5,8,62.5,0,2,0.0,5,10,50.0,1,3,33.3,2,3,5,1,0,0,0,0,2,4
../kbl_data/2023-2024,S43G01N246,서울 삼성,Home,신동혁,3,0,1,0.0,1,2,50.0,1,3,33.3,0,0,0.0,0,0,0,0,0,0,0,0,0,1
../kbl_data/2023-2024,S43G01N246,서울 삼성,Home,조준희,0,0,0,0.0,0,0,0.0,0,0,0.0,0,0,0.0,0,0,0,0,0,0,0,0,0,0
../kbl_data/2023-2024,S43G01N246,서울 삼성,Home,아반 나바,0,0,0,0.0,0,0,0.0,0,0,0.0,0,0,0.0,0,0,0,0,0,0,0,0,0,0
../kbl_data/2023-2024,S43G01N246,서울 삼성,Home,이스마엘 레인,0,0,0,0.0,0,1,0.0,0,1,0.0,0,2,0.0,1,1,2,0,0,0,0,0,0,1
../kbl_data/2023-2024,S43G01N246,서울 삼성,Home,코피 코번,35,17,26,65.4,0,0,0.0,17,26,65.4,1,4,25.0,7,9,16,4,1,2,0,2,2,1
../kbl_data/2023-2024,S43G01N246,울산 현대모비스,Away,함지훈,10,3,4,75.0,1,1,100.0,4,5,80.0,1,2,50.0,1,3,4,1,0,1,0,0,1,1
../kbl_data/2023-2024,S43G01N246,울산 현대모비스,Away,김현민,0,0,0,0.0,0,0,0.0,0,0,0.0,0,0,0.0,0,0,0,0,0,0,0,0,0,0
../kbl_data/2023-2024,S43G01N246,울산 현대모비스,Away,김현수,0,0,0,0.0,0,0,0.0,0,0,0.0,0,0,0.0,0,0,0,0,0,0,0,0,0,0
../kbl_data/2023-2024,S43G01N246,울산 현대모비스,Away,장재석,8,4,7,57.1,0,0,0.0,4,7,57.1,0,2,0.0,1,4,5,0,1,1,0,0,1,3
../kbl_data/2023-2024,S43G01N246,울산 현대모비스,Away,김지완,9,3,3,100.0,1,4,25.0,4,7,57.1,0,0,0.0,1,0,1,3,1,0,0,0,1,2
../kbl_data/2023-2024,S43G01N246,울산 현대모비스,Away,김준일,5,1,1,100.0,0,0,0.0,1,1,100.0,3,4,75.0,1,1,2,1,0,0,0,0,1,4
../kbl_data/2023-2024,S43G01N246,울산 현대모비스,Away,김국찬,13,1,2,50.0,3,6,50.0,4,8,50.0,2,2,100.0,0,2,2,1,1,1,0,0,2,5
../kbl_data/2023-2024,S43G01N246,울산 현대모비스,Away,박준은,0,0,0,0.0,0,0,0.0,0,0,0.0,0,0,0.0,0,1,1,0,0,0,0,0,0,1
../kbl_data/2023-2024,S43G01N246,울산 현대모비스,Away,이우석,8,4,8,50.0,0,2,0.0,4,10,40.0,0,2,0.0,3,9,12,8,2,0,0,0,1,2
../kbl_data/2023-2024,S43G01N246,울산 현대모비스,Away,신민석,0,0,0,0.0,0,1,0.0,0,1,0.0,0,0,0.0,0,0,0,2,0,0,0,0,2,1
../kbl_data/2023-2024,S43G01N246,울산 현대모비스,Away,게이지 프림,29,8,24,33.3,0,1,0.0,8,25,32.0,13,14,92.9,5,9,14,1,1,2,0,0,0,5
../kbl_data/2023-2024,S43G01N246,울산 현대모비스,Away,박무빈,9,3,6,50.0,1,5,20.0,4,11,36.4,0,0,0.0,1,4,5,5,0,0,0,0,2,2
../kbl_data/2023-2024,S43G01N247,창원 LG,Home,이관희,8,1,4,25.0,2,7,28.6,3,11,27.3,0,0,0.0,0,1,1,1,0,0,0,0,0,1
../kbl_data/2023-2024,S43G01N247,창원 LG,Home,정희재,9,0,0,0.0,3,6,50.0,3,6,50.0,0,0,0.0,1,4,5,3,1,0,1,0,1,5
../kbl_data/2023-2024,S43G01N247,창원 LG,Home,임동섭,3,0,0,0.0,1,1,100.0,1,1,100.0,0,0,0.0,0,0,0,0,0,0,0,0,0,1
../kbl_data/2023-2024,S43G01N247,창원 LG,Home,이재도,12,3,8,37.5,2,4,50.0,5,12,41.7,0,0,0.0,2,4,6,8,2,1,0,0,4,1
../kbl_data/2023-2024,S43G01N247,창원 LG,Home,정인덕,8,0,0,0.0,2,2,100.0,2,2,100.0,2,2,100.0,0,0,0,0,0,0,0,0,0,0
../kbl_data/2023-2024,S43G01N247,창원 LG,Home,양홍석,13,1,2,50.0,3,5,60.0,4,7,57.1,2,2,100.0,4,4,8,2,0,0,0,0,1,1
../kbl_data/2023-2024,S43G01N247,창원 LG,Home,박정현,0,0,0,0.0,0,0,0.0,0,0,0.0,0,0,0.0,0,0,0,0,0,0,0,0,0,0
../kbl_data/2023-2024,S43G01N247,창원 LG,Home,아셈 마레이,17,7,14,50.0,0,0,0.0,7,14,50.0,3,9,33.3,6,9,15,6,1,1,0,0,0,1
../kbl_data/2023-2024,S43G01N247,창원 LG,Home,저스틴 구탕,6,0,1,0.0,2,4,50.0,2,5,40.0,0,0,0.0,2,1,3,2,0,0,0,0,1,2
../kbl_data/2023-2024,S43G01N247,창원 LG,Home,양준석,2,1,3,33.3,0,2,0.0,1,5,20.0,0,0,0.0,0,0,0,2,0,0,0,0,2,1
../kbl_data/2023-2024,S43G01N247,창원 LG,Home,유기상,14,1,3,33.3,2,6,33.3,3,9,33.3,6,7,85.7,6,1,7,0,1,0,0,0,0,3
../kbl_data/2023-2024,S43G01N247,창원 LG,Home,후안 텔로,2,1,4,25.0,0,0,0.0,1,4,25.0,0,0,0.0,1,4,5,1,1,0,0,0,2,0
../kbl_data/2023-2024,S43G01N247,안양 정관장,Away,정준원,2,1,2,50.0,0,1,0.0,1,3,33.3,0,0,0.0,0,1,1,0,0,0,0,0,0,0
../kbl_data/2023-2024,S43G01N247,안양 정관장,Away,배병준,15,2,4,50.0,3,4,75.0,5,8,62.5,2,2,100.0,0,1,1,0,0,0,0,0,1,1
../kbl_data/2023-2024,S43G01N247,안양 정관장,Away,정효근,2,1,1,100.0,0,1,0.0,1,2,50.0,0,0,0.0,1,1,2,1,0,0,0,0,0,2
../kbl_data/2023-2024,S43G01N247,안양 정관장,Away,이종현,6,0,1,0.0,2,3,66.7,2,4,50.0,0,0,0.0,0,4,4,0,2,2,0,0,2,2
../kbl_data/2023-2024,S43G01N247,안양 정관장,Away,박지훈,11,4,6,66.7,1,4,25.0,5,10,50.0,0,0,0.0,1,2,3,5,3,0,0,0,3,2
../kbl_data/2023-2024,S43G01N247,안양 정관장,Away,최성원,9,2,5,40.0,1,4,25.0,3,9,33.3,2,3,66.7,0,1,1,1,1,0,0,0,1,1
../kbl_data/2023-2024,S43G01N247,안양 정관장,Away,이우정,6,0,1,0.0,1,2,50.0,1,3,33.3,3,4,75.0,0,4,4,1,1,0,0,0,2,2
../kbl_data/2023-2024,S43G01N247,안양 정관장,Away,김경원,4,0,1,0.0,0,0,0.0,0,1,0.0,4,4,100.0,0,0,0,0,1,0,0,0,0,2
../kbl_data/2023-2024,S43G01N247,안양 정관장,Away,고찬혁,0,0,0,0.0,0,1,0.0,0,1,0.0,0,0,0.0,0,1,1,1,0,0,0,0,1,0
../kbl_data/2023-2024,S43G01N247,안양 정관장,Away,나성호,0,0,0,0.0,0,0,0.0,0,0,0.0,0,0,0.0,1,0,1,0,0,0,0,0,0,2
../kbl_data/2023-2024,S43G01N247,안양 정관장,Away,로버트 카터,6,3,7,42.9,0,2,0.0,3,9,33.3,0,0,0.0,1,2,3,2,0,0,0,0,2,4
../kbl_data/2023-2024,S43G01N247,안양 정관장,Away,자밀 윌슨,9,4,5,80.0,0,2,0.0,4,7,57.1,1,1,100.0,0,4,4,1,0,2,0,0,0,1
../kbl_data/2023-2024,S43G01N248,서울 SK,Home,양우섭,3,0,1,0.0,1,2,50.0,1,3,33.3,0,0,0.0,0,1,1,0,1,0,0,0,0,1
../kbl_data/2023-2024,S43G01N248,서울 SK,Home,허일영,4,2,4,50.0,0,1,0.0,2,5,40.0,0,0,0.0,0,1,1,0,0,0,0,0,0,0
../kbl_data/2023-2024,S43G01N248,서울 SK,Home,김선형,14,2,5,40.0,2,6,33.3,4,11,36.4,4,7,57.1,2,0,2,6,3,1,0,0,2,2
../kbl_data/2023-2024,S43G01N248,서울 SK,Home,오세근,6,2,6,33.3,0,3,0.0,2,9,22.2,2,2,100.0,1,7,8,1,1,0,0,0,2,3
../kbl_data/2023-2024,S43G01N248,서울 SK,Home,리온 윌리엄스,4,2,3,66.7,0,0,0.0,2,3,66.7,0,1,0.0,0,1,1,0,0,0,0,0,1,2
../kbl_data/2023-2024,S43G01N248,서울 SK,Home,안영준,10,1,3,33.3,2,6,33.3,3,9,33.3,2,2,100.0,0,3,3,0,3,1,0,0,1,2
../kbl_data/2023-2024,S43G01N248,서울 SK,Home,자밀 워니,6,3,8,37.5,0,3,0.0,3,11,27.3,0,0,0.0,3,9,12,5,2,0,0,0,1,1
../kbl_data/2023-2024,S43G01N248,서울 SK,Home,전성환,0,0,0,0.0,0,0,0.0,0,0,0.0,0,0,0.0,0,0,0,0,0,0,0,0,0,0
../kbl_data/2023-2024,S43G01N248,서울 SK,Home,김형빈,9,1,2,50.0,1,4,25.0,2,6,33.3,4,4,100.0,1,1,2,0,0,0,0,0,1,3
../kbl_data/2023-2024,S43G01N248,서울 SK,Home,오재현,4,2,5,40.0,0,4,0.0,2,9,22.2,0,0,0.0,1,0,1,3,2,0,0,0,2,3
../kbl_data/2023-2024,S43G01N248,서울 SK,Home,문가온,0,0,0,0.0,0,0,0.0,0,0,0.0,0,0,0.0,0,1,1,0,0,0,0,0,0,0
../kbl_data/2023-2024,S43G01N248,서울 SK,Home,이경도,2,1,1,100.0,0,0,0.0,1,1,100.0,0,0,0.0,1,0,1,0,0,0,0,0,0,0
../kbl_data/2023-2024,S43G01N248,고양 소노,Away,김강선,0,0,0,0.0,0,3,0.0,0,3,0.0,0,0,0.0,1,0,1,2,1,0,0,0,1,2
../kbl_data/2023-2024,S43G01N248,고양 소노,Away,함준후,5,1,1,100.0,1,4,25.0,2,5,40.0,0,0,0.0,1,6,7,1,0,0,0,0,1,5
../kbl_data/2023-2024,S43G01N248,고양 소노,Away,김민욱,11,4,4,100.0,1,1,100.0,5,5,100.0,0,2,0.0,2,3,5,0,1,0,0,0,2,3
../kbl_data/2023-2024,S43G01N248,고양 소노,Away,전성현,4,2,4,50.0,0,12,0.0,2,16,12.5,0,0,0.0,2,2,4,5,0,0,0,0,1,1
../kbl_data/2023-2024,S43G01N248,고양 소노,Away,김지후,0,0,0,0.0,0,1,0.0,0,1,0.0,0,0,0.0,1,0,1,0,0,0,0,0,0,1
../kbl_data/2023-2024,S43G01N248,고양 소노,Away,김진용,0,0,0,0.0,0,0,0.0,0,0,0.0,0,0,0.0,0,0,0,0,0,0,0,0,0,0
../kbl_data/2023-2024,S43G01N248,고양 소노,Away,치나누 오누아쿠,21,6,11,54.5,1,3,33.3,7,14,50.0,6,7,85.7,5,21,26,4,2,1,0,1,7,2
../kbl_data/2023-2024,S43G01N248,고양 소노,Away,이진석,0,0,1,0.0,0,1,0.0,0,2,0.0,0,0,0.0,2,0,2,0,0,0,0,0,0,0
../kbl_data/2023-2024,S43G01N248,고양 소노,Away,이정현,34,8,10,80.0,6,11,54.5,14,21,66.7,0,2,0.0,0,6,6,9,4,0,0,0,3,2
../kbl_data/2023-2024,S43G01N248,고양 소노,Away,백지웅,0,0,0,0.0,0,0,0.0,0,0,0.0,0,0,0.0,0,0,0,0,0,0,0,0,0,1
../kbl_data/2023-2024,S43G01N248,고양 소노,Away,조재우,0,0,1,0.0,0,0,0.0,0,1,0.0,0,0,0.0,2,0,2,0,1,0,0,0,0,2
../kbl_data/2023-2024,S43G01N248,고양 소노,Away,민기남,0,0,1,0.0,0,0,0.0,0,1,0.0,0,0,0.0,0,0,0,0,0,0,0,0,0,0
../kbl_data/2023-2024,S43G01N249,부산 KCC,Home,정창영,4,2,3,66.7,0,2,0.0,2,5,40.0,0,0,0.0,3,3,6,6,0,0,0,0,0,3
../kbl_data/2023-2024,S43G01N249,부산 KCC,Home,라건아,20,7,8,87.5,1,3,33.3,8,11,72.7,3,3,100.0,1,9,10,1,0,3,0,0,1,3
../kbl_data/2023-2024,S43G01N249,부산 KCC,Home,전준범,0,0,0,0.0,0,1,0.0,0,1,0.0,0,2,0.0,1,1,2,0,1,0,0,0,0,1
../kbl_data/2023-2024,S43G01N249,부산 KCC,Home,허웅,10,2,7,28.6,1,7,14.3,3,14,21.4,3,3,100.0,0,0,0,9,1,0,1,0,2,2
../kbl_data/2023-2024,S43G01N249,부산 KCC,Home,이승현,17,8,9,88.9,0,0,0.0,8,9,88.9,1,2,50.0,1,7,8,1,0,1,0,0,0,2
../kbl_data/2023-2024,S43G01N249,부산 KCC,Home,이호현,8,2,4,50.0,1,2,50.0,3,6,50.0,1,2,50.0,0,1,1,3,1,0,0,0,1,3
../kbl_data/2023-2024,S43G01N249,부산 KCC,Home,곽정훈,2,1,1,100.0,0,0,0.0,1,1,100.0,0,0,0.0,1,0,1,0,0,0,0,0,0,0
../kbl_data/2023-2024,S43G01N249,부산 KCC,Home,이근휘,12,1,1,100.0,3,8,37.5,4,9,44.4,1,2,50.0,1,2,3,1,0,0,0,0,1,0
../kbl_data/2023-2024,S43G01N249,부산 KCC,Home,여준형,0,0,0,0.0,0,0,0.0,0,0,0.0,0,0,0.0,0,0,0,0,0,0,0,0,0,1
../kbl_data/2023-2024,S43G01N249,부산 KCC,Home,캘빈 제프리 에피스톨라,10,2,2,100.0,2,2,100.0,4,4,100.0,0,0,0.0,0,0,0,1,0,0,0,0,1,3
../kbl_data/2023-2024,S43G01N249,부산 KCC,Home,이주영,2,1,1,100.0,0,2,0.0,1,3,33.3,0,0,0.0,0,0,0,0,0,0,0,0,0,0
../kbl_data/2023-2024,S43G01N249,부산 KCC,Home,알리제 드숀 존슨,13,5,8,62.5,0,2,0.0,5,10,50.0,3,4,75.0,4,5,9,7,2,0,0,0,2,1
../kbl_data/2023-2024,S43G01N249,서울 삼성,Away,이정현,3,1,3,33.3,0,6,0.0,1,9,11.1,1,2,50.0,1,7,8,8,0,0,0,0,2,2
../kbl_data/2023-2024,S43G01N249,서울 삼성,Away,홍경기,5,1,1,100.0,1,3,33.3,2,4,50.0,0,0,0.0,0,1,1,1,0,0,0,0,1,2
../kbl_data/2023-2024,S43G01N249,서울 삼성,Away,김승원,0,0,0,0.0,0,0,0.0,0,0,0.0,0,0,0.0,0,0,0,0,0,0,0,0,0,0
../kbl_data/2023-2024,S43G01N249,서울 삼성,Away,이동엽,11,3,3,100.0,1,3,33.3,4,6,66.7,2,4,50.0,0,2,2,1,2,0,0,0,1,3
../kbl_data/2023-2024,S43G01N249,서울 삼성,Away,최승욱,9,3,5,60.0,1,2,50.0,4,7,57.1,0,1,0.0,1,0,1,1,1,0,0,0,0,1
../kbl_data/2023-2024,S43G01N249,서울 삼성,Away,윤성원,6,0,1,0.0,2,5,40.0,2,6,33.3,0,0,0.0,1,0,1,1,0,0,0,0,0,2
../kbl_data/2023-2024,S43G01N249,서울 삼성,Away,차민석,11,2,3,66.7,2,4,50.0,4,7,57.1,1,3,33.3,3,3,6,3,0,0,0,0,1,3
../kbl_data/2023-2024,S43G01N249,서울 삼성,Away,신동혁,0,0,0,0.0,0,1,0.0,0,1,0.0,0,0,0.0,0,0,0,4,0,0,0,0,1,1
../kbl_data/2023-2024,S43G01N249,서울 삼성,Away,조준희,2,1,2,50.0,0,1,0.0,1,3,33.3,0,0,0.0,0,1,1,2,1,0,0,0,0,2
../kbl_data/2023-2024,S43G01N249,서울 삼성,Away,아반 나바,0,0,0,0.0,0,0,0.0,0,0,0.0,0,0,0.0,0,0,0,0,0,0,0,0,1,0
../kbl_data/2023-2024,S43G01N249,서울 삼성,Away,이스마엘 레인,23,7,9,77.8,3,7,42.9,10,16,62.5,0,0,0.0,1,3,4,0,0,1,0,0,2,2
../kbl_data/2023-2024,S43G01N249,서울 삼성,Away,코피 코번,15,6,12,50.0,0,0,0.0,6,12,50.0,3,7,42.9,6,3,9,1,0,2,0,0,4,1
../kbl_data/2023-2024,S43G01N250,안양 정관장,Home,정준원,0,0,0,0.0,0,0,0.0,0,0,0.0,0,0,0.0,0,1,1,0,0,0,0,0,1,1
../kbl_data/2023-2024,S43G01N250,안양 정관장,Home,배병준,7,2,4,50.0,1,5,20.0,3,9,33.3,0,0,0.0,1,1,2,5,1,0,0,0,1,1
../kbl_data/2023-2024,S43G01N250,안양 정관장,Home,정효근,20,4,7,57.1,4,9,44.4,8,16,50.0,0,0,0.0,0,2,2,2,0,0,0,0,0,2
../kbl_data/2023-2024,S43G01N250,안양 정관장,Home,이종현,6,3,3,100.0,0,0,0.0,3,3,100.0,0,0,0.0,2,5,7,1,0,0,0,1,1,0
../kbl_data/2023-2024,S43G01N250,안양 정관장,Home,박지훈,22,8,14,57.1,2,6,33.3,10,20,50.0,0,0,0.0,0,8,8,12,0,0,0,0,2,12
../kbl_data/2023-2024,S43G01N250,안양 정관장,Home,최성원,5,1,2,50.0,1,2,50.0,2,4,50.0,0,0,0.0,0,1,1,4,0,0,0,0,0,1
../kbl_data/2023-2024,S43G01N250,안양 정관장,Home,이우정,0,0,0,0.0,0,0,0.0,0,0,0.0,0,0,0.0,0,0,0,0,0,0,0,0,0,1
../kbl_data/2023-2024,S43G01N250,안양 정관장,Home,김경원,12,3,3,100.0,1,2,50.0,4,5,80.0,3,3,100.0,1,5,6,2,1,1,0,0,0,3
../kbl_data/2023-2024,S43G01N250,안양 정관장,Home,렌즈 아반도,0,0,0,0.0,0,0,0.0,0,0,0.0,0,0,0.0,0,0,0,0,0,0,0,0,0,0
../kbl_data/2023-2024,S43G01N250,안양 정관장,Home,나성호,0,0,0,0.0,0,0,0.0,0,0,0.0,0,0,0.0,0,0,0,0,0,0,0,0,0,0
../kbl_data/2023-2024,S43G01N250,안양 정관장,Home,로버트 카터,18,7,13,53.8,1,2,50.0,8,15,53.3,1,2,50.0,1,4,5,1,0,0,0,0,1,3
../kbl_data/2023-2024,S43G01N250,안양 정관장,Home,자밀 윌슨,6,0,0,0.0,2,2,100.0,2,2,100.0,0,0,0.0,0,2,2,0,1,1,0,0,1,3
../kbl_data/2023-2024,S43G01N250,대구 한국가스공사,Away,박지훈,22,8,14,57.1,2,6,33.3,10,20,50.0,0,0,0.0,0,8,8,12,0,0,0,0,2,12
../kbl_data/2023-2024,S43G01N250,대구 한국가스공사,Away,양준우,6,0,0,0.0,2,3,66.7,2,3,66.7,0,2,0.0,0,0,0,1,0,0,0,0,1,2
../kbl_data/2023-2024,S43G01N250,대구 한국가스공사,Away,이도헌,0,0,0,0.0,0,1,0.0,0,1,0.0,0,0,0.0,0,0,0,0,0,0,0,0,0,2
../kbl_data/2023-2024,S43G01N250,대구 한국가스공사,Away,앤드류 니콜슨,26,8,17,47.1,2,6,33.3,10,23,43.5,4,4,100.0,2,6,8,2,0,0,0,3,1,1
../kbl_data/2023-2024,S43G01N250,대구 한국가스공사,Away,신승민,17,4,6,66.7,3,6,50.0,7,12,58.3,0,0,0.0,1,4,5,5,0,0,1,0,0,1
../kbl_data/2023-2024,S43G01N250,대구 한국가스공사,Away,김진모,0,0,0,0.0,0,0,0.0,0,0,0.0,0,0,0.0,0,0,0,0,0,0,0,0,0,0
../kbl_data/2023-2024,S43G01N250,대구 한국가스공사,Away,최주영,0,0,0,0.0,0,0,0.0,0,0,0.0,0,0,0.0,0,1,1,0,0,0,0,0,0,0
../kbl_data/2023-2024,S43G01N250,대구 한국가스공사,Away,염유성,0,0,0,0.0,0,0,0.0,0,0,0.0,0,0,0.0,0,0,0,0,0,0,0,0,1,0
../kbl_data/2023-2024,S43G01N250,대구 한국가스공사,Away,안세영,0,0,0,0.0,0,1,0.0,0,1,0.0,0,0,0.0,0,1,1,2,0,0,0,0,0,4
../kbl_data/2023-2024,S43G01N250,대구 한국가스공사,Away,김태호,0,0,0,0.0,0,0,0.0,0,0,0.0,0,0,0.0,0,0,0,0,0,0,0,0,0,0
../kbl_data/2023-2024,S43G01N250,대구 한국가스공사,Away,신주영,11,1,2,50.0,3,4,75.0,4,6,66.7,0,3,0.0,0,5,5,4,1,1,0,0,1,4
../kbl_data/2023-2024,S43G01N250,대구 한국가스공사,Away,듀반 맥스웰,10,4,9,44.4,0,0,0.0,4,9,44.4,2,4,50.0,3,2,5,0,2,0,0,0,1,0
../kbl_data/2023-2024,S43G01N251,서울 SK,Home,양우섭,6,1,1,100.0,1,2,50.0,2,3,66.7,1,1,100.0,0,1,1,0,0,0,0,0,2,2
../kbl_data/2023-2024,S43G01N251,서울 SK,Home,허일영,3,0,1,0.0,1,1,100.0,1,2,50.0,0,0,0.0,1,1,2,1,1,0,0,0,0,1
../kbl_data/2023-2024,S43G01N251,서울 SK,Home,김선형,24,5,9,55.6,4,6,66.7,9,15,60.0,2,2,100.0,0,1,1,1,3,0,0,0,1,4
../kbl_data/2023-2024,S43G01N251,서울 SK,Home,오세근,4,1,3,33.3,0,1,0.0,1,4,25.0,2,2,100.0,2,4,6,1,1,0,0,0,0,2
../kbl_data/2023-2024,S43G01N251,서울 SK,Home,리온 윌리엄스,0,0,1,0.0,0,0,0.0,0,1,0.0,0,0,0.0,0,0,0,0,1,0,0,0,0,0
../kbl_data/2023-2024,S43G01N251,서울 SK,Home,최원혁,5,2,2,100.0,0,2,0.0,2,4,50.0,1,1,100.0,1,4,5,5,0,0,0,0,2,5
../kbl_data/2023-2024,S43G01N251,서울 SK,Home,안영준,9,2,6,33.3,1,1,100.0,3,7,42.9,2,3,66.7,1,3,4,1,0,1,0,0,2,4
../kbl_data/2023-2024,S43G01N251,서울 SK,Home,자밀 워니,27,9,23,39.1,2,5,40.0,11,28,39.3,3,6,50.0,2,9,11,6,1,0,0,0,0,0
../kbl_data/2023-2024,S43G01N251,서울 SK,Home,전성환,0,0,0,0.0,0,0,0.0,0,0,0.0,0,0,0.0,0,0,0,0,0,0,0,0,0,0
../kbl_data/2023-2024,S43G01N251,서울 SK,Home,김형빈,5,1,3,33.3,1,2,50.0,2,5,40.0,0,0,0.0,0,2,2,0,0,1,1,0,0,1
../kbl_data/2023-2024,S43G01N251,서울 SK,Home,문가온,0,0,0,0.0,0,0,0.0,0,0,0.0,0,0,0.0,0,0,0,0,0,0,0,0,0,0
../kbl_data/2023-2024,S43G01N251,서울 SK,Home,이경도,0,0,0,0.0,0,0,0.0,0,0,0.0,0,0,0.0,0,0,0,0,0,0,0,0,0,1
../kbl_data/2023-2024,S43G01N251,원주 DB,Away,서민수,0,0,0,0.0,0,2,0.0,0,2,0.0,0,0,0.0,0,0,0,0,0,0,1,0,2,3
../kbl_data/2023-2024,S43G01N251,원주 DB,Away,김영현,3,0,0,0.0,1,2,50.0,1,2,50.0,0,0,0.0,1,1,2,0,0,0,0,0,0,1
../kbl_data/2023-2024,S43G01N251,원주 DB,Away,최승욱,4,2,4,50.0,0,1,0.0,2,5,40.0,0,0,0.0,2,1,3,2,1,0,1,0,0,1
../kbl_data/2023-2024,S43G01N251,원주 DB,Away,강상재,20,4,7,57.1,3,6,50.0,7,13,53.8,3,4,75.0,0,7,7,6,0,1,0,0,1,1
../kbl_data/2023-2024,S43G01N251,원주 DB,Away,유현준,10,1,3,33.3,2,4,50.0,3,7,42.9,2,2,100.0,0,4,4,3,2,0,0,0,1,3
../kbl_data/2023-2024,S43G01N251,원주 DB,Away,이윤수,0,0,0,0.0,0,0,0.0,0,0,0.0,0,0,0.0,0,0,0,0,0,0,0,0,0,0
../kbl_data/2023-2024,S43G01N251,원주 DB,Away,디드릭 로슨,4,1,2,50.0,0,4,0.0,1,6,16.7,2,2,100.0,0,4,4,2,0,1,0,0,3,2
../kbl_data/2023-2024,S43G01N251,원주 DB,Away,이선 알바노,25,5,11,45.5,3,6,50.0,8,17,47.1,6,8,75.0,1,1,2,8,1,0,0,0,1,2
../kbl_data/2023-2024,S43G01N251,원주 DB,Away,박인웅,8,2,5,40.0,1,4,25.0,3,9,33.3,1,1,100.0,3,2,5,1,0,0,0,0,0,3
../kbl_data/2023-2024,S43G01N251,원주 DB,Away,김형준,0,0,0,0.0,0,0,0.0,0,0,0.0,0,0,0.0,0,0,0,0,0,0,0,0,0,0
../kbl_data/2023-2024,S43G01N251,원주 DB,Away,최승빈,0,0,0,0.0,0,0,0.0,0,0,0.0,0,0,0.0,0,0,0,0,0,0,0,0,0,0
../kbl_data/2023-2024,S43G01N251,원주 DB,Away,제프 위디,10,5,9,55.6,0,1,0.0,5,10,50.0,0,0,0.0,4,13,17,1,0,2,0,1,3,2
../kbl_data/2023-2024,S43G01N252,부산 KCC,Home,정창영,5,1,2,50.0,0,2,0.0,1,4,25.0,3,6,50.0,0,2,2,4,2,0,0,0,1,0
../kbl_data/2023-2024,S43G01N252,부산 KCC,Home,라건아,16,5,8,62.5,2,6,33.3,7,14,50.0,0,0,0.0,2,8,10,2,1,3,0,1,2,3
../kbl_data/2023-2024,S43G01N252,부산 KCC,Home,전준범,0,0,0,0.0,0,0,0.0,0,0,0.0,0,0,0.0,0,0,0,0,0,0,0,0,0,0
../kbl_data/2023-2024,S43G01N252,부산 KCC,Home,허웅,26,6,10,60.0,1,6,16.7,7,16,43.8,11,11,100.0,0,0,0,3,1,0,0,0,4,0
../kbl_data/2023-2024,S43G01N252,부산 KCC,Home,이승현,19,8,12,66.7,0,1,0.0,8,13,61.5,3,4,75.0,3,3,6,2,1,0,0,0,0,2
../kbl_data/2023-2024,S43G01N252,부산 KCC,Home,이호현,9,2,5,40.0,1,1,100.0,3,6,50.0,2,2,100.0,0,1,1,4,1,0,1,0,1,4
../kbl_data/2023-2024,S43G01N252,부산 KCC,Home,곽정훈,2,1,2,50.0,0,0,0.0,1,2,50.0,0,0,0.0,1,0,1,0,0,0,0,0,0,0
../kbl_data/2023-2024,S43G01N252,부산 KCC,Home,이근휘,3,0,1,0.0,1,3,33.3,1,4,25.0,0,0,0.0,1,3,4,0,0,0,0,0,0,3
../kbl_data/2023-2024,S43G01N252,부산 KCC,Home,여준형,0,0,0,0.0,0,0,0.0,0,0,0.0,0,0,0.0,0,0,0,0,0,0,0,0,0,0
../kbl_data/2023-2024,S43G01N252,부산 KCC,Home,캘빈 제프리 에피스톨라,9,2,3,66.7,1,2,50.0,3,5,60.0,2,2,100.0,1,1,2,1,2,0,0,0,0,4
../kbl_data/2023-2024,S43G01N252,부산 KCC,Home,이주영,0,0,0,0.0,0,0,0.0,0,0,0.0,0,0,0.0,0,0,0,0,0,0,0,0,0,0
../kbl_data/2023-2024,S43G01N252,부산 KCC,Home,알리제 드숀 존슨,3,1,2,50.0,0,0,0.0,1,2,50.0,1,2,50.0,0,4,4,1,0,0,0,0,2,3
../kbl_data/2023-2024,S43G01N252,창원 LG,Away,이관희,10,3,7,42.9,1,5,20.0,4,12,33.3,1,2,50.0,0,3,3,2,0,1,0,0,0,1
../kbl_data/2023-2024,S43G01N252,창원 LG,Away,정희재,16,3,3,100.0,3,7,42.9,6,10,60.0,1,3,33.3,1,4,5,0,1,0,0,0,0,5
../kbl_data/2023-2024,S43G01N252,창원 LG,Away,이재도,20,3,4,75.0,4,7,57.1,7,11,63.6,2,2,100.0,1,1,2,6,0,1,0,0,1,2
../kbl_data/2023-2024,S43G01N252,창원 LG,Away,정인덕,0,0,0,0.0,0,0,0.0,0,0,0.0,0,0,0.0,0,0,0,0,0,0,0,0,0,0
../kbl_data/2023-2024,S43G01N252,창원 LG,Away,양홍석,11,1,4,25.0,3,4,75.0,4,8,50.0,0,0,0.0,2,1,3,3,0,0,0,0,3,4
../kbl_data/2023-2024,S43G01N252,창원 LG,Away,박정현,2,1,1,100.0,0,0,0.0,1,1,100.0,0,0,0.0,0,0,0,0,0,0,0,0,0,0
../kbl_data/2023-2024,S43G01N252,창원 LG,Away,아셈 마레이,17,7,12,58.3,0,0,0.0,7,12,58.3,3,3,100.0,5,11,16,4,4,1,0,0,4,3
../kbl_data/2023-2024,S43G01N252,창원 LG,Away,이승우,0,0,0,0.0,0,0,0.0,0,0,0.0,0,0,0.0,0,0,0,0,0,0,0,0,0,0
../kbl_data/2023-2024,S43G01N252,창원 LG,Away,저스틴 구탕,14,3,5,60.0,2,3,66.7,5,8,62.5,2,2,100.0,0,1,1,2,1,0,0,0,1,2
../kbl_data/2023-2024,S43G01N252,창원 LG,Away,양준석,2,1,4,25.0,0,0,0.0,1,4,25.0,0,0,0.0,0,1,1,0,1,0,0,0,0,2
../kbl_data/2023-2024,S43G01N252,창원 LG,Away,유기상,5,1,3,33.3,1,3,33.3,2,6,33.3,0,1,0.0,2,1,3,2,2,0,0,0,0,4
../kbl_data/2023-2024,S43G01N252,창원 LG,Away,후안 텔로,4,2,2,100.0,0,0,0.0,2,2,100.0,0,0,0.0,0,2,2,2,0,0,0,0,1,2
../kbl_data/2023-2024,S43G01N253,고양 소노,Home,김강선,0,0,1,0.0,0,1,0.0,0,2,0.0,0,0,0.0,1,0,1,1,2,0,0,0,1,1
../kbl_data/2023-2024,S43G01N253,고양 소노,Home,함준후,12,2,2,100.0,2,3,66.7,4,5,80.0,2,2,100.0,2,1,3,2,0,0,0,0,0,5
../kbl_data/2023-2024,S43G01N253,고양 소노,Home,김민욱,12,1,3,33.3,3,11,27.3,4,14,28.6,1,1,100.0,0,2,2,1,1,1,0,0,1,2
../kbl_data/2023-2024,S43G01N253,고양 소노,Home,전성현,1,0,0,0.0,0,4,0.0,0,4,0.0,1,2,50.0,1,0,1,0,0,0,0,0,1,0
../kbl_data/2023-2024,S43G01N253,고양 소노,Home,김지후,7,2,3,66.7,1,1,100.0,3,4,75.0,0,0,0.0,0,1,1,0,0,0,0,0,0,1
../kbl_data/2023-2024,S43G01N253,고양 소노,Home,김진용,0,0,0,0.0,0,0,0.0,0,0,0.0,0,0,0.0,0,0,0,0,0,0,0,0,0,0
../kbl_data/2023-2024,S43G01N253,고양 소노,Home,치나누 오누아쿠,27,10,17,58.8,1,3,33.3,11,20,55.0,4,7,57.1,4,19,23,7,0,2,1,1,1,1
../kbl_data/2023-2024,S43G01N253,고양 소노,Home,이진석,0,0,0,0.0,0,0,0.0,0,0,0.0,0,0,0.0,0,0,0,0,0,0,0,0,0,0
../kbl_data/2023-2024,S43G01N253,고양 소노,Home,이정현,38,5,9,55.6,7,12,58.3,12,21,57.1,7,7,100.0,0,3,3,8,2,0,0,0,2,4
../kbl_data/2023-2024,S43G01N253,고양 소노,Home,백지웅,5,1,1,100.0,1,4,25.0,2,5,40.0,0,0,0.0,0,2,2,0,0,0,0,0,0,1
../kbl_data/2023-2024,S43G01N253,고양 소노,Home,조재우,0,0,2,0.0,0,0,0.0,0,2,0.0,0,0,0.0,1,0,1,1,0,1,0,0,0,0
../kbl_data/2023-2024,S43G01N253,고양 소노,Home,민기남,0,0,0,0.0,0,0,0.0,0,0,0.0,0,0,0.0,0,0,0,0,0,0,0,0,0,0
../kbl_data/2023-2024,S43G01N253,울산 현대모비스,Away,함지훈,6,2,4,50.0,0,1,0.0,2,5,40.0,2,3,66.7,1,1,2,2,0,1,0,0,0,1
../kbl_data/2023-2024,S43G01N253,울산 현대모비스,Away,김현민,2,1,2,50.0,0,0,0.0,1,2,50.0,0,0,0.0,1,0,1,0,0,0,0,0,0,0
../kbl_data/2023-2024,S43G01N253,울산 현대모비스,Away,김현수,0,0,0,0.0,0,0,0.0,0,0,0.0,0,0,0.0,0,0,0,0,0,0,0,0,0,0
../kbl_data/2023-2024,S43G01N253,울산 현대모비스,Away,장재석,2,1,2,50.0,0,0,0.0,1,2,50.0,0,0,0.0,0,0,0,2,0,1,0,0,1,2
../kbl_data/2023-2024,S43G01N253,울산 현대모비스,Away,김지완,3,0,2,0.0,1,4,25.0,1,6,16.7,0,0,0.0,2,1,3,2,0,0,0,0,1,3
../kbl_data/2023-2024,S43G01N253,울산 현대모비스,Away,김준일,2,0,0,0.0,0,0,0.0,0,0,0.0,2,2,100.0,0,2,2,3,0,0,0,0,1,2
../kbl_data/2023-2024,S43G01N253,울산 현대모비스,Away,김국찬,4,2,3,66.7,0,1,0.0,2,4,50.0,0,0,0.0,0,2,2,0,0,0,0,0,1,0
../kbl_data/2023-2024,S43G01N253,울산 현대모비스,Away,박준은,0,0,0,0.0,0,0,0.0,0,0,0.0,0,0,0.0,0,0,0,0,0,0,0,0,0,0
../kbl_data/2023-2024,S43G01N253,울산 현대모비스,Away,이우석,17,7,12,58.3,1,3,33.3,8,15,53.3,0,1,0.0,0,6,6,3,1,0,0,0,2,3
../kbl_data/2023-2024,S43G01N253,울산 현대모비스,Away,신민석,7,2,3,66.7,1,5,20.0,3,8,37.5,0,0,0.0,0,3,3,3,2,0,0,0,0,3
../kbl_data/2023-2024,S43G01N253,울산 현대모비스,Away,게이지 프림,27,13,23,56.5,0,0,0.0,13,23,56.5,1,2,50.0,4,13,17,5,1,0,0,2,2,4
../kbl_data/2023-2024,S43G01N253,울산 현대모비스,Away,박무빈,17,3,6,50.0,3,6,50.0,6,12,50.0,2,2,100.0,2,0,2,3,0,0,0,0,1,4
../kbl_data/2023-2024,S43G01N254,수원 KT,Home,한희원,4,0,0,0.0,1,3,33.3,1,3,33.3,1,2,50.0,1,1,2,1,1,0,0,0,0,1
../kbl_data/2023-2024,S43G01N254,수원 KT,Home,최창진,1,0,0,0.0,0,0,0.0,0,0,0.0,1,2,50.0,0,2,2,0,0,0,0,0,1,1
../kbl_data/2023-2024,S43G01N254,수원 KT,Home,문성곤,6,0,0,0.0,2,5,40.0,2,5,40.0,0,0,0.0,0,1,1,0,1,0,0,0,0,4
../kbl_data/2023-2024,S43G01N254,수원 KT,Home,이현석,0,0,0,0.0,0,0,0.0,0,0,0.0,0,0,0.0,0,0,0,0,0,0,0,0,0,0
../kbl_data/2023-2024,S43G01N254,수원 KT,Home,정성우,7,1,1,100.0,1,3,33.3,2,4,50.0,2,2,100.0,1,1,2,4,2,0,1,0,2,2
../kbl_data/2023-2024,S43G01N254,수원 KT,Home,최성모,0,0,0,0.0,0,0,0.0,0,0,0.0,0,0,0.0,0,0,0,0,0,0,0,0,0,0
../kbl_data/2023-2024,S43G01N254,수원 KT,Home,허훈,16,1,6,16.7,3,11,27.3,4,17,23.5,5,8,62.5,0,1,1,4,1,0,0,0,2,1
../kbl_data/2023-2024,S43G01N254,수원 KT,Home,박준영,0,0,0,0.0,0,2,0.0,0,2,0.0,0,0,0.0,0,1,1,0,0,0,0,0,0,2
../kbl_data/2023-2024,S43G01N254,수원 KT,Home,하윤기,21,8,13,61.5,0,0,0.0,8,13,61.5,5,7,71.4,3,0,3,0,0,1,0,0,2,3
../kbl_data/2023-2024,S43G01N254,수원 KT,Home,문정현,6,0,3,0.0,2,3,66.7,2,6,33.3,0,0,0.0,5,4,9,2,0,0,0,0,0,2
../kbl_data/2023-2024,S43G01N254,수원 KT,Home,마이클 에릭,0,0,0,0.0,0,0,0.0,0,0,0.0,0,0,0.0,0,0,0,2,0,0,0,0,0,1
../kbl_data/2023-2024,S43G01N254,수원 KT,Home,패리스 배스,24,6,11,54.5,0,4,0.0,6,15,40.0,12,14,85.7,4,10,14,3,6,0,0,1,0,3
../kbl_data/2023-2024,S43G01N254,대구 한국가스공사,Away,박지훈,7,2,2,100.0,1,3,33.3,3,5,60.0,0,0,0.0,3,0,3,3,0,0,0,0,0,3
../kbl_data/2023-2024,S43G01N254,대구 한국가스공사,Away,양준우,6,0,0,0.0,2,7,28.6,2,7,28.6,0,0,0.0,0,4,4,2,0,0,0,0,1,4
../kbl_data/2023-2024,S43G01N254,대구 한국가스공사,Away,이도헌,8,0,2,0.0,2,5,40.0,2,7,28.6,2,2,100.0,0,3,3,2,0,0,1,0,1,4
../kbl_data/2023-2024,S43G01N254,대구 한국가스공사,Away,앤드류 니콜슨,24,6,12,50.0,3,6,50.0,9,18,50.0,3,4,75.0,4,6,10,0,1,0,0,3,2,1
../kbl_data/2023-2024,S43G01N254,대구 한국가스공사,Away,신승민,20,6,9,66.7,2,6,33.3,8,15,53.3,2,2,100.0,0,4,4,3,1,1,0,0,6,2
../kbl_data/2023-2024,S43G01N254,대구 한국가스공사,Away,김진모,0,0,0,0.0,0,0,0.0,0,0,0.0,0,0,0.0,0,0,0,0,0,0,0,0,0,0
../kbl_data/2023-2024,S43G01N254,대구 한국가스공사,Away,최주영,0,0,0,0.0,0,0,0.0,0,0,0.0,0,0,0.0,0,0,0,0,0,0,0,0,0,0
../kbl_data/2023-2024,S43G01N254,대구 한국가스공사,Away,염유성,3,0,0,0.0,1,2,50.0,1,2,50.0,0,0,0.0,0,1,1,0,0,0,0,0,0,1
../kbl_data/2023-2024,S43G01N254,대구 한국가스공사,Away,안세영,5,2,3,66.7,0,0,0.0,2,3,66.7,1,1,100.0,1,2,3,3,0,0,0,0,1,4
../kbl_data/2023-2024,S43G01N254,대구 한국가스공사,Away,김태호,0,0,0,0.0,0,0,0.0,0,0,0.0,0,0,0.0,0,0,0,0,0,0,0,0,0,0
../kbl_data/2023-2024,S43G01N254,대구 한국가스공사,Away,신주영,0,0,2,0.0,0,1,0.0,0,3,0.0,0,0,0.0,1,4,5,0,0,0,0,0,2,5
../kbl_data/2023-2024,S43G01N254,대구 한국가스공사,Away,듀반 맥스웰,8,4,5,80.0,0,1,0.0,4,6,66.7,0,0,0.0,1,4,5,1,0,0,0,0,1,4
../kbl_data/2023-2024,S43G01N255,원주 DB,Home,서민수,3,0,1,0.0,1,4,25.0,1,5,20.0,0,0,0.0,2,2,4,0,0,0,0,0,2,4
../kbl_data/2023-2024,S43G01N255,원주 DB,Home,김영현,7,2,2,100.0,1,4,25.0,3,6,50.0,0,0,0.0,1,0,1,2,0,0,0,0,0,4
../kbl_data/2023-2024,S43G01N255,원주 DB,Home,최승욱,3,0,2,0.0,1,1,100.0,1,3,33.3,0,0,0.0,2,0,2,0,0,0,0,0,0,2
../kbl_data/2023-2024,S43G01N255,원주 DB,Home,유현준,7,1,4,25.0,1,3,33.3,2,7,28.6,2,2,100.0,0,2,2,6,2,0,0,0,3,2
../kbl_data/2023-2024,S43G01N255,원주 DB,Home,이윤수,0,0,0,0.0,0,0,0.0,0,0,0.0,0,2,0.0,1,0,1,0,0,0,0,0,0,0
../kbl_data/2023-2024,S43G01N255,원주 DB,Home,디드릭 로슨,9,0,1,0.0,2,9,22.2,2,10,20.0,3,5,60.0,1,3,4,1,0,0,0,0,1,0
../kbl_data/2023-2024,S43G01N255,원주 DB,Home,이준희,3,1,7,14.3,0,0,0.0,1,7,14.3,1,2,50.0,1,0,1,2,0,0,0,0,1,1
../kbl_data/2023-2024,S43G01N255,원주 DB,Home,이선 알바노,12,2,2,100.0,2,5,40.0,4,7,57.1,2,2,100.0,1,2,3,3,0,0,0,0,4,0
../kbl_data/2023-2024,S43G01N255,원주 DB,Home,박인웅,5,1,2,50.0,1,6,16.7,2,8,25.0,0,0,0.0,2,3,5,0,2,0,0,0,1,4
../kbl_data/2023-2024,S43G01N255,원주 DB,Home,인승찬,0,0,1,0.0,0,0,0.0,0,1,0.0,0,0,0.0,0,0,0,0,0,0,0,0,0,2
../kbl_data/2023-2024,S43G01N255,원주 DB,Home,김형준,0,0,1,0.0,0,2,0.0,0,3,0.0,0,0,0.0,1,0,1,0,1,0,0,0,2,2
../kbl_data/2023-2024,S43G01N255,원주 DB,Home,제프 위디,19,6,9,66.7,1,2,50.0,7,11,63.6,4,5,80.0,3,7,10,2,1,2,0,0,2,1
../kbl_data/2023-2024,S43G01N255,안양 정관장,Away,정준원,0,0,0,0.0,0,0,0.0,0,0,0.0,0,0,0.0,0,0,0,0,0,0,0,0,0,0
../kbl_data/2023-2024,S43G01N255,안양 정관장,Away,정효근,2,1,1,100.0,0,1,0.0,1,2,50.0,0,0,0.0,0,0,0,0,0,0,0,0,0,1
../kbl_data/2023-2024,S43G01N255,안양 정관장,Away,이종현,0,0,2,0.0,0,1,0.0,0,3,0.0,0,0,0.0,2,1,3,2,0,0,0,0,0,1
../kbl_data/2023-2024,S43G01N255,안양 정관장,Away,박지훈,19,3,3,100.0,2,4,50.0,5,7,71.4,7,8,87.5,2,3,5,6,2,0,0,0,0,3
../kbl_data/2023-2024,S43G01N255,안양 정관장,Away,최성원,6,0,2,0.0,2,3,66.7,2,5,40.0,0,0,0.0,0,0,0,1,0,0,0,0,2,0
../kbl_data/2023-2024,S43G01N255,안양 정관장,Away,이우정,12,1,3,33.3,3,4,75.0,4,7,57.1,1,2,50.0,1,5,6,3,4,0,0,0,1,4
../kbl_data/2023-2024,S43G01N255,안양 정관장,Away,김경원,15,5,9,55.6,1,3,33.3,6,12,50.0,2,4,50.0,0,5,5,0,2,2,0,0,2,2
../kbl_data/2023-2024,S43G01N255,안양 정관장,Away,렌즈 아반도,10,4,7,57.1,0,0,0.0,4,7,57.1,2,2,100.0,1,0,1,1,1,2,0,0,0,1
../kbl_data/2023-2024,S43G01N255,안양 정관장,Away,고찬혁,10,4,5,80.0,0,3,0.0,4,8,50.0,2,2,100.0,0,1,1,0,1,0,0,0,0,1
../kbl_data/2023-2024,S43G01N255,안양 정관장,Away,나성호,2,1,2,50.0,0,1,0.0,1,3,33.3,0,0,0.0,1,3,4,0,0,0,0,0,0,3
../kbl_data/2023-2024,S43G01N255,안양 정관장,Away,로버트 카터,4,1,4,25.0,0,2,0.0,1,6,16.7,2,2,100.0,0,4,4,1,1,2,0,0,3,1
../kbl_data/2023-2024,S43G01N255,안양 정관장,Away,자밀 윌슨,16,2,3,66.7,4,6,66.7,6,9,66.7,0,0,0.0,1,7,8,3,0,1,0,0,2,4
../kbl_data/2023-2024,S43G01N256,서울 SK,Home,양우섭,5,1,3,33.3,1,1,100.0,2,4,50.0,0,0,0.0,1,0,1,1,0,0,0,0,0,2
../kbl_data/2023-2024,S43G01N256,서울 SK,Home,허일영,8,1,3,33.3,2,2,100.0,3,5,60.0,0,0,0.0,2,3,5,0,0,1,0,0,0,3
../kbl_data/2023-2024,S43G01N256,서울 SK,Home,김선형,15,5,7,71.4,1,2,50.0,6,9,66.7,2,2,100.0,1,1,2,2,0,0,0,0,1,2
../kbl_data/2023-2024,S43G01N256,서울 SK,Home,오세근,9,3,7,42.9,0,1,0.0,3,8,37.5,3,4,75.0,1,0,1,2,4,0,0,0,2,1
../kbl_data/2023-2024,S43G01N256,서울 SK,Home,리온 윌리엄스,0,0,2,0.0,0,0,0.0,0,2,0.0,0,0,0.0,1,3,4,0,0,0,0,0,0,0
../kbl_data/2023-2024,S43G01N256,서울 SK,Home,최원혁,0,0,0,0.0,0,1,0.0,0,1,0.0,0,0,0.0,0,0,0,1,0,0,0,0,1,2
../kbl_data/2023-2024,S43G01N256,서울 SK,Home,안영준,7,2,5,40.0,1,5,20.0,3,10,30.0,0,1,0.0,0,3,3,1,0,0,0,0,2,1
../kbl_data/2023-2024,S43G01N256,서울 SK,Home,자밀 워니,30,11,22,50.0,2,3,66.7,13,25,52.0,2,3,66.7,5,10,15,6,5,1,0,1,4,1
../kbl_data/2023-2024,S43G01N256,서울 SK,Home,전성환,0,0,0,0.0,0,0,0.0,0,0,0.0,0,0,0.0,0,0,0,0,0,0,0,0,0,0
../kbl_data/2023-2024,S43G01N256,서울 SK,Home,김형빈,10,3,4,75.0,1,2,50.0,4,6,66.7,1,2,50.0,1,2,3,2,0,2,1,0,0,1
../kbl_data/2023-2024,S43G01N256,서울 SK,Home,문가온,0,0,0,0.0,0,0,0.0,0,0,0.0,0,0,0.0,0,0,0,0,0,0,0,0,0,0
../kbl_data/2023-2024,S43G01N256,서울 SK,Home,이경도,0,0,0,0.0,0,0,0.0,0,0,0.0,0,0,0.0,0,0,0,0,0,0,0,0,0,0
../kbl_data/2023-2024,S43G01N256,서울 삼성,Away,이정현,6,0,2,0.0,1,4,25.0,1,6,16.7,3,3,100.0,1,6,7,7,0,0,0,0,4,2
../kbl_data/2023-2024,S43G01N256,서울 삼성,Away,홍경기,10,2,2,100.0,2,5,40.0,4,7,57.1,0,0,0.0,3,2,5,0,0,0,0,0,1,3
../kbl_data/2023-2024,S43G01N256,서울 삼성,Away,김승원,0,0,0,0.0,0,0,0.0,0,0,0.0,0,0,0.0,1,2,3,1,2,0,0,0,0,4
../kbl_data/2023-2024,S43G01N256,서울 삼성,Away,이동엽,12,3,3,100.0,2,6,33.3,5,9,55.6,0,0,0.0,0,0,0,0,1,0,0,0,1,3
../kbl_data/2023-2024,S43G01N256,서울 삼성,Away,최승욱,8,1,2,50.0,2,2,100.0,3,4,75.0,0,0,0.0,0,2,2,0,2,0,0,0,1,1
../kbl_data/2023-2024,S43G01N256,서울 삼성,Away,윤성원,0,0,1,0.0,0,2,0.0,0,3,0.0,0,0,0.0,0,0,0,0,1,0,0,0,0,3
../kbl_data/2023-2024,S43G01N256,서울 삼성,Away,김한솔,0,0,0,0.0,0,0,0.0,0,0,0.0,0,0,0.0,0,0,0,0,0,0,0,0,0,0
../kbl_data/2023-2024,S43G01N256,서울 삼성,Away,차민석,8,4,5,80.0,0,0,0.0,4,5,80.0,0,0,0.0,4,2,6,1,1,0,1,0,5,3
../kbl_data/2023-2024,S43G01N256,서울 삼성,Away,신동혁,3,0,6,0.0,1,7,14.3,1,13,7.7,0,0,0.0,1,0,1,1,1,1,0,0,0,0
../kbl_data/2023-2024,S43G01N256,서울 삼성,Away,조준희,2,1,2,50.0,0,2,0.0,1,4,25.0,0,0,0.0,0,1,1,0,0,0,0,0,0,0
../kbl_data/2023-2024,S43G01N256,서울 삼성,Away,아반 나바,0,0,0,0.0,0,0,0.0,0,0,0.0,0,0,0.0,0,0,0,0,0,0,0,0,0,0
../kbl_data/2023-2024,S43G01N256,서울 삼성,Away,이스마엘 레인,26,11,19,57.9,1,4,25.0,12,23,52.2,1,2,50.0,5,8,13,2,1,0,0,3,0,1
../kbl_data/2023-2024,S43G01N257,울산 현대모비스,Home,함지훈,11,5,5,100.0,0,0,0.0,5,5,100.0,1,1,100.0,3,4,7,4,0,0,0,0,2,0
../kbl_data/2023-2024,S43G01N257,울산 현대모비스,Home,김현민,0,0,0,0.0,0,0,0.0,0,0,0.0,0,0,0.0,0,0,0,0,0,0,0,0,0,0
../kbl_data/2023-2024,S43G01N257,울산 현대모비스,Home,최진수,2,1,2,50.0,0,0,0.0,1,2,50.0,0,0,0.0,0,1,1,3,1,0,0,0,0,2
../kbl_data/2023-2024,S43G01N257,울산 현대모비스,Home,장재석,2,1,1,100.0,0,0,0.0,1,1,100.0,0,0,0.0,0,1,1,1,0,0,0,0,2,1
../kbl_data/2023-2024,S43G01N257,울산 현대모비스,Home,김지완,0,0,1,0.0,0,4,0.0,0,5,0.0,0,0,0.0,1,0,1,1,0,0,0,0,3,2
../kbl_data/2023-2024,S43G01N257,울산 현대모비스,Home,김준일,2,1,2,50.0,0,0,0.0,1,2,50.0,0,0,0.0,0,2,2,2,2,0,0,0,0,4
../kbl_data/2023-2024,S43G01N257,울산 현대모비스,Home,김국찬,10,1,1,100.0,2,5,40.0,3,6,50.0,2,2,100.0,0,3,3,2,4,0,0,0,1,4
../kbl_data/2023-2024,S43G01N257,울산 현대모비스,Home,이우석,11,4,5,80.0,1,1,100.0,5,6,83.3,0,0,0.0,0,0,0,2,0,0,0,0,2,1
../kbl_data/2023-2024,S43G01N257,울산 현대모비스,Home,신민석,2,1,1,100.0,0,1,0.0,1,2,50.0,0,0,0.0,1,1,2,0,0,0,0,0,0,1
../kbl_data/2023-2024,S43G01N257,울산 현대모비스,Home,게이지 프림,24,11,17,64.7,0,1,0.0,11,18,61.1,2,2,100.0,1,7,8,0,1,0,0,0,2,3
../kbl_data/2023-2024,S43G01N257,울산 현대모비스,Home,김태완,3,0,0,0.0,1,2,50.0,1,2,50.0,0,0,0.0,0,0,0,0,0,0,0,0,0,1
../kbl_data/2023-2024,S43G01N257,울산 현대모비스,Home,미구엘 안드레 옥존,18,6,10,60.0,1,6,16.7,7,16,43.8,3,3,100.0,0,4,4,5,0,0,1,0,2,2
../kbl_data/2023-2024,S43G01N257,창원 LG,Away,이관희,0,0,1,0.0,0,2,0.0,0,3,0.0,0,0,0.0,0,0,0,0,0,0,0,0,0,1
../kbl_data/2023-2024,S43G01N257,창원 LG,Away,정희재,2,1,1,100.0,0,2,0.0,1,3,33.3,0,0,0.0,0,0,0,7,2,0,1,0,2,4
../kbl_data/2023-2024,S43G01N257,창원 LG,Away,이재도,20,6,8,75.0,2,5,40.0,8,13,61.5,2,3,66.7,2,2,4,4,1,0,0,0,3,2
../kbl_data/2023-2024,S43G01N257,창원 LG,Away,정인덕,3,0,0,0.0,1,1,100.0,1,1,100.0,0,2,0.0,0,0,0,0,1,0,0,0,0,0
../kbl_data/2023-2024,S43G01N257,창원 LG,Away,양홍석,9,3,5,60.0,1,3,33.3,4,8,50.0,0,2,0.0,0,1,1,1,0,0,0,0,1,2
../kbl_data/2023-2024,S43G01N257,창원 LG,Away,박정현,0,0,0,0.0,0,0,0.0,0,0,0.0,0,0,0.0,0,0,0,0,0,0,0,0,0,0
../kbl_data/2023-2024,S43G01N257,창원 LG,Away,아셈 마레이,23,11,14,78.6,0,0,0.0,11,14,78.6,1,5,20.0,5,11,16,6,2,0,0,1,3,3
../kbl_data/2023-2024,S43G01N257,창원 LG,Away,이승우,0,0,0,0.0,0,0,0.0,0,0,0.0,0,0,0.0,0,0,0,0,0,0,0,0,0,0
../kbl_data/2023-2024,S43G01N257,창원 LG,Away,저스틴 구탕,11,5,7,71.4,0,2,0.0,5,9,55.6,1,2,50.0,2,1,3,0,1,0,0,0,2,2
../kbl_data/2023-2024,S43G01N257,창원 LG,Away,양준석,7,2,4,50.0,1,1,100.0,3,5,60.0,0,0,0.0,0,1,1,2,1,0,0,0,0,0
../kbl_data/2023-2024,S43G01N257,창원 LG,Away,유기상,7,0,1,0.0,2,8,25.0,2,9,22.2,1,2,50.0,1,2,3,1,0,0,0,0,0,1
../kbl_data/2023-2024,S43G01N257,창원 LG,Away,후안 텔로,4,2,3,66.7,0,0,0.0,2,3,66.7,0,0,0.0,0,0,0,0,0,0,0,0,0,2
../kbl_data/2023-2024,S43G01N258,원주 DB,Home,서민수,5,1,1,100.0,1,2,50.0,2,3,66.7,0,0,0.0,1,1,2,0,0,0,0,0,0,1
../kbl_data/2023-2024,S43G01N258,원주 DB,Home,김영현,3,0,2,0.0,1,4,25.0,1,6,16.7,0,0,0.0,0,1,1,0,1,0,0,0,1,3
../kbl_data/2023-2024,S43G01N258,원주 DB,Home,최승욱,0,0,2,0.0,0,1,0.0,0,3,0.0,0,2,0.0,1,0,1,1,1,0,0,0,0,2
../kbl_data/2023-2024,S43G01N258,원주 DB,Home,유현준,3,0,2,0.0,1,4,25.0,1,6,16.7,0,0,0.0,0,2,2,0,0,0,0,0,1,1
../kbl_data/2023-2024,S43G01N258,원주 DB,Home,김훈,10,2,2,100.0,2,3,66.7,4,5,80.0,0,0,0.0,1,2,3,0,2,0,1,0,0,1
../kbl_data/2023-2024,S43G01N258,원주 DB,Home,이윤수,0,0,0,0.0,0,0,0.0,0,0,0.0,0,0,0.0,0,0,0,0,0,0,0,0,0,0
../kbl_data/2023-2024,S43G01N258,원주 DB,Home,이용우,5,1,3,33.3,1,5,20.0,2,8,25.0,0,0,0.0,3,2,5,4,1,0,0,0,0,0
../kbl_data/2023-2024,S43G01N258,원주 DB,Home,이선 알바노,33,10,18,55.6,3,12,25.0,13,30,43.3,4,7,57.1,2,3,5,12,0,2,0,0,1,3
../kbl_data/2023-2024,S43G01N258,원주 DB,Home,박인웅,7,2,3,66.7,1,5,20.0,3,8,37.5,0,0,0.0,0,1,1,2,0,0,0,0,0,0
../kbl_data/2023-2024,S43G01N258,원주 DB,Home,박승재,0,0,0,0.0,0,0,0.0,0,0,0.0,0,0,0.0,0,0,0,0,0,0,0,0,0,0
../kbl_data/2023-2024,S43G01N258,원주 DB,Home,최승빈,0,0,0,0.0,0,0,0.0,0,0,0.0,0,0,0.0,0,0,0,0,0,0,0,0,0,0
../kbl_data/2023-2024,S43G01N258,원주 DB,Home,제프 위디,20,7,11,63.6,2,4,50.0,9,15,60.0,0,0,0.0,3,15,18,2,1,2,0,1,4,4
../kbl_data/2023-2024,S43G01N258,고양 소노,Away,김강선,4,2,3,66.7,0,1,0.0,2,4,50.0,0,0,0.0,0,0,0,4,1,0,0,0,1,0
../kbl_data/2023-2024,S43G01N258,고양 소노,Away,함준후,7,2,2,100.0,1,1,100.0,3,3,100.0,0,0,0.0,1,4,5,4,0,0,1,0,1,3
../kbl_data/2023-2024,S43G01N258,고양 소노,Away,김민욱,3,0,1,0.0,1,1,100.0,1,2,50.0,0,0,0.0,0,2,2,0,0,0,0,0,0,1
../kbl_data/2023-2024,S43G01N258,고양 소노,Away,김지후,13,5,8,62.5,1,8,12.5,6,16,37.5,0,2,0.0,0,3,3,1,0,0,0,0,0,2
../kbl_data/2023-2024,S43G01N258,고양 소노,Away,김진용,0,0,0,0.0,0,0,0.0,0,0,0.0,0,0,0.0,0,0,0,0,0,0,0,0,0,0
../kbl_data/2023-2024,S43G01N258,고양 소노,Away,치나누 오누아쿠,39,17,28,60.7,1,7,14.3,18,35,51.4,2,4,50.0,7,24,31,8,3,1,0,1,5,2
../kbl_data/2023-2024,S43G01N258,고양 소노,Away,이진석,0,0,0,0.0,0,0,0.0,0,0,0.0,0,0,0.0,0,0,0,0,0,0,0,0,0,0
../kbl_data/2023-2024,S43G01N258,고양 소노,Away,이정현,15,6,11,54.5,0,2,0.0,6,13,46.2,3,5,60.0,1,2,3,7,0,0,1,0,3,5
../kbl_data/2023-2024,S43G01N258,고양 소노,Away,백지웅,3,0,0,0.0,1,5,20.0,1,5,20.0,0,0,0.0,1,0,1,0,0,0,0,0,0,3
../kbl_data/2023-2024,S43G01N258,고양 소노,Away,조재우,0,0,0,0.0,0,0,0.0,0,0,0.0,0,0,0.0,0,0,0,0,0,0,0,0,0,0
../kbl_data/2023-2024,S43G01N258,고양 소노,Away,민기남,0,0,0,0.0,0,0,0.0,0,0,0.0,0,0,0.0,0,1,1,1,1,0,0,0,0,1
../kbl_data/2023-2024,S43G01N258,고양 소노,Away,알렉스 카바노,0,0,0,0.0,0,0,0.0,0,0,0.0,0,0,0.0,0,0,0,0,0,0,0,0,0,0
../kbl_data/2023-2024,S43G01N259,서울 삼성,Home,이정현,23,5,10,50.0,3,8,37.5,8,18,44.4,4,5,80.0,1,4,5,8,2,0,0,0,1,4
../kbl_data/2023-2024,S43G01N259,서울 삼성,Home,홍경기,9,3,6,50.0,1,2,50.0,4,8,50.0,0,0,0.0,0,2,2,0,0,0,0,0,0,4
../kbl_data/2023-2024,S43G01N259,서울 삼성,Home,김승원,0,0,0,0.0,0,0,0.0,0,0,0.0,0,0,0.0,0,0,0,0,0,0,0,0,0,0
../kbl_data/2023-2024,S43G01N259,서울 삼성,Home,이동엽,4,0,1,0.0,1,3,33.3,1,4,25.0,1,2,50.0,0,6,6,4,1,0,0,0,1,2
../kbl_data/2023-2024,S43G01N259,서울 삼성,Home,최승욱,4,2,2,100.0,0,0,0.0,2,2,100.0,0,0,0.0,0,1,1,0,0,0,0,0,1,1
../kbl_data/2023-2024,S43G01N259,서울 삼성,Home,윤성원,8,1,3,33.3,2,4,50.0,3,7,42.9,0,0,0.0,1,1,2,3,0,0,0,0,0,3
../kbl_data/2023-2024,S43G01N259,서울 삼성,Home,차민석,12,4,7,57.1,1,3,33.3,5,10,50.0,1,2,50.0,3,4,7,0,0,0,0,0,0,3
../kbl_data/2023-2024,S43G01N259,서울 삼성,Home,신동혁,8,1,1,100.0,2,4,50.0,3,5,60.0,0,0,0.0,0,0,0,0,1,0,0,0,0,2
../kbl_data/2023-2024,S43G01N259,서울 삼성,Home,조준희,0,0,0,0.0,0,0,0.0,0,0,0.0,0,0,0.0,0,0,0,0,0,0,0,0,0,0
../kbl_data/2023-2024,S43G01N259,서울 삼성,Home,아반 나바,0,0,0,0.0,0,0,0.0,0,0,0.0,0,0,0.0,0,0,0,0,0,0,0,0,0,0
../kbl_data/2023-2024,S43G01N259,서울 삼성,Home,이스마엘 레인,2,1,2,50.0,0,1,0.0,1,3,33.3,0,0,0.0,1,0,1,0,0,1,0,0,0,0
../kbl_data/2023-2024,S43G01N259,서울 삼성,Home,코피 코번,26,12,17,70.6,0,0,0.0,12,17,70.6,2,6,33.3,7,9,16,4,1,1,0,0,1,2
../kbl_data/2023-2024,S43G01N259,부산 KCC,Away,정창영,12,4,8,50.0,1,6,16.7,5,14,35.7,1,3,33.3,2,1,3,6,0,1,0,0,1,4
../kbl_data/2023-2024,S43G01N259,부산 KCC,Away,라건아,34,10,14,71.4,3,5,60.0,13,19,68.4,5,6,83.3,3,6,9,0,1,2,0,0,1,5
../kbl_data/2023-2024,S43G01N259,부산 KCC,Away,전준범,0,0,1,0.0,0,0,0.0,0,1,0.0,0,0,0.0,0,0,0,0,0,0,0,0,0,2
../kbl_data/2023-2024,S43G01N259,부산 KCC,Away,이승현,8,3,3,100.0,0,1,0.0,3,4,75.0,2,4,50.0,2,2,4,6,0,0,0,0,0,1
../kbl_data/2023-2024,S43G01N259,부산 KCC,Away,이호현,20,6,10,60.0,2,2,100.0,8,12,66.7,2,2,100.0,0,3,3,2,0,0,0,0,3,3
../kbl_data/2023-2024,S43G01N259,부산 KCC,Away,곽정훈,0,0,0,0.0,0,1,0.0,0,1,0.0,0,0,0.0,0,1,1,0,0,0,0,0,0,0
../kbl_data/2023-2024,S43G01N259,부산 KCC,Away,이근휘,6,0,1,0.0,1,7,14.3,1,8,12.5,3,4,75.0,0,3,3,0,1,0,0,0,1,1
../kbl_data/2023-2024,S43G01N259,부산 KCC,Away,김동현,0,0,0,0.0,0,0,0.0,0,0,0.0,0,0,0.0,0,0,0,0,0,0,0,0,0,0
../kbl_data/2023-2024,S43G01N259,부산 KCC,Away,여준형,0,0,0,0.0,0,0,0.0,0,0,0.0,0,0,0.0,1,0,1,0,0,0,0,0,0,0
../kbl_data/2023-2024,S43G01N259,부산 KCC,Away,캘빈 제프리 에피스톨라,3,1,1,100.0,0,0,0.0,1,1,100.0,1,2,50.0,0,0,0,0,0,0,0,0,0,0
../kbl_data/2023-2024,S43G01N259,부산 KCC,Away,이주영,0,0,0,0.0,0,0,0.0,0,0,0.0,0,0,0.0,0,0,0,0,0,0,0,0,0,0
../kbl_data/2023-2024,S43G01N259,부산 KCC,Away,알리제 드숀 존슨,4,2,3,66.7,0,2,0.0,2,5,40.0,0,0,0.0,1,3,4,0,0,0,0,0,1,1
../kbl_data/2023-2024,S43G01N260,서울 SK,Home,양우섭,2,1,2,50.0,0,4,0.0,1,6,16.7,0,0,0.0,1,2,3,3,0,0,0,0,2,2
../kbl_data/2023-2024,S43G01N260,서울 SK,Home,허일영,15,3,5,60.0,3,9,33.3,6,14,42.9,0,0,0.0,1,1,2,1,0,0,0,0,2,4
../kbl_data/2023-2024,S43G01N260,서울 SK,Home,김선형,10,1,6,16.7,2,6,33.3,3,12,25.0,2,2,100.0,1,1,2,4,4,0,0,0,0,1
../kbl_data/2023-2024,S43G01N260,서울 SK,Home,오세근,4,1,4,25.0,0,3,0.0,1,7,14.3,2,2,100.0,1,7,8,1,2,2,0,0,0,0
../kbl_data/2023-2024,S43G01N260,서울 SK,Home,리온 윌리엄스,0,0,1,0.0,0,1,0.0,0,2,0.0,0,0,0.0,0,1,1,0,0,0,0,0,0,2
../kbl_data/2023-2024,S43G01N260,서울 SK,Home,최원혁,0,0,0,0.0,0,2,0.0,0,2,0.0,0,0,0.0,1,1,2,1,0,0,1,0,0,0
../kbl_data/2023-2024,S43G01N260,서울 SK,Home,자밀 워니,24,9,13,69.2,1,3,33.3,10,16,62.5,3,4,75.0,2,6,8,6,0,0,0,1,3,1
../kbl_data/2023-2024,S43G01N260,서울 SK,Home,전성환,5,1,1,100.0,1,3,33.3,2,4,50.0,0,0,0.0,1,0,1,1,0,0,0,0,3,3
../kbl_data/2023-2024,S43G01N260,서울 SK,Home,김형빈,14,1,3,33.3,2,3,66.7,3,6,50.0,6,6,100.0,0,4,4,0,1,0,0,0,1,5
../kbl_data/2023-2024,S43G01N260,서울 SK,Home,선상혁,4,2,2,100.0,0,0,0.0,2,2,100.0,0,0,0.0,0,2,2,0,0,0,0,0,0,2
../kbl_data/2023-2024,S43G01N260,서울 SK,Home,문가온,2,1,1,100.0,0,1,0.0,1,2,50.0,0,0,0.0,0,1,1,0,2,0,0,0,0,0
../kbl_data/2023-2024,S43G01N260,서울 SK,Home,김건우,0,0,0,0.0,0,0,0.0,0,0,0.0,0,0,0.0,0,0,0,0,0,0,0,0,0,0
../kbl_data/2023-2024,S43G01N260,수원 KT,Away,한희원,2,1,2,50.0,0,3,0.0,1,5,20.0,0,0,0.0,0,3,3,1,0,0,0,0,1,1
../kbl_data/2023-2024,S43G01N260,수원 KT,Away,최창진,0,0,0,0.0,0,0,0.0,0,0,0.0,0,0,0.0,0,0,0,0,0,0,0,0,0,0
../kbl_data/2023-2024,S43G01N260,수원 KT,Away,문성곤,9,3,3,100.0,1,3,33.3,4,6,66.7,0,0,0.0,0,7,7,5,2,2,0,0,1,2
../kbl_data/2023-2024,S43G01N260,수원 KT,Away,이현석,0,0,0,0.0,0,2,0.0,0,2,0.0,0,0,0.0,0,1,1,0,0,0,0,0,0,1
../kbl_data/2023-2024,S43G01N260,수원 KT,Away,정성우,8,2,3,66.7,1,1,100.0,3,4,75.0,1,1,100.0,0,2,2,4,1,0,1,0,1,4
../kbl_data/2023-2024,S43G01N260,수원 KT,Away,최성모,2,1,1,100.0,0,0,0.0,1,1,100.0,0,0,0.0,0,0,0,0,1,0,0,0,1,0
../kbl_data/2023-2024,S43G01N260,수원 KT,Away,허훈,23,6,10,60.0,3,6,50.0,9,16,56.2,2,3,66.7,0,2,2,3,0,1,0,0,2,2
../kbl_data/2023-2024,S43G01N260,수원 KT,Away,하윤기,10,4,10,40.0,0,0,0.0,4,10,40.0,2,5,40.0,4,2,6,1,0,0,0,1,1,2
../kbl_data/2023-2024,S43G01N260,수원 KT,Away,이두원,2,1,2,50.0,0,0,0.0,1,2,50.0,0,0,0.0,1,0,1,0,0,0,0,0,1,1
../kbl_data/2023-2024,S43G01N260,수원 KT,Away,문정현,0,0,1,0.0,0,1,0.0,0,2,0.0,0,0,0.0,1,1,2,2,0,0,0,0,1,1
../kbl_data/2023-2024,S43G01N260,수원 KT,Away,마이클 에릭,2,1,2,50.0,0,0,0.0,1,2,50.0,0,2,0.0,0,1,1,0,0,1,0,1,0,0
../kbl_data/2023-2024,S43G01N260,수원 KT,Away,패리스 배스,41,9,12,75.0,7,11,63.6,16,23,69.6,2,3,66.7,2,11,13,6,4,1,0,3,4,1
../kbl_data/2023-2024,S43G01N261,부산 KCC,Home,정창영,6,3,4,75.0,0,0,0.0,3,4,75.0,0,0,0.0,0,0,0,0,0,1,0,0,0,0
../kbl_data/2023-2024,S43G01N261,부산 KCC,Home,라건아,0,0,0,0.0,0,0,0.0,0,0,0.0,0,0,0.0,0,0,0,0,0,0,0,0,0,0
../kbl_data/2023-2024,S43G01N261,부산 KCC,Home,이승현,6,2,4,50.0,0,1,0.0,2,5,40.0,2,2,100.0,0,1,1,1,0,0,0,0,0,1
../kbl_data/2023-2024,S43G01N261,부산 KCC,Home,이호현,2,1,3,33.3,0,2,0.0,1,5,20.0,0,0,0.0,0,1,1,1,0,0,0,0,2,1
../kbl_data/2023-2024,S43G01N261,부산 KCC,Home,곽정훈,16,1,4,25.0,4,7,57.1,5,11,45.5,2,2,100.0,1,6,7,1,0,0,1,0,3,3
../kbl_data/2023-2024,S43G01N261,부산 KCC,Home,이근휘,6,0,0,0.0,2,5,40.0,2,5,40.0,0,0,0.0,0,1,1,0,0,0,0,0,0,2
../kbl_data/2023-2024,S43G01N261,부산 KCC,Home,김동현,0,0,1,0.0,0,1,0.0,0,2,0.0,0,0,0.0,0,1,1,0,1,0,0,0,3,2
../kbl_data/2023-2024,S43G01N261,부산 KCC,Home,서정현,6,3,6,50.0,0,0,0.0,3,6,50.0,0,0,0.0,4,3,7,1,1,0,0,0,1,2
../kbl_data/2023-2024,S43G01N261,부산 KCC,Home,여준형,0,0,1,0.0,0,2,0.0,0,3,0.0,0,0,0.0,0,2,2,1,1,0,0,0,0,4
../kbl_data/2023-2024,S43G01N261,부산 KCC,Home,캘빈 제프리 에피스톨라,9,3,4,75.0,1,4,25.0,4,8,50.0,0,0,0.0,0,0,0,2,1,0,0,0,0,2
../kbl_data/2023-2024,S43G01N261,부산 KCC,Home,이주영,4,2,5,40.0,0,2,0.0,2,7,28.6,0,0,0.0,0,2,2,0,1,0,0,0,1,1
../kbl_data/2023-2024,S43G01N261,부산 KCC,Home,알리제 드숀 존슨,36,12,19,63.2,1,4,25.0,13,23,56.5,9,15,60.0,8,21,29,8,0,0,0,0,4,4
../kbl_data/2023-2024,S43G01N261,안양 정관장,Away,배병준,4,2,3,66.7,0,3,0.0,2,6,33.3,0,0,0.0,0,1,1,1,1,0,0,0,0,0
../kbl_data/2023-2024,S43G01N261,안양 정관장,Away,정효근,17,6,6,100.0,0,2,0.0,6,8,75.0,5,7,71.4,1,7,8,0,0,0,0,0,0,2
../kbl_data/2023-2024,S43G01N261,안양 정관장,Away,이종현,4,2,2,100.0,0,2,0.0,2,4,50.0,0,0,0.0,0,4,4,1,0,1,0,0,0,2
../kbl_data/2023-2024,S43G01N261,안양 정관장,Away,박지훈,14,6,7,85.7,0,2,0.0,6,9,66.7,2,6,33.3,0,2,2,6,4,1,1,0,1,2
../kbl_data/2023-2024,S43G01N261,안양 정관장,Away,최성원,10,5,8,62.5,0,2,0.0,5,10,50.0,0,0,0.0,0,2,2,6,2,0,0,0,1,0
../kbl_data/2023-2024,S43G01N261,안양 정관장,Away,이우정,0,0,1,0.0,0,4,0.0,0,5,0.0,0,0,0.0,0,0,0,4,0,0,0,0,1,3
../kbl_data/2023-2024,S43G01N261,안양 정관장,Away,김경원,6,3,3,100.0,0,1,0.0,3,4,75.0,0,0,0.0,0,2,2,0,1,1,0,0,0,1
../kbl_data/2023-2024,S43G01N261,안양 정관장,Away,렌즈 아반도,6,3,5,60.0,0,3,0.0,3,8,37.5,0,0,0.0,1,2,3,1,0,0,0,0,1,3
../kbl_data/2023-2024,S43G01N261,안양 정관장,Away,표승빈,0,0,0,0.0,0,0,0.0,0,0,0.0,0,0,0.0,0,0,0,0,0,0,0,0,0,0
../kbl_data/2023-2024,S43G01N261,안양 정관장,Away,나성호,0,0,1,0.0,0,0,0.0,0,1,0.0,0,0,0.0,0,0,0,0,0,0,0,0,0,1
../kbl_data/2023-2024,S43G01N261,안양 정관장,Away,로버트 카터,13,4,7,57.1,1,3,33.3,5,10,50.0,2,2,100.0,1,5,6,0,0,1,0,0,0,0
../kbl_data/2023-2024,S43G01N261,안양 정관장,Away,자밀 윌슨,14,2,2,100.0,3,7,42.9,5,9,55.6,1,1,100.0,0,3,3,4,1,1,0,0,3,5
../kbl_data/2023-2024,S43G01N262,대구 한국가스공사,Home,김동량,4,2,3,66.7,0,0,0.0,2,3,66.7,0,0,0.0,0,0,0,0,0,0,0,0,0,1
../kbl_data/2023-2024,S43G01N262,대구 한국가스공사,Home,박지훈,15,3,5,60.0,3,5,60.0,6,10,60.0,0,0,0.0,2,3,5,2,0,0,0,0,2,3
../kbl_data/2023-2024,S43G01N262,대구 한국가스공사,Home,김낙현,4,2,3,66.7,0,2,0.0,2,5,40.0,0,0,0.0,0,1,1,5,1,0,0,0,1,1
../kbl_data/2023-2024,S43G01N262,대구 한국가스공사,Home,양준우,0,0,0,0.0,0,0,0.0,0,0,0.0,0,0,0.0,0,0,0,0,0,0,0,0,0,0
../kbl_data/2023-2024,S43G01N262,대구 한국가스공사,Home,이도헌,2,0,0,0.0,0,0,0.0,0,0,0.0,2,2,100.0,0,1,1,0,0,0,0,0,0,1
../kbl_data/2023-2024,S43G01N262,대구 한국가스공사,Home,앤드류 니콜슨,27,7,14,50.0,2,8,25.0,9,22,40.9,7,8,87.5,1,11,12,0,2,0,0,0,1,2
../kbl_data/2023-2024,S43G01N262,대구 한국가스공사,Home,신승민,6,3,7,42.9,0,2,0.0,3,9,33.3,0,0,0.0,1,5,6,3,1,0,0,0,0,1
../kbl_data/2023-2024,S43G01N262,대구 한국가스공사,Home,샘조세프 벨란겔,10,4,7,57.1,0,0,0.0,4,7,57.1,2,4,50.0,2,2,4,4,2,0,1,0,1,2
../kbl_data/2023-2024,S43G01N262,대구 한국가스공사,Home,염유성,0,0,0,0.0,0,0,0.0,0,0,0.0,0,0,0.0,0,0,0,0,0,0,0,0,0,0
../kbl_data/2023-2024,S43G01N262,대구 한국가스공사,Home,안세영,0,0,0,0.0,0,0,0.0,0,0,0.0,0,0,0.0,0,0,0,0,0,0,0,0,0,0
../kbl_data/2023-2024,S43G01N262,대구 한국가스공사,Home,신주영,12,2,5,40.0,1,3,33.3,3,8,37.5,5,8,62.5,0,3,3,0,0,0,0,0,1,5
../kbl_data/2023-2024,S43G01N262,대구 한국가스공사,Home,듀반 맥스웰,2,0,0,0.0,0,0,0.0,0,0,0.0,2,2,100.0,0,1,1,1,0,0,0,0,0,0
../kbl_data/2023-2024,S43G01N262,울산 현대모비스,Away,함지훈,7,1,4,25.0,1,3,33.3,2,7,28.6,2,2,100.0,1,6,7,0,0,0,0,0,1,3
../kbl_data/2023-2024,S43G01N262,울산 현대모비스,Away,김현민,0,0,0,0.0,0,0,0.0,0,0,0.0,0,0,0.0,0,0,0,0,0,0,0,0,0,0
../kbl_data/2023-2024,S43G01N262,울산 현대모비스,Away,최진수,0,0,0,0.0,0,0,0.0,0,0,0.0,0,0,0.0,0,0,0,2,0,0,0,0,2,1
../kbl_data/2023-2024,S43G01N262,울산 현대모비스,Away,김현수,0,0,0,0.0,0,0,0.0,0,0,0.0,0,0,0.0,0,0,0,0,0,0,0,0,0,0
../kbl_data/2023-2024,S43G01N262,울산 현대모비스,Away,김지완,5,1,1,100.0,1,2,50.0,2,3,66.7,0,0,0.0,1,1,2,4,0,0,0,0,2,2
../kbl_data/2023-2024,S43G01N262,울산 현대모비스,Away,김준일,0,0,3,0.0,0,0,0.0,0,3,0.0,0,0,0.0,0,0,0,0,0,0,0,0,0,0
../kbl_data/2023-2024,S43G01N262,울산 현대모비스,Away,김국찬,0,0,1,0.0,0,3,0.0,0,4,0.0,0,0,0.0,0,0,0,0,0,0,0,0,0,3
../kbl_data/2023-2024,S43G01N262,울산 현대모비스,Away,이우석,19,8,14,57.1,1,3,33.3,9,17,52.9,0,0,0.0,1,6,7,2,1,0,0,0,0,3
../kbl_data/2023-2024,S43G01N262,울산 현대모비스,Away,신민석,10,5,6,83.3,0,2,0.0,5,8,62.5,0,0,0.0,3,3,6,3,2,0,0,0,1,4
../kbl_data/2023-2024,S43G01N262,울산 현대모비스,Away,게이지 프림,23,10,18,55.6,0,1,0.0,10,19,52.6,3,3,100.0,1,9,10,0,0,0,0,1,1,2
../kbl_data/2023-2024,S43G01N262,울산 현대모비스,Away,김태완,5,1,2,50.0,1,1,100.0,2,3,66.7,0,0,0.0,0,1,1,1,0,0,0,0,1,3
../kbl_data/2023-2024,S43G01N262,울산 현대모비스,Away,미구엘 안드레 옥존,9,3,3,100.0,1,5,20.0,4,8,50.0,0,0,0.0,0,3,3,4,1,0,0,0,0,2
../kbl_data/2023-2024,S43G01N263,수원 KT,Home,한희원,2,0,1,0.0,0,2,0.0,0,3,0.0,2,3,66.7,1,5,6,1,0,0,0,0,1,3
../kbl_data/2023-2024,S43G01N263,수원 KT,Home,최창진,0,0,0,0.0,0,2,0.0,0,2,0.0,0,0,0.0,1,0,1,0,0,0,0,0,0,0
../kbl_data/2023-2024,S43G01N263,수원 KT,Home,문성곤,3,0,0,0.0,1,5,20.0,1,5,20.0,0,0,0.0,1,2,3,2,2,0,0,0,0,1
../kbl_data/2023-2024,S43G01N263,수원 KT,Home,이현석,0,0,0,0.0,0,0,0.0,0,0,0.0,0,0,0.0,0,0,0,0,0,0,0,0,0,0
../kbl_data/2023-2024,S43G01N263,수원 KT,Home,정성우,5,1,2,50.0,1,2,50.0,2,4,50.0,0,0,0.0,0,0,0,2,1,0,0,0,1,1
../kbl_data/2023-2024,S43G01N263,수원 KT,Home,최성모,5,1,2,50.0,1,3,33.3,2,5,40.0,0,0,0.0,0,1,1,0,0,0,0,0,0,1
../kbl_data/2023-2024,S43G01N263,수원 KT,Home,허훈,23,3,6,50.0,4,12,33.3,7,18,38.9,5,5,100.0,1,1,2,4,1,0,0,0,2,1
../kbl_data/2023-2024,S43G01N263,수원 KT,Home,박찬호,4,2,3,66.7,0,0,0.0,2,3,66.7,0,1,0.0,1,1,2,1,0,1,0,0,0,2
../kbl_data/2023-2024,S43G01N263,수원 KT,Home,이두원,4,1,7,14.3,0,0,0.0,1,7,14.3,2,2,100.0,5,2,7,0,0,1,0,0,2,4
../kbl_data/2023-2024,S43G01N263,수원 KT,Home,문정현,2,1,4,25.0,0,2,0.0,1,6,16.7,0,0,0.0,3,2,5,2,0,0,0,0,1,1
../kbl_data/2023-2024,S43G01N263,수원 KT,Home,마이클 에릭,14,5,8,62.5,0,0,0.0,5,8,62.5,4,6,66.7,4,4,8,0,2,0,0,2,2,2
../kbl_data/2023-2024,S43G01N263,수원 KT,Home,패리스 배스,19,6,9,66.7,2,9,22.2,8,18,44.4,1,2,50.0,6,4,10,3,1,0,0,4,2,3
../kbl_data/2023-2024,S43G01N263,안양 정관장,Away,정준원,12,4,5,80.0,1,3,33.3,5,8,62.5,1,2,50.0,1,0,1,3,1,0,0,0,1,1
../kbl_data/2023-2024,S43G01N263,안양 정관장,Away,배병준,5,1,2,50.0,1,5,20.0,2,7,28.6,0,0,0.0,0,0,0,2,0,0,0,0,1,0
../kbl_data/2023-2024,S43G01N263,안양 정관장,Away,정효근,7,2,4,50.0,1,3,33.3,3,7,42.9,0,0,0.0,4,1,5,0,0,0,0,0,2,2
../kbl_data/2023-2024,S43G01N263,안양 정관장,Away,이종현,2,0,1,0.0,0,0,0.0,0,1,0.0,2,2,100.0,1,2,3,0,1,0,0,0,1,3
../kbl_data/2023-2024,S43G01N263,안양 정관장,Away,박지훈,7,2,3,66.7,1,7,14.3,3,10,30.0,0,0,0.0,0,5,5,5,1,0,0,0,1,2
../kbl_data/2023-2024,S43G01N263,안양 정관장,Away,이우정,4,2,4,50.0,0,2,0.0,2,6,33.3,0,0,0.0,1,1,2,2,0,0,0,0,1,1
../kbl_data/2023-2024,S43G01N263,안양 정관장,Away,김경원,4,1,4,25.0,0,0,0.0,1,4,25.0,2,2,100.0,3,5,8,2,1,3,1,0,0,3
../kbl_data/2023-2024,S43G01N263,안양 정관장,Away,렌즈 아반도,18,5,6,83.3,1,3,33.3,6,9,66.7,5,6,83.3,1,2,3,4,1,4,1,2,4,1
../kbl_data/2023-2024,S43G01N263,안양 정관장,Away,고찬혁,0,0,0,0.0,0,0,0.0,0,0,0.0,0,0,0.0,0,0,0,0,0,0,0,0,0,0
../kbl_data/2023-2024,S43G01N263,안양 정관장,Away,나성호,0,0,0,0.0,0,0,0.0,0,0,0.0,0,0,0.0,0,0,0,0,0,0,0,0,0,0
../kbl_data/2023-2024,S43G01N263,안양 정관장,Away,로버트 카터,16,3,5,60.0,3,6,50.0,6,11,54.5,1,2,50.0,1,4,5,5,2,0,0,0,0,3
../kbl_data/2023-2024,S43G01N263,안양 정관장,Away,자밀 윌슨,8,3,5,60.0,0,2,0.0,3,7,42.9,2,2,100.0,0,3,3,2,1,2,0,0,1,1
../kbl_data/2023-2024,S43G01N264,서울 SK,Home,양우섭,4,2,2,100.0,0,2,0.0,2,4,50.0,0,0,0.0,0,2,2,1,0,0,0,0,0,0
../kbl_data/2023-2024,S43G01N264,서울 SK,Home,허일영,5,1,1,100.0,0,2,0.0,1,3,33.3,3,4,75.0,1,2,3,0,1,0,0,0,2,2
../kbl_data/2023-2024,S43G01N264,서울 SK,Home,송창용,2,0,0,0.0,0,1,0.0,0,1,0.0,2,2,100.0,0,3,3,0,0,0,0,0,0,4
../kbl_data/2023-2024,S43G01N264,서울 SK,Home,김선형,12,4,6,66.7,1,5,20.0,5,11,45.5,1,2,50.0,0,2,2,4,0,0,0,0,2,2
../kbl_data/2023-2024,S43G01N264,서울 SK,Home,오세근,3,0,1,0.0,1,2,50.0,1,3,33.3,0,0,0.0,1,1,2,1,0,0,1,0,0,0
../kbl_data/2023-2024,S43G01N264,서울 SK,Home,최부경,6,2,3,66.7,0,0,0.0,2,3,66.7,2,2,100.0,0,1,1,2,1,1,1,0,2,3
../kbl_data/2023-2024,S43G01N264,서울 SK,Home,리온 윌리엄스,11,4,4,100.0,1,1,100.0,5,5,100.0,0,0,0.0,1,2,3,0,0,1,0,0,0,4
../kbl_data/2023-2024,S43G01N264,서울 SK,Home,자밀 워니,21,8,19,42.1,0,3,0.0,8,22,36.4,5,6,83.3,4,12,16,4,0,1,0,1,3,2
../kbl_data/2023-2024,S43G01N264,서울 SK,Home,전성환,2,1,2,50.0,0,0,0.0,1,2,50.0,0,0,0.0,0,1,1,0,0,0,0,0,0,0
../kbl_data/2023-2024,S43G01N264,서울 SK,Home,김형빈,3,1,3,33.3,0,2,0.0,1,5,20.0,1,1,100.0,0,3,3,1,0,0,0,0,0,3
../kbl_data/2023-2024,S43G01N264,서울 SK,Home,오재현,11,1,4,25.0,2,2,100.0,3,6,50.0,3,3,100.0,1,4,5,4,2,0,0,0,2,5
../kbl_data/2023-2024,S43G01N264,서울 SK,Home,문가온,2,1,1,100.0,0,0,0.0,1,1,100.0,0,0,0.0,1,0,1,0,0,0,0,0,0,0
../kbl_data/2023-2024,S43G01N264,창원 LG,Away,이관희,2,1,1,100.0,0,6,0.0,1,7,14.3,0,0,0.0,0,2,2,0,0,0,0,0,0,2
../kbl_data/2023-2024,S43G01N264,창원 LG,Away,정희재,6,2,2,100.0,0,2,0.0,2,4,50.0,2,2,100.0,2,0,2,2,0,0,0,0,0,2
../kbl_data/2023-2024,S43G01N264,창원 LG,Away,임동섭,1,0,0,0.0,0,5,0.0,0,5,0.0,1,1,100.0,0,0,0,0,0,0,0,0,0,2
../kbl_data/2023-2024,S43G01N264,창원 LG,Away,이재도,4,2,3,66.7,0,1,0.0,2,4,50.0,0,0,0.0,0,3,3,2,1,0,0,0,3,2
../kbl_data/2023-2024,S43G01N264,창원 LG,Away,정인덕,0,0,0,0.0,0,1,0.0,0,1,0.0,0,0,0.0,0,2,2,0,0,0,0,0,0,0
../kbl_data/2023-2024,S43G01N264,창원 LG,Away,양홍석,19,3,4,75.0,4,9,44.4,7,13,53.8,1,1,100.0,0,8,8,2,2,0,0,0,1,3
../kbl_data/2023-2024,S43G01N264,창원 LG,Away,박정현,5,1,2,50.0,0,0,0.0,1,2,50.0,3,3,100.0,0,1,1,0,0,0,0,0,0,0
../kbl_data/2023-2024,S43G01N264,창원 LG,Away,아셈 마레이,10,3,7,42.9,0,1,0.0,3,8,37.5,4,10,40.0,1,6,7,2,3,0,0,1,3,2
../kbl_data/2023-2024,S43G01N264,창원 LG,Away,저스틴 구탕,4,0,2,0.0,0,0,0.0,0,2,0.0,4,6,66.7,0,1,1,2,0,0,0,0,1,2
../kbl_data/2023-2024,S43G01N264,창원 LG,Away,양준석,7,2,3,66.7,1,3,33.3,3,6,50.0,0,0,0.0,4,0,4,2,1,0,1,0,0,2
../kbl_data/2023-2024,S43G01N264,창원 LG,Away,유기상,2,1,2,50.0,0,2,0.0,1,4,25.0,0,0,0.0,0,0,0,1,0,1,0,0,1,1
../kbl_data/2023-2024,S43G01N264,창원 LG,Away,후안 텔로,2,1,6,16.7,0,2,0.0,1,8,12.5,0,2,0.0,2,3,5,1,1,0,0,0,1,3
../kbl_data/2023-2024,S43G01N265,부산 KCC,Home,정창영,11,2,4,50.0,1,1,100.0,3,5,60.0,4,4,100.0,0,3,3,6,0,0,0,0,1,3
../kbl_data/2023-2024,S43G01N265,부산 KCC,Home,라건아,43,18,20,90.0,1,2,50.0,19,22,86.4,4,5,80.0,4,6,10,2,0,0,0,1,2,4
../kbl_data/2023-2024,S43G01N265,부산 KCC,Home,허웅,8,4,11,36.4,0,1,0.0,4,12,33.3,0,0,0.0,0,1,1,3,1,0,1,0,2,3
../kbl_data/2023-2024,S43G01N265,부산 KCC,Home,이승현,10,5,9,55.6,0,0,0.0,5,9,55.6,0,0,0.0,0,4,4,3,0,0,0,0,0,1
../kbl_data/2023-2024,S43G01N265,부산 KCC,Home,이호현,12,6,8,75.0,0,2,0.0,6,10,60.0,0,1,0.0,1,0,1,5,3,0,0,0,0,3
../kbl_data/2023-2024,S43G01N265,부산 KCC,Home,최준용,14,4,6,66.7,2,3,66.7,6,9,66.7,0,0,0.0,0,4,4,2,0,0,1,0,2,1
../kbl_data/2023-2024,S43G01N265,부산 KCC,Home,곽정훈,0,0,0,0.0,0,0,0.0,0,0,0.0,0,0,0.0,0,0,0,0,1,0,0,0,1,1
../kbl_data/2023-2024,S43G01N265,부산 KCC,Home,이근휘,2,1,1,100.0,0,1,0.0,1,2,50.0,0,0,0.0,0,2,2,2,2,0,0,0,1,1
../kbl_data/2023-2024,S43G01N265,부산 KCC,Home,여준형,0,0,0,0.0,0,0,0.0,0,0,0.0,0,0,0.0,0,0,0,0,0,0,0,0,0,0
../kbl_data/2023-2024,S43G01N265,부산 KCC,Home,캘빈 제프리 에피스톨라,3,1,1,100.0,0,0,0.0,1,1,100.0,1,2,50.0,0,1,1,0,1,0,0,0,0,3
../kbl_data/2023-2024,S43G01N265,부산 KCC,Home,이주영,0,0,1,0.0,0,0,0.0,0,1,0.0,0,0,0.0,0,0,0,0,0,0,0,0,1,0
../kbl_data/2023-2024,S43G01N265,부산 KCC,Home,알리제 드숀 존슨,7,3,5,60.0,0,1,0.0,3,6,50.0,1,1,100.0,2,1,3,3,3,0,0,0,0,1
../kbl_data/2023-2024,S43G01N265,울산 현대모비스,Away,함지훈,3,0,1,0.0,1,2,50.0,1,3,33.3,0,0,0.0,0,0,0,1,0,1,0,0,0,0
../kbl_data/2023-2024,S43G01N265,울산 현대모비스,Away,최진수,4,0,1,0.0,0,1,0.0,0,2,0.0,4,4,100.0,0,0,0,2,1,0,0,0,0,0
../kbl_data/2023-2024,S43G01N265,울산 현대모비스,Away,장재석,4,2,3,66.7,0,0,0.0,2,3,66.7,0,0,0.0,3,2,5,3,1,0,0,0,3,2
../kbl_data/2023-2024,S43G01N265,울산 현대모비스,Away,김지완,5,1,3,33.3,1,5,20.0,2,8,25.0,0,0,0.0,0,1,1,8,0,0,0,0,1,1
../kbl_data/2023-2024,S43G01N265,울산 현대모비스,Away,김준일,10,3,6,50.0,0,1,0.0,3,7,42.9,4,6,66.7,3,3,6,3,0,1,0,0,1,4
../kbl_data/2023-2024,S43G01N265,울산 현대모비스,Away,김국찬,11,3,3,100.0,1,1,100.0,4,4,100.0,2,2,100.0,0,3,3,0,0,0,0,0,1,2
../kbl_data/2023-2024,S43G01N265,울산 현대모비스,Away,이우석,11,4,4,100.0,1,1,100.0,5,5,100.0,0,0,0.0,0,0,0,3,1,0,0,0,1,3
../kbl_data/2023-2024,S43G01N265,울산 현대모비스,Away,신민석,8,4,4,100.0,0,1,0.0,4,5,80.0,0,0,0.0,0,5,5,0,1,0,0,0,2,1
../kbl_data/2023-2024,S43G01N265,울산 현대모비스,Away,게이지 프림,14,5,10,50.0,0,0,0.0,5,10,50.0,4,5,80.0,0,1,1,3,0,0,0,0,1,1
../kbl_data/2023-2024,S43G01N265,울산 현대모비스,Away,김태완,5,1,1,100.0,1,1,100.0,2,2,100.0,0,0,0.0,0,0,0,1,0,0,0,0,1,2
../kbl_data/2023-2024,S43G01N265,울산 현대모비스,Away,케베 알루마,23,5,8,62.5,4,9,44.4,9,17,52.9,1,3,33.3,2,8,10,3,1,1,0,0,2,4
../kbl_data/2023-2024,S43G01N265,울산 현대모비스,Away,미구엘 안드레 옥존,5,1,3,33.3,1,3,33.3,2,6,33.3,0,0,0.0,1,1,2,2,0,0,0,0,3,1
../kbl_data/2023-2024,S43G01N266,울산 현대모비스,Home,함지훈,6,0,0,0.0,2,2,100.0,2,2,100.0,0,0,0.0,1,1,2,6,2,0,0,0,1,3
../kbl_data/2023-2024,S43G01N266,울산 현대모비스,Home,최진수,0,0,0,0.0,0,0,0.0,0,0,0.0,0,0,0.0,0,0,0,0,0,0,0,0,0,0
../kbl_data/2023-2024,S43G01N266,울산 현대모비스,Home,김현수,0,0,0,0.0,0,0,0.0,0,0,0.0,0,0,0.0,0,0,0,0,0,0,0,0,0,0
../kbl_data/2023-2024,S43G01N266,울산 현대모비스,Home,장재석,0,0,2,0.0,0,0,0.0,0,2,0.0,0,0,0.0,0,1,1,0,1,0,0,0,2,1
../kbl_data/2023-2024,S43G01N266,울산 현대모비스,Home,김지완,0,0,0,0.0,0,1,0.0,0,1,0.0,0,0,0.0,0,0,0,2,1,0,0,0,0,3
../kbl_data/2023-2024,S43G01N266,울산 현대모비스,Home,김준일,4,2,4,50.0,0,0,0.0,2,4,50.0,0,0,0.0,0,3,3,2,0,0,0,0,0,1
../kbl_data/2023-2024,S43G01N266,울산 현대모비스,Home,이우석,17,7,13,53.8,1,3,33.3,8,16,50.0,0,1,0.0,0,1,1,0,3,0,0,0,1,1
../kbl_data/2023-2024,S43G01N266,울산 현대모비스,Home,신민석,8,2,4,50.0,1,6,16.7,3,10,30.0,1,2,50.0,2,3,5,0,2,0,0,0,0,2
../kbl_data/2023-2024,S43G01N266,울산 현대모비스,Home,게이지 프림,14,5,9,55.6,0,0,0.0,5,9,55.6,4,7,57.1,1,3,4,0,0,0,0,0,1,2
../kbl_data/2023-2024,S43G01N266,울산 현대모비스,Home,김태완,6,0,0,0.0,2,4,50.0,2,4,50.0,0,0,0.0,1,2,3,2,0,0,0,0,0,1
../kbl_data/2023-2024,S43G01N266,울산 현대모비스,Home,케베 알루마,17,2,5,40.0,3,5,60.0,5,10,50.0,4,4,100.0,3,7,10,3,0,1,0,0,3,2
../kbl_data/2023-2024,S43G01N266,울산 현대모비스,Home,미구엘 안드레 옥존,11,1,2,50.0,3,7,42.9,4,9,44.4,0,0,0.0,1,0,1,2,0,0,0,0,2,2
../kbl_data/2023-2024,S43G01N266,안양 정관장,Away,정준원,0,0,2,0.0,0,0,0.0,0,2,0.0,0,0,0.0,0,0,0,0,1,0,0,0,0,1
../kbl_data/2023-2024,S43G01N266,안양 정관장,Away,배병준,8,4,5,80.0,0,1,0.0,4,6,66.7,0,0,0.0,0,2,2,1,0,0,0,0,0,2
../kbl_data/2023-2024,S43G01N266,안양 정관장,Away,정효근,9,2,4,50.0,1,2,50.0,3,6,50.0,2,2,100.0,1,2,3,4,0,2,0,0,2,3
../kbl_data/2023-2024,S43G01N266,안양 정관장,Away,이종현,8,2,2,100.0,0,1,0.0,2,3,66.7,4,4,100.0,0,2,2,0,2,1,0,0,1,2
../kbl_data/2023-2024,S43G01N266,안양 정관장,Away,박지훈,12,5,8,62.5,0,1,0.0,5,9,55.6,2,2,100.0,1,3,4,6,2,0,0,0,3,2
../kbl_data/2023-2024,S43G01N266,안양 정관장,Away,이우정,0,0,1,0.0,0,0,0.0,0,1,0.0,0,0,0.0,1,0,1,2,0,0,0,0,0,1
../kbl_data/2023-2024,S43G01N266,안양 정관장,Away,김경원,7,3,3,100.0,0,1,0.0,3,4,75.0,1,3,33.3,2,2,4,0,0,0,0,0,1,2
../kbl_data/2023-2024,S43G01N266,안양 정관장,Away,렌즈 아반도,10,5,10,50.0,0,2,0.0,5,12,41.7,0,0,0.0,1,1,2,1,1,2,0,2,2,1
../kbl_data/2023-2024,S43G01N266,안양 정관장,Away,고찬혁,0,0,0,0.0,0,0,0.0,0,0,0.0,0,0,0.0,0,0,0,0,0,0,0,0,0,0
../kbl_data/2023-2024,S43G01N266,안양 정관장,Away,나성호,0,0,0,0.0,0,0,0.0,0,0,0.0,0,0,0.0,0,0,0,0,0,0,0,0,0,0
../kbl_data/2023-2024,S43G01N266,안양 정관장,Away,로버트 카터,5,1,2,50.0,1,1,100.0,2,3,66.7,0,0,0.0,0,3,3,0,0,0,0,0,2,2
../kbl_data/2023-2024,S43G01N266,안양 정관장,Away,자밀 윌슨,22,3,5,60.0,4,6,66.7,7,11,63.6,4,5,80.0,0,11,11,1,1,0,0,0,3,3
../kbl_data/2023-2024,S43G01N267,부산 KCC,Home,정창영,3,1,1,100.0,0,1,0.0,1,2,50.0,1,2,50.0,1,2,3,1,0,0,0,0,1,1
../kbl_data/2023-2024,S43G01N267,부산 KCC,Home,라건아,16,8,11,72.7,0,2,0.0,8,13,61.5,0,0,0.0,4,6,10,1,1,1,0,0,1,2
../kbl_data/2023-2024,S43G01N267,부산 KCC,Home,허웅,16,1,4,25.0,4,9,44.4,5,13,38.5,2,2,100.0,0,2,2,7,1,0,1,0,0,1
../kbl_data/2023-2024,S43G01N267,부산 KCC,Home,이승현,4,1,4,25.0,0,0,0.0,1,4,25.0,2,2,100.0,1,4,5,3,0,0,0,0,2,0
../kbl_data/2023-2024,S43G01N267,부산 KCC,Home,이호현,15,1,3,33.3,3,3,100.0,4,6,66.7,4,4,100.0,1,3,4,3,0,0,0,0,2,2
../kbl_data/2023-2024,S43G01N267,부산 KCC,Home,송교창,8,2,7,28.6,1,3,33.3,3,10,30.0,1,2,50.0,1,1,2,2,1,0,0,0,1,4
../kbl_data/2023-2024,S43G01N267,부산 KCC,Home,최준용,17,1,3,33.3,4,6,66.7,5,9,55.6,3,4,75.0,0,5,5,3,0,0,0,1,1,0
../kbl_data/2023-2024,S43G01N267,부산 KCC,Home,곽정훈,7,2,2,100.0,1,2,50.0,3,4,75.0,0,0,0.0,3,1,4,0,0,0,0,0,0,4
../kbl_data/2023-2024,S43G01N267,부산 KCC,Home,이근휘,3,0,0,0.0,1,3,33.3,1,3,33.3,0,0,0.0,0,0,0,1,0,0,0,0,0,2
../kbl_data/2023-2024,S43G01N267,부산 KCC,Home,캘빈 제프리 에피스톨라,6,2,3,66.7,0,1,0.0,2,4,50.0,2,2,100.0,0,2,2,2,2,0,0,0,0,1
../kbl_data/2023-2024,S43G01N267,부산 KCC,Home,이주영,3,0,1,0.0,1,1,100.0,1,2,50.0,0,0,0.0,0,0,0,1,0,0,0,0,0,0
../kbl_data/2023-2024,S43G01N267,부산 KCC,Home,알리제 드숀 존슨,4,2,2,100.0,0,0,0.0,2,2,100.0,0,0,0.0,1,6,7,2,1,0,0,0,1,0
../kbl_data/2023-2024,S43G01N267,서울 SK,Away,양우섭,6,3,3,100.0,0,0,0.0,3,3,100.0,0,0,0.0,1,1,2,2,0,0,0,0,0,1
../kbl_data/2023-2024,S43G01N267,서울 SK,Away,허일영,6,1,3,33.3,0,6,0.0,1,9,11.1,4,5,80.0,2,3,5,0,1,0,0,0,2,2
../kbl_data/2023-2024,S43G01N267,서울 SK,Away,송창용,6,0,1,0.0,1,1,100.0,1,2,50.0,3,4,75.0,0,0,0,1,0,0,0,0,0,4
../kbl_data/2023-2024,S43G01N267,서울 SK,Away,김선형,10,3,6,50.0,1,1,100.0,4,7,57.1,1,2,50.0,0,1,1,2,1,0,0,0,0,3
../kbl_data/2023-2024,S43G01N267,서울 SK,Away,오세근,0,0,3,0.0,0,1,0.0,0,4,0.0,0,0,0.0,0,1,1,0,0,1,0,0,0,1
../kbl_data/2023-2024,S43G01N267,서울 SK,Away,최부경,4,1,2,50.0,0,0,0.0,1,2,50.0,2,2,100.0,0,2,2,0,0,0,0,0,0,1
../kbl_data/2023-2024,S43G01N267,서울 SK,Away,리온 윌리엄스,11,4,6,66.7,1,2,50.0,5,8,62.5,0,0,0.0,1,2,3,1,1,0,0,0,1,3
../kbl_data/2023-2024,S43G01N267,서울 SK,Away,자밀 워니,15,7,15,46.7,0,4,0.0,7,19,36.8,1,1,100.0,3,8,11,2,0,0,0,0,0,0
../kbl_data/2023-2024,S43G01N267,서울 SK,Away,전성환,2,1,1,100.0,0,0,0.0,1,1,100.0,0,0,0.0,1,0,1,1,0,0,0,0,1,1
../kbl_data/2023-2024,S43G01N267,서울 SK,Away,김형빈,8,1,2,50.0,2,5,40.0,3,7,42.9,0,0,0.0,0,4,4,0,1,0,0,0,0,4
../kbl_data/2023-2024,S43G01N267,서울 SK,Away,오재현,11,5,7,71.4,0,1,0.0,5,8,62.5,1,2,50.0,1,3,4,7,1,0,0,0,4,2
../kbl_data/2023-2024,S43G01N267,서울 SK,Away,문가온,0,0,0,0.0,0,2,0.0,0,2,0.0,0,0,0.0,0,0,0,0,0,0,0,0,0,0
../kbl_data/2023-2024,S43G01N268,원주 DB,Home,서민수,0,0,1,0.0,0,0,0.0,0,1,0.0,0,2,0.0,2,3,5,1,0,0,0,0,1,1
../kbl_data/2023-2024,S43G01N268,원주 DB,Home,김영현,0,0,2,0.0,0,1,0.0,0,3,0.0,0,0,0.0,1,0,1,0,1,0,0,0,0,2
../kbl_data/2023-2024,S43G01N268,원주 DB,Home,김종규,17,7,12,58.3,0,0,0.0,7,12,58.3,3,3,100.0,4,3,7,1,0,1,0,0,1,3
../kbl_data/2023-2024,S43G01N268,원주 DB,Home,최승욱,2,1,1,100.0,0,1,0.0,1,2,50.0,0,0,0.0,0,0,0,0,0,0,0,0,0,1
../kbl_data/2023-2024,S43G01N268,원주 DB,Home,강상재,10,2,4,50.0,2,6,33.3,4,10,40.0,0,2,0.0,1,6,7,3,1,0,0,0,2,1
../kbl_data/2023-2024,S43G01N268,원주 DB,Home,유현준,3,0,0,0.0,1,2,50.0,1,2,50.0,0,0,0.0,0,2,2,6,1,0,0,0,3,4
../kbl_data/2023-2024,S43G01N268,원주 DB,Home,김훈,0,0,1,0.0,0,1,0.0,0,2,0.0,0,0,0.0,0,3,3,0,0,0,0,0,0,1
../kbl_data/2023-2024,S43G01N268,원주 DB,Home,디드릭 로슨,21,2,9,22.2,5,11,45.5,7,20,35.0,2,3,66.7,2,12,14,4,1,2,0,1,1,3
../kbl_data/2023-2024,S43G01N268,원주 DB,Home,이용우,0,0,0,0.0,0,0,0.0,0,0,0.0,0,0,0.0,0,0,0,0,0,0,0,0,1,1
../kbl_data/2023-2024,S43G01N268,원주 DB,Home,이선 알바노,18,5,8,62.5,2,5,40.0,7,13,53.8,2,2,100.0,1,0,1,3,1,0,0,0,0,3
../kbl_data/2023-2024,S43G01N268,원주 DB,Home,박인웅,9,3,5,60.0,1,1,100.0,4,6,66.7,0,0,0.0,2,5,7,1,1,0,0,0,3,2
../kbl_data/2023-2024,S43G01N268,원주 DB,Home,제프 위디,2,1,2,50.0,0,0,0.0,1,2,50.0,0,0,0.0,1,0,1,0,0,0,0,0,0,0
../kbl_data/2023-2024,S43G01N268,대구 한국가스공사,Away,박지훈,2,1,3,33.3,0,2,0.0,1,5,20.0,0,0,0.0,0,5,5,0,1,0,0,0,0,3
../kbl_data/2023-2024,S43G01N268,대구 한국가스공사,Away,양준우,0,0,2,0.0,0,0,0.0,0,2,0.0,0,0,0.0,0,1,1,0,0,0,0,0,0,0
../kbl_data/2023-2024,S43G01N268,대구 한국가스공사,Away,이도헌,3,0,0,0.0,1,4,25.0,1,4,25.0,0,0,0.0,0,1,1,1,0,0,0,0,0,4
../kbl_data/2023-2024,S43G01N268,대구 한국가스공사,Away,앤드류 니콜슨,6,3,4,75.0,0,0,0.0,3,4,75.0,0,0,0.0,2,0,2,0,0,0,0,0,0,0
../kbl_data/2023-2024,S43G01N268,대구 한국가스공사,Away,신승민,18,2,6,33.3,3,6,50.0,5,12,41.7,5,8,62.5,1,6,7,1,2,0,0,0,3,3
../kbl_data/2023-2024,S43G01N268,대구 한국가스공사,Away,김진모,0,0,0,0.0,0,1,0.0,0,1,0.0,0,0,0.0,0,0,0,0,1,0,0,0,0,0
../kbl_data/2023-2024,S43G01N268,대구 한국가스공사,Away,최주영,0,0,1,0.0,0,0,0.0,0,1,0.0,0,0,0.0,1,1,2,0,1,0,0,0,0,0
../kbl_data/2023-2024,S43G01N268,대구 한국가스공사,Away,샘조세프 벨란겔,8,2,6,33.3,0,4,0.0,2,10,20.0,4,5,80.0,0,2,2,6,0,0,0,0,2,3
../kbl_data/2023-2024,S43G01N268,대구 한국가스공사,Away,염유성,0,0,0,0.0,0,1,0.0,0,1,0.0,0,0,0.0,0,0,0,0,0,0,0,0,0,1
../kbl_data/2023-2024,S43G01N268,대구 한국가스공사,Away,안세영,3,0,0,0.0,0,1,0.0,0,1,0.0,3,4,75.0,0,0,0,0,1,0,0,0,0,0
../kbl_data/2023-2024,S43G01N268,대구 한국가스공사,Away,신주영,12,2,5,40.0,2,3,66.7,4,8,50.0,2,4,50.0,1,1,2,1,1,1,0,0,0,4
../kbl_data/2023-2024,S43G01N268,대구 한국가스공사,Away,듀반 맥스웰,21,10,21,47.6,0,0,0.0,10,21,47.6,1,2,50.0,8,10,18,1,1,4,2,1,2,2
../kbl_data/2023-2024,S43G01N269,고양 소노,Home,김강선,4,1,2,50.0,0,1,0.0,1,3,33.3,2,2,100.0,0,0,0,3,2,0,0,0,1,4
../kbl_data/2023-2024,S43G01N269,고양 소노,Home,함준후,9,3,5,60.0,1,3,33.3,4,8,50.0,0,0,0.0,4,2,6,0,1,0,0,0,1,3
../kbl_data/2023-2024,S43G01N269,고양 소노,Home,김민욱,11,1,2,50.0,3,5,60.0,4,7,57.1,0,0,0.0,2,5,7,2,2,0,1,0,2,4
../kbl_data/2023-2024,S43G01N269,고양 소노,Home,김지후,11,1,1,100.0,2,6,33.3,3,7,42.9,3,5,60.0,1,0,1,0,1,0,0,0,1,3
../kbl_data/2023-2024,S43G01N269,고양 소노,Home,김진용,4,2,3,66.7,0,0,0.0,2,3,66.7,0,0,0.0,1,0,1,1,1,0,0,0,0,2
../kbl_data/2023-2024,S43G01N269,고양 소노,Home,치나누 오누아쿠,17,5,8,62.5,1,5,20.0,6,13,46.2,4,4,100.0,4,11,15,4,2,1,0,0,4,1
../kbl_data/2023-2024,S43G01N269,고양 소노,Home,이진석,0,0,0,0.0,0,0,0.0,0,0,0.0,0,0,0.0,0,0,0,0,0,0,0,0,1,0
../kbl_data/2023-2024,S43G01N269,고양 소노,Home,이정현,39,5,18,27.8,7,17,41.2,12,35,34.3,8,12,66.7,3,4,7,9,7,1,0,0,5,2
../kbl_data/2023-2024,S43G01N269,고양 소노,Home,백지웅,0,0,0,0.0,0,4,0.0,0,4,0.0,0,0,0.0,0,1,1,1,0,0,0,0,0,1
../kbl_data/2023-2024,S43G01N269,고양 소노,Home,조재우,0,0,1,0.0,0,0,0.0,0,1,0.0,0,0,0.0,0,0,0,0,0,0,0,0,0,2
../kbl_data/2023-2024,S43G01N269,고양 소노,Home,민기남,0,0,0,0.0,0,0,0.0,0,0,0.0,0,0,0.0,0,0,0,0,0,0,0,0,0,2
../kbl_data/2023-2024,S43G01N269,고양 소노,Home,알렉스 카바노,0,0,0,0.0,0,0,0.0,0,0,0.0,0,0,0.0,0,0,0,0,0,0,0,0,0,0
../kbl_data/2023-2024,S43G01N269,수원 KT,Away,한희원,9,1,1,100.0,0,8,0.0,1,9,11.1,7,7,100.0,1,2,3,2,2,0,0,0,2,2
../kbl_data/2023-2024,S43G01N269,수원 KT,Away,최창진,8,1,1,100.0,2,2,100.0,3,3,100.0,0,0,0.0,0,1,1,5,0,0,0,0,1,3
../kbl_data/2023-2024,S43G01N269,수원 KT,Away,정성우,17,4,6,66.7,2,8,25.0,6,14,42.9,3,4,75.0,2,1,3,2,2,0,1,0,4,1
../kbl_data/2023-2024,S43G01N269,수원 KT,Away,최성모,13,3,3,100.0,1,5,20.0,4,8,50.0,4,6,66.7,0,8,8,4,1,1,1,0,4,4
../kbl_data/2023-2024,S43G01N269,수원 KT,Away,박찬호,0,0,2,0.0,0,0,0.0,0,2,0.0,0,0,0.0,0,0,0,0,0,0,0,0,1,2
../kbl_data/2023-2024,S43G01N269,수원 KT,Away,최진광,3,0,1,0.0,1,1,100.0,1,2,50.0,0,0,0.0,0,0,0,1,0,0,0,0,1,5
../kbl_data/2023-2024,S43G01N269,수원 KT,Away,이호준,0,0,0,0.0,0,3,0.0,0,3,0.0,0,0,0.0,0,0,0,1,0,0,0,0,0,0
../kbl_data/2023-2024,S43G01N269,수원 KT,Away,이두원,4,2,6,33.3,0,0,0.0,2,6,33.3,0,0,0.0,4,1,5,0,0,1,0,0,0,2
../kbl_data/2023-2024,S43G01N269,수원 KT,Away,박선웅,0,0,0,0.0,0,0,0.0,0,0,0.0,0,0,0.0,0,2,2,0,0,0,0,0,1,1
../kbl_data/2023-2024,S43G01N269,수원 KT,Away,문정현,2,1,2,50.0,0,3,0.0,1,5,20.0,0,0,0.0,2,2,4,3,3,0,0,0,1,3
../kbl_data/2023-2024,S43G01N269,수원 KT,Away,마이클 에릭,33,12,13,92.3,0,0,0.0,12,13,92.3,9,11,81.8,2,13,15,1,2,3,0,2,2,1
../kbl_data/2023-2024,S43G01N269,수원 KT,Away,패리스 배스,2,1,1,100.0,0,1,0.0,1,2,50.0,0,2,0.0,2,3,5,1,0,0,0,0,2,2
../kbl_data/2023-2024,S43G01N270,창원 LG,Home,이관희,5,1,4,25.0,1,7,14.3,2,11,18.2,0,0,0.0,1,2,3,0,1,0,0,0,0,1
../kbl_data/2023-2024,S43G01N270,창원 LG,Home,정희재,9,3,3,100.0,0,1,0.0,3,4,75.0,3,4,75.0,0,1,1,2,1,0,0,0,0,1
../kbl_data/2023-2024,S43G01N270,창원 LG,Home,이재도,11,3,4,75.0,1,3,33.3,4,7,57.1,2,2,100.0,0,1,1,4,0,1,0,0,1,0
../kbl_data/2023-2024,S43G01N270,창원 LG,Home,정인덕,4,2,2,100.0,0,2,0.0,2,4,50.0,0,0,0.0,0,1,1,0,1,0,0,0,0,0
../kbl_data/2023-2024,S43G01N270,창원 LG,Home,양홍석,9,3,7,42.9,1,4,25.0,4,11,36.4,0,0,0.0,0,0,0,2,1,0,0,0,1,4
../kbl_data/2023-2024,S43G01N270,창원 LG,Home,박정현,6,3,3,100.0,0,0,0.0,3,3,100.0,0,0,0.0,0,2,2,0,0,2,0,0,1,1
../kbl_data/2023-2024,S43G01N270,창원 LG,Home,윤원상,9,1,2,50.0,2,4,50.0,3,6,50.0,1,2,50.0,1,3,4,2,0,0,0,0,0,3
../kbl_data/2023-2024,S43G01N270,창원 LG,Home,아셈 마레이,13,4,6,66.7,0,0,0.0,4,6,66.7,5,6,83.3,4,4,8,1,1,3,0,0,1,2
../kbl_data/2023-2024,S43G01N270,창원 LG,Home,저스틴 구탕,10,3,5,60.0,1,2,50.0,4,7,57.1,1,3,33.3,1,7,8,5,1,1,0,0,2,2
../kbl_data/2023-2024,S43G01N270,창원 LG,Home,양준석,3,0,1,0.0,1,1,100.0,1,2,50.0,0,0,0.0,1,1,2,3,2,0,2,0,2,4
../kbl_data/2023-2024,S43G01N270,창원 LG,Home,유기상,6,0,1,0.0,2,4,50.0,2,5,40.0,0,0,0.0,0,2,2,1,2,1,0,0,0,1
../kbl_data/2023-2024,S43G01N270,창원 LG,Home,후안 텔로,13,6,8,75.0,0,1,0.0,6,9,66.7,1,1,100.0,4,6,10,5,1,0,0,0,0,0
../kbl_data/2023-2024,S43G01N270,서울 삼성,Away,이정현,9,1,3,33.3,2,4,50.0,3,7,42.9,1,2,50.0,0,3,3,7,1,0,0,0,5,2
../kbl_data/2023-2024,S43G01N270,서울 삼성,Away,홍경기,7,0,1,0.0,2,5,40.0,2,6,33.3,1,2,50.0,1,2,3,0,1,0,0,0,3,1
../kbl_data/2023-2024,S43G01N270,서울 삼성,Away,김승원,0,0,1,0.0,0,0,0.0,0,1,0.0,0,0,0.0,2,1,3,1,0,0,0,0,0,2
../kbl_data/2023-2024,S43G01N270,서울 삼성,Away,이동엽,6,0,3,0.0,2,2,100.0,2,5,40.0,0,0,0.0,0,3,3,5,0,0,0,0,1,1
../kbl_data/2023-2024,S43G01N270,서울 삼성,Away,최승욱,6,3,7,42.9,0,2,0.0,3,9,33.3,0,0,0.0,2,2,4,0,0,0,1,0,1,2
../kbl_data/2023-2024,S43G01N270,서울 삼성,Away,윤성원,5,1,2,50.0,1,1,100.0,2,3,66.7,0,0,0.0,1,2,3,1,0,0,0,0,0,3
../kbl_data/2023-2024,S43G01N270,서울 삼성,Away,김한솔,0,0,0,0.0,0,0,0.0,0,0,0.0,0,0,0.0,0,0,0,0,0,0,0,0,0,0
../kbl_data/2023-2024,S43G01N270,서울 삼성,Away,차민석,5,1,3,33.3,0,1,0.0,1,4,25.0,3,8,37.5,1,2,3,1,0,0,0,0,0,2
../kbl_data/2023-2024,S43G01N270,서울 삼성,Away,신동혁,12,3,8,37.5,2,4,50.0,5,12,41.7,0,2,0.0,0,2,2,0,0,1,0,0,0,0
../kbl_data/2023-2024,S43G01N270,서울 삼성,Away,조준희,0,0,4,0.0,0,2,0.0,0,6,0.0,0,0,0.0,1,1,2,0,0,0,0,0,0,2
../kbl_data/2023-2024,S43G01N270,서울 삼성,Away,아반 나바,0,0,0,0.0,0,0,0.0,0,0,0.0,0,0,0.0,0,0,0,0,0,0,0,0,0,0
../kbl_data/2023-2024,S43G01N270,서울 삼성,Away,이스마엘 레인,13,6,11,54.5,0,2,0.0,6,13,46.2,1,2,50.0,2,2,4,3,1,2,0,1,6,5
../kbl_data/2024-2025,S45G01N1,부산 KCC,Home,정창영,7,2,2,100.0,1,2,50.0,3,4,75.0,0,0,0.0,0,3,3,2,1,0,0,0,0,3
../kbl_data/2024-2025,S45G01N1,부산 KCC,Home,전준범,0,0,1,0.0,0,1,0.0,0,2,0.0,0,0,0.0,0,1,1,0,1,0,0,0,0,1
../kbl_data/2024-2025,S45G01N1,부산 KCC,Home,허웅,18,3,7,42.9,4,12,33.3,7,19,36.8,0,0,0.0,0,3,3,3,0,0,1,0,0,1
../kbl_data/2024-2025,S45G01N1,부산 KCC,Home,이승현,6,3,7,42.9,0,1,0.0,3,8,37.5,0,0,0.0,2,3,5,0,0,0,1,0,1,3
../kbl_data/2024-2025,S45G01N1,부산 KCC,Home,이호현,4,2,5,40.0,0,1,0.0,2,6,33.3,0,0,0.0,1,1,2,2,0,0,0,0,0,1
../kbl_data/2024-2025,S45G01N1,부산 KCC,Home,디온테 버튼,40,13,20,65.0,3,8,37.5,16,28,57.1,5,5,100.0,3,13,16,2,4,4,2,0,5,1
../kbl_data/2024-2025,S45G01N1,부산 KCC,Home,이근휘,0,0,0,0.0,0,0,0.0,0,0,0.0,0,0,0.0,0,0,0,0,0,0,0,0,0,0
../kbl_data/2024-2025,S45G01N1,부산 KCC,Home,김동현,0,0,1,0.0,0,4,0.0,0,5,0.0,0,0,0.0,0,2,2,1,0,0,0,0,1,3
../kbl_data/2024-2025,S45G01N1,부산 KCC,Home,송동훈,0,0,0,0.0,0,0,0.0,0,0,0.0,0,0,0.0,0,0,0,0,0,0,0,0,0,0
../kbl_data/2024-2025,S45G01N1,부산 KCC,Home,여준형,2,1,2,50.0,0,0,0.0,1,2,50.0,0,0,0.0,0,1,1,0,0,0,0,0,0,1
../kbl_data/2024-2025,S45G01N1,부산 KCC,Home,캘빈 제프리 에피스톨라,0,0,0,0.0,0,0,0.0,0,0,0.0,0,0,0.0,0,0,0,0,0,0,0,0,0,0
../kbl_data/2024-2025,S45G01N1,부산 KCC,Home,이주영,0,0,0,0.0,0,0,0.0,0,0,0.0,0,0,0.0,0,0,0,0,0,0,0,0,0,0
../kbl_data/2024-2025,S45G01N1,수원 KT,Away,한희원,14,1,4,25.0,4,9,44.4,5,13,38.5,0,0,0.0,1,0,1,1,0,1,0,0,0,4
../kbl_data/2024-2025,S45G01N1,수원 KT,Away,최창진,0,0,0,0.0,0,1,0.0,0,1,0.0,0,0,0.0,1,0,1,1,0,0,1,0,0,0
../kbl_data/2024-2025,S45G01N1,수원 KT,Away,문성곤,2,1,1,100.0,0,3,0.0,1,4,25.0,0,0,0.0,1,3,4,1,1,0,0,0,0,3
../kbl_data/2024-2025,S45G01N1,수원 KT,Away,이현석,0,0,0,0.0,0,0,0.0,0,0,0.0,0,0,0.0,0,3,3,0,0,0,0,0,2,0
../kbl_data/2024-2025,S45G01N1,수원 KT,Away,허훈,5,1,6,16.7,1,5,20.0,2,11,18.2,0,0,0.0,2,0,2,7,1,0,0,0,4,2
../kbl_data/2024-2025,S45G01N1,수원 KT,Away,박준영,0,0,0,0.0,0,0,0.0,0,0,0.0,0,0,0.0,0,0,0,0,0,0,0,0,0,0
../kbl_data/2024-2025,S45G01N1,수원 KT,Away,최진광,0,0,0,0.0,0,0,0.0,0,0,0.0,0,0,0.0,0,0,0,0,0,0,0,0,0,1
../kbl_data/2024-2025,S45G01N1,수원 KT,Away,이윤기,0,0,1,0.0,0,0,0.0,0,1,0.0,0,0,0.0,0,0,0,0,0,0,0,0,0,1
../kbl_data/2024-2025,S45G01N1,수원 KT,Away,하윤기,8,4,11,36.4,0,0,0.0,4,11,36.4,0,0,0.0,4,5,9,1,0,2,0,0,0,1
../kbl_data/2024-2025,S45G01N1,수원 KT,Away,문정현,5,1,5,20.0,1,4,25.0,2,9,22.2,0,0,0.0,2,6,8,1,0,0,0,0,0,1
../kbl_data/2024-2025,S45G01N1,수원 KT,Away,제레미아 틸먼,6,3,7,42.9,0,0,0.0,3,7,42.9,0,0,0.0,4,1,5,2,0,0,0,0,3,2
../kbl_data/2024-2025,S45G01N1,수원 KT,Away,레이션 해먼즈,32,11,22,50.0,2,5,40.0,13,27,48.1,4,5,80.0,5,14,19,2,1,0,0,0,3,2
../kbl_data/2024-2025,S45G01N2,원주 DB,Home,이관희,7,0,3,0.0,1,2,50.0,1,5,20.0,4,4,100.0,0,0,0,1,0,0,0,0,1,2
../kbl_data/2024-2025,S45G01N2,원주 DB,Home,김시래,0,0,0,0.0,0,0,0.0,0,0,0.0,0,0,0.0,0,0,0,0,0,0,0,0,0,0
../kbl_data/2024-2025,S45G01N2,원주 DB,Home,서민수,3,1,1,100.0,0,2,0.0,1,3,33.3,1,2,50.0,3,0,3,0,0,0,1,0,0,2
../kbl_data/2024-2025,S45G01N2,원주 DB,Home,김영현,0,0,1,0.0,0,2,0.0,0,3,0.0,0,0,0.0,2,0,2,0,0,0,1,0,2,2
../kbl_data/2024-2025,S45G01N2,원주 DB,Home,김종규,12,4,6,66.7,0,0,0.0,4,6,66.7,4,4,100.0,1,5,6,2,0,2,0,0,0,4
../kbl_data/2024-2025,S45G01N2,원주 DB,Home,강상재,10,4,6,66.7,0,2,0.0,4,8,50.0,2,2,100.0,1,3,4,5,0,2,0,0,2,2
../kbl_data/2024-2025,S45G01N2,원주 DB,Home,유현준,4,2,4,50.0,0,2,0.0,2,6,33.3,0,0,0.0,0,1,1,1,1,0,0,0,2,0
../kbl_data/2024-2025,S45G01N2,원주 DB,Home,치나누 오누아쿠,11,3,5,60.0,0,1,0.0,3,6,50.0,5,8,62.5,0,6,6,2,3,0,0,1,2,4
../kbl_data/2024-2025,S45G01N2,원주 DB,Home,김훈,0,0,0,0.0,0,1,0.0,0,1,0.0,0,0,0.0,0,1,1,0,0,0,0,0,0,1
../kbl_data/2024-2025,S45G01N2,원주 DB,Home,이용우,0,0,0,0.0,0,0,0.0,0,0,0.0,0,0,0.0,0,0,0,0,0,0,0,0,0,0
../kbl_data/2024-2025,S45G01N2,원주 DB,Home,이선 알바노,29,7,8,87.5,4,8,50.0,11,16,68.8,3,5,60.0,0,1,1,8,2,0,0,0,2,3
../kbl_data/2024-2025,S45G01N2,원주 DB,Home,로버트 카터,12,4,7,57.1,1,3,33.3,5,10,50.0,1,1,100.0,1,4,5,0,2,1,0,0,3,1
../kbl_data/2024-2025,S45G01N2,서울 삼성,Away,이정현,10,2,4,50.0,1,6,16.7,3,10,30.0,3,4,75.0,1,3,4,10,1,0,0,0,5,2
../kbl_data/2024-2025,S45G01N2,서울 삼성,Away,최현민,5,1,2,50.0,1,4,25.0,2,6,33.3,0,0,0.0,2,2,4,0,1,0,1,0,0,2
../kbl_data/2024-2025,S45G01N2,서울 삼성,Away,이동엽,0,0,2,0.0,0,2,0.0,0,4,0.0,0,0,0.0,1,2,3,2,0,0,0,0,3,5
../kbl_data/2024-2025,S45G01N2,서울 삼성,Away,최승욱,2,1,1,100.0,0,1,0.0,1,2,50.0,0,0,0.0,1,1,2,0,2,0,1,0,2,3
../kbl_data/2024-2025,S45G01N2,서울 삼성,Away,윤성원,0,0,0,0.0,0,0,0.0,0,0,0.0,0,0,0.0,0,1,1,0,0,0,0,0,0,0
../kbl_data/2024-2025,S45G01N2,서울 삼성,Away,마커스 데릭슨,19,4,9,44.4,3,5,60.0,7,14,50.0,2,2,100.0,2,1,3,0,2,0,1,0,2,5
../kbl_data/2024-2025,S45G01N2,서울 삼성,Away,차민석,0,0,3,0.0,0,1,0.0,0,4,0.0,0,0,0.0,0,1,1,1,0,0,0,0,0,0
../kbl_data/2024-2025,S45G01N2,서울 삼성,Away,이원석,19,8,10,80.0,1,1,100.0,9,11,81.8,0,0,0.0,2,5,7,0,0,0,0,2,1,3
../kbl_data/2024-2025,S45G01N2,서울 삼성,Away,저스틴 구탕,4,2,3,66.7,0,2,0.0,2,5,40.0,0,0,0.0,0,1,1,6,1,0,1,0,2,4
../kbl_data/2024-2025,S45G01N2,서울 삼성,Away,김근현,0,0,0,0.0,0,0,0.0,0,0,0.0,0,0,0.0,0,0,0,0,0,0,0,0,0,0
../kbl_data/2024-2025,S45G01N2,서울 삼성,Away,조준희,0,0,0,0.0,0,0,0.0,0,0,0.0,0,0,0.0,0,0,0,0,0,0,0,0,0,0
../kbl_data/2024-2025,S45G01N2,서울 삼성,Away,코피 코번,24,8,15,53.3,0,0,0.0,8,15,53.3,8,12,66.7,6,6,12,1,0,1,0,1,1,1
../kbl_data/2024-2025,S45G01N3,창원 LG,Home,허일영,0,0,0,0.0,0,0,0.0,0,0,0.0,0,0,0.0,0,0,0,0,0,0,0,0,0,1
../kbl_data/2024-2025,S45G01N3,창원 LG,Home,최진수,0,0,0,0.0,0,1,0.0,0,1,0.0,0,0,0.0,0,0,0,1,0,0,0,0,0,2
../kbl_data/2024-2025,S45G01N3,창원 LG,Home,장민국,1,0,1,0.0,0,3,0.0,0,4,0.0,1,2,50.0,1,2,3,0,0,0,0,0,0,1
../kbl_data/2024-2025,S45G01N3,창원 LG,Home,두경민,13,2,5,40.0,2,6,33.3,4,11,36.4,3,4,75.0,0,1,1,6,1,0,1,0,2,3
../kbl_data/2024-2025,S45G01N3,창원 LG,Home,정인덕,10,3,3,100.0,1,4,25.0,4,7,57.1,1,2,50.0,0,1,1,0,2,1,0,0,1,3
../kbl_data/2024-2025,S45G01N3,창원 LG,Home,대릴 먼로,2,1,2,50.0,0,2,0.0,1,4,25.0,0,0,0.0,1,1,2,0,0,0,0,0,1,1
../kbl_data/2024-2025,S45G01N3,창원 LG,Home,장태빈,0,0,0,0.0,0,0,0.0,0,0,0.0,0,0,0.0,0,0,0,0,0,0,0,0,0,0
../kbl_data/2024-2025,S45G01N3,창원 LG,Home,아셈 마레이,19,7,14,50.0,0,0,0.0,7,14,50.0,5,9,55.6,8,11,19,2,0,1,0,0,4,2
../kbl_data/2024-2025,S45G01N3,창원 LG,Home,양준석,7,0,2,0.0,1,4,25.0,1,6,16.7,4,7,57.1,1,0,1,5,0,0,0,0,2,3
../kbl_data/2024-2025,S45G01N3,창원 LG,Home,이승훈,0,0,0,0.0,0,0,0.0,0,0,0.0,0,0,0.0,0,0,0,0,0,0,0,0,0,0
../kbl_data/2024-2025,S45G01N3,창원 LG,Home,유기상,10,2,4,50.0,1,4,25.0,3,8,37.5,3,3,100.0,0,2,2,3,2,1,0,0,0,0
../kbl_data/2024-2025,S45G01N3,창원 LG,Home,칼 타마요,8,4,10,40.0,0,4,0.0,4,14,28.6,0,0,0.0,2,5,7,1,2,0,1,0,2,5
../kbl_data/2024-2025,S45G01N3,대구 한국가스공사,Away,김동량,0,0,0,0.0,0,0,0.0,0,0,0.0,0,0,0.0,0,0,0,0,0,0,0,0,0,0
../kbl_data/2024-2025,S45G01N3,대구 한국가스공사,Away,박지훈,2,1,1,100.0,0,0,0.0,1,1,100.0,0,0,0.0,0,4,4,0,0,0,0,0,1,1
../kbl_data/2024-2025,S45G01N3,대구 한국가스공사,Away,이대헌,10,5,6,83.3,0,2,0.0,5,8,62.5,0,0,0.0,3,4,7,2,2,1,0,0,0,1
../kbl_data/2024-2025,S45G01N3,대구 한국가스공사,Away,정성우,4,1,4,25.0,0,1,0.0,1,5,20.0,2,2,100.0,2,0,2,0,0,0,0,0,0,3
../kbl_data/2024-2025,S45G01N3,대구 한국가스공사,Away,김낙현,2,1,3,33.3,0,5,0.0,1,8,12.5,0,0,0.0,1,0,1,4,0,1,0,0,2,3
../kbl_data/2024-2025,S45G01N3,대구 한국가스공사,Away,양재혁,0,0,0,0.0,0,0,0.0,0,0,0.0,0,0,0.0,0,0,0,0,0,0,0,0,0,0
../kbl_data/2024-2025,S45G01N3,대구 한국가스공사,Away,곽정훈,0,0,0,0.0,0,0,0.0,0,0,0.0,0,0,0.0,0,0,0,0,0,0,0,0,0,0
../kbl_data/2024-2025,S45G01N3,대구 한국가스공사,Away,앤드류 니콜슨,14,5,9,55.6,0,5,0.0,5,14,35.7,4,4,100.0,0,7,7,0,1,3,0,0,2,2
../kbl_data/2024-2025,S45G01N3,대구 한국가스공사,Away,신승민,10,1,2,50.0,0,1,0.0,1,3,33.3,8,8,100.0,0,2,2,0,0,0,1,0,3,4
../kbl_data/2024-2025,S45G01N3,대구 한국가스공사,Away,샘조세프 벨란겔,20,2,7,28.6,5,8,62.5,7,15,46.7,1,2,50.0,0,2,2,3,2,0,0,0,4,3
../kbl_data/2024-2025,S45G01N3,대구 한국가스공사,Away,유슈 은도예,0,0,1,0.0,0,0,0.0,0,1,0.0,0,0,0.0,1,7,8,1,0,1,0,0,1,3
../kbl_data/2024-2025,S45G01N3,대구 한국가스공사,Away,신주영,5,1,3,33.3,1,3,33.3,2,6,33.3,0,0,0.0,0,2,2,1,1,0,1,0,0,2
../kbl_data/2024-2025,S45G01N4,수원 KT,Home,한희원,9,1,4,25.0,2,7,28.6,3,11,27.3,1,2,50.0,0,2,2,2,0,1,0,0,2,3
../kbl_data/2024-2025,S45G01N4,수원 KT,Home,최창진,0,0,0,0.0,0,0,0.0,0,0,0.0,0,0,0.0,0,0,0,0,1,0,0,0,2,0
../kbl_data/2024-2025,S45G01N4,수원 KT,Home,문성곤,4,2,3,66.7,0,1,0.0,2,4,50.0,0,0,0.0,1,3,4,3,4,0,0,0,0,2
../kbl_data/2024-2025,S45G01N4,수원 KT,Home,이현석,2,1,1,100.0,0,0,0.0,1,1,100.0,0,0,0.0,0,1,1,0,0,0,0,0,0,1
../kbl_data/2024-2025,S45G01N4,수원 KT,Home,허훈,17,7,15,46.7,1,5,20.0,8,20,40.0,0,0,0.0,0,0,0,7,3,0,0,0,3,1
../kbl_data/2024-2025,S45G01N4,수원 KT,Home,박준영,2,1,1,100.0,0,0,0.0,1,1,100.0,0,0,0.0,0,1,1,0,0,0,0,0,1,1
../kbl_data/2024-2025,S45G01N4,수원 KT,Home,최진광,3,0,0,0.0,1,1,100.0,1,1,100.0,0,0,0.0,0,0,0,1,0,0,0,0,1,0
../kbl_data/2024-2025,S45G01N4,수원 KT,Home,이윤기,0,0,1,0.0,0,1,0.0,0,2,0.0,0,0,0.0,0,0,0,0,0,0,0,0,0,0
../kbl_data/2024-2025,S45G01N4,수원 KT,Home,이두원,0,0,0,0.0,0,1,0.0,0,1,0.0,0,0,0.0,0,3,3,0,0,0,0,0,1,2
../kbl_data/2024-2025,S45G01N4,수원 KT,Home,문정현,16,4,6,66.7,2,4,50.0,6,10,60.0,2,2,100.0,2,1,3,2,3,1,0,0,4,3
../kbl_data/2024-2025,S45G01N4,수원 KT,Home,제레미아 틸먼,8,3,7,42.9,0,0,0.0,3,7,42.9,2,4,50.0,1,10,11,0,0,1,0,0,1,2
../kbl_data/2024-2025,S45G01N4,수원 KT,Home,레이션 해먼즈,11,3,4,75.0,1,3,33.3,4,7,57.1,2,3,66.7,1,8,9,1,1,0,0,0,1,3
../kbl_data/2024-2025,S45G01N4,서울 삼성,Away,이정현,5,1,3,33.3,1,4,25.0,2,7,28.6,0,0,0.0,0,1,1,6,2,0,0,0,1,1
../kbl_data/2024-2025,S45G01N4,서울 삼성,Away,최현민,7,3,5,60.0,0,3,0.0,3,8,37.5,1,1,100.0,0,0,0,0,2,0,0,0,0,2
../kbl_data/2024-2025,S45G01N4,서울 삼성,Away,이동엽,0,0,1,0.0,0,1,0.0,0,2,0.0,0,0,0.0,1,2,3,1,0,0,0,0,0,1
../kbl_data/2024-2025,S45G01N4,서울 삼성,Away,최승욱,8,2,2,100.0,0,1,0.0,2,3,66.7,4,4,100.0,2,4,6,1,0,0,0,0,1,1
../kbl_data/2024-2025,S45G01N4,서울 삼성,Away,윤성원,0,0,0,0.0,0,0,0.0,0,0,0.0,0,0,0.0,0,0,0,0,0,0,0,0,0,0
../kbl_data/2024-2025,S45G01N4,서울 삼성,Away,마커스 데릭슨,6,1,8,12.5,0,4,0.0,1,12,8.3,4,4,100.0,1,3,4,1,3,0,0,0,2,4
../kbl_data/2024-2025,S45G01N4,서울 삼성,Away,차민석,3,1,1,100.0,0,1,0.0,1,2,50.0,1,2,50.0,3,2,5,2,1,0,0,0,1,2
../kbl_data/2024-2025,S45G01N4,서울 삼성,Away,이원석,12,4,8,50.0,1,2,50.0,5,10,50.0,1,4,25.0,1,1,2,0,1,1,0,0,3,2
../kbl_data/2024-2025,S45G01N4,서울 삼성,Away,저스틴 구탕,6,3,5,60.0,0,3,0.0,3,8,37.5,0,0,0.0,2,4,6,2,0,2,0,0,0,3
../kbl_data/2024-2025,S45G01N4,서울 삼성,Away,조준희,0,0,0,0.0,0,0,0.0,0,0,0.0,0,0,0.0,0,0,0,0,0,0,0,0,0,0
../kbl_data/2024-2025,S45G01N4,서울 삼성,Away,박승재,3,0,1,0.0,1,8,12.5,1,9,11.1,0,0,0.0,0,4,4,5,0,0,0,0,3,2
../kbl_data/2024-2025,S45G01N4,서울 삼성,Away,코피 코번,13,6,12,50.0,0,0,0.0,6,12,50.0,1,2,50.0,4,5,9,2,2,1,0,0,4,0
../kbl_data/2024-2025,S45G01N5,서울 SK,Home,김선형,6,2,5,40.0,0,4,0.0,2,9,22.2,2,6,33.3,0,0,0,4,2,0,0,0,1,1
../kbl_data/2024-2025,S45G01N5,서울 SK,Home,오세근,9,3,6,50.0,1,3,33.3,4,9,44.4,0,0,0.0,2,2,4,1,0,0,0,0,0,4
../kbl_data/2024-2025,S45G01N5,서울 SK,Home,최부경,6,2,4,50.0,0,1,0.0,2,5,40.0,2,2,100.0,0,3,3,1,0,0,0,0,2,0
../kbl_data/2024-2025,S45G01N5,서울 SK,Home,최원혁,2,1,2,50.0,0,0,0.0,1,2,50.0,0,0,0.0,2,1,3,3,1,0,0,0,1,0
../kbl_data/2024-2025,S45G01N5,서울 SK,Home,장문호,0,0,0,0.0,0,0,0.0,0,0,0.0,0,0,0.0,0,0,0,0,0,0,0,0,0,0
../kbl_data/2024-2025,S45G01N5,서울 SK,Home,안영준,24,8,8,100.0,2,3,66.7,10,11,90.9,2,3,66.7,4,3,7,2,1,1,0,0,0,1
../kbl_data/2024-2025,S45G01N5,서울 SK,Home,자밀 워니,19,9,13,69.2,0,6,0.0,9,19,47.4,1,4,25.0,1,11,12,7,1,0,0,2,1,0
../kbl_data/2024-2025,S45G01N5,서울 SK,Home,김형빈,7,0,1,0.0,2,4,50.0,2,5,40.0,1,2,50.0,1,4,5,1,1,2,0,0,1,1
../kbl_data/2024-2025,S45G01N5,서울 SK,Home,아이재아 힉스,6,3,4,75.0,0,1,0.0,3,5,60.0,0,0,0.0,3,0,3,0,0,0,0,0,0,1
../kbl_data/2024-2025,S45G01N5,서울 SK,Home,박민우,0,0,0,0.0,0,0,0.0,0,0,0.0,0,0,0.0,0,0,0,0,0,0,0,0,0,0
../kbl_data/2024-2025,S45G01N5,서울 SK,Home,오재현,16,6,10,60.0,0,1,0.0,6,11,54.5,4,5,80.0,1,3,4,5,5,1,0,0,2,5
../kbl_data/2024-2025,S45G01N5,서울 SK,Home,고메즈 델 리아노,0,0,1,0.0,0,0,0.0,0,1,0.0,0,0,0.0,0,2,2,2,0,0,0,0,0,0
../kbl_data/2024-2025,S45G01N5,안양 정관장,Away,송창용,0,0,0,0.0,0,1,0.0,0,1,0.0,0,0,0.0,0,0,0,0,0,0,0,0,0,0
../kbl_data/2024-2025,S45G01N5,안양 정관장,Away,정준원,2,1,1,100.0,0,0,0.0,1,1,100.0,0,0,0.0,0,0,0,0,0,0,0,0,0,2
../kbl_data/2024-2025,S45G01N5,안양 정관장,Away,배병준,22,4,6,66.7,4,10,40.0,8,16,50.0,2,2,100.0,2,2,4,3,1,1,0,0,1,2
../kbl_data/2024-2025,S45G01N5,안양 정관장,Away,정효근,3,0,2,0.0,1,6,16.7,1,8,12.5,0,0,0.0,1,5,6,1,1,0,0,0,4,2
../kbl_data/2024-2025,S45G01N5,안양 정관장,Away,이종현,4,1,2,50.0,0,0,0.0,1,2,50.0,2,2,100.0,1,4,5,1,2,2,0,0,0,1
../kbl_data/2024-2025,S45G01N5,안양 정관장,Away,박지훈,10,2,2,100.0,2,4,50.0,4,6,66.7,0,0,0.0,2,2,4,6,1,0,0,0,3,5
../kbl_data/2024-2025,S45G01N5,안양 정관장,Away,최성원,4,2,5,40.0,0,3,0.0,2,8,25.0,0,0,0.0,1,0,1,3,0,0,0,0,2,2
../kbl_data/2024-2025,S45G01N5,안양 정관장,Away,이우정,2,1,2,50.0,0,1,0.0,1,3,33.3,0,0,0.0,1,0,1,0,1,0,0,0,2,0
../kbl_data/2024-2025,S45G01N5,안양 정관장,Away,캐디 라렌,14,4,7,57.1,1,3,33.3,5,10,50.0,3,4,75.0,5,5,10,3,0,0,0,2,2,1
../kbl_data/2024-2025,S45G01N5,안양 정관장,Away,김경원,4,2,2,100.0,0,0,0.0,2,2,100.0,0,0,0.0,0,2,2,0,1,0,0,1,0,0
../kbl_data/2024-2025,S45G01N5,안양 정관장,Away,하비 고메즈,0,0,2,0.0,0,1,0.0,0,3,0.0,0,0,0.0,1,0,1,0,0,0,0,0,2,1
../kbl_data/2024-2025,S45G01N5,안양 정관장,Away,마이클 영 Jr,6,1,8,12.5,1,3,33.3,2,11,18.2,1,4,25.0,1,4,5,2,0,0,0,0,2,1
../kbl_data/2024-2025,S45G01N6,울산 현대모비스,Home,함지훈,3,1,2,50.0,0,1,0.0,1,3,33.3,1,2,50.0,0,1,1,4,0,0,0,0,2,0
../kbl_data/2024-2025,S45G01N6,울산 현대모비스,Home,장재석,2,1,3,33.3,0,0,0.0,1,3,33.3,0,2,0.0,0,0,0,0,0,0,0,0,0,0
../kbl_data/2024-2025,S45G01N6,울산 현대모비스,Home,한호빈,0,0,2,0.0,0,0,0.0,0,2,0.0,0,0,0.0,0,0,0,1,0,0,0,0,2,2
../kbl_data/2024-2025,S45G01N6,울산 현대모비스,Home,김준일,0,0,0,0.0,0,0,0.0,0,0,0.0,0,0,0.0,0,0,0,0,0,0,0,0,0,0
../kbl_data/2024-2025,S45G01N6,울산 현대모비스,Home,김국찬,16,0,3,0.0,4,9,44.4,4,12,33.3,4,5,80.0,1,4,5,0,1,0,0,0,1,3
../kbl_data/2024-2025,S45G01N6,울산 현대모비스,Home,서명진,2,0,1,0.0,0,1,0.0,0,2,0.0,2,2,100.0,1,0,1,2,0,0,0,0,0,2
../kbl_data/2024-2025,S45G01N6,울산 현대모비스,Home,숀 롱,17,7,10,70.0,0,0,0.0,7,10,70.0,3,3,100.0,2,3,5,1,2,0,0,1,3,2
../kbl_data/2024-2025,S45G01N6,울산 현대모비스,Home,이우석,17,6,8,75.0,1,3,33.3,7,11,63.6,2,2,100.0,1,3,4,2,0,0,0,0,3,2
../kbl_data/2024-2025,S45G01N6,울산 현대모비스,Home,이승우,1,0,0,0.0,0,0,0.0,0,0,0.0,1,2,50.0,0,1,1,0,1,0,0,0,0,1
../kbl_data/2024-2025,S45G01N6,울산 현대모비스,Home,게이지 프림,19,7,13,53.8,0,0,0.0,7,13,53.8,5,6,83.3,3,4,7,1,0,0,0,0,0,1
../kbl_data/2024-2025,S45G01N6,울산 현대모비스,Home,박무빈,5,1,4,25.0,1,4,25.0,2,8,25.0,0,0,0.0,2,1,3,4,0,0,0,0,2,2
../kbl_data/2024-2025,S45G01N6,울산 현대모비스,Home,미구엘 안드레 옥존,0,0,1,0.0,0,3,0.0,0,4,0.0,0,0,0.0,0,0,0,0,0,0,0,0,0,0
../kbl_data/2024-2025,S45G01N6,고양 소노,Away,정희재,3,0,1,0.0,1,2,50.0,1,3,33.3,0,0,0.0,1,3,4,3,1,0,0,0,0,3
../kbl_data/2024-2025,S45G01N6,고양 소노,Away,임동섭,5,2,3,66.7,0,3,0.0,2,6,33.3,1,2,50.0,0,3,3,0,1,0,0,0,1,4
../kbl_data/2024-2025,S45G01N6,고양 소노,Away,김민욱,6,0,0,0.0,2,2,100.0,2,2,100.0,0,0,0.0,1,0,1,0,0,1,0,0,0,1
../kbl_data/2024-2025,S45G01N6,고양 소노,Away,이재도,2,0,2,0.0,0,0,0.0,0,2,0.0,2,2,100.0,0,1,1,4,0,0,0,0,1,1
../kbl_data/2024-2025,S45G01N6,고양 소노,Away,김영훈,0,0,0,0.0,0,1,0.0,0,1,0.0,0,0,0.0,0,2,2,0,0,0,0,0,0,1
../kbl_data/2024-2025,S45G01N6,고양 소노,Away,최승욱,4,2,2,100.0,0,1,0.0,2,3,66.7,0,0,0.0,4,3,7,2,2,0,0,0,0,1
../kbl_data/2024-2025,S45G01N6,고양 소노,Away,김진유,1,0,0,0.0,0,0,0.0,0,0,0.0,1,2,50.0,0,1,1,0,1,0,1,0,0,3
../kbl_data/2024-2025,S45G01N6,고양 소노,Away,이정현,43,11,19,57.9,6,13,46.2,17,32,53.1,3,3,100.0,2,1,3,7,4,0,0,0,2,3
../kbl_data/2024-2025,S45G01N6,고양 소노,Away,백지웅,0,0,0,0.0,0,0,0.0,0,0,0.0,0,0,0.0,0,0,0,0,0,0,0,0,0,0
../kbl_data/2024-2025,S45G01N6,고양 소노,Away,민기남,0,0,0,0.0,0,0,0.0,0,0,0.0,0,0,0.0,0,0,0,0,0,0,0,0,0,0
../kbl_data/2024-2025,S45G01N6,고양 소노,Away,앨런 윌리엄스,18,9,14,64.3,0,0,0.0,9,14,64.3,0,0,0.0,3,8,11,0,0,0,0,0,2,4
../kbl_data/2024-2025,S45G01N6,고양 소노,Away,디제이 번즈 Jr,18,9,12,75.0,0,1,0.0,9,13,69.2,0,0,0.0,0,3,3,1,1,0,0,0,0,4
../kbl_data/2024-2025,S45G01N7,창원 LG,Home,허일영,0,0,0,0.0,0,2,0.0,0,2,0.0,0,0,0.0,0,1,1,0,0,0,0,0,0,0
../kbl_data/2024-2025,S45G01N7,창원 LG,Home,최진수,0,0,0,0.0,0,0,0.0,0,0,0.0,0,0,0.0,0,0,0,0,0,0,0,0,0,0
../kbl_data/2024-2025,S45G01N7,창원 LG,Home,장민국,3,0,0,0.0,1,3,33.3,1,3,33.3,0,0,0.0,1,1,2,0,0,0,0,0,0,3
../kbl_data/2024-2025,S45G01N7,창원 LG,Home,두경민,7,1,2,50.0,1,4,25.0,2,6,33.3,2,2,100.0,0,6,6,5,1,0,1,0,2,2
../kbl_data/2024-2025,S45G01N7,창원 LG,Home,정인덕,10,0,0,0.0,3,4,75.0,3,4,75.0,1,2,50.0,0,1,1,1,1,0,0,0,2,2
../kbl_data/2024-2025,S45G01N7,창원 LG,Home,대릴 먼로,10,5,6,83.3,0,1,0.0,5,7,71.4,0,0,0.0,2,3,5,1,0,0,0,0,2,1
../kbl_data/2024-2025,S45G01N7,창원 LG,Home,장태빈,0,0,0,0.0,0,0,0.0,0,0,0.0,0,0,0.0,0,0,0,0,0,0,0,0,0,0
../kbl_data/2024-2025,S45G01N7,창원 LG,Home,아셈 마레이,22,10,15,66.7,0,0,0.0,10,15,66.7,2,3,66.7,3,7,10,4,1,1,0,0,5,2
../kbl_data/2024-2025,S45G01N7,창원 LG,Home,양준석,7,2,3,66.7,1,4,25.0,3,7,42.9,0,0,0.0,1,2,3,7,1,0,0,0,2,1
../kbl_data/2024-2025,S45G01N7,창원 LG,Home,이승훈,0,0,0,0.0,0,0,0.0,0,0,0.0,0,0,0.0,0,0,0,0,0,0,0,0,0,0
../kbl_data/2024-2025,S45G01N7,창원 LG,Home,유기상,14,1,2,50.0,4,9,44.4,5,11,45.5,0,0,0.0,0,2,2,1,3,1,0,0,2,3
../kbl_data/2024-2025,S45G01N7,창원 LG,Home,칼 타마요,16,5,6,83.3,2,6,33.3,7,12,58.3,0,0,0.0,1,4,5,4,1,1,0,1,2,3
../kbl_data/2024-2025,S45G01N7,부산 KCC,Away,정창영,8,3,3,100.0,0,1,0.0,3,4,75.0,2,2,100.0,0,1,1,0,0,0,0,0,0,1
../kbl_data/2024-2025,S45G01N7,부산 KCC,Away,리온 윌리엄스,0,0,1,0.0,0,1,0.0,0,2,0.0,0,0,0.0,0,0,0,0,0,0,0,0,1,0
../kbl_data/2024-2025,S45G01N7,부산 KCC,Away,전준범,0,0,0,0.0,0,0,0.0,0,0,0.0,0,0,0.0,0,0,0,0,0,0,0,0,0,0
../kbl_data/2024-2025,S45G01N7,부산 KCC,Away,허웅,13,4,7,57.1,1,7,14.3,5,14,35.7,2,2,100.0,0,2,2,2,2,0,0,0,2,4
../kbl_data/2024-2025,S45G01N7,부산 KCC,Away,이승현,25,11,16,68.8,1,2,50.0,12,18,66.7,0,0,0.0,3,1,4,3,2,0,0,0,1,3
../kbl_data/2024-2025,S45G01N7,부산 KCC,Away,이호현,2,1,2,50.0,0,0,0.0,1,2,50.0,0,0,0.0,0,1,1,3,0,0,0,0,0,0
../kbl_data/2024-2025,S45G01N7,부산 KCC,Away,디온테 버튼,17,6,7,85.7,1,4,25.0,7,11,63.6,2,3,66.7,0,10,10,5,2,2,0,1,3,1
../kbl_data/2024-2025,S45G01N7,부산 KCC,Away,이근휘,3,0,0,0.0,1,2,50.0,1,2,50.0,0,0,0.0,0,0,0,0,0,0,0,0,0,0
../kbl_data/2024-2025,S45G01N7,부산 KCC,Away,김동현,6,3,5,60.0,0,4,0.0,3,9,33.3,0,0,0.0,2,3,5,2,3,0,0,0,1,4
../kbl_data/2024-2025,S45G01N7,부산 KCC,Away,여준형,0,0,0,0.0,0,0,0.0,0,0,0.0,0,0,0.0,0,0,0,0,0,0,0,0,0,0
../kbl_data/2024-2025,S45G01N7,부산 KCC,Away,캘빈 제프리 에피스톨라,10,2,2,100.0,2,5,40.0,4,7,57.1,0,0,0.0,0,4,4,5,4,0,1,0,1,4
../kbl_data/2024-2025,S45G01N7,부산 KCC,Away,이주영,0,0,0,0.0,0,0,0.0,0,0,0.0,0,0,0.0,0,0,0,0,0,0,0,0,0,0
../kbl_data/2024-2025,S45G01N8,서울 SK,Home,김선형,22,5,10,50.0,4,9,44.4,9,19,47.4,0,0,0.0,3,2,5,6,4,0,0,0,4,1
../kbl_data/2024-2025,S45G01N8,서울 SK,Home,오세근,5,1,2,50.0,1,3,33.3,2,5,40.0,0,0,0.0,1,3,4,2,0,0,0,0,0,1
../kbl_data/2024-2025,S45G01N8,서울 SK,Home,최부경,6,1,4,25.0,0,0,0.0,1,4,25.0,4,4,100.0,4,5,9,0,0,2,0,0,0,2
../kbl_data/2024-2025,S45G01N8,서울 SK,Home,최원혁,0,0,1,0.0,0,1,0.0,0,2,0.0,0,0,0.0,1,1,2,2,2,0,0,0,1,3
../kbl_data/2024-2025,S45G01N8,서울 SK,Home,장문호,0,0,0,0.0,0,0,0.0,0,0,0.0,0,0,0.0,0,0,0,0,0,0,0,0,0,0
../kbl_data/2024-2025,S45G01N8,서울 SK,Home,안영준,16,5,7,71.4,2,6,33.3,7,13,53.8,0,2,0.0,0,2,2,2,2,1,0,0,4,4
../kbl_data/2024-2025,S45G01N8,서울 SK,Home,자밀 워니,25,9,20,45.0,1,6,16.7,10,26,38.5,4,5,80.0,1,10,11,1,2,2,0,2,1,1
../kbl_data/2024-2025,S45G01N8,서울 SK,Home,김형빈,0,0,1,0.0,0,2,0.0,0,3,0.0,0,0,0.0,1,2,3,0,2,0,1,0,1,2
../kbl_data/2024-2025,S45G01N8,서울 SK,Home,아이재아 힉스,0,0,0,0.0,0,0,0.0,0,0,0.0,0,0,0.0,0,0,0,0,0,0,0,0,0,0
../kbl_data/2024-2025,S45G01N8,서울 SK,Home,박민우,0,0,0,0.0,0,0,0.0,0,0,0.0,0,0,0.0,0,0,0,0,0,0,0,0,0,0
../kbl_data/2024-2025,S45G01N8,서울 SK,Home,오재현,3,0,3,0.0,0,0,0.0,0,3,0.0,3,4,75.0,0,3,3,3,2,0,0,0,1,4
../kbl_data/2024-2025,S45G01N8,서울 SK,Home,고메즈 델 리아노,0,0,0,0.0,0,0,0.0,0,0,0.0,0,0,0.0,0,0,0,0,0,0,0,0,0,0
../kbl_data/2024-2025,S45G01N8,원주 DB,Away,이관희,13,2,4,50.0,3,9,33.3,5,13,38.5,0,0,0.0,2,1,3,0,2,1,0,0,1,2
../kbl_data/2024-2025,S45G01N8,원주 DB,Away,김시래,0,0,0,0.0,0,1,0.0,0,1,0.0,0,0,0.0,0,0,0,1,0,0,0,0,0,0
../kbl_data/2024-2025,S45G01N8,원주 DB,Away,서민수,2,0,0,0.0,0,1,0.0,0,1,0.0,2,2,100.0,0,2,2,0,0,1,0,0,0,3
../kbl_data/2024-2025,S45G01N8,원주 DB,Away,김영현,3,0,1,0.0,1,1,100.0,1,2,50.0,0,0,0.0,0,0,0,1,1,0,0,0,1,1
../kbl_data/2024-2025,S45G01N8,원주 DB,Away,김종규,2,1,2,50.0,0,0,0.0,1,2,50.0,0,0,0.0,2,4,6,1,0,0,0,0,1,2
../kbl_data/2024-2025,S45G01N8,원주 DB,Away,강상재,10,5,13,38.5,0,0,0.0,5,13,38.5,0,0,0.0,6,4,10,4,2,0,0,0,0,1
../kbl_data/2024-2025,S45G01N8,원주 DB,Away,유현준,3,0,2,0.0,1,4,25.0,1,6,16.7,0,0,0.0,1,5,6,3,2,0,0,0,3,1
../kbl_data/2024-2025,S45G01N8,원주 DB,Away,치나누 오누아쿠,19,7,17,41.2,0,2,0.0,7,19,36.8,5,5,100.0,5,11,16,5,0,1,0,2,9,1
../kbl_data/2024-2025,S45G01N8,원주 DB,Away,김훈,10,1,2,50.0,2,5,40.0,3,7,42.9,2,2,100.0,2,1,3,0,2,0,0,0,0,5
../kbl_data/2024-2025,S45G01N8,원주 DB,Away,이용우,0,0,0,0.0,0,0,0.0,0,0,0.0,0,0,0.0,0,0,0,0,0,0,0,0,0,0
../kbl_data/2024-2025,S45G01N8,원주 DB,Away,이선 알바노,2,1,4,25.0,0,6,0.0,1,10,10.0,0,0,0.0,1,2,3,3,1,0,0,0,5,3
../kbl_data/2024-2025,S45G01N8,원주 DB,Away,로버트 카터,8,1,1,100.0,2,4,50.0,3,5,60.0,0,0,0.0,1,2,3,3,0,0,0,0,0,1
../kbl_data/2024-2025,S45G01N9,부산 KCC,Home,정창영,14,2,5,40.0,2,3,66.7,4,8,50.0,4,4,100.0,0,3,3,3,2,0,0,0,2,4
../kbl_data/2024-2025,S45G01N9,부산 KCC,Home,리온 윌리엄스,2,1,2,50.0,0,1,0.0,1,3,33.3,0,0,0.0,0,0,0,0,0,0,0,0,0,3
../kbl_data/2024-2025,S45G01N9,부산 KCC,Home,전준범,3,0,0,0.0,1,1,100.0,1,1,100.0,0,0,0.0,0,0,0,0,0,0,0,0,0,1
../kbl_data/2024-2025,S45G01N9,부산 KCC,Home,이승현,21,9,15,60.0,0,0,0.0,9,15,60.0,3,4,75.0,2,4,6,5,0,1,1,0,2,0
../kbl_data/2024-2025,S45G01N9,부산 KCC,Home,이호현,2,1,3,33.3,0,0,0.0,1,3,33.3,0,0,0.0,0,0,0,2,0,0,0,0,1,0
../kbl_data/2024-2025,S45G01N9,부산 KCC,Home,디온테 버튼,7,3,6,50.0,0,3,0.0,3,9,33.3,1,1,100.0,1,6,7,5,1,0,0,0,2,5
../kbl_data/2024-2025,S45G01N9,부산 KCC,Home,이근휘,6,0,0,0.0,2,8,25.0,2,8,25.0,0,0,0.0,0,0,0,2,0,0,0,0,0,2
../kbl_data/2024-2025,S45G01N9,부산 KCC,Home,김동현,10,2,3,66.7,2,3,66.7,4,6,66.7,0,0,0.0,2,1,3,2,1,0,0,0,1,3
../kbl_data/2024-2025,S45G01N9,부산 KCC,Home,송동훈,0,0,0,0.0,0,0,0.0,0,0,0.0,0,0,0.0,0,0,0,0,0,0,0,0,0,0
../kbl_data/2024-2025,S45G01N9,부산 KCC,Home,여준형,0,0,0,0.0,0,0,0.0,0,0,0.0,0,0,0.0,0,0,0,0,0,0,0,0,0,0
../kbl_data/2024-2025,S45G01N9,부산 KCC,Home,캘빈 제프리 에피스톨라,4,2,4,50.0,0,0,0.0,2,4,50.0,0,0,0.0,0,2,2,1,0,0,0,0,2,1
../kbl_data/2024-2025,S45G01N9,부산 KCC,Home,이주영,0,0,1,0.0,0,0,0.0,0,1,0.0,0,0,0.0,0,0,0,0,0,0,0,0,0,0
../kbl_data/2024-2025,S45G01N9,고양 소노,Away,정희재,8,1,1,100.0,1,4,25.0,2,5,40.0,3,4,75.0,1,3,4,0,0,0,1,0,1,4
../kbl_data/2024-2025,S45G01N9,고양 소노,Away,임동섭,0,0,0,0.0,0,2,0.0,0,2,0.0,0,0,0.0,0,0,0,1,0,0,0,0,0,2
../kbl_data/2024-2025,S45G01N9,고양 소노,Away,김민욱,0,0,0,0.0,0,0,0.0,0,0,0.0,0,0,0.0,0,0,0,1,0,0,0,0,0,0
../kbl_data/2024-2025,S45G01N9,고양 소노,Away,이재도,28,8,12,66.7,3,6,50.0,11,18,61.1,3,3,100.0,1,6,7,6,6,0,0,0,2,0
../kbl_data/2024-2025,S45G01N9,고양 소노,Away,김영훈,0,0,0,0.0,0,0,0.0,0,0,0.0,0,0,0.0,0,0,0,0,0,0,0,0,0,0
../kbl_data/2024-2025,S45G01N9,고양 소노,Away,최승욱,2,1,2,50.0,0,4,0.0,1,6,16.7,0,0,0.0,1,1,2,2,0,0,0,0,0,3
../kbl_data/2024-2025,S45G01N9,고양 소노,Away,김진유,2,1,1,100.0,0,1,0.0,1,2,50.0,0,0,0.0,7,1,8,1,0,2,0,0,1,2
../kbl_data/2024-2025,S45G01N9,고양 소노,Away,이정현,14,4,8,50.0,2,9,22.2,6,17,35.3,0,0,0.0,0,2,2,3,0,0,1,0,2,2
../kbl_data/2024-2025,S45G01N9,고양 소노,Away,백지웅,0,0,0,0.0,0,0,0.0,0,0,0.0,0,0,0.0,0,0,0,0,0,0,0,0,0,0
../kbl_data/2024-2025,S45G01N9,고양 소노,Away,박종하,0,0,0,0.0,0,0,0.0,0,0,0.0,0,0,0.0,0,0,0,0,0,0,0,0,0,0
../kbl_data/2024-2025,S45G01N9,고양 소노,Away,앨런 윌리엄스,25,10,19,52.6,0,1,0.0,10,20,50.0,5,6,83.3,7,13,20,2,0,0,0,0,0,2
../kbl_data/2024-2025,S45G01N9,고양 소노,Away,디제이 번즈 Jr,0,0,3,0.0,0,0,0.0,0,3,0.0,0,0,0.0,0,0,0,1,0,0,0,0,1,3
../kbl_data/2024-2025,S45G01N10,원주 DB,Home,이관희,8,1,4,25.0,1,1,100.0,2,5,40.0,3,4,75.0,0,2,2,1,0,0,0,0,2,2
../kbl_data/2024-2025,S45G01N10,원주 DB,Home,김시래,2,1,2,50.0,0,2,0.0,1,4,25.0,0,2,0.0,0,1,1,3,1,0,0,0,0,1
../kbl_data/2024-2025,S45G01N10,원주 DB,Home,서민수,0,0,0,0.0,0,0,0.0,0,0,0.0,0,0,0.0,0,0,0,0,0,0,0,0,0,2
../kbl_data/2024-2025,S45G01N10,원주 DB,Home,김영현,2,1,2,50.0,0,1,0.0,1,3,33.3,0,0,0.0,0,1,1,0,0,0,0,0,0,3
../kbl_data/2024-2025,S45G01N10,원주 DB,Home,김종규,5,2,5,40.0,0,0,0.0,2,5,40.0,1,2,50.0,2,2,4,1,0,0,0,0,1,1
../kbl_data/2024-2025,S45G01N10,원주 DB,Home,박봉진,0,0,1,0.0,0,1,0.0,0,2,0.0,0,0,0.0,4,2,6,0,0,0,1,0,0,3
../kbl_data/2024-2025,S45G01N10,원주 DB,Home,강상재,2,1,2,50.0,0,1,0.0,1,3,33.3,0,0,0.0,1,3,4,0,0,1,0,0,1,0
../kbl_data/2024-2025,S45G01N10,원주 DB,Home,유현준,9,1,3,33.3,2,4,50.0,3,7,42.9,1,1,100.0,0,2,2,4,0,0,1,0,1,2
../kbl_data/2024-2025,S45G01N10,원주 DB,Home,치나누 오누아쿠,11,5,10,50.0,0,1,0.0,5,11,45.5,1,2,50.0,4,8,12,2,1,0,0,0,4,0
../kbl_data/2024-2025,S45G01N10,원주 DB,Home,김훈,3,0,1,0.0,1,5,20.0,1,6,16.7,0,0,0.0,1,0,1,0,2,0,0,0,0,4
../kbl_data/2024-2025,S45G01N10,원주 DB,Home,이선 알바노,6,3,10,30.0,0,2,0.0,3,12,25.0,0,0,0.0,0,1,1,4,0,0,0,0,1,1
../kbl_data/2024-2025,S45G01N10,원주 DB,Home,로버트 카터,14,5,11,45.5,1,3,33.3,6,14,42.9,1,2,50.0,1,5,6,0,1,1,0,1,3,2
../kbl_data/2024-2025,S45G01N10,대구 한국가스공사,Away,김동량,2,1,4,25.0,0,0,0.0,1,4,25.0,0,0,0.0,1,2,3,0,0,0,0,0,0,2
../kbl_data/2024-2025,S45G01N10,대구 한국가스공사,Away,박지훈,4,1,1,100.0,0,1,0.0,1,2,50.0,2,2,100.0,0,1,1,1,3,0,0,0,1,2
../kbl_data/2024-2025,S45G01N10,대구 한국가스공사,Away,조상열,0,0,0,0.0,0,0,0.0,0,0,0.0,0,0,0.0,1,0,1,0,0,0,0,0,0,1
../kbl_data/2024-2025,S45G01N10,대구 한국가스공사,Away,정성우,7,2,4,50.0,1,2,50.0,3,6,50.0,0,0,0.0,0,2,2,4,2,0,1,0,0,3
../kbl_data/2024-2025,S45G01N10,대구 한국가스공사,Away,김낙현,3,0,2,0.0,1,6,16.7,1,8,12.5,0,0,0.0,0,1,1,4,0,1,0,0,1,2
../kbl_data/2024-2025,S45G01N10,대구 한국가스공사,Away,양재혁,7,2,3,66.7,1,3,33.3,3,6,50.0,0,0,0.0,2,1,3,3,1,1,0,0,0,3
../kbl_data/2024-2025,S45G01N10,대구 한국가스공사,Away,곽정훈,3,0,0,0.0,1,2,50.0,1,2,50.0,0,0,0.0,1,2,3,0,0,0,0,0,1,1
../kbl_data/2024-2025,S45G01N10,대구 한국가스공사,Away,앤드류 니콜슨,24,5,9,55.6,4,7,57.1,9,16,56.2,2,2,100.0,2,7,9,0,0,2,0,0,0,0
../kbl_data/2024-2025,S45G01N10,대구 한국가스공사,Away,신승민,13,1,2,50.0,3,6,50.0,4,8,50.0,2,3,66.7,0,6,6,1,0,0,0,0,1,3
../kbl_data/2024-2025,S45G01N10,대구 한국가스공사,Away,샘조세프 벨란겔,14,3,4,75.0,2,4,50.0,5,8,62.5,2,2,100.0,0,3,3,4,0,0,0,0,1,3
../kbl_data/2024-2025,S45G01N10,대구 한국가스공사,Away,유슈 은도예,14,7,12,58.3,0,0,0.0,7,12,58.3,0,1,0.0,3,5,8,1,0,1,0,1,2,0
../kbl_data/2024-2025,S45G01N10,대구 한국가스공사,Away,신주영,1,0,0,0.0,0,0,0.0,0,0,0.0,1,2,50.0,0,1,1,1,0,0,0,0,2,0
../kbl_data/2024-2025,S45G01N11,창원 LG,Home,허일영,13,2,2,100.0,3,5,60.0,5,7,71.4,0,0,0.0,3,0,3,0,1,0,0,0,1,3
../kbl_data/2024-2025,S45G01N11,창원 LG,Home,최진수,0,0,0,0.0,0,0,0.0,0,0,0.0,0,0,0.0,1,0,1,1,0,0,0,0,0,1
../kbl_data/2024-2025,S45G01N11,창원 LG,Home,장민국,0,0,0,0.0,0,0,0.0,0,0,0.0,0,0,0.0,0,0,0,0,0,0,0,0,0,0
../kbl_data/2024-2025,S45G01N11,창원 LG,Home,정인덕,10,3,6,50.0,1,4,25.0,4,10,40.0,1,2,50.0,0,6,6,1,1,0,1,0,1,2
../kbl_data/2024-2025,S45G01N11,창원 LG,Home,대릴 먼로,4,2,3,66.7,0,3,0.0,2,6,33.3,0,0,0.0,1,2,3,1,0,0,0,0,1,0
../kbl_data/2024-2025,S45G01N11,창원 LG,Home,장태빈,0,0,0,0.0,0,1,0.0,0,1,0.0,0,0,0.0,0,0,0,0,0,0,0,0,0,1
../kbl_data/2024-2025,S45G01N11,창원 LG,Home,박정현,0,0,0,0.0,0,0,0.0,0,0,0.0,0,0,0.0,0,0,0,0,0,0,0,0,0,0
../kbl_data/2024-2025,S45G01N11,창원 LG,Home,아셈 마레이,14,5,8,62.5,0,0,0.0,5,8,62.5,4,6,66.7,5,10,15,5,3,2,0,1,5,3
../kbl_data/2024-2025,S45G01N11,창원 LG,Home,양준석,22,6,7,85.7,2,5,40.0,8,12,66.7,4,5,80.0,1,1,2,9,0,0,0,0,0,3
../kbl_data/2024-2025,S45G01N11,창원 LG,Home,이승훈,0,0,0,0.0,0,0,0.0,0,0,0.0,0,0,0.0,0,0,0,0,0,0,0,0,0,0
../kbl_data/2024-2025,S45G01N11,창원 LG,Home,유기상,10,2,6,33.3,2,5,40.0,4,11,36.4,0,0,0.0,1,3,4,2,1,0,0,0,1,1
../kbl_data/2024-2025,S45G01N11,창원 LG,Home,칼 타마요,9,3,7,42.9,1,6,16.7,4,13,30.8,0,0,0.0,3,4,7,1,1,0,0,0,2,4
../kbl_data/2024-2025,S45G01N11,안양 정관장,Away,송창용,0,0,1,0.0,0,0,0.0,0,1,0.0,0,0,0.0,1,0,1,0,0,0,0,0,0,0
../kbl_data/2024-2025,S45G01N11,안양 정관장,Away,이원대,0,0,1,0.0,0,0,0.0,0,1,0.0,0,0,0.0,0,0,0,0,0,0,0,0,0,0
../kbl_data/2024-2025,S45G01N11,안양 정관장,Away,배병준,5,0,3,0.0,1,6,16.7,1,9,11.1,2,2,100.0,0,2,2,4,0,1,0,0,1,4
../kbl_data/2024-2025,S45G01N11,안양 정관장,Away,정효근,0,0,0,0.0,0,0,0.0,0,0,0.0,0,0,0.0,0,0,0,0,0,0,0,0,0,0
../kbl_data/2024-2025,S45G01N11,안양 정관장,Away,이종현,7,2,3,66.7,1,3,33.3,3,6,50.0,0,0,0.0,1,4,5,2,3,1,0,0,3,2
../kbl_data/2024-2025,S45G01N11,안양 정관장,Away,박지훈,15,4,6,66.7,2,3,66.7,6,9,66.7,1,1,100.0,0,1,1,6,1,0,0,0,2,3
../kbl_data/2024-2025,S45G01N11,안양 정관장,Away,최성원,12,1,3,33.3,3,6,50.0,4,9,44.4,1,2,50.0,1,3,4,0,1,0,0,0,0,1
../kbl_data/2024-2025,S45G01N11,안양 정관장,Away,김준형,0,0,0,0.0,0,0,0.0,0,0,0.0,0,0,0.0,0,0,0,1,0,0,0,0,0,0
../kbl_data/2024-2025,S45G01N11,안양 정관장,Away,캐디 라렌,13,4,9,44.4,1,4,25.0,5,13,38.5,2,2,100.0,1,7,8,3,0,2,0,1,1,3
../kbl_data/2024-2025,S45G01N11,안양 정관장,Away,김경원,0,0,1,0.0,0,0,0.0,0,1,0.0,0,0,0.0,0,0,0,0,0,0,0,0,0,0
../kbl_data/2024-2025,S45G01N11,안양 정관장,Away,하비 고메즈,17,2,3,66.7,4,7,57.1,6,10,60.0,1,2,50.0,1,3,4,0,1,0,0,0,2,2
../kbl_data/2024-2025,S45G01N11,안양 정관장,Away,마이클 영 Jr,6,3,5,60.0,0,0,0.0,3,5,60.0,0,0,0.0,0,2,2,2,0,0,0,0,1,2
../kbl_data/2024-2025,S45G01N12,부산 KCC,Home,정창영,10,2,3,66.7,1,2,50.0,3,5,60.0,3,4,75.0,0,0,0,0,0,0,0,0,1,4
../kbl_data/2024-2025,S45G01N12,부산 KCC,Home,리온 윌리엄스,4,1,6,16.7,0,1,0.0,1,7,14.3,2,2,100.0,2,6,8,7,3,0,0,0,1,3
../kbl_data/2024-2025,S45G01N12,부산 KCC,Home,전준범,19,2,4,50.0,4,7,57.1,6,11,54.5,3,5,60.0,1,2,3,1,0,0,0,0,1,4
../kbl_data/2024-2025,S45G01N12,부산 KCC,Home,이승현,9,3,8,37.5,0,1,0.0,3,9,33.3,3,3,100.0,1,5,6,2,1,0,0,0,2,0
../kbl_data/2024-2025,S45G01N12,부산 KCC,Home,이호현,2,1,6,16.7,0,0,0.0,1,6,16.7,0,0,0.0,0,2,2,3,0,0,0,0,1,0
../kbl_data/2024-2025,S45G01N12,부산 KCC,Home,디온테 버튼,0,0,0,0.0,0,0,0.0,0,0,0.0,0,0,0.0,0,0,0,0,0,0,0,0,0,0
../kbl_data/2024-2025,S45G01N12,부산 KCC,Home,이근휘,14,1,2,50.0,4,6,66.7,5,8,62.5,0,0,0.0,2,0,2,0,1,0,0,0,0,1
../kbl_data/2024-2025,S45G01N12,부산 KCC,Home,김동현,2,1,1,100.0,0,0,0.0,1,1,100.0,0,0,0.0,0,1,1,1,1,0,0,0,1,1
../kbl_data/2024-2025,S45G01N12,부산 KCC,Home,송동훈,0,0,1,0.0,0,0,0.0,0,1,0.0,0,0,0.0,0,0,0,0,0,0,0,0,0,0
../kbl_data/2024-2025,S45G01N12,부산 KCC,Home,여준형,6,3,6,50.0,0,0,0.0,3,6,50.0,0,0,0.0,0,1,1,1,0,0,0,0,0,3
../kbl_data/2024-2025,S45G01N12,부산 KCC,Home,캘빈 제프리 에피스톨라,8,4,9,44.4,0,0,0.0,4,9,44.4,0,0,0.0,0,1,1,3,2,0,0,0,3,3
../kbl_data/2024-2025,S45G01N12,부산 KCC,Home,이주영,2,1,1,100.0,0,1,0.0,1,2,50.0,0,0,0.0,0,0,0,0,1,0,0,0,1,0
../kbl_data/2024-2025,S45G01N12,울산 현대모비스,Away,함지훈,6,1,1,100.0,1,1,100.0,2,2,100.0,1,2,50.0,0,3,3,6,1,0,0,0,4,1
../kbl_data/2024-2025,S45G01N12,울산 현대모비스,Away,장재석,4,2,3,66.7,0,0,0.0,2,3,66.7,0,0,0.0,2,1,3,2,0,0,0,0,0,4
../kbl_data/2024-2025,S45G01N12,울산 현대모비스,Away,한호빈,0,0,1,0.0,0,1,0.0,0,2,0.0,0,0,0.0,0,0,0,0,0,0,0,0,1,1
../kbl_data/2024-2025,S45G01N12,울산 현대모비스,Away,김준일,2,1,1,100.0,0,0,0.0,1,1,100.0,0,0,0.0,1,1,2,0,0,0,0,0,0,0
../kbl_data/2024-2025,S45G01N12,울산 현대모비스,Away,김국찬,15,4,5,80.0,2,3,66.7,6,8,75.0,1,2,50.0,1,3,4,2,1,0,1,0,1,4
../kbl_data/2024-2025,S45G01N12,울산 현대모비스,Away,서명진,7,2,3,66.7,1,2,50.0,3,5,60.0,0,0,0.0,0,0,0,3,0,1,1,0,3,1
../kbl_data/2024-2025,S45G01N12,울산 현대모비스,Away,숀 롱,16,7,10,70.0,0,0,0.0,7,10,70.0,2,3,66.7,2,8,10,2,0,1,0,1,1,2
../kbl_data/2024-2025,S45G01N12,울산 현대모비스,Away,이우석,2,1,5,20.0,0,2,0.0,1,7,14.3,0,0,0.0,1,2,3,4,1,0,0,0,1,2
../kbl_data/2024-2025,S45G01N12,울산 현대모비스,Away,이승우,2,1,1,100.0,0,0,0.0,1,1,100.0,0,0,0.0,0,1,1,1,0,0,0,0,0,0
../kbl_data/2024-2025,S45G01N12,울산 현대모비스,Away,게이지 프림,26,9,11,81.8,2,2,100.0,11,13,84.6,2,2,100.0,1,9,10,3,2,0,0,0,0,0
../kbl_data/2024-2025,S45G01N12,울산 현대모비스,Away,박무빈,4,2,3,66.7,0,0,0.0,2,3,66.7,0,0,0.0,0,1,1,0,1,0,0,0,1,2
../kbl_data/2024-2025,S45G01N12,울산 현대모비스,Away,미구엘 안드레 옥존,12,1,5,20.0,3,9,33.3,4,14,28.6,1,1,100.0,1,1,2,3,1,1,0,0,1,1
../kbl_data/2024-2025,S45G01N13,수원 KT,Home,한희원,2,1,5,20.0,0,3,0.0,1,8,12.5,0,0,0.0,1,6,7,0,2,0,0,0,0,1
../kbl_data/2024-2025,S45G01N13,수원 KT,Home,최창진,0,0,0,0.0,0,0,0.0,0,0,0.0,0,0,0.0,0,1,1,1,0,0,0,0,2,0
../kbl_data/2024-2025,S45G01N13,수원 KT,Home,문성곤,11,1,2,50.0,2,4,50.0,3,6,50.0,3,5,60.0,1,2,3,0,0,0,0,0,3,3
../kbl_data/2024-2025,S45G01N13,수원 KT,Home,이현석,0,0,0,0.0,0,0,0.0,0,0,0.0,0,0,0.0,1,1,2,0,0,0,0,0,0,0
../kbl_data/2024-2025,S45G01N13,수원 KT,Home,허훈,8,1,10,10.0,2,7,28.6,3,17,17.6,0,0,0.0,1,1,2,12,0,0,0,0,4,2
../kbl_data/2024-2025,S45G01N13,수원 KT,Home,박준영,11,4,7,57.1,1,2,50.0,5,9,55.6,0,0,0.0,4,7,11,4,1,0,0,0,1,3
../kbl_data/2024-2025,S45G01N13,수원 KT,Home,최진광,0,0,0,0.0,0,0,0.0,0,0,0.0,0,0,0.0,0,0,0,0,0,0,0,0,0,0
../kbl_data/2024-2025,S45G01N13,수원 KT,Home,이두원,2,1,4,25.0,0,0,0.0,1,4,25.0,0,0,0.0,3,0,3,0,0,0,0,0,0,1
../kbl_data/2024-2025,S45G01N13,수원 KT,Home,고찬혁,0,0,0,0.0,0,0,0.0,0,0,0.0,0,0,0.0,0,0,0,0,0,0,0,0,0,0
../kbl_data/2024-2025,S45G01N13,수원 KT,Home,문정현,12,4,5,80.0,0,1,0.0,4,6,66.7,4,5,80.0,1,3,4,2,0,0,0,0,1,3
../kbl_data/2024-2025,S45G01N13,수원 KT,Home,제레미아 틸먼,2,1,4,25.0,0,0,0.0,1,4,25.0,0,0,0.0,1,3,4,2,1,1,0,0,1,1
../kbl_data/2024-2025,S45G01N13,수원 KT,Home,레이션 해먼즈,29,7,14,50.0,4,5,80.0,11,19,57.9,3,4,75.0,2,12,14,0,0,0,0,0,1,4
../kbl_data/2024-2025,S45G01N13,서울 SK,Away,김선형,11,3,7,42.9,1,6,16.7,4,13,30.8,2,2,100.0,0,2,2,3,0,0,0,0,1,1
../kbl_data/2024-2025,S45G01N13,서울 SK,Away,오세근,4,2,6,33.3,0,2,0.0,2,8,25.0,0,0,0.0,0,5,5,2,2,0,0,0,0,3
../kbl_data/2024-2025,S45G01N13,서울 SK,Away,최부경,0,0,2,0.0,0,1,0.0,0,3,0.0,0,0,0.0,2,1,3,0,0,1,0,0,0,1
../kbl_data/2024-2025,S45G01N13,서울 SK,Away,최원혁,0,0,0,0.0,0,0,0.0,0,0,0.0,0,0,0.0,0,1,1,0,2,0,0,0,1,1
../kbl_data/2024-2025,S45G01N13,서울 SK,Away,장문호,0,0,0,0.0,0,0,0.0,0,0,0.0,0,0,0.0,0,0,0,0,0,0,0,0,0,0
../kbl_data/2024-2025,S45G01N13,서울 SK,Away,안영준,22,6,8,75.0,2,7,28.6,8,15,53.3,4,5,80.0,2,3,5,4,3,1,0,0,1,5
../kbl_data/2024-2025,S45G01N13,서울 SK,Away,자밀 워니,20,8,18,44.4,0,3,0.0,8,21,38.1,4,7,57.1,0,12,12,7,2,2,0,0,0,0
../kbl_data/2024-2025,S45G01N13,서울 SK,Away,김형빈,2,1,2,50.0,0,1,0.0,1,3,33.3,0,0,0.0,0,0,0,1,0,0,0,0,0,2
../kbl_data/2024-2025,S45G01N13,서울 SK,Away,아이재아 힉스,2,1,1,100.0,0,0,0.0,1,1,100.0,0,0,0.0,1,1,2,0,0,0,0,0,0,0
../kbl_data/2024-2025,S45G01N13,서울 SK,Away,박민우,0,0,0,0.0,0,0,0.0,0,0,0.0,0,0,0.0,0,0,0,0,0,0,0,0,0,0
../kbl_data/2024-2025,S45G01N13,서울 SK,Away,오재현,9,3,5,60.0,0,3,0.0,3,8,37.5,3,3,100.0,3,0,3,2,1,0,0,0,1,4
../kbl_data/2024-2025,S45G01N13,서울 SK,Away,고메즈 델 리아노,5,2,3,66.7,0,1,0.0,2,4,50.0,1,2,50.0,0,2,2,1,0,0,0,0,0,1
../kbl_data/2024-2025,S45G01N14,대구 한국가스공사,Home,김동량,0,0,0,0.0,0,0,0.0,0,0,0.0,0,0,0.0,0,0,0,0,0,0,0,0,0,0
../kbl_data/2024-2025,S45G01N14,대구 한국가스공사,Home,박지훈,2,1,2,50.0,0,0,0.0,1,2,50.0,0,0,0.0,0,1,1,0,1,0,0,0,0,3
../kbl_data/2024-2025,S45G01N14,대구 한국가스공사,Home,이대헌,9,4,7,57.1,0,1,0.0,4,8,50.0,1,3,33.3,3,2,5,3,1,0,0,1,1,0
../kbl_data/2024-2025,S45G01N14,대구 한국가스공사,Home,정성우,0,0,2,0.0,0,2,0.0,0,4,0.0,0,0,0.0,1,2,3,3,1,0,0,0,2,3
../kbl_data/2024-2025,S45G01N14,대구 한국가스공사,Home,김낙현,20,4,6,66.7,4,8,50.0,8,14,57.1,0,0,0.0,0,2,2,2,1,0,0,0,4,2
../kbl_data/2024-2025,S45G01N14,대구 한국가스공사,Home,양재혁,0,0,0,0.0,0,0,0.0,0,0,0.0,0,0,0.0,0,0,0,0,0,1,0,0,0,2
../kbl_data/2024-2025,S45G01N14,대구 한국가스공사,Home,곽정훈,3,0,0,0.0,1,1,100.0,1,1,100.0,0,0,0.0,0,0,0,0,0,0,0,0,0,0
../kbl_data/2024-2025,S45G01N14,대구 한국가스공사,Home,앤드류 니콜슨,8,1,6,16.7,2,9,22.2,3,15,20.0,0,0,0.0,1,4,5,1,3,0,0,0,1,0
../kbl_data/2024-2025,S45G01N14,대구 한국가스공사,Home,신승민,2,1,3,33.3,0,1,0.0,1,4,25.0,0,0,0.0,3,3,6,1,0,0,0,0,0,3
../kbl_data/2024-2025,S45G01N14,대구 한국가스공사,Home,샘조세프 벨란겔,23,4,7,57.1,3,6,50.0,7,13,53.8,6,6,100.0,0,5,5,7,1,0,0,0,2,3
../kbl_data/2024-2025,S45G01N14,대구 한국가스공사,Home,유슈 은도예,9,4,7,57.1,0,0,0.0,4,7,57.1,1,2,50.0,1,3,4,0,0,2,1,2,0,2
../kbl_data/2024-2025,S45G01N14,대구 한국가스공사,Home,신주영,0,0,0,0.0,0,0,0.0,0,0,0.0,0,0,0.0,0,0,0,0,0,0,0,0,0,0
../kbl_data/2024-2025,S45G01N14,서울 삼성,Away,이정현,10,1,3,33.3,2,5,40.0,3,8,37.5,2,2,100.0,1,5,6,3,0,0,0,0,5,4
../kbl_data/2024-2025,S45G01N14,서울 삼성,Away,최현민,0,0,1,0.0,0,0,0.0,0,1,0.0,0,0,0.0,1,0,1,0,0,0,0,0,0,0
../kbl_data/2024-2025,S45G01N14,서울 삼성,Away,이동엽,0,0,0,0.0,0,0,0.0,0,0,0.0,0,0,0.0,0,0,0,0,0,0,0,0,0,0
../kbl_data/2024-2025,S45G01N14,서울 삼성,Away,최성모,6,0,1,0.0,2,5,40.0,2,6,33.3,0,0,0.0,0,0,0,4,1,0,0,0,3,1
../kbl_data/2024-2025,S45G01N14,서울 삼성,Away,최승욱,2,1,2,50.0,0,1,0.0,1,3,33.3,0,0,0.0,0,2,2,1,0,0,0,0,0,1
../kbl_data/2024-2025,S45G01N14,서울 삼성,Away,마커스 데릭슨,3,0,0,0.0,1,3,33.3,1,3,33.3,0,0,0.0,1,2,3,1,0,0,0,0,1,2
../kbl_data/2024-2025,S45G01N14,서울 삼성,Away,차민석,2,1,7,14.3,0,0,0.0,1,7,14.3,0,0,0.0,1,1,2,1,1,0,0,0,1,2
../kbl_data/2024-2025,S45G01N14,서울 삼성,Away,이원석,5,2,2,100.0,0,3,0.0,2,5,40.0,1,1,100.0,1,5,6,0,2,3,0,0,0,1
../kbl_data/2024-2025,S45G01N14,서울 삼성,Away,저스틴 구탕,8,4,7,57.1,0,0,0.0,4,7,57.1,0,0,0.0,0,3,3,1,0,0,1,0,3,3
../kbl_data/2024-2025,S45G01N14,서울 삼성,Away,조준희,0,0,0,0.0,0,0,0.0,0,0,0.0,0,0,0.0,0,0,0,0,0,0,0,0,0,0
../kbl_data/2024-2025,S45G01N14,서울 삼성,Away,박승재,8,1,3,33.3,2,3,66.7,3,6,50.0,0,0,0.0,1,3,4,3,0,0,0,0,1,2
../kbl_data/2024-2025,S45G01N14,서울 삼성,Away,코피 코번,26,12,19,63.2,0,0,0.0,12,19,63.2,2,2,100.0,5,6,11,0,1,1,0,0,3,3
../kbl_data/2024-2025,S45G01N15,고양 소노,Home,정희재,14,0,0,0.0,4,6,66.7,4,6,66.7,2,2,100.0,3,5,8,1,1,2,0,0,0,3
../kbl_data/2024-2025,S45G01N15,고양 소노,Home,임동섭,0,0,1,0.0,0,2,0.0,0,3,0.0,0,0,0.0,0,0,0,0,0,0,0,0,0,0
../kbl_data/2024-2025,S45G01N15,고양 소노,Home,김민욱,0,0,0,0.0,0,0,0.0,0,0,0.0,0,0,0.0,0,0,0,0,0,0,0,0,0,0
../kbl_data/2024-2025,S45G01N15,고양 소노,Home,이재도,10,1,5,20.0,2,5,40.0,3,10,30.0,2,2,100.0,2,4,6,5,0,0,0,0,0,3
../kbl_data/2024-2025,S45G01N15,고양 소노,Home,김영훈,1,0,0,0.0,0,0,0.0,0,0,0.0,1,2,50.0,0,0,0,0,0,0,0,0,0,0
../kbl_data/2024-2025,S45G01N15,고양 소노,Home,최승욱,12,6,8,75.0,0,1,0.0,6,9,66.7,0,0,0.0,2,0,2,2,2,1,0,0,1,2
../kbl_data/2024-2025,S45G01N15,고양 소노,Home,김진유,5,1,1,100.0,1,2,50.0,2,3,66.7,0,0,0.0,2,4,6,1,0,0,0,0,0,1
../kbl_data/2024-2025,S45G01N15,고양 소노,Home,이정현,18,8,14,57.1,0,9,0.0,8,23,34.8,2,3,66.7,0,3,3,4,1,0,0,0,1,3
../kbl_data/2024-2025,S45G01N15,고양 소노,Home,백지웅,0,0,0,0.0,0,0,0.0,0,0,0.0,0,0,0.0,0,0,0,0,0,0,0,0,0,0
../kbl_data/2024-2025,S45G01N15,고양 소노,Home,박종하,0,0,0,0.0,0,0,0.0,0,0,0.0,0,0,0.0,0,0,0,0,0,0,0,0,0,0
../kbl_data/2024-2025,S45G01N15,고양 소노,Home,앨런 윌리엄스,18,9,14,64.3,0,1,0.0,9,15,60.0,0,0,0.0,2,8,10,2,0,0,0,1,5,4
../kbl_data/2024-2025,S45G01N15,고양 소노,Home,디제이 번즈 Jr,4,2,5,40.0,0,1,0.0,2,6,33.3,0,0,0.0,3,2,5,0,1,0,0,0,1,1
../kbl_data/2024-2025,S45G01N15,창원 LG,Away,허일영,10,2,2,100.0,2,5,40.0,4,7,57.1,0,0,0.0,0,4,4,0,0,0,0,0,0,2
../kbl_data/2024-2025,S45G01N15,창원 LG,Away,최진수,0,0,0,0.0,0,0,0.0,0,0,0.0,0,0,0.0,0,0,0,0,0,0,0,0,0,0
../kbl_data/2024-2025,S45G01N15,창원 LG,Away,장민국,0,0,1,0.0,0,0,0.0,0,1,0.0,0,2,0.0,0,0,0,1,0,0,0,0,0,0
../kbl_data/2024-2025,S45G01N15,창원 LG,Away,정인덕,5,1,2,50.0,1,1,100.0,2,3,66.7,0,0,0.0,0,2,2,1,0,0,0,0,2,1
../kbl_data/2024-2025,S45G01N15,창원 LG,Away,대릴 먼로,7,1,1,100.0,0,1,0.0,1,2,50.0,5,5,100.0,0,3,3,6,1,0,0,0,0,2
../kbl_data/2024-2025,S45G01N15,창원 LG,Away,장태빈,0,0,0,0.0,0,0,0.0,0,0,0.0,0,0,0.0,0,0,0,0,0,0,0,0,0,0
../kbl_data/2024-2025,S45G01N15,창원 LG,Away,박정현,0,0,0,0.0,0,0,0.0,0,0,0.0,0,0,0.0,0,0,0,0,0,0,0,0,0,0
../kbl_data/2024-2025,S45G01N15,창원 LG,Away,아셈 마레이,13,4,10,40.0,0,0,0.0,4,10,40.0,5,8,62.5,1,8,9,4,1,0,2,0,2,4
../kbl_data/2024-2025,S45G01N15,창원 LG,Away,양준석,13,2,8,25.0,3,5,60.0,5,13,38.5,0,0,0.0,1,1,2,8,0,0,0,0,2,2
../kbl_data/2024-2025,S45G01N15,창원 LG,Away,이승훈,0,0,0,0.0,0,2,0.0,0,2,0.0,0,0,0.0,0,1,1,0,0,0,0,0,0,0
../kbl_data/2024-2025,S45G01N15,창원 LG,Away,유기상,10,0,0,0.0,3,6,50.0,3,6,50.0,1,2,50.0,0,1,1,2,1,1,0,0,0,2
../kbl_data/2024-2025,S45G01N15,창원 LG,Away,칼 타마요,19,8,10,80.0,1,3,33.3,9,13,69.2,0,0,0.0,3,4,7,3,1,1,0,0,2,3
../kbl_data/2024-2025,S45G01N16,안양 정관장,Home,정준원,0,0,0,0.0,0,0,0.0,0,0,0.0,0,0,0.0,0,0,0,0,0,0,0,0,0,0
../kbl_data/2024-2025,S45G01N16,안양 정관장,Home,이원대,0,0,2,0.0,0,1,0.0,0,3,0.0,0,0,0.0,0,1,1,2,0,0,0,0,0,2
../kbl_data/2024-2025,S45G01N16,안양 정관장,Home,배병준,17,5,6,83.3,2,5,40.0,7,11,63.6,1,2,50.0,1,2,3,0,1,0,0,0,1,3
../kbl_data/2024-2025,S45G01N16,안양 정관장,Home,정효근,6,2,8,25.0,0,1,0.0,2,9,22.2,2,3,66.7,3,6,9,1,2,0,0,1,3,4
../kbl_data/2024-2025,S45G01N16,안양 정관장,Home,이종현,10,3,5,60.0,1,2,50.0,4,7,57.1,1,2,50.0,2,6,8,1,1,2,0,0,2,1
../kbl_data/2024-2025,S45G01N16,안양 정관장,Home,박지훈,4,2,5,40.0,0,4,0.0,2,9,22.2,0,0,0.0,1,2,3,7,1,1,0,0,3,3
../kbl_data/2024-2025,S45G01N16,안양 정관장,Home,최성원,9,3,4,75.0,1,5,20.0,4,9,44.4,0,0,0.0,0,1,1,2,1,0,0,0,1,2
../kbl_data/2024-2025,S45G01N16,안양 정관장,Home,김준형,0,0,0,0.0,0,0,0.0,0,0,0.0,0,0,0.0,0,0,0,0,0,0,0,0,0,0
../kbl_data/2024-2025,S45G01N16,안양 정관장,Home,캐디 라렌,15,6,16,37.5,1,5,20.0,7,21,33.3,0,0,0.0,4,14,18,0,1,4,0,1,1,0
../kbl_data/2024-2025,S45G01N16,안양 정관장,Home,김경원,0,0,0,0.0,0,0,0.0,0,0,0.0,0,0,0.0,0,0,0,0,0,0,0,0,0,0
../kbl_data/2024-2025,S45G01N16,안양 정관장,Home,하비 고메즈,1,0,0,0.0,0,2,0.0,0,2,0.0,1,2,50.0,0,0,0,0,0,0,0,0,0,0
../kbl_data/2024-2025,S45G01N16,안양 정관장,Home,마이클 영 Jr,6,3,4,75.0,0,0,0.0,3,4,75.0,0,0,0.0,0,1,1,2,1,0,0,0,1,0
../kbl_data/2024-2025,S45G01N16,원주 DB,Away,이관희,8,3,4,75.0,0,7,0.0,3,11,27.3,2,2,100.0,0,3,3,3,0,0,0,0,2,1
../kbl_data/2024-2025,S45G01N16,원주 DB,Away,김시래,5,1,2,50.0,1,1,100.0,2,3,66.7,0,0,0.0,0,1,1,2,1,0,0,0,1,4
../kbl_data/2024-2025,S45G01N16,원주 DB,Away,서민수,3,1,3,33.3,0,1,0.0,1,4,25.0,1,1,100.0,1,0,1,0,0,0,0,0,1,2
../kbl_data/2024-2025,S45G01N16,원주 DB,Away,김영현,0,0,0,0.0,0,0,0.0,0,0,0.0,0,0,0.0,0,0,0,0,0,0,0,0,0,0
../kbl_data/2024-2025,S45G01N16,원주 DB,Away,김종규,6,3,6,50.0,0,0,0.0,3,6,50.0,0,0,0.0,2,4,6,0,0,2,0,0,0,1
../kbl_data/2024-2025,S45G01N16,원주 DB,Away,강상재,8,4,5,80.0,0,3,0.0,4,8,50.0,0,0,0.0,0,2,2,0,0,3,0,0,1,2
../kbl_data/2024-2025,S45G01N16,원주 DB,Away,유현준,15,1,2,50.0,4,5,80.0,5,7,71.4,1,2,50.0,0,2,2,1,1,0,0,0,1,2
../kbl_data/2024-2025,S45G01N16,원주 DB,Away,치나누 오누아쿠,11,5,9,55.6,0,1,0.0,5,10,50.0,1,2,50.0,1,10,11,3,1,1,0,1,2,2
../kbl_data/2024-2025,S45G01N16,원주 DB,Away,김훈,0,0,0,0.0,0,0,0.0,0,0,0.0,0,0,0.0,0,0,0,0,0,0,0,0,0,0
../kbl_data/2024-2025,S45G01N16,원주 DB,Away,이용우,0,0,0,0.0,0,1,0.0,0,1,0.0,0,0,0.0,1,0,1,1,1,0,0,0,1,1
../kbl_data/2024-2025,S45G01N16,원주 DB,Away,이선 알바노,0,0,6,0.0,0,3,0.0,0,9,0.0,0,2,0.0,1,2,3,2,2,0,0,0,1,1
../kbl_data/2024-2025,S45G01N16,원주 DB,Away,로버트 카터,4,2,3,66.7,0,4,0.0,2,7,28.6,0,0,0.0,1,2,3,3,1,1,0,0,1,1
../kbl_data/2024-2025,S45G01N17,서울 삼성,Home,이정현,16,1,2,50.0,3,9,33.3,4,11,36.4,5,5,100.0,2,2,4,4,1,1,0,0,5,4
../kbl_data/2024-2025,S45G01N17,서울 삼성,Home,최현민,14,4,6,66.7,2,6,33.3,6,12,50.0,0,0,0.0,1,1,2,1,1,0,0,0,2,3
../kbl_data/2024-2025,S45G01N17,서울 삼성,Home,이동엽,0,0,0,0.0,0,0,0.0,0,0,0.0,0,0,0.0,0,0,0,0,0,0,0,0,0,0
../kbl_data/2024-2025,S45G01N17,서울 삼성,Home,최성모,5,1,2,50.0,1,2,50.0,2,4,50.0,0,0,0.0,0,2,2,1,2,0,0,0,0,3
../kbl_data/2024-2025,S45G01N17,서울 삼성,Home,최승욱,2,1,1,100.0,0,1,0.0,1,2,50.0,0,0,0.0,0,0,0,1,0,0,1,0,1,1
../kbl_data/2024-2025,S45G01N17,서울 삼성,Home,마커스 데릭슨,7,3,4,75.0,0,2,0.0,3,6,50.0,1,1,100.0,0,1,1,1,0,0,0,1,1,3
../kbl_data/2024-2025,S45G01N17,서울 삼성,Home,차민석,0,0,0,0.0,0,1,0.0,0,1,0.0,0,0,0.0,0,2,2,0,0,1,0,0,0,1
../kbl_data/2024-2025,S45G01N17,서울 삼성,Home,이원석,9,4,8,50.0,0,4,0.0,4,12,33.3,1,1,100.0,3,5,8,2,1,1,0,0,0,2
../kbl_data/2024-2025,S45G01N17,서울 삼성,Home,저스틴 구탕,3,0,1,0.0,1,1,100.0,1,2,50.0,0,0,0.0,0,5,5,3,1,0,0,0,2,2
../kbl_data/2024-2025,S45G01N17,서울 삼성,Home,조준희,0,0,0,0.0,0,0,0.0,0,0,0.0,0,0,0.0,0,0,0,0,0,0,0,0,0,0
../kbl_data/2024-2025,S45G01N17,서울 삼성,Home,박승재,0,0,1,0.0,0,1,0.0,0,2,0.0,0,0,0.0,0,5,5,3,1,0,0,0,3,4
../kbl_data/2024-2025,S45G01N17,서울 삼성,Home,코피 코번,17,7,11,63.6,0,0,0.0,7,11,63.6,3,4,75.0,3,9,12,3,0,0,0,0,6,1
../kbl_data/2024-2025,S45G01N17,서울 SK,Away,김선형,6,1,4,25.0,1,4,25.0,2,8,25.0,1,2,50.0,1,4,5,5,1,2,0,0,4,1
../kbl_data/2024-2025,S45G01N17,서울 SK,Away,오세근,0,0,2,0.0,0,0,0.0,0,2,0.0,0,0,0.0,0,1,1,1,0,0,0,0,0,1
../kbl_data/2024-2025,S45G01N17,서울 SK,Away,최부경,6,2,2,100.0,0,1,0.0,2,3,66.7,2,2,100.0,1,2,3,0,0,0,1,0,1,2
../kbl_data/2024-2025,S45G01N17,서울 SK,Away,최원혁,0,0,0,0.0,0,2,0.0,0,2,0.0,0,0,0.0,0,1,1,0,0,0,0,0,1,1
../kbl_data/2024-2025,S45G01N17,서울 SK,Away,장문호,0,0,0,0.0,0,0,0.0,0,0,0.0,0,0,0.0,0,0,0,0,0,0,0,0,0,0
../kbl_data/2024-2025,S45G01N17,서울 SK,Away,안영준,10,0,4,0.0,2,6,33.3,2,10,20.0,4,4,100.0,0,3,3,3,2,0,0,0,0,2
../kbl_data/2024-2025,S45G01N17,서울 SK,Away,자밀 워니,29,10,17,58.8,1,4,25.0,11,21,52.4,6,8,75.0,2,8,10,3,3,0,0,0,2,1
../kbl_data/2024-2025,S45G01N17,서울 SK,Away,김형빈,3,0,1,0.0,1,4,25.0,1,5,20.0,0,0,0.0,0,3,3,0,1,0,0,0,0,3
../kbl_data/2024-2025,S45G01N17,서울 SK,Away,아이재아 힉스,6,2,3,66.7,0,1,0.0,2,4,50.0,2,2,100.0,1,0,1,0,0,0,0,1,0,1
../kbl_data/2024-2025,S45G01N17,서울 SK,Away,박민우,0,0,0,0.0,0,0,0.0,0,0,0.0,0,0,0.0,0,0,0,0,0,0,0,0,0,0
../kbl_data/2024-2025,S45G01N17,서울 SK,Away,오재현,11,4,7,57.1,0,2,0.0,4,9,44.4,3,4,75.0,0,2,2,3,4,0,1,0,1,2
../kbl_data/2024-2025,S45G01N17,서울 SK,Away,고메즈 델 리아노,5,2,2,100.0,0,0,0.0,2,2,100.0,1,2,50.0,1,0,1,0,2,0,0,0,1,0
../kbl_data/2024-2025,S45G01N18,수원 KT,Home,한희원,3,0,1,0.0,1,7,14.3,1,8,12.5,0,0,0.0,1,7,8,1,1,0,1,0,0,3
../kbl_data/2024-2025,S45G01N18,수원 KT,Home,최창진,0,0,1,0.0,0,1,0.0,0,2,0.0,0,0,0.0,0,1,1,0,1,0,0,0,0,2
../kbl_data/2024-2025,S45G01N18,수원 KT,Home,문성곤,0,0,0,0.0,0,2,0.0,0,2,0.0,0,0,0.0,1,0,1,1,0,0,0,0,1,1
../kbl_data/2024-2025,S45G01N18,수원 KT,Home,이현석,0,0,0,0.0,0,1,0.0,0,1,0.0,0,0,0.0,0,1,1,1,0,0,0,0,1,0
../kbl_data/2024-2025,S45G01N18,수원 KT,Home,허훈,26,7,16,43.8,3,8,37.5,10,24,41.7,3,5,60.0,1,5,6,12,1,0,1,0,3,2
../kbl_data/2024-2025,S45G01N18,수원 KT,Home,박준영,15,3,8,37.5,3,6,50.0,6,14,42.9,0,2,0.0,3,3,6,2,0,1,0,0,1,4
../kbl_data/2024-2025,S45G01N18,수원 KT,Home,최진광,0,0,0,0.0,0,0,0.0,0,0,0.0,0,0,0.0,0,0,0,0,0,0,0,0,0,0
../kbl_data/2024-2025,S45G01N18,수원 KT,Home,이두원,2,1,5,20.0,0,0,0.0,1,5,20.0,0,0,0.0,0,0,0,1,0,1,0,0,0,0
../kbl_data/2024-2025,S45G01N18,수원 KT,Home,고찬혁,0,0,0,0.0,0,0,0.0,0,0,0.0,0,0,0.0,0,0,0,0,0,0,0,0,0,0
../kbl_data/2024-2025,S45G01N18,수원 KT,Home,문정현,18,4,12,33.3,3,5,60.0,7,17,41.2,1,3,33.3,5,3,8,2,2,0,0,0,0,2
../kbl_data/2024-2025,S45G01N18,수원 KT,Home,제레미아 틸먼,17,7,10,70.0,0,0,0.0,7,10,70.0,3,4,75.0,5,2,7,1,0,0,0,1,2,3
../kbl_data/2024-2025,S45G01N18,수원 KT,Home,레이션 해먼즈,8,1,5,20.0,2,2,100.0,3,7,42.9,0,0,0.0,1,11,12,1,1,1,0,0,0,4
../kbl_data/2024-2025,S45G01N18,울산 현대모비스,Away,함지훈,4,1,2,50.0,0,3,0.0,1,5,20.0,2,2,100.0,2,2,4,4,3,0,0,0,1,1
../kbl_data/2024-2025,S45G01N18,울산 현대모비스,Away,장재석,9,3,4,75.0,0,0,0.0,3,4,75.0,3,7,42.9,4,0,4,4,0,0,0,0,2,2
../kbl_data/2024-2025,S45G01N18,울산 현대모비스,Away,한호빈,0,0,2,0.0,0,1,0.0,0,3,0.0,0,0,0.0,0,1,1,1,2,0,0,0,0,3
../kbl_data/2024-2025,S45G01N18,울산 현대모비스,Away,김준일,0,0,0,0.0,0,0,0.0,0,0,0.0,0,0,0.0,0,0,0,0,0,0,0,0,0,0
../kbl_data/2024-2025,S45G01N18,울산 현대모비스,Away,김국찬,13,2,3,66.7,3,8,37.5,5,11,45.5,0,0,0.0,3,5,8,2,0,1,0,0,1,1
../kbl_data/2024-2025,S45G01N18,울산 현대모비스,Away,서명진,0,0,0,0.0,0,0,0.0,0,0,0.0,0,0,0.0,0,2,2,0,0,0,0,0,0,3
../kbl_data/2024-2025,S45G01N18,울산 현대모비스,Away,숀 롱,10,5,6,83.3,0,0,0.0,5,6,83.3,0,5,0.0,1,3,4,3,0,0,0,1,0,2
../kbl_data/2024-2025,S45G01N18,울산 현대모비스,Away,이우석,17,4,12,33.3,2,6,33.3,6,18,33.3,3,4,75.0,3,5,8,4,0,0,0,0,1,2
../kbl_data/2024-2025,S45G01N18,울산 현대모비스,Away,이승우,0,0,0,0.0,0,0,0.0,0,0,0.0,0,0,0.0,0,0,0,0,0,0,0,0,0,0
../kbl_data/2024-2025,S45G01N18,울산 현대모비스,Away,게이지 프림,18,6,15,40.0,0,2,0.0,6,17,35.3,6,6,100.0,3,12,15,4,0,2,0,0,5,3
../kbl_data/2024-2025,S45G01N18,울산 현대모비스,Away,박무빈,0,0,0,0.0,0,0,0.0,0,0,0.0,0,0,0.0,0,0,0,0,0,0,0,0,0,0
../kbl_data/2024-2025,S45G01N18,울산 현대모비스,Away,미구엘 안드레 옥존,20,2,4,50.0,5,12,41.7,7,16,43.8,1,2,50.0,1,5,6,4,0,1,0,0,2,2
../kbl_data/2024-2025,S45G01N19,원주 DB,Home,이관희,0,0,0,0.0,0,3,0.0,0,3,0.0,0,0,0.0,1,0,1,1,1,0,0,0,1,1
../kbl_data/2024-2025,S45G01N19,원주 DB,Home,김시래,0,0,0,0.0,0,0,0.0,0,0,0.0,0,0,0.0,0,0,0,0,0,0,0,0,0,0
../kbl_data/2024-2025,S45G01N19,원주 DB,Home,서민수,0,0,0,0.0,0,0,0.0,0,0,0.0,0,0,0.0,0,1,1,0,0,0,0,0,0,0
../kbl_data/2024-2025,S45G01N19,원주 DB,Home,김영현,8,1,2,50.0,2,3,66.7,3,5,60.0,0,0,0.0,0,3,3,0,1,0,0,0,0,2
../kbl_data/2024-2025,S45G01N19,원주 DB,Home,김종규,0,0,0,0.0,0,0,0.0,0,0,0.0,0,0,0.0,0,0,0,0,0,0,0,0,2,1
../kbl_data/2024-2025,S45G01N19,원주 DB,Home,박봉진,0,0,0,0.0,0,0,0.0,0,0,0.0,0,0,0.0,1,0,1,0,0,0,0,0,1,2
../kbl_data/2024-2025,S45G01N19,원주 DB,Home,강상재,12,3,5,60.0,2,3,66.7,5,8,62.5,0,0,0.0,2,6,8,5,0,1,0,0,2,1
../kbl_data/2024-2025,S45G01N19,원주 DB,Home,유현준,10,2,2,100.0,2,4,50.0,4,6,66.7,0,0,0.0,0,1,1,5,0,0,0,0,1,2
../kbl_data/2024-2025,S45G01N19,원주 DB,Home,치나누 오누아쿠,20,9,16,56.2,0,3,0.0,9,19,47.4,2,3,66.7,2,9,11,2,2,2,0,0,7,0
../kbl_data/2024-2025,S45G01N19,원주 DB,Home,이용우,3,0,1,0.0,1,2,50.0,1,3,33.3,0,0,0.0,0,1,1,0,0,0,0,0,0,1
../kbl_data/2024-2025,S45G01N19,원주 DB,Home,이선 알바노,11,4,10,40.0,1,5,20.0,5,15,33.3,0,0,0.0,1,5,6,5,0,0,0,0,3,2
../kbl_data/2024-2025,S45G01N19,원주 DB,Home,로버트 카터,6,3,4,75.0,0,1,0.0,3,5,60.0,0,0,0.0,0,3,3,0,0,0,0,0,0,1
../kbl_data/2024-2025,S45G01N19,부산 KCC,Away,정창영,7,2,3,66.7,1,3,33.3,3,6,50.0,0,0,0.0,1,2,3,2,1,0,0,0,1,2
../kbl_data/2024-2025,S45G01N19,부산 KCC,Away,리온 윌리엄스,4,2,5,40.0,0,1,0.0,2,6,33.3,0,0,0.0,1,2,3,0,2,1,0,0,0,1
../kbl_data/2024-2025,S45G01N19,부산 KCC,Away,전준범,6,0,0,0.0,2,7,28.6,2,7,28.6,0,0,0.0,0,0,0,1,2,0,0,0,0,1
../kbl_data/2024-2025,S45G01N19,부산 KCC,Away,이승현,11,4,11,36.4,1,2,50.0,5,13,38.5,0,0,0.0,0,5,5,8,1,1,0,0,1,2
../kbl_data/2024-2025,S45G01N19,부산 KCC,Away,이호현,19,5,6,83.3,3,5,60.0,8,11,72.7,0,0,0.0,1,1,2,2,1,0,0,0,0,0
../kbl_data/2024-2025,S45G01N19,부산 KCC,Away,디온테 버튼,13,5,10,50.0,1,5,20.0,6,15,40.0,0,0,0.0,0,3,3,4,0,1,0,1,3,0
../kbl_data/2024-2025,S45G01N19,부산 KCC,Away,이근휘,6,0,0,0.0,2,4,50.0,2,4,50.0,0,0,0.0,1,1,2,0,1,0,0,0,0,1
../kbl_data/2024-2025,S45G01N19,부산 KCC,Away,김동현,8,4,6,66.7,0,2,0.0,4,8,50.0,0,0,0.0,1,5,6,2,1,1,0,0,0,4
../kbl_data/2024-2025,S45G01N19,부산 KCC,Away,송동훈,0,0,0,0.0,0,0,0.0,0,0,0.0,0,0,0.0,0,0,0,0,0,0,0,0,0,0
../kbl_data/2024-2025,S45G01N19,부산 KCC,Away,여준형,0,0,0,0.0,0,0,0.0,0,0,0.0,0,0,0.0,0,0,0,0,0,0,0,0,0,0
../kbl_data/2024-2025,S45G01N19,부산 KCC,Away,캘빈 제프리 에피스톨라,3,0,1,0.0,1,2,50.0,1,3,33.3,0,0,0.0,0,4,4,3,0,0,0,0,1,1
../kbl_data/2024-2025,S45G01N19,부산 KCC,Away,이주영,0,0,0,0.0,0,0,0.0,0,0,0.0,0,0,0.0,0,0,0,0,0,0,0,0,0,0
../kbl_data/2024-2025,S45G01N20,고양 소노,Home,정희재,6,0,1,0.0,2,5,40.0,2,6,33.3,0,0,0.0,0,2,2,2,1,1,0,0,0,5
../kbl_data/2024-2025,S45G01N20,고양 소노,Home,임동섭,7,0,0,0.0,1,1,100.0,1,1,100.0,4,5,80.0,1,2,3,0,0,0,0,0,0,4
../kbl_data/2024-2025,S45G01N20,고양 소노,Home,김민욱,3,0,0,0.0,1,3,33.3,1,3,33.3,0,0,0.0,0,0,0,0,0,0,0,0,0,1
../kbl_data/2024-2025,S45G01N20,고양 소노,Home,이재도,21,4,5,80.0,4,6,66.7,8,11,72.7,1,3,33.3,0,3,3,8,1,0,0,0,1,3
../kbl_data/2024-2025,S45G01N20,고양 소노,Home,김영훈,0,0,0,0.0,0,0,0.0,0,0,0.0,0,0,0.0,0,0,0,0,0,0,0,0,0,0
../kbl_data/2024-2025,S45G01N20,고양 소노,Home,최승욱,7,2,3,66.7,1,3,33.3,3,6,50.0,0,0,0.0,0,3,3,1,1,1,1,0,1,0
../kbl_data/2024-2025,S45G01N20,고양 소노,Home,김진유,0,0,0,0.0,0,0,0.0,0,0,0.0,0,0,0.0,0,0,0,0,0,0,0,0,0,0
../kbl_data/2024-2025,S45G01N20,고양 소노,Home,이정현,16,5,8,62.5,2,12,16.7,7,20,35.0,0,0,0.0,0,3,3,4,3,0,0,0,1,2
../kbl_data/2024-2025,S45G01N20,고양 소노,Home,백지웅,0,0,0,0.0,0,0,0.0,0,0,0.0,0,0,0.0,0,1,1,0,0,0,0,0,0,0
../kbl_data/2024-2025,S45G01N20,고양 소노,Home,박종하,0,0,0,0.0,0,0,0.0,0,0,0.0,0,0,0.0,0,0,0,0,0,0,0,0,0,0
../kbl_data/2024-2025,S45G01N20,고양 소노,Home,앨런 윌리엄스,17,7,13,53.8,0,0,0.0,7,13,53.8,3,6,50.0,5,5,10,2,3,0,0,0,2,3
../kbl_data/2024-2025,S45G01N20,고양 소노,Home,디제이 번즈 Jr,6,3,5,60.0,0,1,0.0,3,6,50.0,0,0,0.0,0,5,5,0,0,0,0,0,1,1
../kbl_data/2024-2025,S45G01N20,안양 정관장,Away,정준원,0,0,0,0.0,0,0,0.0,0,0,0.0,0,0,0.0,0,0,0,0,0,0,0,0,0,0
../kbl_data/2024-2025,S45G01N20,안양 정관장,Away,이원대,0,0,0,0.0,0,0,0.0,0,0,0.0,0,0,0.0,0,0,0,0,0,0,0,0,0,0
../kbl_data/2024-2025,S45G01N20,안양 정관장,Away,배병준,9,2,4,50.0,1,4,25.0,3,8,37.5,2,2,100.0,0,2,2,2,0,1,0,0,3,1
../kbl_data/2024-2025,S45G01N20,안양 정관장,Away,정효근,9,2,3,66.7,1,1,100.0,3,4,75.0,2,2,100.0,1,7,8,2,0,1,0,0,2,2
../kbl_data/2024-2025,S45G01N20,안양 정관장,Away,이종현,6,3,4,75.0,0,1,0.0,3,5,60.0,0,0,0.0,1,6,7,3,0,2,0,0,2,3
../kbl_data/2024-2025,S45G01N20,안양 정관장,Away,박지훈,13,5,10,50.0,1,2,50.0,6,12,50.0,0,0,0.0,0,3,3,3,0,0,0,0,3,5
../kbl_data/2024-2025,S45G01N20,안양 정관장,Away,최성원,12,2,4,50.0,2,5,40.0,4,9,44.4,2,2,100.0,1,0,1,5,1,0,0,0,0,1
../kbl_data/2024-2025,S45G01N20,안양 정관장,Away,김준형,0,0,0,0.0,0,0,0.0,0,0,0.0,0,0,0.0,0,1,1,0,0,1,0,0,0,1
../kbl_data/2024-2025,S45G01N20,안양 정관장,Away,캐디 라렌,9,2,6,33.3,1,4,25.0,3,10,30.0,2,4,50.0,3,3,6,2,0,2,1,0,0,2
../kbl_data/2024-2025,S45G01N20,안양 정관장,Away,김경원,0,0,0,0.0,0,0,0.0,0,0,0.0,0,0,0.0,0,0,0,0,0,0,0,0,0,0
../kbl_data/2024-2025,S45G01N20,안양 정관장,Away,하비 고메즈,4,1,2,50.0,0,1,0.0,1,3,33.3,2,2,100.0,2,1,3,1,1,0,0,0,1,1
../kbl_data/2024-2025,S45G01N20,안양 정관장,Away,마이클 영 Jr,8,3,3,100.0,0,3,0.0,3,6,50.0,2,4,50.0,1,5,6,3,0,0,1,1,3,2
../kbl_data/2024-2025,S45G01N21,서울 삼성,Home,이정현,15,3,4,75.0,2,5,40.0,5,9,55.6,3,4,75.0,0,3,3,6,1,0,0,0,2,3
../kbl_data/2024-2025,S45G01N21,서울 삼성,Home,최현민,0,0,0,0.0,0,4,0.0,0,4,0.0,0,2,0.0,0,5,5,1,0,0,1,0,0,2
../kbl_data/2024-2025,S45G01N21,서울 삼성,Home,이동엽,0,0,0,0.0,0,0,0.0,0,0,0.0,0,0,0.0,0,0,0,0,0,0,0,0,0,0
../kbl_data/2024-2025,S45G01N21,서울 삼성,Home,최성모,6,0,2,0.0,2,2,100.0,2,4,50.0,0,0,0.0,0,8,8,3,0,0,0,0,3,1
../kbl_data/2024-2025,S45G01N21,서울 삼성,Home,최승욱,3,0,1,0.0,1,6,16.7,1,7,14.3,0,0,0.0,1,1,2,1,0,0,0,0,0,1
../kbl_data/2024-2025,S45G01N21,서울 삼성,Home,마커스 데릭슨,11,3,5,60.0,1,4,25.0,4,9,44.4,2,2,100.0,0,2,2,0,0,0,0,0,1,0
../kbl_data/2024-2025,S45G01N21,서울 삼성,Home,차민석,1,0,2,0.0,0,0,0.0,0,2,0.0,1,2,50.0,0,2,2,0,0,0,0,0,0,2
../kbl_data/2024-2025,S45G01N21,서울 삼성,Home,이원석,4,2,4,50.0,0,0,0.0,2,4,50.0,0,0,0.0,1,0,1,0,0,0,0,1,1,5
../kbl_data/2024-2025,S45G01N21,서울 삼성,Home,저스틴 구탕,4,2,6,33.3,0,0,0.0,2,6,33.3,0,0,0.0,0,5,5,5,0,1,0,1,3,1
../kbl_data/2024-2025,S45G01N21,서울 삼성,Home,조준희,0,0,0,0.0,0,0,0.0,0,0,0.0,0,0,0.0,0,0,0,0,0,0,0,0,0,0
../kbl_data/2024-2025,S45G01N21,서울 삼성,Home,박승재,0,0,1,0.0,0,1,0.0,0,2,0.0,0,0,0.0,0,1,1,1,0,0,0,0,1,2
../kbl_data/2024-2025,S45G01N21,서울 삼성,Home,코피 코번,29,13,18,72.2,0,0,0.0,13,18,72.2,3,4,75.0,8,4,12,4,0,2,0,0,2,3
../kbl_data/2024-2025,S45G01N21,부산 KCC,Away,정창영,4,2,2,100.0,0,3,0.0,2,5,40.0,0,0,0.0,1,0,1,2,0,0,0,0,0,2
../kbl_data/2024-2025,S45G01N21,부산 KCC,Away,리온 윌리엄스,5,2,5,40.0,0,0,0.0,2,5,40.0,1,2,50.0,0,1,1,0,0,0,0,0,0,1
../kbl_data/2024-2025,S45G01N21,부산 KCC,Away,전준범,11,1,2,50.0,3,5,60.0,4,7,57.1,0,1,0.0,0,2,2,2,0,0,0,0,2,5
../kbl_data/2024-2025,S45G01N21,부산 KCC,Away,이승현,14,6,12,50.0,0,1,0.0,6,13,46.2,2,4,50.0,1,2,3,1,0,0,0,0,1,0
../kbl_data/2024-2025,S45G01N21,부산 KCC,Away,이호현,17,7,11,63.6,1,1,100.0,8,12,66.7,0,0,0.0,0,6,6,4,2,0,0,0,0,3
../kbl_data/2024-2025,S45G01N21,부산 KCC,Away,디온테 버튼,17,8,14,57.1,0,4,0.0,8,18,44.4,1,3,33.3,2,9,11,3,3,3,0,1,0,2
../kbl_data/2024-2025,S45G01N21,부산 KCC,Away,이근휘,3,0,0,0.0,1,1,100.0,1,1,100.0,0,0,0.0,0,1,1,0,0,0,0,0,0,0
../kbl_data/2024-2025,S45G01N21,부산 KCC,Away,김동현,4,2,3,66.7,0,2,0.0,2,5,40.0,0,0,0.0,0,3,3,2,1,0,1,0,0,3
../kbl_data/2024-2025,S45G01N21,부산 KCC,Away,송동훈,0,0,0,0.0,0,0,0.0,0,0,0.0,0,0,0.0,0,0,0,0,0,0,0,0,0,0
../kbl_data/2024-2025,S45G01N21,부산 KCC,Away,여준형,0,0,0,0.0,0,1,0.0,0,1,0.0,0,0,0.0,0,1,1,0,0,0,0,0,0,0
../kbl_data/2024-2025,S45G01N21,부산 KCC,Away,캘빈 제프리 에피스톨라,2,1,2,50.0,0,0,0.0,1,2,50.0,0,0,0.0,0,0,0,2,1,0,0,0,0,1
../kbl_data/2024-2025,S45G01N21,부산 KCC,Away,이주영,0,0,0,0.0,0,0,0.0,0,0,0.0,0,0,0.0,0,0,0,0,0,0,0,0,0,0
../kbl_data/2024-2025,S45G01N22,안양 정관장,Home,정준원,0,0,0,0.0,0,0,0.0,0,0,0.0,0,0,0.0,0,0,0,0,0,0,0,0,0,1
../kbl_data/2024-2025,S45G01N22,안양 정관장,Home,배병준,2,1,3,33.3,0,2,0.0,1,5,20.0,0,0,0.0,1,1,2,1,1,0,0,0,0,3
../kbl_data/2024-2025,S45G01N22,안양 정관장,Home,정효근,7,2,4,50.0,1,2,50.0,3,6,50.0,0,0,0.0,0,1,1,1,2,1,0,0,2,0
../kbl_data/2024-2025,S45G01N22,안양 정관장,Home,이종현,6,0,1,0.0,1,2,50.0,1,3,33.3,3,4,75.0,2,3,5,0,1,0,0,0,2,1
../kbl_data/2024-2025,S45G01N22,안양 정관장,Home,박지훈,12,6,14,42.9,0,0,0.0,6,14,42.9,0,0,0.0,0,0,0,8,8,0,0,0,8,6
../kbl_data/2024-2025,S45G01N22,안양 정관장,Home,최성원,8,0,0,0.0,2,5,40.0,2,5,40.0,2,4,50.0,1,0,1,1,0,0,0,0,3,3
../kbl_data/2024-2025,S45G01N22,안양 정관장,Home,이우정,6,0,1,0.0,2,3,66.7,2,4,50.0,0,0,0.0,0,2,2,1,0,0,0,0,0,4
../kbl_data/2024-2025,S45G01N22,안양 정관장,Home,김준형,0,0,1,0.0,0,2,0.0,0,3,0.0,0,0,0.0,1,2,3,0,0,0,0,0,0,0
../kbl_data/2024-2025,S45G01N22,안양 정관장,Home,캐디 라렌,4,2,5,40.0,0,2,0.0,2,7,28.6,0,0,0.0,1,3,4,1,1,0,0,0,3,2
../kbl_data/2024-2025,S45G01N22,안양 정관장,Home,김경원,2,1,2,50.0,0,0,0.0,1,2,50.0,0,0,0.0,0,2,2,0,0,0,0,0,0,0
../kbl_data/2024-2025,S45G01N22,안양 정관장,Home,하비 고메즈,2,0,1,0.0,0,1,0.0,0,2,0.0,2,2,100.0,0,1,1,1,0,0,0,0,2,1
../kbl_data/2024-2025,S45G01N22,안양 정관장,Home,마이클 영 Jr,21,4,7,57.1,2,3,66.7,6,10,60.0,7,7,100.0,0,1,1,2,1,0,0,2,2,1
../kbl_data/2024-2025,S45G01N22,대구 한국가스공사,Away,김동량,0,0,0,0.0,0,0,0.0,0,0,0.0,0,0,0.0,0,0,0,0,0,0,0,0,0,0
../kbl_data/2024-2025,S45G01N22,대구 한국가스공사,Away,박지훈,12,6,14,42.9,0,0,0.0,6,14,42.9,0,0,0.0,0,0,0,8,8,0,0,0,8,6
../kbl_data/2024-2025,S45G01N22,대구 한국가스공사,Away,이대헌,10,2,3,66.7,1,3,33.3,3,6,50.0,3,4,75.0,1,4,5,5,2,0,0,0,0,1
../kbl_data/2024-2025,S45G01N22,대구 한국가스공사,Away,정성우,14,4,7,57.1,2,5,40.0,6,12,50.0,0,0,0.0,1,0,1,1,3,0,0,0,1,3
../kbl_data/2024-2025,S45G01N22,대구 한국가스공사,Away,김낙현,13,2,5,40.0,3,5,60.0,5,10,50.0,0,0,0.0,0,2,2,3,1,0,1,0,2,3
../kbl_data/2024-2025,S45G01N22,대구 한국가스공사,Away,양재혁,0,0,0,0.0,0,1,0.0,0,1,0.0,0,0,0.0,0,1,1,0,0,0,0,0,0,1
../kbl_data/2024-2025,S45G01N22,대구 한국가스공사,Away,곽정훈,6,0,0,0.0,2,4,50.0,2,4,50.0,0,0,0.0,0,2,2,0,0,0,0,0,0,0
../kbl_data/2024-2025,S45G01N22,대구 한국가스공사,Away,앤드류 니콜슨,20,4,7,57.1,4,6,66.7,8,13,61.5,0,0,0.0,2,4,6,0,0,0,0,0,4,2
../kbl_data/2024-2025,S45G01N22,대구 한국가스공사,Away,신승민,6,0,0,0.0,2,5,40.0,2,5,40.0,0,0,0.0,0,3,3,3,1,0,0,0,2,3
../kbl_data/2024-2025,S45G01N22,대구 한국가스공사,Away,샘조세프 벨란겔,7,2,4,50.0,0,2,0.0,2,6,33.3,3,3,100.0,0,0,0,8,2,0,0,0,2,3
../kbl_data/2024-2025,S45G01N22,대구 한국가스공사,Away,유슈 은도예,16,5,5,100.0,0,0,0.0,5,5,100.0,6,7,85.7,2,6,8,2,1,1,0,2,0,3
../kbl_data/2024-2025,S45G01N22,대구 한국가스공사,Away,신주영,5,1,1,100.0,1,2,50.0,2,3,66.7,0,0,0.0,2,4,6,0,1,1,0,0,0,2
../kbl_data/2024-2025,S45G01N23,고양 소노,Home,정희재,3,0,1,0.0,1,5,20.0,1,6,16.7,0,0,0.0,3,1,4,1,1,0,0,0,0,3
../kbl_data/2024-2025,S45G01N23,고양 소노,Home,임동섭,5,1,2,50.0,1,7,14.3,2,9,22.2,0,0,0.0,0,2,2,0,1,0,0,0,1,4
../kbl_data/2024-2025,S45G01N23,고양 소노,Home,김민욱,9,0,0,0.0,3,5,60.0,3,5,60.0,0,0,0.0,0,1,1,2,0,0,0,0,0,2
../kbl_data/2024-2025,S45G01N23,고양 소노,Home,이재도,4,2,3,66.7,0,5,0.0,2,8,25.0,0,0,0.0,0,2,2,4,1,0,1,0,2,5
../kbl_data/2024-2025,S45G01N23,고양 소노,Home,김영훈,0,0,0,0.0,0,0,0.0,0,0,0.0,0,0,0.0,0,0,0,0,0,0,0,0,0,0
../kbl_data/2024-2025,S45G01N23,고양 소노,Home,최승욱,2,1,3,33.3,0,3,0.0,1,6,16.7,0,0,0.0,0,1,1,0,0,1,0,0,0,0
../kbl_data/2024-2025,S45G01N23,고양 소노,Home,김진유,5,2,3,66.7,0,0,0.0,2,3,66.7,1,2,50.0,2,1,3,0,0,0,0,0,1,1
../kbl_data/2024-2025,S45G01N23,고양 소노,Home,이정현,14,0,3,0.0,3,7,42.9,3,10,30.0,5,6,83.3,0,5,5,6,5,2,1,0,3,1
../kbl_data/2024-2025,S45G01N23,고양 소노,Home,백지웅,0,0,0,0.0,0,0,0.0,0,0,0.0,0,0,0.0,0,0,0,0,0,0,0,0,0,0
../kbl_data/2024-2025,S45G01N23,고양 소노,Home,박종하,0,0,0,0.0,0,1,0.0,0,1,0.0,0,0,0.0,0,0,0,0,0,0,0,0,1,0
../kbl_data/2024-2025,S45G01N23,고양 소노,Home,앨런 윌리엄스,17,7,17,41.2,0,0,0.0,7,17,41.2,3,7,42.9,8,8,16,2,1,2,0,0,3,5
../kbl_data/2024-2025,S45G01N23,고양 소노,Home,디제이 번즈 Jr,2,1,5,20.0,0,0,0.0,1,5,20.0,0,0,0.0,1,1,2,1,0,0,0,0,0,0
../kbl_data/2024-2025,S45G01N23,수원 KT,Away,한희원,5,2,3,66.7,0,5,0.0,2,8,25.0,1,1,100.0,2,1,3,2,2,1,0,0,0,3
../kbl_data/2024-2025,S45G01N23,수원 KT,Away,최창진,4,0,0,0.0,0,0,0.0,0,0,0.0,4,4,100.0,2,4,6,2,1,0,0,0,1,1
../kbl_data/2024-2025,S45G01N23,수원 KT,Away,문성곤,0,0,0,0.0,0,0,0.0,0,0,0.0,0,0,0.0,0,0,0,0,0,0,0,0,1,0
../kbl_data/2024-2025,S45G01N23,수원 KT,Away,이현석,0,0,0,0.0,0,0,0.0,0,0,0.0,0,0,0.0,1,0,1,0,0,0,0,0,1,1
../kbl_data/2024-2025,S45G01N23,수원 KT,Away,허훈,15,5,11,45.5,1,5,20.0,6,16,37.5,2,2,100.0,1,0,1,6,1,0,0,0,5,4
../kbl_data/2024-2025,S45G01N23,수원 KT,Away,박준영,11,2,6,33.3,2,3,66.7,4,9,44.4,1,2,50.0,3,3,6,2,0,0,0,0,1,1
../kbl_data/2024-2025,S45G01N23,수원 KT,Away,최진광,0,0,0,0.0,0,1,0.0,0,1,0.0,0,0,0.0,0,0,0,0,0,0,0,0,1,0
../kbl_data/2024-2025,S45G01N23,수원 KT,Away,하윤기,4,1,4,25.0,0,0,0.0,1,4,25.0,2,4,50.0,2,3,5,0,0,0,0,0,1,2
../kbl_data/2024-2025,S45G01N23,수원 KT,Away,고찬혁,0,0,0,0.0,0,0,0.0,0,0,0.0,0,0,0.0,0,0,0,0,0,0,0,0,0,0
../kbl_data/2024-2025,S45G01N23,수원 KT,Away,문정현,11,2,6,33.3,1,3,33.3,3,9,33.3,4,4,100.0,4,7,11,2,3,1,0,0,2,3
../kbl_data/2024-2025,S45G01N23,수원 KT,Away,제레미아 틸먼,6,3,7,42.9,0,0,0.0,3,7,42.9,0,0,0.0,2,4,6,1,0,2,0,1,1,2
../kbl_data/2024-2025,S45G01N23,수원 KT,Away,레이션 해먼즈,13,3,9,33.3,1,4,25.0,4,13,30.8,4,4,100.0,0,9,9,1,0,0,0,0,1,4
../kbl_data/2024-2025,S45G01N24,서울 삼성,Home,이정현,15,3,5,60.0,3,9,33.3,6,14,42.9,0,0,0.0,0,3,3,8,1,0,0,0,5,4
../kbl_data/2024-2025,S45G01N24,서울 삼성,Home,최현민,3,0,2,0.0,1,7,14.3,1,9,11.1,0,0,0.0,2,1,3,0,0,0,0,0,1,2
../kbl_data/2024-2025,S45G01N24,서울 삼성,Home,이동엽,0,0,0,0.0,0,0,0.0,0,0,0.0,0,0,0.0,0,0,0,0,0,0,0,0,1,0
../kbl_data/2024-2025,S45G01N24,서울 삼성,Home,최성모,0,0,3,0.0,0,4,0.0,0,7,0.0,0,2,0.0,2,1,3,3,0,0,1,0,1,5
../kbl_data/2024-2025,S45G01N24,서울 삼성,Home,최승욱,7,2,4,50.0,1,4,25.0,3,8,37.5,0,2,0.0,3,4,7,0,1,0,1,0,0,3
../kbl_data/2024-2025,S45G01N24,서울 삼성,Home,마커스 데릭슨,0,0,2,0.0,0,1,0.0,0,3,0.0,0,0,0.0,0,2,2,0,0,1,0,0,2,2
../kbl_data/2024-2025,S45G01N24,서울 삼성,Home,차민석,3,1,1,100.0,0,1,0.0,1,2,50.0,1,1,100.0,2,2,4,0,1,0,0,0,0,2
../kbl_data/2024-2025,S45G01N24,서울 삼성,Home,이원석,19,3,5,60.0,3,7,42.9,6,12,50.0,4,8,50.0,4,4,8,0,3,1,0,0,0,4
../kbl_data/2024-2025,S45G01N24,서울 삼성,Home,저스틴 구탕,3,0,0,0.0,1,4,25.0,1,4,25.0,0,0,0.0,0,4,4,4,2,0,0,0,0,0
../kbl_data/2024-2025,S45G01N24,서울 삼성,Home,조준희,0,0,0,0.0,0,0,0.0,0,0,0.0,0,0,0.0,0,0,0,0,0,0,0,0,0,0
../kbl_data/2024-2025,S45G01N24,서울 삼성,Home,박승재,7,2,5,40.0,1,5,20.0,3,10,30.0,0,0,0.0,1,1,2,0,0,0,0,0,1,1
../kbl_data/2024-2025,S45G01N24,서울 삼성,Home,코피 코번,23,10,17,58.8,0,0,0.0,10,17,58.8,3,7,42.9,8,8,16,4,0,1,0,1,0,1
../kbl_data/2024-2025,S45G01N24,울산 현대모비스,Away,함지훈,2,1,4,25.0,0,0,0.0,1,4,25.0,0,0,0.0,0,0,0,2,0,0,0,0,0,0
../kbl_data/2024-2025,S45G01N24,울산 현대모비스,Away,장재석,6,2,6,33.3,0,0,0.0,2,6,33.3,2,3,66.7,5,6,11,3,0,1,0,0,1,4
../kbl_data/2024-2025,S45G01N24,울산 현대모비스,Away,한호빈,2,1,2,50.0,0,0,0.0,1,2,50.0,0,0,0.0,0,0,0,1,0,0,0,0,1,1
../kbl_data/2024-2025,S45G01N24,울산 현대모비스,Away,김준일,0,0,1,0.0,0,0,0.0,0,1,0.0,0,0,0.0,1,0,1,0,0,2,0,0,1,1
../kbl_data/2024-2025,S45G01N24,울산 현대모비스,Away,김국찬,11,4,6,66.7,0,5,0.0,4,11,36.4,3,4,75.0,1,6,7,4,1,0,0,0,1,3
../kbl_data/2024-2025,S45G01N24,울산 현대모비스,Away,서명진,2,1,3,33.3,0,0,0.0,1,3,33.3,0,0,0.0,0,1,1,1,1,0,0,0,1,0
../kbl_data/2024-2025,S45G01N24,울산 현대모비스,Away,숀 롱,14,5,10,50.0,0,0,0.0,5,10,50.0,4,7,57.1,1,2,3,1,1,0,0,3,1,2
../kbl_data/2024-2025,S45G01N24,울산 현대모비스,Away,이우석,16,3,5,60.0,3,6,50.0,6,11,54.5,1,1,100.0,1,6,7,2,1,0,0,0,1,2
../kbl_data/2024-2025,S45G01N24,울산 현대모비스,Away,이승우,0,0,0,0.0,0,0,0.0,0,0,0.0,0,0,0.0,0,0,0,0,0,0,0,0,0,0
../kbl_data/2024-2025,S45G01N24,울산 현대모비스,Away,게이지 프림,21,7,14,50.0,2,2,100.0,9,16,56.2,1,2,50.0,3,3,6,4,1,0,0,0,1,5
../kbl_data/2024-2025,S45G01N24,울산 현대모비스,Away,박무빈,2,1,2,50.0,0,1,0.0,1,3,33.3,0,0,0.0,1,1,2,1,0,0,0,0,2,1
../kbl_data/2024-2025,S45G01N24,울산 현대모비스,Away,미구엘 안드레 옥존,7,3,4,75.0,0,7,0.0,3,11,27.3,1,2,50.0,1,3,4,5,0,0,1,0,0,3
../kbl_data/2024-2025,S45G01N25,부산 KCC,Home,정창영,8,1,1,100.0,2,3,66.7,3,4,75.0,0,0,0.0,0,0,0,1,0,0,0,0,0,2
../kbl_data/2024-2025,S45G01N25,부산 KCC,Home,리온 윌리엄스,2,1,6,16.7,0,0,0.0,1,6,16.7,0,0,0.0,1,1,2,0,2,0,0,0,0,3
../kbl_data/2024-2025,S45G01N25,부산 KCC,Home,전준범,2,1,1,100.0,0,2,0.0,1,3,33.3,0,0,0.0,0,0,0,0,0,0,0,0,1,2
../kbl_data/2024-2025,S45G01N25,부산 KCC,Home,허웅,8,2,3,66.7,1,7,14.3,3,10,30.0,1,2,50.0,1,1,2,2,1,0,0,0,1,3
../kbl_data/2024-2025,S45G01N25,부산 KCC,Home,이승현,10,4,14,28.6,0,0,0.0,4,14,28.6,2,3,66.7,2,4,6,2,4,0,0,0,1,1
../kbl_data/2024-2025,S45G01N25,부산 KCC,Home,이호현,11,3,5,60.0,1,2,50.0,4,7,57.1,2,2,100.0,0,1,1,2,2,0,0,0,2,2
../kbl_data/2024-2025,S45G01N25,부산 KCC,Home,디온테 버튼,8,4,10,40.0,0,3,0.0,4,13,30.8,0,0,0.0,2,3,5,2,3,1,0,0,1,1
../kbl_data/2024-2025,S45G01N25,부산 KCC,Home,이근휘,3,0,0,0.0,1,3,33.3,1,3,33.3,0,0,0.0,0,1,1,0,0,0,0,0,1,1
../kbl_data/2024-2025,S45G01N25,부산 KCC,Home,김동현,2,1,3,33.3,0,1,0.0,1,4,25.0,0,0,0.0,0,2,2,0,0,0,1,0,1,5
../kbl_data/2024-2025,S45G01N25,부산 KCC,Home,여준형,2,1,1,100.0,0,0,0.0,1,1,100.0,0,0,0.0,0,0,0,0,0,0,0,0,0,0
../kbl_data/2024-2025,S45G01N25,부산 KCC,Home,캘빈 제프리 에피스톨라,2,0,1,0.0,0,0,0.0,0,1,0.0,2,2,100.0,0,1,1,3,0,0,0,0,1,0
../kbl_data/2024-2025,S45G01N25,부산 KCC,Home,이주영,0,0,0,0.0,0,0,0.0,0,0,0.0,0,0,0.0,0,0,0,0,0,0,0,0,0,0
../kbl_data/2024-2025,S45G01N25,대구 한국가스공사,Away,김동량,0,0,0,0.0,0,0,0.0,0,0,0.0,0,0,0.0,0,0,0,3,0,0,0,0,0,0
../kbl_data/2024-2025,S45G01N25,대구 한국가스공사,Away,박지훈,0,0,0,0.0,0,0,0.0,0,0,0.0,0,0,0.0,1,4,5,0,0,0,0,0,1,3
../kbl_data/2024-2025,S45G01N25,대구 한국가스공사,Away,이대헌,2,1,2,50.0,0,2,0.0,1,4,25.0,0,0,0.0,1,3,4,0,0,0,0,0,3,2
../kbl_data/2024-2025,S45G01N25,대구 한국가스공사,Away,정성우,3,0,2,0.0,1,4,25.0,1,6,16.7,0,0,0.0,1,1,2,2,2,0,0,0,1,2
../kbl_data/2024-2025,S45G01N25,대구 한국가스공사,Away,김낙현,3,0,5,0.0,1,5,20.0,1,10,10.0,0,0,0.0,0,1,1,0,0,0,0,0,2,2
../kbl_data/2024-2025,S45G01N25,대구 한국가스공사,Away,양재혁,3,0,0,0.0,1,1,100.0,1,1,100.0,0,0,0.0,1,1,2,0,0,0,0,0,0,4
../kbl_data/2024-2025,S45G01N25,대구 한국가스공사,Away,곽정훈,3,0,0,0.0,1,3,33.3,1,3,33.3,0,0,0.0,1,2,3,0,1,0,0,0,0,1
../kbl_data/2024-2025,S45G01N25,대구 한국가스공사,Away,앤드류 니콜슨,25,7,11,63.6,3,4,75.0,10,15,66.7,2,3,66.7,3,8,11,0,0,0,0,2,2,1
../kbl_data/2024-2025,S45G01N25,대구 한국가스공사,Away,신승민,7,3,3,100.0,0,1,0.0,3,4,75.0,1,1,100.0,2,4,6,4,1,0,0,0,2,3
../kbl_data/2024-2025,S45G01N25,대구 한국가스공사,Away,샘조세프 벨란겔,19,3,3,100.0,2,7,28.6,5,10,50.0,7,7,100.0,0,1,1,8,2,0,0,0,3,1
../kbl_data/2024-2025,S45G01N25,대구 한국가스공사,Away,유슈 은도예,13,4,5,80.0,0,0,0.0,4,5,80.0,5,6,83.3,2,6,8,1,0,1,0,0,2,0
../kbl_data/2024-2025,S45G01N25,대구 한국가스공사,Away,신주영,2,1,1,100.0,0,0,0.0,1,1,100.0,0,0,0.0,0,1,1,0,0,0,0,0,0,0
../kbl_data/2024-2025,S45G01N26,창원 LG,Home,허일영,0,0,0,0.0,0,1,0.0,0,1,0.0,0,0,0.0,0,2,2,0,0,0,1,0,0,0
../kbl_data/2024-2025,S45G01N26,창원 LG,Home,최진수,0,0,0,0.0,0,0,0.0,0,0,0.0,0,0,0.0,0,0,0,0,0,0,0,0,0,0
../kbl_data/2024-2025,S45G01N26,창원 LG,Home,장민국,5,0,0,0.0,1,2,50.0,1,2,50.0,2,2,100.0,0,1,1,0,1,0,0,0,0,0
../kbl_data/2024-2025,S45G01N26,창원 LG,Home,전성현,9,3,4,75.0,1,2,50.0,4,6,66.7,0,0,0.0,0,0,0,0,1,0,0,0,1,2
../kbl_data/2024-2025,S45G01N26,창원 LG,Home,정인덕,2,1,2,50.0,0,2,0.0,1,4,25.0,0,0,0.0,0,0,0,0,0,0,0,1,1,4
../kbl_data/2024-2025,S45G01N26,창원 LG,Home,대릴 먼로,2,0,1,0.0,0,1,0.0,0,2,0.0,2,2,100.0,0,1,1,2,0,0,0,0,1,2
../kbl_data/2024-2025,S45G01N26,창원 LG,Home,장태빈,0,0,0,0.0,0,0,0.0,0,0,0.0,0,0,0.0,0,0,0,0,0,0,0,0,0,0
../kbl_data/2024-2025,S45G01N26,창원 LG,Home,박정현,0,0,0,0.0,0,0,0.0,0,0,0.0,0,0,0.0,0,0,0,0,0,0,0,0,0,0
../kbl_data/2024-2025,S45G01N26,창원 LG,Home,아셈 마레이,18,7,13,53.8,0,0,0.0,7,13,53.8,4,6,66.7,4,11,15,6,0,1,0,0,5,2
../kbl_data/2024-2025,S45G01N26,창원 LG,Home,양준석,10,4,7,57.1,0,3,0.0,4,10,40.0,2,2,100.0,1,1,2,6,3,0,0,0,2,3
../kbl_data/2024-2025,S45G01N26,창원 LG,Home,유기상,7,2,5,40.0,1,5,20.0,3,10,30.0,0,0,0.0,0,3,3,1,0,2,0,0,1,2
../kbl_data/2024-2025,S45G01N26,창원 LG,Home,칼 타마요,13,5,8,62.5,0,2,0.0,5,10,50.0,3,5,60.0,2,6,8,1,0,0,0,0,3,1
../kbl_data/2024-2025,S45G01N26,서울 SK,Away,김선형,18,6,8,75.0,2,5,40.0,8,13,61.5,0,1,0.0,0,2,2,5,1,0,0,0,2,2
../kbl_data/2024-2025,S45G01N26,서울 SK,Away,오세근,4,2,4,50.0,0,1,0.0,2,5,40.0,0,0,0.0,0,2,2,1,1,0,0,0,0,2
../kbl_data/2024-2025,S45G01N26,서울 SK,Away,최부경,4,2,4,50.0,0,1,0.0,2,5,40.0,0,0,0.0,3,2,5,0,0,0,0,0,1,4
../kbl_data/2024-2025,S45G01N26,서울 SK,Away,최원혁,3,0,0,0.0,1,2,50.0,1,2,50.0,0,0,0.0,1,1,2,3,1,0,0,0,1,0
../kbl_data/2024-2025,S45G01N26,서울 SK,Away,장문호,0,0,0,0.0,0,0,0.0,0,0,0.0,0,0,0.0,0,0,0,0,0,0,0,0,0,0
../kbl_data/2024-2025,S45G01N26,서울 SK,Away,안영준,10,3,5,60.0,1,7,14.3,4,12,33.3,1,3,33.3,0,7,7,1,0,0,0,0,2,2
../kbl_data/2024-2025,S45G01N26,서울 SK,Away,자밀 워니,25,9,18,50.0,1,4,25.0,10,22,45.5,4,5,80.0,5,7,12,4,2,1,0,2,1,2
../kbl_data/2024-2025,S45G01N26,서울 SK,Away,김형빈,2,1,1,100.0,0,0,0.0,1,1,100.0,0,0,0.0,0,1,1,0,0,1,0,0,0,2
../kbl_data/2024-2025,S45G01N26,서울 SK,Away,아이재아 힉스,0,0,1,0.0,0,0,0.0,0,1,0.0,0,0,0.0,0,1,1,0,0,0,0,0,1,2
../kbl_data/2024-2025,S45G01N26,서울 SK,Away,박민우,0,0,0,0.0,0,0,0.0,0,0,0.0,0,0,0.0,0,0,0,0,0,0,0,0,0,0
../kbl_data/2024-2025,S45G01N26,서울 SK,Away,오재현,6,3,5,60.0,0,4,0.0,3,9,33.3,0,0,0.0,1,0,1,5,3,0,0,0,2,1
../kbl_data/2024-2025,S45G01N26,서울 SK,Away,고메즈 델 리아노,0,0,0,0.0,0,0,0.0,0,0,0.0,0,0,0.0,0,1,1,0,0,0,0,0,0,1
../kbl_data/2024-2025,S45G01N27,수원 KT,Home,한희원,6,0,3,0.0,2,5,40.0,2,8,25.0,0,0,0.0,0,3,3,2,0,0,0,0,2,2
../kbl_data/2024-2025,S45G01N27,수원 KT,Home,최창진,2,0,1,0.0,0,0,0.0,0,1,0.0,2,2,100.0,1,0,1,0,0,0,0,0,0,0
../kbl_data/2024-2025,S45G01N27,수원 KT,Home,문성곤,2,1,1,100.0,0,1,0.0,1,2,50.0,0,0,0.0,3,1,4,2,0,0,0,0,0,2
../kbl_data/2024-2025,S45G01N27,수원 KT,Home,이현석,0,0,0,0.0,0,0,0.0,0,0,0.0,0,0,0.0,0,1,1,1,0,0,0,0,0,2
../kbl_data/2024-2025,S45G01N27,수원 KT,Home,허훈,27,8,14,57.1,3,9,33.3,11,23,47.8,2,4,50.0,0,2,2,6,5,0,0,0,0,1
../kbl_data/2024-2025,S45G01N27,수원 KT,Home,박준영,0,0,2,0.0,0,3,0.0,0,5,0.0,0,2,0.0,2,2,4,1,0,0,0,0,0,1
../kbl_data/2024-2025,S45G01N27,수원 KT,Home,최진광,0,0,0,0.0,0,0,0.0,0,0,0.0,0,0,0.0,0,0,0,0,0,0,0,0,0,0
../kbl_data/2024-2025,S45G01N27,수원 KT,Home,하윤기,9,3,8,37.5,0,0,0.0,3,8,37.5,3,3,100.0,0,1,1,0,0,1,0,0,0,0
../kbl_data/2024-2025,S45G01N27,수원 KT,Home,고찬혁,0,0,0,0.0,0,0,0.0,0,0,0.0,0,0,0.0,0,0,0,0,0,0,0,0,0,0
../kbl_data/2024-2025,S45G01N27,수원 KT,Home,문정현,9,3,6,50.0,0,1,0.0,3,7,42.9,3,4,75.0,3,4,7,1,2,0,0,1,1,3
../kbl_data/2024-2025,S45G01N27,수원 KT,Home,제레미아 틸먼,5,2,8,25.0,0,0,0.0,2,8,25.0,1,1,100.0,3,0,3,0,0,0,1,0,1,1
../kbl_data/2024-2025,S45G01N27,수원 KT,Home,레이션 해먼즈,20,6,11,54.5,1,6,16.7,7,17,41.2,5,8,62.5,6,9,15,2,1,1,0,0,2,4
../kbl_data/2024-2025,S45G01N27,원주 DB,Away,이관희,3,0,0,0.0,1,2,50.0,1,2,50.0,0,0,0.0,0,2,2,1,0,0,0,0,0,1
../kbl_data/2024-2025,S45G01N27,원주 DB,Away,김시래,0,0,0,0.0,0,0,0.0,0,0,0.0,0,0,0.0,0,0,0,0,0,0,0,0,0,0
../kbl_data/2024-2025,S45G01N27,원주 DB,Away,서민수,0,0,0,0.0,0,0,0.0,0,0,0.0,0,0,0.0,0,4,4,0,0,0,0,0,1,2
../kbl_data/2024-2025,S45G01N27,원주 DB,Away,김영현,3,0,1,0.0,1,2,50.0,1,3,33.3,0,0,0.0,0,0,0,1,0,0,0,0,2,2
../kbl_data/2024-2025,S45G01N27,원주 DB,Away,박봉진,0,0,0,0.0,0,0,0.0,0,0,0.0,0,0,0.0,0,0,0,0,0,0,0,0,0,1
../kbl_data/2024-2025,S45G01N27,원주 DB,Away,강상재,6,3,9,33.3,0,1,0.0,3,10,30.0,0,0,0.0,1,3,4,3,0,0,0,0,0,4
../kbl_data/2024-2025,S45G01N27,원주 DB,Away,유현준,0,0,0,0.0,0,1,0.0,0,1,0.0,0,0,0.0,1,0,1,4,0,0,0,0,3,3
../kbl_data/2024-2025,S45G01N27,원주 DB,Away,치나누 오누아쿠,21,9,11,81.8,0,0,0.0,9,11,81.8,3,6,50.0,5,9,14,3,1,3,1,2,3,4
../kbl_data/2024-2025,S45G01N27,원주 DB,Away,김훈,0,0,0,0.0,0,0,0.0,0,0,0.0,0,0,0.0,0,0,0,0,0,0,0,0,0,0
../kbl_data/2024-2025,S45G01N27,원주 DB,Away,이선 알바노,25,6,11,54.5,3,8,37.5,9,19,47.4,4,4,100.0,1,1,2,4,2,0,0,0,2,4
../kbl_data/2024-2025,S45G01N27,원주 DB,Away,박인웅,2,1,3,33.3,0,3,0.0,1,6,16.7,0,0,0.0,0,2,2,0,0,2,0,0,1,2
../kbl_data/2024-2025,S45G01N27,원주 DB,Away,로버트 카터,18,3,9,33.3,2,3,66.7,5,12,41.7,6,6,100.0,1,5,6,3,0,2,0,0,2,3
../kbl_data/2024-2025,S45G01N28,울산 현대모비스,Home,함지훈,12,4,5,80.0,1,2,50.0,5,7,71.4,1,2,50.0,2,0,2,2,0,0,0,0,1,2
../kbl_data/2024-2025,S45G01N28,울산 현대모비스,Home,장재석,5,2,6,33.3,0,0,0.0,2,6,33.3,1,2,50.0,2,2,4,0,0,0,0,1,2,1
../kbl_data/2024-2025,S45G01N28,울산 현대모비스,Home,한호빈,0,0,1,0.0,0,1,0.0,0,2,0.0,0,0,0.0,0,0,0,2,0,0,0,0,0,1
../kbl_data/2024-2025,S45G01N28,울산 현대모비스,Home,김준일,0,0,2,0.0,0,0,0.0,0,2,0.0,0,0,0.0,1,1,2,2,1,0,0,0,1,1
../kbl_data/2024-2025,S45G01N28,울산 현대모비스,Home,김국찬,3,0,1,0.0,1,1,100.0,1,2,50.0,0,0,0.0,1,3,4,0,0,1,0,0,1,2
../kbl_data/2024-2025,S45G01N28,울산 현대모비스,Home,서명진,6,0,2,0.0,2,5,40.0,2,7,28.6,0,0,0.0,0,1,1,2,1,0,0,0,1,4
../kbl_data/2024-2025,S45G01N28,울산 현대모비스,Home,숀 롱,11,4,5,80.0,0,0,0.0,4,5,80.0,3,6,50.0,2,4,6,0,1,1,0,0,3,1
../kbl_data/2024-2025,S45G01N28,울산 현대모비스,Home,이우석,12,3,8,37.5,0,2,0.0,3,10,30.0,6,7,85.7,2,8,10,7,2,0,0,0,1,1
../kbl_data/2024-2025,S45G01N28,울산 현대모비스,Home,이승우,0,0,0,0.0,0,0,0.0,0,0,0.0,0,0,0.0,0,0,0,0,0,0,0,0,1,0
../kbl_data/2024-2025,S45G01N28,울산 현대모비스,Home,게이지 프림,18,8,14,57.1,0,1,0.0,8,15,53.3,2,2,100.0,1,7,8,0,1,0,0,0,2,1
../kbl_data/2024-2025,S45G01N28,울산 현대모비스,Home,박무빈,0,0,2,0.0,0,0,0.0,0,2,0.0,0,0,0.0,1,0,1,0,0,0,0,0,0,1
../kbl_data/2024-2025,S45G01N28,울산 현대모비스,Home,미구엘 안드레 옥존,4,2,3,66.7,0,4,0.0,2,7,28.6,0,1,0.0,1,4,5,5,0,0,0,0,1,1
../kbl_data/2024-2025,S45G01N28,안양 정관장,Away,정준원,0,0,0,0.0,0,0,0.0,0,0,0.0,0,0,0.0,0,0,0,0,0,0,0,0,0,0
../kbl_data/2024-2025,S45G01N28,안양 정관장,Away,배병준,19,3,5,60.0,4,6,66.7,7,11,63.6,1,2,50.0,0,2,2,1,0,0,1,0,3,3
../kbl_data/2024-2025,S45G01N28,안양 정관장,Away,정효근,6,3,6,50.0,0,2,0.0,3,8,37.5,0,2,0.0,1,2,3,1,2,1,0,0,0,1
../kbl_data/2024-2025,S45G01N28,안양 정관장,Away,이종현,4,2,3,66.7,0,2,0.0,2,5,40.0,0,0,0.0,0,2,2,0,0,1,0,0,0,3
../kbl_data/2024-2025,S45G01N28,안양 정관장,Away,박지훈,23,7,10,70.0,2,4,50.0,9,14,64.3,3,3,100.0,1,6,7,4,2,0,0,0,2,4
../kbl_data/2024-2025,S45G01N28,안양 정관장,Away,최성원,8,1,4,25.0,2,4,50.0,3,8,37.5,0,0,0.0,1,3,4,5,2,0,0,0,2,2
../kbl_data/2024-2025,S45G01N28,안양 정관장,Away,이우정,0,0,0,0.0,0,3,0.0,0,3,0.0,0,0,0.0,0,1,1,1,0,0,0,0,0,2
../kbl_data/2024-2025,S45G01N28,안양 정관장,Away,김준형,0,0,0,0.0,0,0,0.0,0,0,0.0,0,0,0.0,0,0,0,0,0,0,0,0,0,0
../kbl_data/2024-2025,S45G01N28,안양 정관장,Away,캐디 라렌,3,1,6,16.7,0,0,0.0,1,6,16.7,1,2,50.0,0,3,3,2,0,2,0,0,0,1
../kbl_data/2024-2025,S45G01N28,안양 정관장,Away,김경원,0,0,0,0.0,0,0,0.0,0,0,0.0,0,0,0.0,0,0,0,0,0,0,0,0,0,0
../kbl_data/2024-2025,S45G01N28,안양 정관장,Away,하비 고메즈,3,0,1,0.0,1,2,50.0,1,3,33.3,0,0,0.0,1,2,3,1,0,0,0,0,1,0
../kbl_data/2024-2025,S45G01N28,안양 정관장,Away,마이클 영 Jr,6,3,7,42.9,0,2,0.0,3,9,33.3,0,0,0.0,0,4,4,4,0,1,1,1,1,4
../kbl_data/2024-2025,S45G01N29,서울 삼성,Home,이정현,58,8,14,57.1,10,32,31.2,18,46,39.1,12,12,100.0,2,16,18,32,12,0,2,0,12,12
../kbl_data/2024-2025,S45G01N29,서울 삼성,Home,최현민,0,0,0,0.0,0,1,0.0,0,1,0.0,0,2,0.0,0,1,1,0,0,0,0,0,0,0
../kbl_data/2024-2025,S45G01N29,서울 삼성,Home,최성모,23,3,4,75.0,5,8,62.5,8,12,66.7,2,2,100.0,0,2,2,3,1,0,0,0,0,4
../kbl_data/2024-2025,S45G01N29,서울 삼성,Home,최승욱,56,10,18,55.6,10,28,35.7,20,46,43.5,6,8,75.0,4,12,16,10,4,2,0,0,4,10
../kbl_data/2024-2025,S45G01N29,서울 삼성,Home,김진용,0,0,0,0.0,0,0,0.0,0,0,0.0,0,0,0.0,0,0,0,0,0,0,0,0,0,0
../kbl_data/2024-2025,S45G01N29,서울 삼성,Home,마커스 데릭슨,4,2,2,100.0,0,0,0.0,2,2,100.0,0,1,0.0,1,1,2,0,0,0,0,0,1,2
../kbl_data/2024-2025,S45G01N29,서울 삼성,Home,차민석,4,2,3,66.7,0,1,0.0,2,4,50.0,0,0,0.0,1,0,1,0,1,1,0,0,0,2
../kbl_data/2024-2025,S45G01N29,서울 삼성,Home,이원석,11,4,6,66.7,1,3,33.3,5,9,55.6,0,0,0.0,4,6,10,1,0,0,0,0,1,3
../kbl_data/2024-2025,S45G01N29,서울 삼성,Home,저스틴 구탕,0,0,1,0.0,0,1,0.0,0,2,0.0,0,0,0.0,0,0,0,1,0,0,0,0,0,2
../kbl_data/2024-2025,S45G01N29,서울 삼성,Home,조준희,0,0,0,0.0,0,1,0.0,0,1,0.0,0,0,0.0,0,0,0,0,0,0,0,0,0,1
../kbl_data/2024-2025,S45G01N29,서울 삼성,Home,박승재,0,0,0,0.0,0,1,0.0,0,1,0.0,0,0,0.0,0,0,0,0,1,0,0,0,1,0
../kbl_data/2024-2025,S45G01N29,서울 삼성,Home,코피 코번,23,9,15,60.0,0,0,0.0,9,15,60.0,5,6,83.3,4,7,11,0,1,0,0,1,4,2
../kbl_data/2024-2025,S45G01N29,고양 소노,Away,정희재,0,0,0,0.0,0,1,0.0,0,1,0.0,0,0,0.0,1,1,2,0,1,0,0,0,0,0
../kbl_data/2024-2025,S45G01N29,고양 소노,Away,임동섭,0,0,0,0.0,0,0,0.0,0,0,0.0,0,0,0.0,0,0,0,0,0,0,0,0,0,0
../kbl_data/2024-2025,S45G01N29,고양 소노,Away,김민욱,3,0,0,0.0,1,3,33.3,1,3,33.3,0,0,0.0,1,1,2,1,1,0,0,0,0,3
../kbl_data/2024-2025,S45G01N29,고양 소노,Away,이재도,7,2,5,40.0,1,3,33.3,3,8,37.5,0,0,0.0,0,4,4,6,0,0,0,0,3,2
../kbl_data/2024-2025,S45G01N29,고양 소노,Away,김영훈,0,0,0,0.0,0,0,0.0,0,0,0.0,0,0,0.0,0,0,0,0,0,0,0,0,0,0
../kbl_data/2024-2025,S45G01N29,고양 소노,Away,최승욱,56,10,18,55.6,10,28,35.7,20,46,43.5,6,8,75.0,4,12,16,10,4,2,0,0,4,10
../kbl_data/2024-2025,S45G01N29,고양 소노,Away,김진유,0,0,0,0.0,0,1,0.0,0,1,0.0,0,0,0.0,0,1,1,0,1,0,0,0,0,1
../kbl_data/2024-2025,S45G01N29,고양 소노,Away,이정현,58,8,14,57.1,10,32,31.2,18,46,39.1,12,12,100.0,2,16,18,32,12,0,2,0,12,12
../kbl_data/2024-2025,S45G01N29,고양 소노,Away,조은후,0,0,0,0.0,0,0,0.0,0,0,0.0,0,0,0.0,0,0,0,0,0,0,0,0,0,0
../kbl_data/2024-2025,S45G01N29,고양 소노,Away,백지웅,0,0,0,0.0,0,0,0.0,0,0,0.0,0,0,0.0,0,0,0,0,0,0,0,0,0,0
../kbl_data/2024-2025,S45G01N29,고양 소노,Away,앨런 윌리엄스,22,7,14,50.0,0,1,0.0,7,15,46.7,8,8,100.0,4,3,7,2,1,0,0,0,3,4
../kbl_data/2024-2025,S45G01N29,고양 소노,Away,디제이 번즈 Jr,0,0,1,0.0,0,0,0.0,0,1,0.0,0,0,0.0,0,0,0,1,0,0,0,0,0,1
../kbl_data/2024-2025,S45G01N30,창원 LG,Home,허일영,5,1,2,50.0,1,1,100.0,2,3,66.7,0,0,0.0,0,2,2,0,0,0,0,0,0,1
../kbl_data/2024-2025,S45G01N30,창원 LG,Home,최진수,0,0,0,0.0,0,0,0.0,0,0,0.0,0,0,0.0,0,0,0,0,0,0,0,0,0,0
../kbl_data/2024-2025,S45G01N30,창원 LG,Home,장민국,10,2,3,66.7,2,4,50.0,4,7,57.1,0,0,0.0,0,3,3,0,2,0,3,0,0,0
../kbl_data/2024-2025,S45G01N30,창원 LG,Home,전성현,7,2,5,40.0,1,6,16.7,3,11,27.3,0,0,0.0,0,0,0,1,0,0,0,0,0,1
../kbl_data/2024-2025,S45G01N30,창원 LG,Home,정인덕,10,2,2,100.0,2,3,66.7,4,5,80.0,0,0,0.0,0,1,1,2,1,0,0,0,1,3
../kbl_data/2024-2025,S45G01N30,창원 LG,Home,대릴 먼로,2,1,3,33.3,0,1,0.0,1,4,25.0,0,0,0.0,0,3,3,6,1,1,0,0,1,4
../kbl_data/2024-2025,S45G01N30,창원 LG,Home,장태빈,0,0,0,0.0,0,0,0.0,0,0,0.0,0,0,0.0,0,0,0,0,0,0,0,0,0,0
../kbl_data/2024-2025,S45G01N30,창원 LG,Home,박정현,0,0,0,0.0,0,0,0.0,0,0,0.0,0,0,0.0,0,0,0,0,0,0,0,0,0,0
../kbl_data/2024-2025,S45G01N30,창원 LG,Home,아셈 마레이,14,7,14,50.0,0,0,0.0,7,14,50.0,0,0,0.0,4,2,6,4,2,0,0,0,1,5
../kbl_data/2024-2025,S45G01N30,창원 LG,Home,양준석,12,5,9,55.6,0,2,0.0,5,11,45.5,2,3,66.7,2,0,2,3,0,0,0,0,0,2
../kbl_data/2024-2025,S45G01N30,창원 LG,Home,유기상,4,2,4,50.0,0,2,0.0,2,6,33.3,0,0,0.0,0,3,3,2,1,0,0,0,2,2
../kbl_data/2024-2025,S45G01N30,창원 LG,Home,칼 타마요,9,3,9,33.3,1,3,33.3,4,12,33.3,0,0,0.0,1,1,2,0,4,0,0,0,3,2
../kbl_data/2024-2025,S45G01N30,울산 현대모비스,Away,함지훈,4,1,6,16.7,0,1,0.0,1,7,14.3,2,2,100.0,3,2,5,3,0,0,0,0,2,1
../kbl_data/2024-2025,S45G01N30,울산 현대모비스,Away,장재석,6,2,5,40.0,0,0,0.0,2,5,40.0,2,2,100.0,2,1,3,1,1,0,1,0,0,2
../kbl_data/2024-2025,S45G01N30,울산 현대모비스,Away,한호빈,0,0,0,0.0,0,0,0.0,0,0,0.0,0,0,0.0,0,0,0,0,0,0,0,0,0,0
../kbl_data/2024-2025,S45G01N30,울산 현대모비스,Away,김국찬,2,1,1,100.0,0,0,0.0,1,1,100.0,0,0,0.0,0,0,0,0,0,0,0,0,1,1
../kbl_data/2024-2025,S45G01N30,울산 현대모비스,Away,서명진,2,1,1,100.0,0,3,0.0,1,4,25.0,0,0,0.0,0,4,4,3,0,0,0,0,3,3
../kbl_data/2024-2025,S45G01N30,울산 현대모비스,Away,숀 롱,15,6,7,85.7,0,0,0.0,6,7,85.7,3,8,37.5,3,4,7,2,0,1,0,1,2,1
../kbl_data/2024-2025,S45G01N30,울산 현대모비스,Away,이우석,21,8,12,66.7,1,1,100.0,9,13,69.2,2,2,100.0,1,3,4,2,0,0,0,0,1,0
../kbl_data/2024-2025,S45G01N30,울산 현대모비스,Away,이승우,0,0,0,0.0,0,1,0.0,0,1,0.0,0,0,0.0,0,0,0,0,0,0,0,0,0,0
../kbl_data/2024-2025,S45G01N30,울산 현대모비스,Away,신민석,0,0,0,0.0,0,0,0.0,0,0,0.0,0,0,0.0,0,0,0,0,0,0,0,0,0,0
../kbl_data/2024-2025,S45G01N30,울산 현대모비스,Away,게이지 프림,11,4,8,50.0,1,2,50.0,5,10,50.0,0,0,0.0,4,6,10,0,0,0,0,0,5,3
../kbl_data/2024-2025,S45G01N30,울산 현대모비스,Away,박무빈,15,5,9,55.6,1,2,50.0,6,11,54.5,2,2,100.0,0,5,5,5,0,0,1,0,4,3
../kbl_data/2024-2025,S45G01N30,울산 현대모비스,Away,미구엘 안드레 옥존,2,1,1,100.0,0,0,0.0,1,1,100.0,0,0,0.0,1,1,2,2,1,0,0,0,1,1
../kbl_data/2024-2025,S45G01N31,대구 한국가스공사,Home,김동량,0,0,0,0.0,0,0,0.0,0,0,0.0,0,0,0.0,1,1,2,2,0,0,0,0,0,0
../kbl_data/2024-2025,S45G01N31,대구 한국가스공사,Home,박지훈,3,0,0,0.0,1,3,33.3,1,3,33.3,0,0,0.0,1,0,1,0,0,0,0,0,0,2
../kbl_data/2024-2025,S45G01N31,대구 한국가스공사,Home,이대헌,8,4,5,80.0,0,1,0.0,4,6,66.7,0,0,0.0,6,2,8,0,1,0,0,0,4,0
../kbl_data/2024-2025,S45G01N31,대구 한국가스공사,Home,정성우,2,0,1,0.0,0,3,0.0,0,4,0.0,2,2,100.0,0,1,1,5,1,0,0,0,1,1
../kbl_data/2024-2025,S45G01N31,대구 한국가스공사,Home,김낙현,14,1,5,20.0,3,6,50.0,4,11,36.4,3,3,100.0,0,1,1,8,1,0,1,0,0,4
../kbl_data/2024-2025,S45G01N31,대구 한국가스공사,Home,양재혁,3,0,0,0.0,1,1,100.0,1,1,100.0,0,0,0.0,0,0,0,0,1,0,0,0,1,1
../kbl_data/2024-2025,S45G01N31,대구 한국가스공사,Home,곽정훈,16,2,2,100.0,4,6,66.7,6,8,75.0,0,0,0.0,1,2,3,0,3,0,0,0,1,3
../kbl_data/2024-2025,S45G01N31,대구 한국가스공사,Home,앤드류 니콜슨,25,3,8,37.5,5,7,71.4,8,15,53.3,4,4,100.0,1,10,11,3,1,2,0,0,3,2
../kbl_data/2024-2025,S45G01N31,대구 한국가스공사,Home,신승민,0,0,1,0.0,0,2,0.0,0,3,0.0,0,0,0.0,1,1,2,1,1,0,0,0,1,1
../kbl_data/2024-2025,S45G01N31,대구 한국가스공사,Home,샘조세프 벨란겔,12,4,8,50.0,1,4,25.0,5,12,41.7,1,1,100.0,0,1,1,5,2,1,0,0,3,2
../kbl_data/2024-2025,S45G01N31,대구 한국가스공사,Home,유슈 은도예,5,1,1,100.0,0,0,0.0,1,1,100.0,3,3,100.0,1,1,2,0,0,0,0,0,0,1
../kbl_data/2024-2025,S45G01N31,대구 한국가스공사,Home,신주영,3,0,0,0.0,1,2,50.0,1,2,50.0,0,0,0.0,0,0,0,0,0,0,0,0,1,0
../kbl_data/2024-2025,S45G01N31,서울 SK,Away,김선형,6,2,4,50.0,0,2,0.0,2,6,33.3,2,4,50.0,1,4,5,5,2,0,0,0,4,2
../kbl_data/2024-2025,S45G01N31,서울 SK,Away,오세근,4,2,2,100.0,0,0,0.0,2,2,100.0,0,0,0.0,1,3,4,0,1,0,0,0,1,1
../kbl_data/2024-2025,S45G01N31,서울 SK,Away,최부경,3,0,1,0.0,0,1,0.0,0,2,0.0,3,4,75.0,2,2,4,0,1,0,0,0,0,2
../kbl_data/2024-2025,S45G01N31,서울 SK,Away,최원혁,0,0,0,0.0,0,4,0.0,0,4,0.0,0,0,0.0,1,0,1,2,1,0,0,0,0,2
../kbl_data/2024-2025,S45G01N31,서울 SK,Away,장문호,0,0,0,0.0,0,0,0.0,0,0,0.0,0,0,0.0,0,0,0,0,0,0,0,0,0,0
../kbl_data/2024-2025,S45G01N31,서울 SK,Away,안영준,21,6,7,85.7,3,6,50.0,9,13,69.2,0,0,0.0,2,4,6,2,0,0,0,0,3,3
../kbl_data/2024-2025,S45G01N31,서울 SK,Away,자밀 워니,34,12,24,50.0,3,5,60.0,15,29,51.7,1,2,50.0,6,4,10,3,2,0,0,3,3,0
../kbl_data/2024-2025,S45G01N31,서울 SK,Away,김형빈,4,1,2,50.0,0,0,0.0,1,2,50.0,2,2,100.0,1,0,1,1,1,0,0,0,0,0
../kbl_data/2024-2025,S45G01N31,서울 SK,Away,아이재아 힉스,4,2,3,66.7,0,2,0.0,2,5,40.0,0,0,0.0,0,0,0,1,0,0,0,0,1,3
../kbl_data/2024-2025,S45G01N31,서울 SK,Away,박민우,0,0,0,0.0,0,0,0.0,0,0,0.0,0,0,0.0,0,0,0,0,0,0,0,0,0,0
../kbl_data/2024-2025,S45G01N31,서울 SK,Away,오재현,0,0,5,0.0,0,1,0.0,0,6,0.0,0,0,0.0,0,2,2,2,1,0,0,0,2,1
../kbl_data/2024-2025,S45G01N31,서울 SK,Away,고메즈 델 리아노,0,0,0,0.0,0,1,0.0,0,1,0.0,0,0,0.0,1,0,1,0,0,0,0,0,1,0
../kbl_data/2024-2025,S45G01N32,부산 KCC,Home,정창영,5,1,1,100.0,1,2,50.0,2,3,66.7,0,0,0.0,1,0,1,1,0,0,0,0,1,2
../kbl_data/2024-2025,S45G01N32,부산 KCC,Home,리온 윌리엄스,8,3,3,100.0,0,0,0.0,3,3,100.0,2,3,66.7,1,2,3,1,0,1,0,0,0,3
../kbl_data/2024-2025,S45G01N32,부산 KCC,Home,전준범,4,0,1,0.0,1,2,50.0,1,3,33.3,1,1,100.0,0,2,2,0,0,0,0,0,0,0
../kbl_data/2024-2025,S45G01N32,부산 KCC,Home,허웅,17,4,4,100.0,3,6,50.0,7,10,70.0,0,0,0.0,0,0,0,4,1,0,0,0,2,3
../kbl_data/2024-2025,S45G01N32,부산 KCC,Home,이승현,13,5,6,83.3,0,0,0.0,5,6,83.3,3,4,75.0,2,12,14,4,1,0,0,0,0,0
../kbl_data/2024-2025,S45G01N32,부산 KCC,Home,이호현,13,3,6,50.0,1,3,33.3,4,9,44.4,4,4,100.0,1,0,1,4,2,0,0,0,1,2
../kbl_data/2024-2025,S45G01N32,부산 KCC,Home,디온테 버튼,17,6,13,46.2,1,3,33.3,7,16,43.8,2,3,66.7,3,5,8,6,2,3,0,2,2,1
../kbl_data/2024-2025,S45G01N32,부산 KCC,Home,이근휘,21,0,0,0.0,7,10,70.0,7,10,70.0,0,0,0.0,1,1,2,0,0,0,0,0,0,1
../kbl_data/2024-2025,S45G01N32,부산 KCC,Home,김동현,0,0,0,0.0,0,0,0.0,0,0,0.0,0,0,0.0,0,1,1,0,0,0,0,0,0,0
../kbl_data/2024-2025,S45G01N32,부산 KCC,Home,여준형,2,1,1,100.0,0,0,0.0,1,1,100.0,0,0,0.0,0,0,0,1,0,1,0,0,0,0
../kbl_data/2024-2025,S45G01N32,부산 KCC,Home,캘빈 제프리 에피스톨라,0,0,1,0.0,0,1,0.0,0,2,0.0,0,0,0.0,0,1,1,2,0,0,0,0,0,0
../kbl_data/2024-2025,S45G01N32,부산 KCC,Home,이주영,2,1,1,100.0,0,0,0.0,1,1,100.0,0,0,0.0,0,0,0,2,0,0,0,0,1,1
../kbl_data/2024-2025,S45G01N32,안양 정관장,Away,정준원,0,0,0,0.0,0,1,0.0,0,1,0.0,0,0,0.0,0,0,0,0,0,0,0,0,1,2
../kbl_data/2024-2025,S45G01N32,안양 정관장,Away,이원대,2,1,1,100.0,0,3,0.0,1,4,25.0,0,0,0.0,0,1,1,2,0,0,0,0,0,2
../kbl_data/2024-2025,S45G01N32,안양 정관장,Away,배병준,16,5,6,83.3,2,4,50.0,7,10,70.0,0,0,0.0,1,1,2,1,0,0,0,0,2,2
../kbl_data/2024-2025,S45G01N32,안양 정관장,Away,정효근,2,1,5,20.0,0,0,0.0,1,5,20.0,0,0,0.0,0,3,3,2,0,0,0,0,0,2
../kbl_data/2024-2025,S45G01N32,안양 정관장,Away,이종현,2,1,1,100.0,0,0,0.0,1,1,100.0,0,0,0.0,0,1,1,0,0,0,0,0,1,0
../kbl_data/2024-2025,S45G01N32,안양 정관장,Away,박지훈,9,3,4,75.0,1,2,50.0,4,6,66.7,0,0,0.0,0,0,0,7,3,0,0,0,3,4
../kbl_data/2024-2025,S45G01N32,안양 정관장,Away,최성원,2,1,3,33.3,0,2,0.0,1,5,20.0,0,0,0.0,0,1,1,0,1,0,0,0,0,1
../kbl_data/2024-2025,S45G01N32,안양 정관장,Away,김준형,2,1,3,33.3,0,4,0.0,1,7,14.3,0,0,0.0,1,1,2,0,0,0,0,0,0,0
../kbl_data/2024-2025,S45G01N32,안양 정관장,Away,캐디 라렌,26,10,14,71.4,2,4,50.0,12,18,66.7,0,0,0.0,5,6,11,5,2,1,0,1,1,1
../kbl_data/2024-2025,S45G01N32,안양 정관장,Away,김경원,2,1,3,33.3,0,1,0.0,1,4,25.0,0,0,0.0,2,0,2,0,0,0,0,0,0,3
../kbl_data/2024-2025,S45G01N32,안양 정관장,Away,하비 고메즈,4,2,4,50.0,0,1,0.0,2,5,40.0,0,0,0.0,0,0,0,1,0,0,0,0,0,3
../kbl_data/2024-2025,S45G01N32,안양 정관장,Away,마이클 영 Jr,4,1,4,25.0,0,0,0.0,1,4,25.0,2,2,100.0,0,3,3,0,0,0,0,0,1,0
../kbl_data/2024-2025,S45G01N33,원주 DB,Home,이관희,8,3,3,100.0,0,3,0.0,3,6,50.0,2,2,100.0,0,2,2,0,0,1,0,0,4,1
../kbl_data/2024-2025,S45G01N33,원주 DB,Home,김시래,0,0,0,0.0,0,0,0.0,0,0,0.0,0,0,0.0,0,0,0,0,0,0,0,0,0,0
../kbl_data/2024-2025,S45G01N33,원주 DB,Home,서민수,4,2,3,66.7,0,1,0.0,2,4,50.0,0,0,0.0,1,1,2,0,0,0,0,0,1,2
../kbl_data/2024-2025,S45G01N33,원주 DB,Home,김영현,3,0,0,0.0,1,3,33.3,1,3,33.3,0,0,0.0,1,1,2,2,0,0,0,0,2,0
../kbl_data/2024-2025,S45G01N33,원주 DB,Home,강상재,15,6,8,75.0,1,3,33.3,7,11,63.6,0,0,0.0,3,4,7,5,0,1,0,0,2,3
../kbl_data/2024-2025,S45G01N33,원주 DB,Home,유현준,10,2,3,66.7,2,5,40.0,4,8,50.0,0,0,0.0,0,2,2,4,1,0,0,0,4,2
../kbl_data/2024-2025,S45G01N33,원주 DB,Home,치나누 오누아쿠,9,3,9,33.3,0,2,0.0,3,11,27.3,3,4,75.0,3,8,11,3,2,0,0,0,2,2
../kbl_data/2024-2025,S45G01N33,원주 DB,Home,김훈,0,0,0,0.0,0,0,0.0,0,0,0.0,0,0,0.0,0,0,0,0,0,0,0,0,0,0
../kbl_data/2024-2025,S45G01N33,원주 DB,Home,이용우,0,0,0,0.0,0,0,0.0,0,0,0.0,0,0,0.0,0,0,0,0,0,0,0,0,0,0
../kbl_data/2024-2025,S45G01N33,원주 DB,Home,이선 알바노,12,2,8,25.0,2,5,40.0,4,13,30.8,2,3,66.7,1,3,4,3,2,0,0,0,4,3
../kbl_data/2024-2025,S45G01N33,원주 DB,Home,박인웅,3,1,2,50.0,0,1,0.0,1,3,33.3,1,2,50.0,1,3,4,2,2,0,1,0,2,2
../kbl_data/2024-2025,S45G01N33,원주 DB,Home,로버트 카터,0,0,0,0.0,0,2,0.0,0,2,0.0,0,0,0.0,0,2,2,0,0,0,0,0,0,5
../kbl_data/2024-2025,S45G01N33,고양 소노,Away,정희재,2,1,1,100.0,0,5,0.0,1,6,16.7,0,0,0.0,1,1,2,0,1,0,0,0,0,2
../kbl_data/2024-2025,S45G01N33,고양 소노,Away,임동섭,8,4,4,100.0,0,1,0.0,4,5,80.0,0,0,0.0,0,2,2,0,3,0,0,0,0,2
../kbl_data/2024-2025,S45G01N33,고양 소노,Away,김민욱,10,1,3,33.3,2,5,40.0,3,8,37.5,2,2,100.0,5,3,8,2,1,0,0,0,0,5
../kbl_data/2024-2025,S45G01N33,고양 소노,Away,이재도,7,0,2,0.0,1,8,12.5,1,10,10.0,4,4,100.0,1,2,3,3,1,0,0,0,3,2
../kbl_data/2024-2025,S45G01N33,고양 소노,Away,김영훈,0,0,1,0.0,0,1,0.0,0,2,0.0,0,0,0.0,0,0,0,0,0,0,0,0,0,2
../kbl_data/2024-2025,S45G01N33,고양 소노,Away,최승욱,2,1,3,33.3,0,2,0.0,1,5,20.0,0,0,0.0,5,0,5,3,1,1,0,0,0,1
../kbl_data/2024-2025,S45G01N33,고양 소노,Away,김진유,0,0,0,0.0,0,0,0.0,0,0,0.0,0,0,0.0,3,1,4,0,2,0,0,0,0,1
../kbl_data/2024-2025,S45G01N33,고양 소노,Away,이정현,22,6,8,75.0,2,9,22.2,8,17,47.1,4,4,100.0,1,4,5,7,2,0,0,0,6,3
../kbl_data/2024-2025,S45G01N33,고양 소노,Away,조은후,0,0,0,0.0,0,0,0.0,0,0,0.0,0,0,0.0,0,0,0,0,0,0,0,0,0,0
../kbl_data/2024-2025,S45G01N33,고양 소노,Away,백지웅,0,0,0,0.0,0,0,0.0,0,0,0.0,0,0,0.0,0,0,0,0,0,0,0,0,0,0
../kbl_data/2024-2025,S45G01N33,고양 소노,Away,앨런 윌리엄스,22,9,20,45.0,0,0,0.0,9,20,45.0,4,7,57.1,6,8,14,3,3,0,0,0,4,2
../kbl_data/2024-2025,S45G01N33,고양 소노,Away,디제이 번즈 Jr,6,3,4,75.0,0,1,0.0,3,5,60.0,0,0,0.0,0,2,2,1,0,0,0,0,0,0
../kbl_data/2024-2025,S45G01N34,대구 한국가스공사,Home,김동량,0,0,0,0.0,0,0,0.0,0,0,0.0,0,0,0.0,0,0,0,0,0,0,0,0,0,0
../kbl_data/2024-2025,S45G01N34,대구 한국가스공사,Home,박지훈,0,0,0,0.0,0,0,0.0,0,0,0.0,0,0,0.0,0,0,0,0,1,0,0,0,0,0
../kbl_data/2024-2025,S45G01N34,대구 한국가스공사,Home,이대헌,2,1,3,33.3,0,0,0.0,1,3,33.3,0,1,0.0,1,3,4,1,0,0,1,0,0,2
../kbl_data/2024-2025,S45G01N34,대구 한국가스공사,Home,정성우,3,0,1,0.0,1,5,20.0,1,6,16.7,0,0,0.0,0,1,1,7,1,0,2,0,1,2
../kbl_data/2024-2025,S45G01N34,대구 한국가스공사,Home,김낙현,11,1,3,33.3,3,4,75.0,4,7,57.1,0,0,0.0,0,0,0,3,0,0,0,0,1,0
../kbl_data/2024-2025,S45G01N34,대구 한국가스공사,Home,양재혁,0,0,0,0.0,0,0,0.0,0,0,0.0,0,0,0.0,0,0,0,0,0,0,0,0,0,3
../kbl_data/2024-2025,S45G01N34,대구 한국가스공사,Home,곽정훈,0,0,2,0.0,0,1,0.0,0,3,0.0,0,0,0.0,1,1,2,0,0,0,0,0,1,3
../kbl_data/2024-2025,S45G01N34,대구 한국가스공사,Home,앤드류 니콜슨,33,8,15,53.3,5,9,55.6,13,24,54.2,2,2,100.0,2,8,10,0,3,0,0,1,5,3
../kbl_data/2024-2025,S45G01N34,대구 한국가스공사,Home,신승민,11,1,3,33.3,3,3,100.0,4,6,66.7,0,0,0.0,0,4,4,1,1,1,0,0,1,4
../kbl_data/2024-2025,S45G01N34,대구 한국가스공사,Home,샘조세프 벨란겔,12,3,6,50.0,1,5,20.0,4,11,36.4,3,4,75.0,0,1,1,8,1,1,0,0,2,4
../kbl_data/2024-2025,S45G01N34,대구 한국가스공사,Home,유슈 은도예,7,3,6,50.0,0,0,0.0,3,6,50.0,1,1,100.0,3,1,4,0,0,0,0,1,0,1
../kbl_data/2024-2025,S45G01N34,대구 한국가스공사,Home,신주영,3,0,0,0.0,1,1,100.0,1,1,100.0,0,0,0.0,0,0,0,0,0,0,0,0,0,0
../kbl_data/2024-2025,S45G01N34,수원 KT,Away,한희원,10,2,2,100.0,2,3,66.7,4,5,80.0,0,0,0.0,0,1,1,1,0,0,0,0,1,2
../kbl_data/2024-2025,S45G01N34,수원 KT,Away,최창진,3,0,1,0.0,1,5,20.0,1,6,16.7,0,0,0.0,0,2,2,4,0,0,0,0,3,3
../kbl_data/2024-2025,S45G01N34,수원 KT,Away,문성곤,0,0,2,0.0,0,4,0.0,0,6,0.0,0,0,0.0,2,0,2,0,0,0,0,0,1,1
../kbl_data/2024-2025,S45G01N34,수원 KT,Away,이현석,2,1,1,100.0,0,2,0.0,1,3,33.3,0,0,0.0,4,1,5,1,1,0,0,0,1,3
../kbl_data/2024-2025,S45G01N34,수원 KT,Away,허훈,18,6,11,54.5,1,8,12.5,7,19,36.8,3,4,75.0,1,1,2,6,2,0,0,0,3,1
../kbl_data/2024-2025,S45G01N34,수원 KT,Away,박준영,0,0,1,0.0,0,0,0.0,0,1,0.0,0,0,0.0,0,0,0,1,0,0,0,0,0,0
../kbl_data/2024-2025,S45G01N34,수원 KT,Away,최진광,0,0,0,0.0,0,0,0.0,0,0,0.0,0,0,0.0,0,0,0,0,0,0,0,0,0,0
../kbl_data/2024-2025,S45G01N34,수원 KT,Away,이호준,0,0,0,0.0,0,0,0.0,0,0,0.0,0,0,0.0,0,0,0,0,0,0,0,0,0,0
../kbl_data/2024-2025,S45G01N34,수원 KT,Away,하윤기,16,7,12,58.3,0,0,0.0,7,12,58.3,2,2,100.0,6,3,9,2,0,2,0,0,2,4
../kbl_data/2024-2025,S45G01N34,수원 KT,Away,박선웅,0,0,0,0.0,0,0,0.0,0,0,0.0,0,0,0.0,0,0,0,0,0,0,0,0,0,0
../kbl_data/2024-2025,S45G01N34,수원 KT,Away,제레미아 틸먼,6,2,2,100.0,0,0,0.0,2,2,100.0,2,2,100.0,2,2,4,0,2,1,0,0,1,1
../kbl_data/2024-2025,S45G01N34,수원 KT,Away,레이션 해먼즈,19,5,7,71.4,2,5,40.0,7,12,58.3,3,5,60.0,0,14,14,0,0,0,1,0,4,3
../kbl_data/2024-2025,S45G01N35,울산 현대모비스,Home,함지훈,11,2,4,50.0,2,3,66.7,4,7,57.1,1,1,100.0,5,0,5,2,1,1,0,0,1,0
../kbl_data/2024-2025,S45G01N35,울산 현대모비스,Home,장재석,0,0,3,0.0,0,0,0.0,0,3,0.0,0,0,0.0,1,2,3,0,0,2,0,0,0,2
../kbl_data/2024-2025,S45G01N35,울산 현대모비스,Home,한호빈,2,1,1,100.0,0,0,0.0,1,1,100.0,0,0,0.0,0,0,0,1,0,0,0,0,0,0
../kbl_data/2024-2025,S45G01N35,울산 현대모비스,Home,김국찬,0,0,1,0.0,0,1,0.0,0,2,0.0,0,0,0.0,1,1,2,0,0,0,0,0,1,1
../kbl_data/2024-2025,S45G01N35,울산 현대모비스,Home,서명진,14,4,4,100.0,2,4,50.0,6,8,75.0,0,0,0.0,1,1,2,2,2,1,0,0,5,2
../kbl_data/2024-2025,S45G01N35,울산 현대모비스,Home,숀 롱,21,7,10,70.0,1,1,100.0,8,11,72.7,4,4,100.0,3,2,5,2,0,0,1,2,1,2
../kbl_data/2024-2025,S45G01N35,울산 현대모비스,Home,이우석,2,1,9,11.1,0,5,0.0,1,14,7.1,0,0,0.0,0,1,1,2,0,0,0,0,1,3
../kbl_data/2024-2025,S45G01N35,울산 현대모비스,Home,이승우,0,0,2,0.0,0,0,0.0,0,2,0.0,0,0,0.0,0,3,3,1,0,0,0,0,0,1
../kbl_data/2024-2025,S45G01N35,울산 현대모비스,Home,신민석,6,0,0,0.0,2,2,100.0,2,2,100.0,0,0,0.0,0,1,1,1,1,0,0,0,0,1
../kbl_data/2024-2025,S45G01N35,울산 현대모비스,Home,게이지 프림,14,7,13,53.8,0,1,0.0,7,14,50.0,0,0,0.0,3,5,8,2,1,0,0,0,1,3
../kbl_data/2024-2025,S45G01N35,울산 현대모비스,Home,박무빈,6,2,7,28.6,0,2,0.0,2,9,22.2,2,3,66.7,0,5,5,6,1,0,0,0,3,1
../kbl_data/2024-2025,S45G01N35,울산 현대모비스,Home,미구엘 안드레 옥존,0,0,0,0.0,0,1,0.0,0,1,0.0,0,0,0.0,0,0,0,0,0,0,1,0,0,2
../kbl_data/2024-2025,S45G01N35,서울 SK,Away,김선형,13,3,4,75.0,2,4,50.0,5,8,62.5,1,2,50.0,1,0,1,2,0,1,0,0,0,3
../kbl_data/2024-2025,S45G01N35,서울 SK,Away,오세근,6,3,4,75.0,0,3,0.0,3,7,42.9,0,0,0.0,0,4,4,1,0,1,0,0,0,1
../kbl_data/2024-2025,S45G01N35,서울 SK,Away,최부경,7,1,1,100.0,0,1,0.0,1,2,50.0,5,5,100.0,3,1,4,0,0,0,0,0,1,0
../kbl_data/2024-2025,S45G01N35,서울 SK,Away,최원혁,2,1,1,100.0,0,1,0.0,1,2,50.0,0,0,0.0,3,2,5,2,1,0,0,0,5,4
../kbl_data/2024-2025,S45G01N35,서울 SK,Away,장문호,2,1,2,50.0,0,1,0.0,1,3,33.3,0,0,0.0,0,0,0,0,0,0,0,0,0,0
../kbl_data/2024-2025,S45G01N35,서울 SK,Away,안영준,14,5,6,83.3,0,3,0.0,5,9,55.6,4,6,66.7,0,6,6,3,2,1,0,0,2,1
../kbl_data/2024-2025,S45G01N35,서울 SK,Away,자밀 워니,26,11,15,73.3,0,4,0.0,11,19,57.9,4,5,80.0,1,9,10,8,2,0,0,4,0,2
../kbl_data/2024-2025,S45G01N35,서울 SK,Away,김형빈,2,1,1,100.0,0,2,0.0,1,3,33.3,0,0,0.0,2,0,2,0,1,1,0,0,0,1
../kbl_data/2024-2025,S45G01N35,서울 SK,Away,아이재아 힉스,7,1,4,25.0,1,1,100.0,2,5,40.0,2,2,100.0,1,0,1,0,0,1,0,0,0,0
../kbl_data/2024-2025,S45G01N35,서울 SK,Away,박민우,2,1,1,100.0,0,0,0.0,1,1,100.0,0,0,0.0,1,0,1,0,0,0,0,0,0,0
../kbl_data/2024-2025,S45G01N35,서울 SK,Away,오재현,7,2,6,33.3,1,1,100.0,3,7,42.9,0,0,0.0,0,3,3,5,1,0,0,0,2,3
../kbl_data/2024-2025,S45G01N35,서울 SK,Away,고메즈 델 리아노,7,3,5,60.0,0,1,0.0,3,6,50.0,1,1,100.0,1,1,2,2,0,0,0,0,1,0
../kbl_data/2024-2025,S45G01N36,서울 삼성,Home,이정현,3,1,3,33.3,0,3,0.0,1,6,16.7,1,1,100.0,0,2,2,6,0,0,0,0,3,3
../kbl_data/2024-2025,S45G01N36,서울 삼성,Home,최현민,6,0,1,0.0,2,4,50.0,2,5,40.0,0,0,0.0,1,0,1,0,0,1,0,0,1,1
../kbl_data/2024-2025,S45G01N36,서울 삼성,Home,최성모,2,0,0,0.0,0,3,0.0,0,3,0.0,2,2,100.0,0,1,1,3,0,0,0,0,2,4
../kbl_data/2024-2025,S45G01N36,서울 삼성,Home,최승욱,0,0,0,0.0,0,3,0.0,0,3,0.0,0,0,0.0,0,1,1,1,0,0,0,0,2,3
../kbl_data/2024-2025,S45G01N36,서울 삼성,Home,김진용,0,0,0,0.0,0,0,0.0,0,0,0.0,0,0,0.0,0,0,0,0,0,0,0,0,0,0
../kbl_data/2024-2025,S45G01N36,서울 삼성,Home,마커스 데릭슨,3,1,4,25.0,0,2,0.0,1,6,16.7,1,2,50.0,1,3,4,0,0,0,0,0,0,1
../kbl_data/2024-2025,S45G01N36,서울 삼성,Home,차민석,13,3,3,100.0,2,3,66.7,5,6,83.3,1,2,50.0,2,2,4,0,0,0,1,0,0,4
../kbl_data/2024-2025,S45G01N36,서울 삼성,Home,이원석,17,6,10,60.0,1,1,100.0,7,11,63.6,2,2,100.0,2,3,5,1,2,1,0,1,0,3
../kbl_data/2024-2025,S45G01N36,서울 삼성,Home,저스틴 구탕,6,0,1,0.0,2,4,50.0,2,5,40.0,0,0,0.0,0,3,3,6,1,1,0,0,1,3
../kbl_data/2024-2025,S45G01N36,서울 삼성,Home,조준희,0,0,0,0.0,0,0,0.0,0,0,0.0,0,0,0.0,0,0,0,0,0,0,0,0,0,0
../kbl_data/2024-2025,S45G01N36,서울 삼성,Home,박승재,3,0,0,0.0,1,1,100.0,1,1,100.0,0,0,0.0,0,0,0,5,1,0,0,0,1,2
../kbl_data/2024-2025,S45G01N36,서울 삼성,Home,코피 코번,27,10,18,55.6,0,0,0.0,10,18,55.6,7,15,46.7,6,8,14,2,0,0,0,1,1,0
../kbl_data/2024-2025,S45G01N36,창원 LG,Away,허일영,5,1,4,25.0,1,3,33.3,2,7,28.6,0,0,0.0,2,0,2,0,0,0,0,0,0,3
../kbl_data/2024-2025,S45G01N36,창원 LG,Away,최진수,9,1,1,100.0,1,2,50.0,2,3,66.7,4,4,100.0,1,3,4,4,0,2,0,0,0,2
../kbl_data/2024-2025,S45G01N36,창원 LG,Away,장민국,0,0,0,0.0,0,0,0.0,0,0,0.0,0,0,0.0,0,1,1,0,0,0,0,0,0,4
../kbl_data/2024-2025,S45G01N36,창원 LG,Away,전성현,14,0,2,0.0,4,6,66.7,4,8,50.0,2,2,100.0,0,0,0,0,0,0,0,0,0,1
../kbl_data/2024-2025,S45G01N36,창원 LG,Away,정인덕,6,0,1,0.0,1,2,50.0,1,3,33.3,3,4,75.0,0,1,1,0,0,1,0,0,0,0
../kbl_data/2024-2025,S45G01N36,창원 LG,Away,대릴 먼로,13,5,8,62.5,0,1,0.0,5,9,55.6,3,4,75.0,2,8,10,3,0,1,0,0,2,4
../kbl_data/2024-2025,S45G01N36,창원 LG,Away,장태빈,0,0,0,0.0,0,0,0.0,0,0,0.0,0,0,0.0,0,0,0,1,0,0,0,0,0,0
../kbl_data/2024-2025,S45G01N36,창원 LG,Away,박정현,0,0,0,0.0,0,0,0.0,0,0,0.0,0,0,0.0,0,0,0,0,0,0,0,0,0,0
../kbl_data/2024-2025,S45G01N36,창원 LG,Away,양준석,14,6,7,85.7,0,1,0.0,6,8,75.0,2,2,100.0,1,3,4,6,1,0,0,0,3,3
../kbl_data/2024-2025,S45G01N36,창원 LG,Away,유기상,15,2,8,25.0,3,9,33.3,5,17,29.4,2,4,50.0,1,1,2,1,1,0,0,0,1,2
../kbl_data/2024-2025,S45G01N36,창원 LG,Away,이강현,0,0,0,0.0,0,0,0.0,0,0,0.0,0,0,0.0,0,0,0,0,0,0,0,0,0,0
../kbl_data/2024-2025,S45G01N36,창원 LG,Away,칼 타마요,3,1,3,33.3,0,1,0.0,1,4,25.0,1,2,50.0,0,3,3,1,1,0,0,0,1,4
../kbl_data/2024-2025,S45G01N37,안양 정관장,Home,송창용,0,0,0,0.0,0,0,0.0,0,0,0.0,0,0,0.0,0,0,0,0,0,0,0,0,0,0
../kbl_data/2024-2025,S45G01N37,안양 정관장,Home,정준원,0,0,0,0.0,0,0,0.0,0,0,0.0,0,0,0.0,0,0,0,0,0,0,0,0,0,0
../kbl_data/2024-2025,S45G01N37,안양 정관장,Home,이원대,0,0,0,0.0,0,0,0.0,0,0,0.0,0,0,0.0,0,0,0,0,0,0,0,0,0,0
../kbl_data/2024-2025,S45G01N37,안양 정관장,Home,배병준,19,5,8,62.5,3,4,75.0,8,12,66.7,0,0,0.0,4,2,6,1,1,0,0,0,1,2
../kbl_data/2024-2025,S45G01N37,안양 정관장,Home,정효근,10,1,3,33.3,1,7,14.3,2,10,20.0,5,8,62.5,4,5,9,3,1,1,0,0,0,3
../kbl_data/2024-2025,S45G01N37,안양 정관장,Home,이종현,8,4,5,80.0,0,1,0.0,4,6,66.7,0,0,0.0,0,3,3,0,1,1,0,0,1,0
../kbl_data/2024-2025,S45G01N37,안양 정관장,Home,박지훈,13,4,7,57.1,1,5,20.0,5,12,41.7,2,2,100.0,1,5,6,7,2,2,0,0,1,3
../kbl_data/2024-2025,S45G01N37,안양 정관장,Home,최성원,7,2,4,50.0,1,6,16.7,3,10,30.0,0,0,0.0,0,1,1,2,1,0,0,0,0,5
../kbl_data/2024-2025,S45G01N37,안양 정관장,Home,캐디 라렌,4,2,4,50.0,0,2,0.0,2,6,33.3,0,0,0.0,4,3,7,2,1,0,0,0,1,1
../kbl_data/2024-2025,S45G01N37,안양 정관장,Home,김경원,0,0,0,0.0,0,0,0.0,0,0,0.0,0,0,0.0,1,0,1,0,0,0,0,0,0,0
../kbl_data/2024-2025,S45G01N37,안양 정관장,Home,하비 고메즈,0,0,0,0.0,0,0,0.0,0,0,0.0,0,0,0.0,0,0,0,0,0,0,0,0,0,0
../kbl_data/2024-2025,S45G01N37,안양 정관장,Home,마이클 영 Jr,13,5,10,50.0,1,3,33.3,6,13,46.2,0,1,0.0,0,5,5,3,1,1,0,0,3,2
../kbl_data/2024-2025,S45G01N37,수원 KT,Away,한희원,10,2,5,40.0,2,8,25.0,4,13,30.8,0,0,0.0,2,6,8,2,0,0,0,0,0,3
../kbl_data/2024-2025,S45G01N37,수원 KT,Away,최창진,8,1,4,25.0,2,4,50.0,3,8,37.5,0,0,0.0,0,3,3,4,0,0,0,0,2,2
../kbl_data/2024-2025,S45G01N37,수원 KT,Away,문성곤,0,0,1,0.0,0,5,0.0,0,6,0.0,0,0,0.0,0,1,1,3,2,0,0,0,0,3
../kbl_data/2024-2025,S45G01N37,수원 KT,Away,이현석,0,0,0,0.0,0,0,0.0,0,0,0.0,0,0,0.0,0,1,1,0,0,0,0,0,0,0
../kbl_data/2024-2025,S45G01N37,수원 KT,Away,허훈,11,2,8,25.0,2,7,28.6,4,15,26.7,1,3,33.3,2,2,4,4,0,1,0,0,3,2
../kbl_data/2024-2025,S45G01N37,수원 KT,Away,박준영,11,4,5,80.0,1,5,20.0,5,10,50.0,0,0,0.0,4,3,7,4,1,1,1,0,1,5
../kbl_data/2024-2025,S45G01N37,수원 KT,Away,최진광,2,0,2,0.0,0,1,0.0,0,3,0.0,2,2,100.0,0,0,0,0,0,0,0,0,1,0
../kbl_data/2024-2025,S45G01N37,수원 KT,Away,이호준,0,0,0,0.0,0,0,0.0,0,0,0.0,0,0,0.0,0,0,0,0,0,0,0,0,0,0
../kbl_data/2024-2025,S45G01N37,수원 KT,Away,이두원,4,2,2,100.0,0,0,0.0,2,2,100.0,0,0,0.0,2,1,3,0,0,0,0,0,0,1
../kbl_data/2024-2025,S45G01N37,수원 KT,Away,박선웅,0,0,0,0.0,0,0,0.0,0,0,0.0,0,0,0.0,0,0,0,0,0,0,0,0,0,0
../kbl_data/2024-2025,S45G01N37,수원 KT,Away,제레미아 틸먼,4,2,3,66.7,0,0,0.0,2,3,66.7,0,2,0.0,2,3,5,0,0,0,0,0,0,0
../kbl_data/2024-2025,S45G01N37,수원 KT,Away,레이션 해먼즈,23,8,11,72.7,2,4,50.0,10,15,66.7,1,2,50.0,6,7,13,1,2,1,0,0,3,1
../kbl_data/2024-2025,S45G01N38,울산 현대모비스,Home,함지훈,1,0,2,0.0,0,0,0.0,0,2,0.0,1,2,50.0,2,2,4,7,2,0,0,0,0,0
../kbl_data/2024-2025,S45G01N38,울산 현대모비스,Home,장재석,6,3,4,75.0,0,0,0.0,3,4,75.0,0,1,0.0,1,1,2,3,2,1,0,0,2,2
../kbl_data/2024-2025,S45G01N38,울산 현대모비스,Home,김지완,0,0,0,0.0,0,0,0.0,0,0,0.0,0,0,0.0,1,0,1,0,0,0,0,0,0,1
../kbl_data/2024-2025,S45G01N38,울산 현대모비스,Home,한호빈,2,1,1,100.0,0,0,0.0,1,1,100.0,0,0,0.0,2,0,2,1,1,1,0,0,1,2
../kbl_data/2024-2025,S45G01N38,울산 현대모비스,Home,서명진,15,3,5,60.0,3,6,50.0,6,11,54.5,0,0,0.0,3,4,7,1,2,0,0,0,2,4
../kbl_data/2024-2025,S45G01N38,울산 현대모비스,Home,숀 롱,24,9,16,56.2,0,1,0.0,9,17,52.9,6,8,75.0,6,5,11,2,2,0,0,1,2,3
../kbl_data/2024-2025,S45G01N38,울산 현대모비스,Home,이우석,19,3,9,33.3,3,6,50.0,6,15,40.0,4,4,100.0,1,6,7,2,1,0,0,0,2,1
../kbl_data/2024-2025,S45G01N38,울산 현대모비스,Home,이승우,0,0,0,0.0,0,0,0.0,0,0,0.0,0,0,0.0,0,0,0,0,0,0,0,0,0,0
../kbl_data/2024-2025,S45G01N38,울산 현대모비스,Home,신민석,0,0,0,0.0,0,0,0.0,0,0,0.0,0,0,0.0,0,0,0,0,0,0,0,0,0,0
../kbl_data/2024-2025,S45G01N38,울산 현대모비스,Home,게이지 프림,2,1,9,11.1,0,0,0.0,1,9,11.1,0,0,0.0,1,0,1,1,1,0,0,0,0,1
../kbl_data/2024-2025,S45G01N38,울산 현대모비스,Home,박무빈,7,1,6,16.7,1,4,25.0,2,10,20.0,2,2,100.0,1,0,1,1,1,0,1,0,4,3
../kbl_data/2024-2025,S45G01N38,울산 현대모비스,Home,미구엘 안드레 옥존,3,0,0,0.0,1,3,33.3,1,3,33.3,0,0,0.0,0,0,0,1,0,0,0,0,1,1
../kbl_data/2024-2025,S45G01N38,원주 DB,Away,이관희,5,1,1,100.0,1,2,50.0,2,3,66.7,0,0,0.0,0,0,0,2,2,0,0,0,2,1
../kbl_data/2024-2025,S45G01N38,원주 DB,Away,김시래,7,2,2,100.0,1,2,50.0,3,4,75.0,0,0,0.0,1,0,1,2,0,0,0,0,4,4
../kbl_data/2024-2025,S45G01N38,원주 DB,Away,서민수,0,0,0,0.0,0,1,0.0,0,1,0.0,0,0,0.0,1,3,4,1,0,0,0,0,0,2
../kbl_data/2024-2025,S45G01N38,원주 DB,Away,김영현,0,0,0,0.0,0,1,0.0,0,1,0.0,0,0,0.0,0,0,0,0,0,0,0,0,1,0
../kbl_data/2024-2025,S45G01N38,원주 DB,Away,박봉진,0,0,0,0.0,0,0,0.0,0,0,0.0,0,0,0.0,0,0,0,0,0,0,0,0,0,0
../kbl_data/2024-2025,S45G01N38,원주 DB,Away,강상재,10,2,3,66.7,2,3,66.7,4,6,66.7,0,0,0.0,1,4,5,1,0,0,0,0,2,1
../kbl_data/2024-2025,S45G01N38,원주 DB,Away,유현준,0,0,1,0.0,0,2,0.0,0,3,0.0,0,0,0.0,0,1,1,4,1,0,0,0,1,3
../kbl_data/2024-2025,S45G01N38,원주 DB,Away,치나누 오누아쿠,21,10,16,62.5,0,1,0.0,10,17,58.8,1,2,50.0,0,13,13,0,3,1,0,3,2,3
../kbl_data/2024-2025,S45G01N38,원주 DB,Away,김훈,2,0,1,0.0,0,0,0.0,0,1,0.0,2,2,100.0,0,0,0,0,0,0,0,0,0,1
../kbl_data/2024-2025,S45G01N38,원주 DB,Away,이선 알바노,23,8,14,57.1,1,4,25.0,9,18,50.0,4,4,100.0,2,2,4,6,2,0,0,0,3,3
../kbl_data/2024-2025,S45G01N38,원주 DB,Away,박인웅,2,1,2,50.0,0,3,0.0,1,5,20.0,0,0,0.0,0,1,1,0,2,0,0,0,1,3
../kbl_data/2024-2025,S45G01N38,원주 DB,Away,로버트 카터,0,0,0,0.0,0,1,0.0,0,1,0.0,0,0,0.0,0,0,0,0,0,0,0,0,0,0
../kbl_data/2024-2025,S45G01N39,대구 한국가스공사,Home,김동량,0,0,0,0.0,0,0,0.0,0,0,0.0,0,0,0.0,0,1,1,1,0,0,0,0,0,0
../kbl_data/2024-2025,S45G01N39,대구 한국가스공사,Home,박지훈,3,0,1,0.0,1,2,50.0,1,3,33.3,0,0,0.0,0,2,2,0,0,1,0,0,0,1
../kbl_data/2024-2025,S45G01N39,대구 한국가스공사,Home,이대헌,8,4,5,80.0,0,1,0.0,4,6,66.7,0,0,0.0,2,4,6,2,0,0,0,0,0,2
../kbl_data/2024-2025,S45G01N39,대구 한국가스공사,Home,정성우,6,3,4,75.0,0,2,0.0,3,6,50.0,0,0,0.0,1,0,1,1,2,0,1,0,2,3
../kbl_data/2024-2025,S45G01N39,대구 한국가스공사,Home,김낙현,15,0,2,0.0,5,8,62.5,5,10,50.0,0,0,0.0,1,1,2,4,1,0,0,0,0,3
../kbl_data/2024-2025,S45G01N39,대구 한국가스공사,Home,양재혁,0,0,0,0.0,0,1,0.0,0,1,0.0,0,0,0.0,0,0,0,1,1,0,0,0,0,1
../kbl_data/2024-2025,S45G01N39,대구 한국가스공사,Home,곽정훈,11,1,1,100.0,3,6,50.0,4,7,57.1,0,0,0.0,1,5,6,0,0,0,0,0,0,3
../kbl_data/2024-2025,S45G01N39,대구 한국가스공사,Home,앤드류 니콜슨,22,4,5,80.0,4,6,66.7,8,11,72.7,2,2,100.0,0,7,7,1,1,1,0,1,0,1
../kbl_data/2024-2025,S45G01N39,대구 한국가스공사,Home,신승민,10,2,4,50.0,1,6,16.7,3,10,30.0,3,4,75.0,2,2,4,4,0,0,0,0,1,2
../kbl_data/2024-2025,S45G01N39,대구 한국가스공사,Home,샘조세프 벨란겔,15,6,9,66.7,1,6,16.7,7,15,46.7,0,0,0.0,1,3,4,5,3,0,0,0,1,1
../kbl_data/2024-2025,S45G01N39,대구 한국가스공사,Home,유슈 은도예,9,2,5,40.0,1,1,100.0,3,6,50.0,2,2,100.0,2,4,6,2,0,3,0,2,1,2
../kbl_data/2024-2025,S45G01N39,대구 한국가스공사,Home,신주영,0,0,0,0.0,0,0,0.0,0,0,0.0,0,0,0.0,1,1,2,1,0,0,0,0,1,1
../kbl_data/2024-2025,S45G01N39,고양 소노,Away,홍경기,0,0,0,0.0,0,1,0.0,0,1,0.0,0,0,0.0,1,0,1,0,0,0,0,0,1,0
../kbl_data/2024-2025,S45G01N39,고양 소노,Away,정희재,6,1,2,50.0,1,3,33.3,2,5,40.0,1,2,50.0,0,3,3,0,0,0,0,0,1,4
../kbl_data/2024-2025,S45G01N39,고양 소노,Away,임동섭,6,0,0,0.0,2,8,25.0,2,8,25.0,0,0,0.0,0,2,2,1,1,1,0,0,0,3
../kbl_data/2024-2025,S45G01N39,고양 소노,Away,김민욱,0,0,0,0.0,0,0,0.0,0,0,0.0,0,0,0.0,0,0,0,0,0,0,0,0,0,0
../kbl_data/2024-2025,S45G01N39,고양 소노,Away,이재도,22,3,5,60.0,5,12,41.7,8,17,47.1,1,1,100.0,2,6,8,7,2,0,0,0,3,2
../kbl_data/2024-2025,S45G01N39,고양 소노,Away,김영훈,1,0,0,0.0,0,1,0.0,0,1,0.0,1,2,50.0,0,1,1,0,0,0,0,0,0,0
../kbl_data/2024-2025,S45G01N39,고양 소노,Away,최승욱,7,2,3,66.7,1,4,25.0,3,7,42.9,0,0,0.0,2,0,2,4,0,0,0,0,0,0
../kbl_data/2024-2025,S45G01N39,고양 소노,Away,김진유,6,3,6,50.0,0,0,0.0,3,6,50.0,0,0,0.0,4,4,8,2,1,1,0,0,0,3
../kbl_data/2024-2025,S45G01N39,고양 소노,Away,이정현,1,0,2,0.0,0,3,0.0,0,5,0.0,1,2,50.0,0,1,1,0,0,0,0,0,1,0
../kbl_data/2024-2025,S45G01N39,고양 소노,Away,민기남,0,0,0,0.0,0,2,0.0,0,2,0.0,0,0,0.0,0,0,0,0,0,0,0,0,1,2
../kbl_data/2024-2025,S45G01N39,고양 소노,Away,앨런 윌리엄스,9,4,14,28.6,0,1,0.0,4,15,26.7,1,4,25.0,5,5,10,2,1,0,0,0,3,3
../kbl_data/2024-2025,S45G01N39,고양 소노,Away,디제이 번즈 Jr,7,3,7,42.9,0,1,0.0,3,8,37.5,1,2,50.0,3,1,4,2,1,0,0,0,1,1
../kbl_data/2024-2025,S45G01N40,수원 KT,Home,한희원,3,0,0,0.0,1,5,20.0,1,5,20.0,0,0,0.0,2,2,4,0,0,1,0,0,1,4
../kbl_data/2024-2025,S45G01N40,수원 KT,Home,최창진,0,0,2,0.0,0,2,0.0,0,4,0.0,0,0,0.0,1,1,2,2,0,0,0,0,1,0
../kbl_data/2024-2025,S45G01N40,수원 KT,Home,문성곤,8,1,1,100.0,2,5,40.0,3,6,50.0,0,0,0.0,1,1,2,2,0,0,0,0,2,3
../kbl_data/2024-2025,S45G01N40,수원 KT,Home,이현석,0,0,0,0.0,0,1,0.0,0,1,0.0,0,0,0.0,0,0,0,0,0,0,0,0,0,1
../kbl_data/2024-2025,S45G01N40,수원 KT,Home,허훈,19,6,8,75.0,2,4,50.0,8,12,66.7,1,2,50.0,0,2,2,7,2,0,0,0,3,4
../kbl_data/2024-2025,S45G01N40,수원 KT,Home,박준영,15,4,7,57.1,2,6,33.3,6,13,46.2,1,2,50.0,6,3,9,2,0,0,0,0,1,2
../kbl_data/2024-2025,S45G01N40,수원 KT,Home,최진광,0,0,0,0.0,0,0,0.0,0,0,0.0,0,0,0.0,0,0,0,0,0,0,0,0,0,0
../kbl_data/2024-2025,S45G01N40,수원 KT,Home,이호준,0,0,0,0.0,0,1,0.0,0,1,0.0,0,0,0.0,0,0,0,0,0,0,0,0,0,0
../kbl_data/2024-2025,S45G01N40,수원 KT,Home,이두원,0,0,1,0.0,0,0,0.0,0,1,0.0,0,0,0.0,0,2,2,0,0,0,0,0,0,0
../kbl_data/2024-2025,S45G01N40,수원 KT,Home,고찬혁,0,0,0,0.0,0,0,0.0,0,0,0.0,0,0,0.0,0,0,0,0,0,0,0,0,0,0
../kbl_data/2024-2025,S45G01N40,수원 KT,Home,제레미아 틸먼,9,2,5,40.0,0,0,0.0,2,5,40.0,5,7,71.4,0,5,5,0,0,0,0,1,1,0
../kbl_data/2024-2025,S45G01N40,수원 KT,Home,레이션 해먼즈,11,4,12,33.3,1,4,25.0,5,16,31.2,0,0,0.0,0,9,9,1,1,0,0,2,0,4
../kbl_data/2024-2025,S45G01N40,창원 LG,Away,허일영,6,2,2,100.0,0,2,0.0,2,4,50.0,2,2,100.0,3,4,7,1,0,0,0,0,0,0
../kbl_data/2024-2025,S45G01N40,창원 LG,Away,최진수,7,1,2,50.0,1,3,33.3,2,5,40.0,2,2,100.0,0,1,1,1,0,1,0,0,0,3
../kbl_data/2024-2025,S45G01N40,창원 LG,Away,장민국,0,0,0,0.0,0,0,0.0,0,0,0.0,0,0,0.0,0,0,0,0,0,0,0,0,0,0
../kbl_data/2024-2025,S45G01N40,창원 LG,Away,전성현,10,3,4,75.0,1,5,20.0,4,9,44.4,1,1,100.0,0,2,2,0,1,0,0,0,0,0
../kbl_data/2024-2025,S45G01N40,창원 LG,Away,정인덕,4,2,2,100.0,0,0,0.0,2,2,100.0,0,0,0.0,1,4,5,1,1,0,0,0,1,0
../kbl_data/2024-2025,S45G01N40,창원 LG,Away,대릴 먼로,8,3,11,27.3,0,0,0.0,3,11,27.3,2,2,100.0,1,9,10,2,1,0,0,0,5,2
../kbl_data/2024-2025,S45G01N40,창원 LG,Away,장태빈,0,0,0,0.0,0,0,0.0,0,0,0.0,0,0,0.0,0,0,0,0,0,0,0,0,0,1
../kbl_data/2024-2025,S45G01N40,창원 LG,Away,박정현,6,2,2,100.0,0,0,0.0,2,2,100.0,2,2,100.0,0,1,1,0,0,0,0,0,0,3
../kbl_data/2024-2025,S45G01N40,창원 LG,Away,양준석,0,0,3,0.0,0,3,0.0,0,6,0.0,0,0,0.0,0,4,4,6,1,0,0,0,1,4
../kbl_data/2024-2025,S45G01N40,창원 LG,Away,유기상,6,1,1,100.0,1,6,16.7,2,7,28.6,1,2,50.0,0,0,0,1,0,0,0,0,1,2
../kbl_data/2024-2025,S45G01N40,창원 LG,Away,이강현,0,0,0,0.0,0,0,0.0,0,0,0.0,0,0,0.0,0,0,0,0,0,0,0,0,0,0
../kbl_data/2024-2025,S45G01N40,창원 LG,Away,칼 타마요,12,2,7,28.6,0,3,0.0,2,10,20.0,8,8,100.0,4,4,8,1,0,1,0,0,0,3
../kbl_data/2024-2025,S45G01N41,서울 SK,Home,김선형,12,6,8,75.0,0,2,0.0,6,10,60.0,0,0,0.0,2,0,2,2,1,0,0,0,0,2
../kbl_data/2024-2025,S45G01N41,서울 SK,Home,오세근,9,4,7,57.1,0,0,0.0,4,7,57.1,1,2,50.0,0,5,5,3,0,0,0,0,0,1
../kbl_data/2024-2025,S45G01N41,서울 SK,Home,최부경,2,1,3,33.3,0,0,0.0,1,3,33.3,0,0,0.0,1,3,4,1,0,0,0,0,0,2
../kbl_data/2024-2025,S45G01N41,서울 SK,Home,최원혁,0,0,0,0.0,0,0,0.0,0,0,0.0,0,0,0.0,0,1,1,0,0,0,0,0,0,1
../kbl_data/2024-2025,S45G01N41,서울 SK,Home,장문호,0,0,0,0.0,0,0,0.0,0,0,0.0,0,0,0.0,1,0,1,0,0,0,0,0,0,1
../kbl_data/2024-2025,S45G01N41,서울 SK,Home,안영준,16,5,6,83.3,1,4,25.0,6,10,60.0,3,4,75.0,2,3,5,3,3,0,0,1,4,2
../kbl_data/2024-2025,S45G01N41,서울 SK,Home,자밀 워니,22,9,15,60.0,1,2,50.0,10,17,58.8,1,2,50.0,3,19,22,10,2,0,0,4,4,0
../kbl_data/2024-2025,S45G01N41,서울 SK,Home,김형빈,6,3,5,60.0,0,0,0.0,3,5,60.0,0,0,0.0,0,0,0,0,0,0,0,0,0,2
../kbl_data/2024-2025,S45G01N41,서울 SK,Home,박민우,0,0,1,0.0,0,0,0.0,0,1,0.0,0,0,0.0,0,1,1,0,0,0,0,0,1,1
../kbl_data/2024-2025,S45G01N41,서울 SK,Home,오재현,17,5,7,71.4,2,4,50.0,7,11,63.6,1,1,100.0,0,1,1,7,1,2,0,0,1,3
../kbl_data/2024-2025,S45G01N41,서울 SK,Home,선상혁,4,2,2,100.0,0,0,0.0,2,2,100.0,0,0,0.0,0,0,0,0,0,0,0,0,0,1
../kbl_data/2024-2025,S45G01N41,서울 SK,Home,고메즈 델 리아노,5,1,1,100.0,1,1,100.0,2,2,100.0,0,2,0.0,0,3,3,5,1,0,0,0,1,0
../kbl_data/2024-2025,S45G01N41,부산 KCC,Away,정창영,15,3,4,75.0,2,6,33.3,5,10,50.0,3,4,75.0,0,3,3,3,1,0,0,0,1,1
../kbl_data/2024-2025,S45G01N41,부산 KCC,Away,리온 윌리엄스,5,2,5,40.0,0,0,0.0,2,5,40.0,1,1,100.0,2,4,6,2,1,0,0,0,1,2
../kbl_data/2024-2025,S45G01N41,부산 KCC,Away,전준범,9,0,0,0.0,3,10,30.0,3,10,30.0,0,0,0.0,0,2,2,0,1,0,0,0,1,2
../kbl_data/2024-2025,S45G01N41,부산 KCC,Away,허웅,15,2,7,28.6,2,7,28.6,4,14,28.6,5,5,100.0,0,1,1,1,0,0,0,0,2,1
../kbl_data/2024-2025,S45G01N41,부산 KCC,Away,이승현,8,4,8,50.0,0,0,0.0,4,8,50.0,0,0,0.0,2,0,2,3,2,1,0,0,0,1
../kbl_data/2024-2025,S45G01N41,부산 KCC,Away,이호현,0,0,3,0.0,0,2,0.0,0,5,0.0,0,0,0.0,0,0,0,2,1,1,0,0,1,3
../kbl_data/2024-2025,S45G01N41,부산 KCC,Away,디온테 버튼,1,0,1,0.0,0,0,0.0,0,1,0.0,1,2,50.0,0,2,2,1,0,0,0,0,2,0
../kbl_data/2024-2025,S45G01N41,부산 KCC,Away,이근휘,2,1,1,100.0,0,5,0.0,1,6,16.7,0,0,0.0,1,1,2,0,0,0,0,0,0,2
../kbl_data/2024-2025,S45G01N41,부산 KCC,Away,송동훈,0,0,1,0.0,0,0,0.0,0,1,0.0,0,0,0.0,0,1,1,1,0,0,0,0,0,0
../kbl_data/2024-2025,S45G01N41,부산 KCC,Away,여준형,2,1,1,100.0,0,0,0.0,1,1,100.0,0,0,0.0,0,0,0,1,0,0,0,0,0,0
../kbl_data/2024-2025,S45G01N41,부산 KCC,Away,캘빈 제프리 에피스톨라,0,0,0,0.0,0,1,0.0,0,1,0.0,0,0,0.0,0,1,1,3,1,0,0,0,1,2
../kbl_data/2024-2025,S45G01N41,부산 KCC,Away,이주영,0,0,0,0.0,0,0,0.0,0,0,0.0,0,0,0.0,0,0,0,1,0,0,0,0,1,0
../kbl_data/2024-2025,S45G01N42,안양 정관장,Home,송창용,2,1,3,33.3,0,0,0.0,1,3,33.3,0,0,0.0,0,2,2,2,1,0,0,0,0,1
../kbl_data/2024-2025,S45G01N42,안양 정관장,Home,정준원,5,1,2,50.0,1,3,33.3,2,5,40.0,0,0,0.0,0,1,1,0,0,0,0,0,0,1
../kbl_data/2024-2025,S45G01N42,안양 정관장,Home,이원대,0,0,1,0.0,0,0,0.0,0,1,0.0,0,0,0.0,0,0,0,1,1,0,0,0,0,1
../kbl_data/2024-2025,S45G01N42,안양 정관장,Home,배병준,17,3,3,100.0,3,4,75.0,6,7,85.7,2,2,100.0,0,3,3,5,1,0,0,0,0,0
../kbl_data/2024-2025,S45G01N42,안양 정관장,Home,정효근,10,4,6,66.7,0,0,0.0,4,6,66.7,2,2,100.0,0,5,5,1,1,1,0,0,1,4
../kbl_data/2024-2025,S45G01N42,안양 정관장,Home,이종현,10,2,2,100.0,2,2,100.0,4,4,100.0,0,0,0.0,1,2,3,3,1,0,0,0,0,2
../kbl_data/2024-2025,S45G01N42,안양 정관장,Home,박지훈,13,4,5,80.0,1,1,100.0,5,6,83.3,2,2,100.0,0,4,4,4,1,0,0,0,0,3
../kbl_data/2024-2025,S45G01N42,안양 정관장,Home,최성원,0,0,1,0.0,0,1,0.0,0,2,0.0,0,0,0.0,0,0,0,1,0,0,0,0,1,0
../kbl_data/2024-2025,S45G01N42,안양 정관장,Home,캐디 라렌,19,8,15,53.3,1,2,50.0,9,17,52.9,0,2,0.0,2,9,11,3,0,1,0,0,1,1
../kbl_data/2024-2025,S45G01N42,안양 정관장,Home,김경원,4,1,4,25.0,0,0,0.0,1,4,25.0,2,2,100.0,2,4,6,2,0,0,0,0,1,4
../kbl_data/2024-2025,S45G01N42,안양 정관장,Home,하비 고메즈,14,3,3,100.0,2,2,100.0,5,5,100.0,2,2,100.0,0,1,1,2,3,0,0,0,1,0
../kbl_data/2024-2025,S45G01N42,안양 정관장,Home,마이클 영 Jr,8,1,3,33.3,0,2,0.0,1,5,20.0,6,6,100.0,1,0,1,1,0,1,0,0,0,3
../kbl_data/2024-2025,S45G01N42,서울 삼성,Away,이정현,8,0,1,0.0,2,5,40.0,2,6,33.3,2,2,100.0,0,1,1,5,1,0,1,0,4,2
../kbl_data/2024-2025,S45G01N42,서울 삼성,Away,최현민,0,0,1,0.0,0,3,0.0,0,4,0.0,0,0,0.0,0,2,2,0,0,0,0,0,0,1
../kbl_data/2024-2025,S45G01N42,서울 삼성,Away,최성모,9,0,2,0.0,3,6,50.0,3,8,37.5,0,0,0.0,0,2,2,2,1,0,0,0,0,2
../kbl_data/2024-2025,S45G01N42,서울 삼성,Away,최승욱,2,1,2,50.0,0,3,0.0,1,5,20.0,0,0,0.0,0,0,0,0,0,0,0,0,0,2
../kbl_data/2024-2025,S45G01N42,서울 삼성,Away,김진용,0,0,1,0.0,0,0,0.0,0,1,0.0,0,0,0.0,0,0,0,1,0,0,0,0,0,0
../kbl_data/2024-2025,S45G01N42,서울 삼성,Away,마커스 데릭슨,2,1,3,33.3,0,3,0.0,1,6,16.7,0,0,0.0,2,1,3,0,0,0,0,0,0,3
../kbl_data/2024-2025,S45G01N42,서울 삼성,Away,차민석,2,1,5,20.0,0,2,0.0,1,7,14.3,0,0,0.0,1,1,2,2,0,0,0,0,1,4
../kbl_data/2024-2025,S45G01N42,서울 삼성,Away,이원석,4,1,2,50.0,0,3,0.0,1,5,20.0,2,2,100.0,2,2,4,0,0,1,0,0,0,4
../kbl_data/2024-2025,S45G01N42,서울 삼성,Away,저스틴 구탕,4,2,2,100.0,0,2,0.0,2,4,50.0,0,0,0.0,2,3,5,2,0,0,0,0,4,1
../kbl_data/2024-2025,S45G01N42,서울 삼성,Away,조준희,2,1,1,100.0,0,1,0.0,1,2,50.0,0,0,0.0,0,1,1,0,0,0,0,0,0,1
../kbl_data/2024-2025,S45G01N42,서울 삼성,Away,박승재,2,1,3,33.3,0,3,0.0,1,6,16.7,0,0,0.0,1,1,2,1,0,0,0,0,2,0
../kbl_data/2024-2025,S45G01N42,서울 삼성,Away,코피 코번,24,9,12,75.0,0,0,0.0,9,12,75.0,6,9,66.7,4,7,11,4,0,2,0,0,2,1
../kbl_data/2024-2025,S45G01N43,원주 DB,Home,김시래,3,1,1,100.0,0,0,0.0,1,1,100.0,1,2,50.0,0,0,0,0,0,0,0,0,1,1
../kbl_data/2024-2025,S45G01N43,원주 DB,Home,서민수,0,0,0,0.0,0,0,0.0,0,0,0.0,0,0,0.0,1,2,3,0,0,0,0,0,0,0
../kbl_data/2024-2025,S45G01N43,원주 DB,Home,김영현,3,0,0,0.0,1,5,20.0,1,5,20.0,0,0,0.0,3,4,7,0,0,0,0,0,0,4
../kbl_data/2024-2025,S45G01N43,원주 DB,Home,박봉진,0,0,1,0.0,0,1,0.0,0,2,0.0,0,0,0.0,2,0,2,3,0,0,1,0,1,3
../kbl_data/2024-2025,S45G01N43,원주 DB,Home,강상재,15,2,5,40.0,3,3,100.0,5,8,62.5,2,3,66.7,4,12,16,1,0,2,0,0,1,2
../kbl_data/2024-2025,S45G01N43,원주 DB,Home,유현준,0,0,1,0.0,0,0,0.0,0,1,0.0,0,0,0.0,0,1,1,0,1,0,0,0,0,1
../kbl_data/2024-2025,S45G01N43,원주 DB,Home,치나누 오누아쿠,29,11,16,68.8,1,4,25.0,12,20,60.0,4,8,50.0,2,6,8,6,1,3,0,0,6,2
../kbl_data/2024-2025,S45G01N43,원주 DB,Home,김훈,0,0,0,0.0,0,1,0.0,0,1,0.0,0,0,0.0,1,2,3,0,0,0,0,0,1,2
../kbl_data/2024-2025,S45G01N43,원주 DB,Home,이용우,0,0,0,0.0,0,0,0.0,0,0,0.0,0,0,0.0,0,1,1,0,0,0,0,0,0,0
../kbl_data/2024-2025,S45G01N43,원주 DB,Home,이선 알바노,11,3,9,33.3,1,6,16.7,4,15,26.7,2,2,100.0,1,0,1,7,2,0,1,0,1,2
../kbl_data/2024-2025,S45G01N43,원주 DB,Home,박인웅,8,1,2,50.0,2,5,40.0,3,7,42.9,0,0,0.0,0,2,2,1,0,0,0,0,1,5
../kbl_data/2024-2025,S45G01N43,원주 DB,Home,로버트 카터,4,0,2,0.0,0,0,0.0,0,2,0.0,4,4,100.0,1,1,2,0,0,0,0,0,0,0
../kbl_data/2024-2025,S45G01N43,창원 LG,Away,허일영,0,0,2,0.0,0,1,0.0,0,3,0.0,0,0,0.0,1,0,1,0,2,0,0,0,2,1
../kbl_data/2024-2025,S45G01N43,창원 LG,Away,최진수,2,1,3,33.3,0,1,0.0,1,4,25.0,0,0,0.0,1,0,1,0,0,0,0,0,0,2
../kbl_data/2024-2025,S45G01N43,창원 LG,Away,장민국,2,1,2,50.0,0,1,0.0,1,3,33.3,0,0,0.0,0,1,1,0,1,0,0,0,0,1
../kbl_data/2024-2025,S45G01N43,창원 LG,Away,두경민,0,0,1,0.0,0,4,0.0,0,5,0.0,0,0,0.0,0,0,0,4,0,0,0,0,2,4
../kbl_data/2024-2025,S45G01N43,창원 LG,Away,전성현,9,1,2,50.0,2,6,33.3,3,8,37.5,1,1,100.0,0,2,2,2,0,0,1,0,0,1
../kbl_data/2024-2025,S45G01N43,창원 LG,Away,정인덕,5,0,0,0.0,1,3,33.3,1,3,33.3,2,2,100.0,0,3,3,0,0,0,0,0,1,0
../kbl_data/2024-2025,S45G01N43,창원 LG,Away,대릴 먼로,5,1,7,14.3,1,2,50.0,2,9,22.2,0,0,0.0,1,6,7,2,1,0,0,0,1,3
../kbl_data/2024-2025,S45G01N43,창원 LG,Away,장태빈,0,0,0,0.0,0,0,0.0,0,0,0.0,0,0,0.0,0,0,0,0,0,0,0,0,0,0
../kbl_data/2024-2025,S45G01N43,창원 LG,Away,박정현,7,1,3,33.3,1,3,33.3,2,6,33.3,2,4,50.0,1,3,4,1,0,0,0,0,1,5
../kbl_data/2024-2025,S45G01N43,창원 LG,Away,양준석,11,3,6,50.0,1,3,33.3,4,9,44.4,2,2,100.0,0,2,2,4,1,0,0,0,0,2
../kbl_data/2024-2025,S45G01N43,창원 LG,Away,유기상,8,1,1,100.0,2,4,50.0,3,5,60.0,0,2,0.0,0,0,0,0,1,1,1,0,1,2
../kbl_data/2024-2025,S45G01N43,창원 LG,Away,칼 타마요,2,1,4,25.0,0,2,0.0,1,6,16.7,0,0,0.0,1,5,6,0,1,0,0,0,1,4
../kbl_data/2024-2025,S45G01N44,대구 한국가스공사,Home,김동량,0,0,0,0.0,0,0,0.0,0,0,0.0,0,0,0.0,0,0,0,0,0,0,0,0,0,0
../kbl_data/2024-2025,S45G01N44,대구 한국가스공사,Home,박지훈,0,0,0,0.0,0,1,0.0,0,1,0.0,0,0,0.0,0,1,1,0,0,0,0,0,0,0
../kbl_data/2024-2025,S45G01N44,대구 한국가스공사,Home,이대헌,2,1,1,100.0,0,1,0.0,1,2,50.0,0,0,0.0,3,0,3,2,0,0,0,0,1,1
../kbl_data/2024-2025,S45G01N44,대구 한국가스공사,Home,정성우,9,4,4,100.0,0,2,0.0,4,6,66.7,1,2,50.0,2,0,2,3,1,0,0,0,1,1
../kbl_data/2024-2025,S45G01N44,대구 한국가스공사,Home,김낙현,4,2,2,100.0,0,5,0.0,2,7,28.6,0,0,0.0,0,1,1,1,1,1,0,0,0,1
../kbl_data/2024-2025,S45G01N44,대구 한국가스공사,Home,양재혁,0,0,0,0.0,0,0,0.0,0,0,0.0,0,0,0.0,0,0,0,0,0,0,0,0,0,0
../kbl_data/2024-2025,S45G01N44,대구 한국가스공사,Home,곽정훈,2,0,0,0.0,0,0,0.0,0,0,0.0,2,2,100.0,0,1,1,0,0,0,0,0,0,1
../kbl_data/2024-2025,S45G01N44,대구 한국가스공사,Home,앤드류 니콜슨,21,3,10,30.0,4,8,50.0,7,18,38.9,3,5,60.0,2,4,6,0,1,1,0,1,4,2
../kbl_data/2024-2025,S45G01N44,대구 한국가스공사,Home,신승민,8,1,3,33.3,2,4,50.0,3,7,42.9,0,0,0.0,0,1,1,0,1,0,1,0,2,2
../kbl_data/2024-2025,S45G01N44,대구 한국가스공사,Home,샘조세프 벨란겔,12,5,12,41.7,0,4,0.0,5,16,31.2,2,2,100.0,2,4,6,5,0,0,0,0,2,4
../kbl_data/2024-2025,S45G01N44,대구 한국가스공사,Home,유슈 은도예,6,3,3,100.0,0,1,0.0,3,4,75.0,0,0,0.0,1,4,5,0,0,1,1,2,1,5
../kbl_data/2024-2025,S45G01N44,대구 한국가스공사,Home,신주영,0,0,1,0.0,0,1,0.0,0,2,0.0,0,0,0.0,2,5,7,1,0,0,0,0,0,2
../kbl_data/2024-2025,S45G01N44,울산 현대모비스,Away,함지훈,6,1,1,100.0,1,1,100.0,2,2,100.0,1,4,25.0,1,2,3,7,0,0,0,0,1,2
../kbl_data/2024-2025,S45G01N44,울산 현대모비스,Away,장재석,4,2,3,66.7,0,0,0.0,2,3,66.7,0,0,0.0,2,4,6,2,0,2,0,0,2,2
../kbl_data/2024-2025,S45G01N44,울산 현대모비스,Away,김지완,0,0,0,0.0,0,0,0.0,0,0,0.0,0,0,0.0,0,0,0,0,0,0,0,0,0,0
../kbl_data/2024-2025,S45G01N44,울산 현대모비스,Away,한호빈,0,0,0,0.0,0,0,0.0,0,0,0.0,0,0,0.0,1,1,2,1,0,0,0,0,0,0
../kbl_data/2024-2025,S45G01N44,울산 현대모비스,Away,서명진,2,1,2,50.0,0,3,0.0,1,5,20.0,0,0,0.0,0,1,1,0,1,0,0,0,1,4
../kbl_data/2024-2025,S45G01N44,울산 현대모비스,Away,숀 롱,11,5,9,55.6,0,0,0.0,5,9,55.6,1,3,33.3,4,1,5,0,1,0,0,2,1,3
../kbl_data/2024-2025,S45G01N44,울산 현대모비스,Away,이우석,10,2,7,28.6,2,4,50.0,4,11,36.4,0,0,0.0,1,5,6,2,0,1,0,0,2,1
../kbl_data/2024-2025,S45G01N44,울산 현대모비스,Away,이승우,0,0,0,0.0,0,0,0.0,0,0,0.0,0,0,0.0,0,0,0,0,0,0,0,0,0,0
../kbl_data/2024-2025,S45G01N44,울산 현대모비스,Away,신민석,0,0,1,0.0,0,0,0.0,0,1,0.0,0,0,0.0,0,0,0,0,0,0,0,0,0,0
../kbl_data/2024-2025,S45G01N44,울산 현대모비스,Away,게이지 프림,23,11,18,61.1,0,0,0.0,11,18,61.1,1,1,100.0,2,3,5,2,2,0,1,1,0,1
../kbl_data/2024-2025,S45G01N44,울산 현대모비스,Away,박무빈,6,1,4,25.0,1,2,50.0,2,6,33.3,1,2,50.0,0,3,3,3,1,0,0,0,1,5
../kbl_data/2024-2025,S45G01N44,울산 현대모비스,Away,미구엘 안드레 옥존,5,1,3,33.3,0,3,0.0,1,6,16.7,3,4,75.0,1,0,1,2,3,1,0,0,3,1
../kbl_data/2024-2025,S45G01N45,서울 SK,Home,김선형,16,5,5,100.0,2,5,40.0,7,10,70.0,0,0,0.0,0,0,0,3,0,1,0,0,0,2
../kbl_data/2024-2025,S45G01N45,서울 SK,Home,오세근,18,5,10,50.0,2,2,100.0,7,12,58.3,2,2,100.0,0,6,6,2,0,0,0,0,1,2
../kbl_data/2024-2025,S45G01N45,서울 SK,Home,최부경,7,3,4,75.0,0,0,0.0,3,4,75.0,1,1,100.0,1,3,4,0,0,0,0,0,0,2
../kbl_data/2024-2025,S45G01N45,서울 SK,Home,최원혁,3,0,0,0.0,1,1,100.0,1,1,100.0,0,0,0.0,1,1,2,3,1,0,0,0,0,3
../kbl_data/2024-2025,S45G01N45,서울 SK,Home,장문호,3,0,0,0.0,1,1,100.0,1,1,100.0,0,0,0.0,0,0,0,0,0,0,0,0,0,0
../kbl_data/2024-2025,S45G01N45,서울 SK,Home,안영준,12,5,7,71.4,0,2,0.0,5,9,55.6,2,4,50.0,1,4,5,3,1,0,1,0,1,2
../kbl_data/2024-2025,S45G01N45,서울 SK,Home,자밀 워니,11,4,8,50.0,1,2,50.0,5,10,50.0,0,0,0.0,2,12,14,13,1,1,0,0,4,0
../kbl_data/2024-2025,S45G01N45,서울 SK,Home,김형빈,0,0,0,0.0,0,0,0.0,0,0,0.0,0,0,0.0,0,0,0,0,0,0,0,0,1,0
../kbl_data/2024-2025,S45G01N45,서울 SK,Home,박민우,0,0,0,0.0,0,1,0.0,0,1,0.0,0,0,0.0,0,1,1,0,0,0,0,0,0,0
../kbl_data/2024-2025,S45G01N45,서울 SK,Home,오재현,15,3,7,42.9,3,7,42.9,6,14,42.9,0,0,0.0,0,1,1,3,1,0,0,0,1,2
../kbl_data/2024-2025,S45G01N45,서울 SK,Home,선상혁,2,1,1,100.0,0,0,0.0,1,1,100.0,0,0,0.0,0,1,1,0,0,0,0,0,0,0
../kbl_data/2024-2025,S45G01N45,서울 SK,Home,고메즈 델 리아노,4,2,2,100.0,0,0,0.0,2,2,100.0,0,0,0.0,0,0,0,1,1,0,0,0,0,1
../kbl_data/2024-2025,S45G01N45,고양 소노,Away,정희재,6,0,0,0.0,2,8,25.0,2,8,25.0,0,0,0.0,1,1,2,2,0,1,0,0,0,4
../kbl_data/2024-2025,S45G01N45,고양 소노,Away,임동섭,14,0,0,0.0,4,11,36.4,4,11,36.4,2,6,33.3,0,4,4,0,2,1,0,0,2,1
../kbl_data/2024-2025,S45G01N45,고양 소노,Away,김민욱,3,0,1,0.0,1,5,20.0,1,6,16.7,0,0,0.0,0,1,1,0,0,0,0,0,0,2
../kbl_data/2024-2025,S45G01N45,고양 소노,Away,이재도,18,3,7,42.9,3,12,25.0,6,19,31.6,3,3,100.0,0,2,2,4,1,0,0,0,2,0
../kbl_data/2024-2025,S45G01N45,고양 소노,Away,최승욱,4,2,2,100.0,0,2,0.0,2,4,50.0,0,0,0.0,5,0,5,3,1,0,0,0,0,1
../kbl_data/2024-2025,S45G01N45,고양 소노,Away,김진유,2,1,2,50.0,0,1,0.0,1,3,33.3,0,0,0.0,0,1,1,0,0,0,0,0,2,1
../kbl_data/2024-2025,S45G01N45,고양 소노,Away,조은후,0,0,0,0.0,0,0,0.0,0,0,0.0,0,0,0.0,0,0,0,2,1,0,0,0,1,0
../kbl_data/2024-2025,S45G01N45,고양 소노,Away,유진,0,0,0,0.0,0,0,0.0,0,0,0.0,0,0,0.0,0,0,0,0,0,0,0,0,0,0
../kbl_data/2024-2025,S45G01N45,고양 소노,Away,백지웅,0,0,0,0.0,0,0,0.0,0,0,0.0,0,0,0.0,0,0,0,0,0,0,0,0,0,1
../kbl_data/2024-2025,S45G01N45,고양 소노,Away,박종하,3,0,0,0.0,1,3,33.3,1,3,33.3,0,0,0.0,0,0,0,0,1,0,0,0,0,0
../kbl_data/2024-2025,S45G01N45,고양 소노,Away,앨런 윌리엄스,19,8,19,42.1,0,0,0.0,8,19,42.1,3,3,100.0,9,10,19,11,0,1,0,0,2,3
../kbl_data/2024-2025,S45G01N45,고양 소노,Away,디제이 번즈 Jr,2,1,3,33.3,0,0,0.0,1,3,33.3,0,0,0.0,0,0,0,0,0,0,0,0,0,0
../kbl_data/2024-2025,S45G01N46,수원 KT,Home,한희원,9,3,6,50.0,1,3,33.3,4,9,44.4,0,1,0.0,6,1,7,3,0,0,0,0,0,3
../kbl_data/2024-2025,S45G01N46,수원 KT,Home,최창진,0,0,0,0.0,0,0,0.0,0,0,0.0,0,0,0.0,0,0,0,1,0,0,0,0,1,2
../kbl_data/2024-2025,S45G01N46,수원 KT,Home,문성곤,5,1,3,33.3,1,8,12.5,2,11,18.2,0,0,0.0,2,4,6,2,2,0,1,0,1,3
../kbl_data/2024-2025,S45G01N46,수원 KT,Home,이현석,0,0,0,0.0,0,1,0.0,0,1,0.0,0,0,0.0,1,1,2,2,2,0,0,0,1,0
../kbl_data/2024-2025,S45G01N46,수원 KT,Home,허훈,18,4,7,57.1,3,7,42.9,7,14,50.0,1,2,50.0,0,0,0,11,0,1,0,0,4,2
../kbl_data/2024-2025,S45G01N46,수원 KT,Home,박준영,20,6,9,66.7,2,3,66.7,8,12,66.7,2,3,66.7,2,6,8,1,2,0,0,0,0,3
../kbl_data/2024-2025,S45G01N46,수원 KT,Home,최진광,0,0,0,0.0,0,0,0.0,0,0,0.0,0,0,0.0,0,0,0,0,0,0,0,0,0,0
../kbl_data/2024-2025,S45G01N46,수원 KT,Home,이호준,0,0,1,0.0,0,0,0.0,0,1,0.0,0,0,0.0,0,0,0,0,0,0,0,0,0,0
../kbl_data/2024-2025,S45G01N46,수원 KT,Home,이두원,0,0,0,0.0,0,0,0.0,0,0,0.0,0,0,0.0,0,3,3,0,0,0,0,0,0,1
../kbl_data/2024-2025,S45G01N46,수원 KT,Home,고찬혁,0,0,0,0.0,0,0,0.0,0,0,0.0,0,0,0.0,0,0,0,0,0,0,0,0,0,0
../kbl_data/2024-2025,S45G01N46,수원 KT,Home,제레미아 틸먼,5,2,5,40.0,0,0,0.0,2,5,40.0,1,2,50.0,0,8,8,1,0,0,0,0,3,0
../kbl_data/2024-2025,S45G01N46,수원 KT,Home,레이션 해먼즈,12,4,12,33.3,1,3,33.3,5,15,33.3,1,2,50.0,3,5,8,1,1,0,0,0,2,2
../kbl_data/2024-2025,S45G01N46,안양 정관장,Away,송창용,2,0,0,0.0,0,0,0.0,0,0,0.0,2,2,100.0,0,1,1,0,0,0,0,0,2,2
../kbl_data/2024-2025,S45G01N46,안양 정관장,Away,정준원,0,0,1,0.0,0,0,0.0,0,1,0.0,0,0,0.0,1,1,2,0,0,0,0,0,0,0
../kbl_data/2024-2025,S45G01N46,안양 정관장,Away,이원대,0,0,0,0.0,0,3,0.0,0,3,0.0,0,0,0.0,0,1,1,0,0,0,0,0,2,2
../kbl_data/2024-2025,S45G01N46,안양 정관장,Away,배병준,9,1,2,50.0,1,2,50.0,2,4,50.0,4,5,80.0,0,0,0,4,3,1,0,0,1,2
../kbl_data/2024-2025,S45G01N46,안양 정관장,Away,정효근,6,2,6,33.3,0,2,0.0,2,8,25.0,2,2,100.0,1,4,5,1,1,1,0,0,3,2
../kbl_data/2024-2025,S45G01N46,안양 정관장,Away,이종현,1,0,2,0.0,0,1,0.0,0,3,0.0,1,2,50.0,1,5,6,2,0,1,0,0,2,1
../kbl_data/2024-2025,S45G01N46,안양 정관장,Away,박지훈,9,1,3,33.3,2,7,28.6,3,10,30.0,1,2,50.0,0,3,3,5,1,0,0,0,0,2
../kbl_data/2024-2025,S45G01N46,안양 정관장,Away,최성원,0,0,2,0.0,0,3,0.0,0,5,0.0,0,0,0.0,0,0,0,0,1,0,0,0,0,1
../kbl_data/2024-2025,S45G01N46,안양 정관장,Away,캐디 라렌,13,5,6,83.3,1,2,50.0,6,8,75.0,0,0,0.0,3,3,6,1,1,0,0,2,2,0
../kbl_data/2024-2025,S45G01N46,안양 정관장,Away,김경원,0,0,0,0.0,0,1,0.0,0,1,0.0,0,0,0.0,0,0,0,0,0,1,0,0,0,1
../kbl_data/2024-2025,S45G01N46,안양 정관장,Away,하비 고메즈,2,1,1,100.0,0,2,0.0,1,3,33.3,0,0,0.0,0,1,1,1,0,0,0,0,0,2
../kbl_data/2024-2025,S45G01N46,안양 정관장,Away,마이클 영 Jr,16,7,9,77.8,0,1,0.0,7,10,70.0,2,3,66.7,1,3,4,0,0,0,0,0,1,1
../kbl_data/2024-2025,S45G01N47,원주 DB,Home,김시래,2,1,2,50.0,0,1,0.0,1,3,33.3,0,0,0.0,0,3,3,4,1,0,0,0,2,2
../kbl_data/2024-2025,S45G01N47,원주 DB,Home,서민수,5,1,1,100.0,1,1,100.0,2,2,100.0,0,0,0.0,0,3,3,0,0,1,0,0,0,2
../kbl_data/2024-2025,S45G01N47,원주 DB,Home,김영현,9,0,1,0.0,3,3,100.0,3,4,75.0,0,0,0.0,1,1,2,1,0,0,0,0,0,2
../kbl_data/2024-2025,S45G01N47,원주 DB,Home,박봉진,3,0,0,0.0,1,2,50.0,1,2,50.0,0,0,0.0,2,2,4,2,0,0,0,0,0,3
../kbl_data/2024-2025,S45G01N47,원주 DB,Home,강상재,7,2,2,100.0,1,6,16.7,3,8,37.5,0,0,0.0,1,3,4,3,0,0,0,0,2,2
../kbl_data/2024-2025,S45G01N47,원주 DB,Home,치나누 오누아쿠,22,8,16,50.0,1,4,25.0,9,20,45.0,3,3,100.0,2,9,11,2,2,0,0,1,2,4
../kbl_data/2024-2025,S45G01N47,원주 DB,Home,김훈,0,0,0,0.0,0,0,0.0,0,0,0.0,0,0,0.0,0,0,0,0,0,0,0,0,0,0
../kbl_data/2024-2025,S45G01N47,원주 DB,Home,이윤수,0,0,0,0.0,0,0,0.0,0,0,0.0,0,0,0.0,0,0,0,0,0,0,0,0,0,0
../kbl_data/2024-2025,S45G01N47,원주 DB,Home,이용우,2,1,2,50.0,0,3,0.0,1,5,20.0,0,0,0.0,0,0,0,1,2,0,0,0,0,2
../kbl_data/2024-2025,S45G01N47,원주 DB,Home,이선 알바노,18,6,13,46.2,2,8,25.0,8,21,38.1,0,2,0.0,1,1,2,4,2,1,0,0,2,3
../kbl_data/2024-2025,S45G01N47,원주 DB,Home,박인웅,0,0,1,0.0,0,1,0.0,0,2,0.0,0,0,0.0,1,1,2,1,0,0,0,0,0,0
../kbl_data/2024-2025,S45G01N47,원주 DB,Home,로버트 카터,12,4,5,80.0,1,3,33.3,5,8,62.5,1,1,100.0,1,3,4,1,0,0,0,0,0,1
../kbl_data/2024-2025,S45G01N47,서울 SK,Away,김선형,12,2,8,25.0,1,3,33.3,3,11,27.3,5,6,83.3,3,2,5,8,0,0,0,0,1,2
../kbl_data/2024-2025,S45G01N47,서울 SK,Away,오세근,2,1,7,14.3,0,0,0.0,1,7,14.3,0,0,0.0,1,1,2,0,0,0,0,0,0,0
../kbl_data/2024-2025,S45G01N47,서울 SK,Away,최부경,4,1,2,50.0,0,0,0.0,1,2,50.0,2,2,100.0,0,0,0,1,0,1,0,0,0,5
../kbl_data/2024-2025,S45G01N47,서울 SK,Away,최원혁,0,0,0,0.0,0,0,0.0,0,0,0.0,0,0,0.0,0,1,1,0,0,0,0,0,0,1
../kbl_data/2024-2025,S45G01N47,서울 SK,Away,장문호,2,1,1,100.0,0,1,0.0,1,2,50.0,0,0,0.0,1,1,2,0,0,0,0,0,0,1
../kbl_data/2024-2025,S45G01N47,서울 SK,Away,안영준,19,1,3,33.3,5,8,62.5,6,11,54.5,2,2,100.0,0,11,11,1,1,1,0,0,1,1
../kbl_data/2024-2025,S45G01N47,서울 SK,Away,자밀 워니,42,12,18,66.7,4,12,33.3,16,30,53.3,6,7,85.7,2,10,12,3,1,2,0,2,5,2
../kbl_data/2024-2025,S45G01N47,서울 SK,Away,김형빈,0,0,1,0.0,0,0,0.0,0,1,0.0,0,0,0.0,0,0,0,0,0,0,0,0,2,1
../kbl_data/2024-2025,S45G01N47,서울 SK,Away,박민우,0,0,0,0.0,0,0,0.0,0,0,0.0,0,0,0.0,0,0,0,0,0,0,0,0,0,0
../kbl_data/2024-2025,S45G01N47,서울 SK,Away,오재현,7,1,2,50.0,1,2,50.0,2,4,50.0,2,2,100.0,0,1,1,5,0,0,0,0,1,3
../kbl_data/2024-2025,S45G01N47,서울 SK,Away,선상혁,0,0,0,0.0,0,0,0.0,0,0,0.0,0,0,0.0,0,0,0,0,0,0,0,0,0,0
../kbl_data/2024-2025,S45G01N47,서울 SK,Away,고메즈 델 리아노,0,0,0,0.0,0,0,0.0,0,0,0.0,0,0,0.0,0,0,0,1,0,0,0,0,1,0
../kbl_data/2024-2025,S45G01N48,고양 소노,Home,함준후,0,0,0,0.0,0,0,0.0,0,0,0.0,0,0,0.0,0,0,0,0,0,0,0,0,0,1
../kbl_data/2024-2025,S45G01N48,고양 소노,Home,정희재,12,3,4,75.0,1,3,33.3,4,7,57.1,3,5,60.0,1,2,3,1,0,0,1,0,0,4
../kbl_data/2024-2025,S45G01N48,고양 소노,Home,임동섭,9,1,1,100.0,2,8,25.0,3,9,33.3,1,2,50.0,3,1,4,1,2,0,0,0,0,4
../kbl_data/2024-2025,S45G01N48,고양 소노,Home,이재도,19,3,8,37.5,4,13,30.8,7,21,33.3,1,2,50.0,0,7,7,6,1,0,0,0,4,3
../kbl_data/2024-2025,S45G01N48,고양 소노,Home,김영훈,0,0,0,0.0,0,0,0.0,0,0,0.0,0,0,0.0,0,0,0,0,0,0,0,0,1,0
../kbl_data/2024-2025,S45G01N48,고양 소노,Home,최승욱,2,1,1,100.0,0,2,0.0,1,3,33.3,0,0,0.0,2,0,2,1,2,0,0,0,0,3
../kbl_data/2024-2025,S45G01N48,고양 소노,Home,김진유,7,2,3,66.7,1,5,20.0,3,8,37.5,0,0,0.0,4,3,7,0,3,0,0,0,1,2
../kbl_data/2024-2025,S45G01N48,고양 소노,Home,조은후,0,0,0,0.0,0,0,0.0,0,0,0.0,0,2,0.0,0,0,0,1,0,0,0,0,0,1
../kbl_data/2024-2025,S45G01N48,고양 소노,Home,백지웅,0,0,0,0.0,0,0,0.0,0,0,0.0,0,0,0.0,0,0,0,0,0,0,0,0,0,0
../kbl_data/2024-2025,S45G01N48,고양 소노,Home,박종하,0,0,0,0.0,0,0,0.0,0,0,0.0,0,0,0.0,0,0,0,0,0,0,0,0,0,0
../kbl_data/2024-2025,S45G01N48,고양 소노,Home,앨런 윌리엄스,25,11,21,52.4,0,1,0.0,11,22,50.0,3,8,37.5,3,9,12,4,1,2,0,0,5,2
../kbl_data/2024-2025,S45G01N48,고양 소노,Home,디제이 번즈 Jr,4,2,3,66.7,0,0,0.0,2,3,66.7,0,0,0.0,0,2,2,1,1,0,0,0,1,4
../kbl_data/2024-2025,S45G01N48,울산 현대모비스,Away,장재석,8,4,5,80.0,0,0,0.0,4,5,80.0,0,0,0.0,2,3,5,3,1,1,0,0,1,3
../kbl_data/2024-2025,S45G01N48,울산 현대모비스,Away,김지완,0,0,0,0.0,0,0,0.0,0,0,0.0,0,0,0.0,0,0,0,0,0,0,0,0,0,0
../kbl_data/2024-2025,S45G01N48,울산 현대모비스,Away,한호빈,3,0,0,0.0,1,1,100.0,1,1,100.0,0,2,0.0,0,3,3,1,0,0,0,0,1,3
../kbl_data/2024-2025,S45G01N48,울산 현대모비스,Away,김준일,13,4,5,80.0,0,0,0.0,4,5,80.0,5,9,55.6,0,5,5,1,1,1,0,0,3,3
../kbl_data/2024-2025,S45G01N48,울산 현대모비스,Away,서명진,9,3,3,100.0,1,8,12.5,4,11,36.4,0,0,0.0,1,2,3,3,3,0,1,0,0,3
../kbl_data/2024-2025,S45G01N48,울산 현대모비스,Away,숀 롱,7,3,4,75.0,0,0,0.0,3,4,75.0,1,1,100.0,3,2,5,0,0,0,0,1,0,5
../kbl_data/2024-2025,S45G01N48,울산 현대모비스,Away,이우석,13,2,6,33.3,3,7,42.9,5,13,38.5,0,0,0.0,2,3,5,3,0,0,0,0,1,1
../kbl_data/2024-2025,S45G01N48,울산 현대모비스,Away,이승우,0,0,0,0.0,0,0,0.0,0,0,0.0,0,0,0.0,0,0,0,0,0,0,0,0,0,0
../kbl_data/2024-2025,S45G01N48,울산 현대모비스,Away,신민석,0,0,0,0.0,0,0,0.0,0,0,0.0,0,0,0.0,0,0,0,0,0,0,0,0,0,0
../kbl_data/2024-2025,S45G01N48,울산 현대모비스,Away,게이지 프림,19,6,11,54.5,1,3,33.3,7,14,50.0,4,6,66.7,1,7,8,6,2,0,0,1,3,1
../kbl_data/2024-2025,S45G01N48,울산 현대모비스,Away,박무빈,8,2,8,25.0,1,5,20.0,3,13,23.1,1,2,50.0,0,2,2,1,0,0,0,0,3,2
../kbl_data/2024-2025,S45G01N48,울산 현대모비스,Away,미구엘 안드레 옥존,0,0,1,0.0,0,3,0.0,0,4,0.0,0,0,0.0,0,1,1,2,0,0,0,0,1,1
../kbl_data/2024-2025,S45G01N49,대구 한국가스공사,Home,차바위,2,1,1,100.0,0,1,0.0,1,2,50.0,0,0,0.0,0,0,0,0,1,0,0,0,1,3
../kbl_data/2024-2025,S45G01N49,대구 한국가스공사,Home,박지훈,0,0,0,0.0,0,0,0.0,0,0,0.0,0,0,0.0,0,0,0,0,0,0,0,0,0,0
../kbl_data/2024-2025,S45G01N49,대구 한국가스공사,Home,이대헌,2,1,2,50.0,0,1,0.0,1,3,33.3,0,2,0.0,2,2,4,0,0,0,0,0,1,0
../kbl_data/2024-2025,S45G01N49,대구 한국가스공사,Home,정성우,5,1,2,50.0,1,3,33.3,2,5,40.0,0,0,0.0,1,1,2,8,3,0,1,0,1,4
../kbl_data/2024-2025,S45G01N49,대구 한국가스공사,Home,김낙현,13,2,3,66.7,3,5,60.0,5,8,62.5,0,0,0.0,0,2,2,1,0,0,0,0,1,1
../kbl_data/2024-2025,S45G01N49,대구 한국가스공사,Home,양재혁,0,0,0,0.0,0,0,0.0,0,0,0.0,0,0,0.0,1,1,2,0,0,0,0,0,2,0
../kbl_data/2024-2025,S45G01N49,대구 한국가스공사,Home,곽정훈,3,0,0,0.0,1,5,20.0,1,5,20.0,0,0,0.0,2,0,2,1,0,0,0,0,0,1
../kbl_data/2024-2025,S45G01N49,대구 한국가스공사,Home,앤드류 니콜슨,12,4,7,57.1,1,9,11.1,5,16,31.2,1,1,100.0,0,14,14,4,0,0,0,1,1,2
../kbl_data/2024-2025,S45G01N49,대구 한국가스공사,Home,신승민,6,0,3,0.0,2,6,33.3,2,9,22.2,0,0,0.0,2,0,2,0,1,0,0,0,1,2
../kbl_data/2024-2025,S45G01N49,대구 한국가스공사,Home,샘조세프 벨란겔,15,3,9,33.3,3,6,50.0,6,15,40.0,0,0,0.0,0,1,1,0,4,1,0,0,1,3
../kbl_data/2024-2025,S45G01N49,대구 한국가스공사,Home,유슈 은도예,6,2,4,50.0,0,0,0.0,2,4,50.0,2,4,50.0,2,2,4,0,1,0,0,1,1,2
../kbl_data/2024-2025,S45G01N49,대구 한국가스공사,Home,신주영,0,0,0,0.0,0,0,0.0,0,0,0.0,0,0,0.0,0,0,0,0,0,0,0,0,0,0
../kbl_data/2024-2025,S45G01N49,원주 DB,Away,김시래,2,1,1,100.0,0,2,0.0,1,3,33.3,0,0,0.0,0,0,0,1,0,0,0,0,1,1
../kbl_data/2024-2025,S45G01N49,원주 DB,Away,서민수,3,0,0,0.0,1,2,50.0,1,2,50.0,0,0,0.0,0,1,1,2,0,0,1,0,1,2
../kbl_data/2024-2025,S45G01N49,원주 DB,Away,김영현,0,0,0,0.0,0,3,0.0,0,3,0.0,0,0,0.0,1,0,1,0,0,0,0,0,1,0
../kbl_data/2024-2025,S45G01N49,원주 DB,Away,박봉진,0,0,0,0.0,0,1,0.0,0,1,0.0,0,0,0.0,0,3,3,1,1,0,0,0,0,1
../kbl_data/2024-2025,S45G01N49,원주 DB,Away,강상재,12,3,4,75.0,2,3,66.7,5,7,71.4,0,0,0.0,5,9,14,0,0,2,0,0,3,1
../kbl_data/2024-2025,S45G01N49,원주 DB,Away,치나누 오누아쿠,16,6,11,54.5,0,0,0.0,6,11,54.5,4,7,57.1,4,5,9,0,0,0,0,2,4,1
../kbl_data/2024-2025,S45G01N49,원주 DB,Away,김훈,0,0,0,0.0,0,0,0.0,0,0,0.0,0,0,0.0,0,0,0,0,0,0,0,0,0,0
../kbl_data/2024-2025,S45G01N49,원주 DB,Away,이용우,12,3,4,75.0,2,5,40.0,5,9,55.6,0,0,0.0,1,2,3,0,1,0,0,0,0,3
../kbl_data/2024-2025,S45G01N49,원주 DB,Away,이선 알바노,8,4,11,36.4,0,5,0.0,4,16,25.0,0,0,0.0,0,2,2,8,1,0,0,0,1,2
../kbl_data/2024-2025,S45G01N49,원주 DB,Away,박인웅,7,2,2,100.0,1,4,25.0,3,6,50.0,0,0,0.0,0,2,2,0,0,0,0,0,0,1
../kbl_data/2024-2025,S45G01N49,원주 DB,Away,최승빈,0,0,0,0.0,0,0,0.0,0,0,0.0,0,0,0.0,0,0,0,0,0,0,0,0,0,0
../kbl_data/2024-2025,S45G01N49,원주 DB,Away,로버트 카터,9,3,9,33.3,1,3,33.3,4,12,33.3,0,0,0.0,3,3,6,3,2,0,0,0,2,3
../kbl_data/2024-2025,S45G01N50,창원 LG,Home,허일영,5,2,4,50.0,0,2,0.0,2,6,33.3,1,2,50.0,4,0,4,0,1,0,0,0,0,3
../kbl_data/2024-2025,S45G01N50,창원 LG,Home,최진수,0,0,1,0.0,0,1,0.0,0,2,0.0,0,0,0.0,0,1,1,1,0,0,0,0,1,1
../kbl_data/2024-2025,S45G01N50,창원 LG,Home,장민국,0,0,0,0.0,0,1,0.0,0,1,0.0,0,0,0.0,1,1,2,0,0,1,1,0,0,1
../kbl_data/2024-2025,S45G01N50,창원 LG,Home,두경민,19,5,6,83.3,3,6,50.0,8,12,66.7,0,0,0.0,1,2,3,5,3,0,0,0,1,2
../kbl_data/2024-2025,S45G01N50,창원 LG,Home,전성현,5,0,0,0.0,1,5,20.0,1,5,20.0,2,4,50.0,0,0,0,0,0,0,0,0,0,0
../kbl_data/2024-2025,S45G01N50,창원 LG,Home,정인덕,7,2,2,100.0,1,4,25.0,3,6,50.0,0,0,0.0,0,2,2,0,0,0,0,0,0,2
../kbl_data/2024-2025,S45G01N50,창원 LG,Home,대릴 먼로,12,6,8,75.0,0,1,0.0,6,9,66.7,0,0,0.0,1,12,13,7,1,0,0,0,3,2
../kbl_data/2024-2025,S45G01N50,창원 LG,Home,박정현,0,0,1,0.0,0,0,0.0,0,1,0.0,0,0,0.0,0,2,2,0,0,0,0,0,1,1
../kbl_data/2024-2025,S45G01N50,창원 LG,Home,양준석,4,2,2,100.0,0,2,0.0,2,4,50.0,0,0,0.0,0,0,0,0,1,0,0,0,1,3
../kbl_data/2024-2025,S45G01N50,창원 LG,Home,유기상,9,1,2,50.0,2,5,40.0,3,7,42.9,1,2,50.0,1,4,5,1,0,0,0,0,0,1
../kbl_data/2024-2025,S45G01N50,창원 LG,Home,이경도,0,0,0,0.0,0,0,0.0,0,0,0.0,0,0,0.0,0,0,0,0,0,0,0,0,0,0
../kbl_data/2024-2025,S45G01N50,창원 LG,Home,칼 타마요,15,3,9,33.3,3,6,50.0,6,15,40.0,0,0,0.0,1,1,2,4,2,1,0,0,3,3
../kbl_data/2024-2025,S45G01N50,수원 KT,Away,한희원,6,0,2,0.0,2,5,40.0,2,7,28.6,0,0,0.0,0,1,1,0,2,0,0,0,0,4
../kbl_data/2024-2025,S45G01N50,수원 KT,Away,최창진,5,0,1,0.0,1,1,100.0,1,2,50.0,2,2,100.0,0,1,1,1,1,0,0,0,1,0
../kbl_data/2024-2025,S45G01N50,수원 KT,Away,문성곤,5,1,2,50.0,1,5,20.0,2,7,28.6,0,0,0.0,2,2,4,1,0,0,0,0,0,1
../kbl_data/2024-2025,S45G01N50,수원 KT,Away,이현석,2,1,1,100.0,0,1,0.0,1,2,50.0,0,0,0.0,1,3,4,1,2,0,0,0,0,4
../kbl_data/2024-2025,S45G01N50,수원 KT,Away,허훈,10,3,10,30.0,1,3,33.3,4,13,30.8,1,2,50.0,0,0,0,10,0,1,0,0,2,3
../kbl_data/2024-2025,S45G01N50,수원 KT,Away,박준영,15,3,8,37.5,1,3,33.3,4,11,36.4,6,6,100.0,5,5,10,2,2,1,0,0,4,4
../kbl_data/2024-2025,S45G01N50,수원 KT,Away,최진광,0,0,0,0.0,0,0,0.0,0,0,0.0,0,0,0.0,0,0,0,0,0,0,0,0,0,0
../kbl_data/2024-2025,S45G01N50,수원 KT,Away,이호준,0,0,0,0.0,0,0,0.0,0,0,0.0,0,0,0.0,0,0,0,0,0,0,0,0,0,0
../kbl_data/2024-2025,S45G01N50,수원 KT,Away,이두원,0,0,0,0.0,0,0,0.0,0,0,0.0,0,0,0.0,0,0,0,0,0,0,0,0,0,0
../kbl_data/2024-2025,S45G01N50,수원 KT,Away,고찬혁,0,0,0,0.0,0,0,0.0,0,0,0.0,0,0,0.0,0,0,0,0,0,0,0,0,0,0
../kbl_data/2024-2025,S45G01N50,수원 KT,Away,제레미아 틸먼,4,2,2,100.0,0,0,0.0,2,2,100.0,0,0,0.0,0,3,3,1,0,0,0,1,3,1
../kbl_data/2024-2025,S45G01N50,수원 KT,Away,레이션 해먼즈,31,9,15,60.0,3,7,42.9,12,22,54.5,4,6,66.7,4,12,16,1,2,1,0,0,1,1
../kbl_data/2024-2025,S45G01N51,부산 KCC,Home,정창영,2,1,2,50.0,0,0,0.0,1,2,50.0,0,0,0.0,0,0,0,0,0,0,0,0,0,2
../kbl_data/2024-2025,S45G01N51,부산 KCC,Home,리온 윌리엄스,9,4,7,57.1,0,0,0.0,4,7,57.1,1,1,100.0,2,2,4,2,1,0,0,0,0,2
../kbl_data/2024-2025,S45G01N51,부산 KCC,Home,전준범,0,0,0,0.0,0,0,0.0,0,0,0.0,0,0,0.0,0,0,0,0,0,0,0,0,0,0
../kbl_data/2024-2025,S45G01N51,부산 KCC,Home,허웅,16,3,5,60.0,3,5,60.0,6,10,60.0,1,2,50.0,1,1,2,4,0,0,0,0,0,0
../kbl_data/2024-2025,S45G01N51,부산 KCC,Home,이승현,18,8,12,66.7,0,3,0.0,8,15,53.3,2,2,100.0,2,2,4,2,0,0,0,0,0,3
../kbl_data/2024-2025,S45G01N51,부산 KCC,Home,이호현,2,1,1,100.0,0,1,0.0,1,2,50.0,0,0,0.0,1,1,2,1,0,0,0,0,0,1
../kbl_data/2024-2025,S45G01N51,부산 KCC,Home,송교창,4,2,5,40.0,0,0,0.0,2,5,40.0,0,0,0.0,2,1,3,3,0,0,0,0,1,0
../kbl_data/2024-2025,S45G01N51,부산 KCC,Home,최준용,5,1,3,33.3,0,2,0.0,1,5,20.0,3,3,100.0,0,5,5,5,0,1,0,0,3,2
../kbl_data/2024-2025,S45G01N51,부산 KCC,Home,디온테 버튼,13,5,14,35.7,0,2,0.0,5,16,31.2,3,4,75.0,1,10,11,2,0,2,1,0,1,0
../kbl_data/2024-2025,S45G01N51,부산 KCC,Home,이근휘,3,0,1,0.0,1,2,50.0,1,3,33.3,0,0,0.0,0,0,0,0,0,0,0,0,0,0
../kbl_data/2024-2025,S45G01N51,부산 KCC,Home,김동현,4,0,0,0.0,1,1,100.0,1,1,100.0,1,2,50.0,0,3,3,0,0,0,0,0,0,2
../kbl_data/2024-2025,S45G01N51,부산 KCC,Home,캘빈 제프리 에피스톨라,8,2,3,66.7,1,1,100.0,3,4,75.0,1,2,50.0,0,3,3,1,2,0,0,0,0,2
../kbl_data/2024-2025,S45G01N51,울산 현대모비스,Away,함지훈,7,3,3,100.0,0,1,0.0,3,4,75.0,1,1,100.0,0,3,3,0,0,0,0,0,1,0
../kbl_data/2024-2025,S45G01N51,울산 현대모비스,Away,장재석,0,0,0,0.0,0,0,0.0,0,0,0.0,0,0,0.0,0,0,0,0,0,0,0,0,0,0
../kbl_data/2024-2025,S45G01N51,울산 현대모비스,Away,김지완,3,0,0,0.0,1,1,100.0,1,1,100.0,0,0,0.0,0,0,0,0,0,0,0,0,0,0
../kbl_data/2024-2025,S45G01N51,울산 현대모비스,Away,한호빈,0,0,0,0.0,0,0,0.0,0,0,0.0,0,0,0.0,0,0,0,2,0,0,0,0,0,1
../kbl_data/2024-2025,S45G01N51,울산 현대모비스,Away,서명진,7,2,6,33.3,1,3,33.3,3,9,33.3,0,0,0.0,0,1,1,2,0,1,0,0,0,1
../kbl_data/2024-2025,S45G01N51,울산 현대모비스,Away,숀 롱,11,5,6,83.3,0,0,0.0,5,6,83.3,1,1,100.0,3,3,6,4,0,0,0,0,3,3
../kbl_data/2024-2025,S45G01N51,울산 현대모비스,Away,이우석,13,2,5,40.0,3,7,42.9,5,12,41.7,0,0,0.0,0,8,8,1,0,0,0,0,1,0
../kbl_data/2024-2025,S45G01N51,울산 현대모비스,Away,이승우,5,1,3,33.3,1,1,100.0,2,4,50.0,0,0,0.0,2,1,3,1,0,0,0,0,0,1
../kbl_data/2024-2025,S45G01N51,울산 현대모비스,Away,신민석,4,0,1,0.0,1,2,50.0,1,3,33.3,1,2,50.0,2,1,3,1,0,0,0,0,0,5
../kbl_data/2024-2025,S45G01N51,울산 현대모비스,Away,게이지 프림,16,7,13,53.8,0,2,0.0,7,15,46.7,2,3,66.7,3,7,10,3,2,0,0,0,2,4
../kbl_data/2024-2025,S45G01N51,울산 현대모비스,Away,박무빈,15,3,12,25.0,3,8,37.5,6,20,30.0,0,0,0.0,1,3,4,5,2,0,0,0,1,4
../kbl_data/2024-2025,S45G01N51,울산 현대모비스,Away,미구엘 안드레 옥존,0,0,0,0.0,0,1,0.0,0,1,0.0,0,0,0.0,1,0,1,1,0,0,0,0,0,1
../kbl_data/2024-2025,S45G01N52,창원 LG,Home,허일영,3,0,0,0.0,1,2,50.0,1,2,50.0,0,0,0.0,1,0,1,1,0,0,0,0,0,1
../kbl_data/2024-2025,S45G01N52,창원 LG,Home,최진수,0,0,0,0.0,0,0,0.0,0,0,0.0,0,0,0.0,0,0,0,0,0,0,0,0,0,0
../kbl_data/2024-2025,S45G01N52,창원 LG,Home,장민국,0,0,0,0.0,0,0,0.0,0,0,0.0,0,0,0.0,0,0,0,0,0,0,0,0,0,0
../kbl_data/2024-2025,S45G01N52,창원 LG,Home,두경민,14,0,2,0.0,4,6,66.7,4,8,50.0,2,2,100.0,1,4,5,8,0,0,0,0,4,0
../kbl_data/2024-2025,S45G01N52,창원 LG,Home,전성현,2,1,4,25.0,0,5,0.0,1,9,11.1,0,0,0.0,1,0,1,2,0,0,0,0,2,2
../kbl_data/2024-2025,S45G01N52,창원 LG,Home,정인덕,13,2,5,40.0,3,6,50.0,5,11,45.5,0,0,0.0,0,2,2,2,1,0,0,0,2,3
../kbl_data/2024-2025,S45G01N52,창원 LG,Home,대릴 먼로,15,6,10,60.0,1,2,50.0,7,12,58.3,0,0,0.0,7,11,18,6,1,1,0,0,2,2
../kbl_data/2024-2025,S45G01N52,창원 LG,Home,박정현,9,3,7,42.9,1,1,100.0,4,8,50.0,0,0,0.0,1,2,3,1,0,0,0,0,0,4
../kbl_data/2024-2025,S45G01N52,창원 LG,Home,양준석,0,0,0,0.0,0,0,0.0,0,0,0.0,0,0,0.0,0,1,1,2,1,0,0,0,2,1
../kbl_data/2024-2025,S45G01N52,창원 LG,Home,유기상,2,1,2,50.0,0,4,0.0,1,6,16.7,0,0,0.0,0,3,3,1,0,0,0,0,1,4
../kbl_data/2024-2025,S45G01N52,창원 LG,Home,이경도,0,0,0,0.0,0,0,0.0,0,0,0.0,0,0,0.0,0,0,0,0,0,0,0,0,0,0
../kbl_data/2024-2025,S45G01N52,창원 LG,Home,칼 타마요,15,6,10,60.0,1,3,33.3,7,13,53.8,0,0,0.0,1,8,9,2,1,0,0,0,3,3
../kbl_data/2024-2025,S45G01N52,서울 SK,Away,김선형,17,4,6,66.7,3,7,42.9,7,13,53.8,0,0,0.0,1,2,3,3,2,0,0,0,1,1
../kbl_data/2024-2025,S45G01N52,서울 SK,Away,오세근,6,1,4,25.0,1,2,50.0,2,6,33.3,1,4,25.0,3,5,8,0,2,0,0,0,0,1
../kbl_data/2024-2025,S45G01N52,서울 SK,Away,최부경,6,0,0,0.0,1,2,50.0,1,2,50.0,3,4,75.0,2,3,5,1,1,0,0,0,1,0
../kbl_data/2024-2025,S45G01N52,서울 SK,Away,최원혁,1,0,0,0.0,0,1,0.0,0,1,0.0,1,2,50.0,2,1,3,2,0,0,0,0,0,3
../kbl_data/2024-2025,S45G01N52,서울 SK,Away,김지후,0,0,0,0.0,0,0,0.0,0,0,0.0,0,0,0.0,0,0,0,0,0,0,0,0,0,0
../kbl_data/2024-2025,S45G01N52,서울 SK,Away,장문호,0,0,0,0.0,0,0,0.0,0,0,0.0,0,0,0.0,1,1,2,1,0,0,0,0,0,1
../kbl_data/2024-2025,S45G01N52,서울 SK,Away,자밀 워니,26,12,31,38.7,0,5,0.0,12,36,33.3,2,4,50.0,1,9,10,3,3,0,0,1,2,0
../kbl_data/2024-2025,S45G01N52,서울 SK,Away,김형빈,4,2,2,100.0,0,2,0.0,2,4,50.0,0,0,0.0,3,1,4,1,1,0,0,0,0,2
../kbl_data/2024-2025,S45G01N52,서울 SK,Away,박민우,0,0,0,0.0,0,0,0.0,0,0,0.0,0,0,0.0,0,0,0,0,1,0,0,0,0,0
../kbl_data/2024-2025,S45G01N52,서울 SK,Away,오재현,18,0,3,0.0,5,8,62.5,5,11,45.5,3,4,75.0,1,3,4,4,2,0,0,0,2,4
../kbl_data/2024-2025,S45G01N52,서울 SK,Away,김건우,0,0,0,0.0,0,0,0.0,0,0,0.0,0,0,0.0,0,0,0,0,0,0,0,0,0,0
../kbl_data/2024-2025,S45G01N52,서울 SK,Away,고메즈 델 리아노,0,0,1,0.0,0,0,0.0,0,1,0.0,0,0,0.0,0,1,1,1,0,0,0,0,0,2
../kbl_data/2024-2025,S45G01N53,서울 삼성,Home,이정현,0,0,6,0.0,0,3,0.0,0,9,0.0,0,0,0.0,1,0,1,6,1,0,0,0,7,2
../kbl_data/2024-2025,S45G01N53,서울 삼성,Home,최현민,6,0,0,0.0,2,3,66.7,2,3,66.7,0,0,0.0,2,1,3,1,0,0,0,0,0,2
../kbl_data/2024-2025,S45G01N53,서울 삼성,Home,최성모,8,2,4,50.0,1,5,20.0,3,9,33.3,1,1,100.0,0,4,4,2,0,0,0,0,0,2
../kbl_data/2024-2025,S45G01N53,서울 삼성,Home,최승욱,5,1,2,50.0,1,3,33.3,2,5,40.0,0,0,0.0,2,4,6,2,1,0,0,0,2,1
../kbl_data/2024-2025,S45G01N53,서울 삼성,Home,김한솔,0,0,0,0.0,0,0,0.0,0,0,0.0,0,0,0.0,0,0,0,0,0,0,0,0,0,0
../kbl_data/2024-2025,S45G01N53,서울 삼성,Home,마커스 데릭슨,1,0,0,0.0,0,0,0.0,0,0,0.0,1,2,50.0,1,1,2,1,0,0,0,0,3,2
../kbl_data/2024-2025,S45G01N53,서울 삼성,Home,차민석,5,1,1,100.0,0,0,0.0,1,1,100.0,3,4,75.0,1,2,3,1,0,1,0,0,2,4
../kbl_data/2024-2025,S45G01N53,서울 삼성,Home,이원석,16,4,5,80.0,2,3,66.7,6,8,75.0,2,4,50.0,2,4,6,1,1,1,0,0,2,3
../kbl_data/2024-2025,S45G01N53,서울 삼성,Home,김근현,0,0,0,0.0,0,1,0.0,0,1,0.0,0,0,0.0,0,0,0,0,0,0,0,0,0,0
../kbl_data/2024-2025,S45G01N53,서울 삼성,Home,조준희,0,0,0,0.0,0,0,0.0,0,0,0.0,0,0,0.0,0,0,0,0,0,0,0,0,0,0
../kbl_data/2024-2025,S45G01N53,서울 삼성,Home,박승재,14,3,6,50.0,2,4,50.0,5,10,50.0,2,3,66.7,1,3,4,3,0,0,1,0,1,3
../kbl_data/2024-2025,S45G01N53,서울 삼성,Home,코피 코번,16,6,12,50.0,0,0,0.0,6,12,50.0,4,7,57.1,3,5,8,1,1,0,0,0,5,2
../kbl_data/2024-2025,S45G01N53,수원 KT,Away,한희원,9,0,2,0.0,3,8,37.5,3,10,30.0,0,0,0.0,2,2,4,3,1,0,0,0,1,3
../kbl_data/2024-2025,S45G01N53,수원 KT,Away,최창진,5,2,4,50.0,0,2,0.0,2,6,33.3,1,3,33.3,2,1,3,3,2,0,0,0,1,2
../kbl_data/2024-2025,S45G01N53,수원 KT,Away,문성곤,3,0,0,0.0,1,5,20.0,1,5,20.0,0,0,0.0,1,1,2,1,2,0,0,0,0,3
../kbl_data/2024-2025,S45G01N53,수원 KT,Away,박준영,12,3,5,60.0,2,3,66.7,5,8,62.5,0,0,0.0,3,5,8,4,2,0,1,0,1,2
../kbl_data/2024-2025,S45G01N53,수원 KT,Away,최진광,0,0,0,0.0,0,1,0.0,0,1,0.0,0,0,0.0,0,0,0,0,0,0,0,0,0,0
../kbl_data/2024-2025,S45G01N53,수원 KT,Away,박지원,10,2,3,66.7,1,4,25.0,3,7,42.9,3,4,75.0,0,0,0,3,1,0,1,0,1,5
../kbl_data/2024-2025,S45G01N53,수원 KT,Away,이호준,0,0,1,0.0,0,0,0.0,0,1,0.0,0,0,0.0,0,0,0,0,0,0,0,0,0,0
../kbl_data/2024-2025,S45G01N53,수원 KT,Away,이두원,1,0,2,0.0,0,0,0.0,0,2,0.0,1,2,50.0,0,1,1,0,1,0,0,0,0,1
../kbl_data/2024-2025,S45G01N53,수원 KT,Away,박선웅,2,1,1,100.0,0,0,0.0,1,1,100.0,0,0,0.0,0,1,1,0,0,0,1,0,0,1
../kbl_data/2024-2025,S45G01N53,수원 KT,Away,고찬혁,0,0,1,0.0,0,0,0.0,0,1,0.0,0,0,0.0,1,0,1,0,0,0,0,0,0,0
../kbl_data/2024-2025,S45G01N53,수원 KT,Away,레이션 해먼즈,29,6,9,66.7,3,9,33.3,9,18,50.0,8,9,88.9,1,4,5,2,1,0,0,0,1,2
../kbl_data/2024-2025,S45G01N53,수원 KT,Away,조던 모건,12,6,9,66.7,0,0,0.0,6,9,66.7,0,1,0.0,1,0,1,1,4,1,0,1,1,3
../kbl_data/2024-2025,S45G01N54,원주 DB,Home,이관희,0,0,0,0.0,0,0,0.0,0,0,0.0,0,0,0.0,0,0,0,0,0,0,0,0,0,0
../kbl_data/2024-2025,S45G01N54,원주 DB,Home,김시래,7,2,2,100.0,1,3,33.3,3,5,60.0,0,0,0.0,0,0,0,6,0,0,0,0,1,1
../kbl_data/2024-2025,S45G01N54,원주 DB,Home,서민수,9,3,3,100.0,1,4,25.0,4,7,57.1,0,0,0.0,1,0,1,0,0,0,0,0,2,3
../kbl_data/2024-2025,S45G01N54,원주 DB,Home,김영현,0,0,1,0.0,0,2,0.0,0,3,0.0,0,0,0.0,1,0,1,0,0,0,0,0,0,2
../kbl_data/2024-2025,S45G01N54,원주 DB,Home,박봉진,0,0,0,0.0,0,0,0.0,0,0,0.0,0,0,0.0,0,0,0,0,0,0,0,0,0,1
../kbl_data/2024-2025,S45G01N54,원주 DB,Home,강상재,6,2,5,40.0,0,3,0.0,2,8,25.0,2,2,100.0,0,7,7,1,0,1,0,0,1,1
../kbl_data/2024-2025,S45G01N54,원주 DB,Home,치나누 오누아쿠,20,6,9,66.7,2,3,66.7,8,12,66.7,2,5,40.0,4,13,17,1,1,1,0,0,4,0
../kbl_data/2024-2025,S45G01N54,원주 DB,Home,이용우,9,0,0,0.0,3,5,60.0,3,5,60.0,0,0,0.0,0,0,0,0,0,0,0,0,0,3
../kbl_data/2024-2025,S45G01N54,원주 DB,Home,이선 알바노,18,7,11,63.6,0,4,0.0,7,15,46.7,4,4,100.0,3,1,4,7,1,0,1,0,1,1
../kbl_data/2024-2025,S45G01N54,원주 DB,Home,박인웅,11,3,3,100.0,1,3,33.3,4,6,66.7,2,2,100.0,4,1,5,0,0,0,0,0,1,3
../kbl_data/2024-2025,S45G01N54,원주 DB,Home,로버트 카터,6,3,4,75.0,0,2,0.0,3,6,50.0,0,0,0.0,1,3,4,0,0,0,0,0,1,0
../kbl_data/2024-2025,S45G01N54,원주 DB,Home,김보배,2,1,1,100.0,0,0,0.0,1,1,100.0,0,0,0.0,0,0,0,0,0,0,0,0,0,0
../kbl_data/2024-2025,S45G01N54,고양 소노,Away,함준후,0,0,0,0.0,0,1,0.0,0,1,0.0,0,0,0.0,0,0,0,0,0,0,0,0,1,1
../kbl_data/2024-2025,S45G01N54,고양 소노,Away,정희재,6,0,1,0.0,2,2,100.0,2,3,66.7,0,0,0.0,1,2,3,1,1,0,0,0,1,3
../kbl_data/2024-2025,S45G01N54,고양 소노,Away,임동섭,3,0,0,0.0,1,7,14.3,1,7,14.3,0,0,0.0,0,1,1,1,1,0,0,0,0,4
../kbl_data/2024-2025,S45G01N54,고양 소노,Away,김민욱,7,2,2,100.0,1,2,50.0,3,4,75.0,0,0,0.0,1,0,1,2,0,0,0,0,0,0
../kbl_data/2024-2025,S45G01N54,고양 소노,Away,이재도,21,1,1,100.0,6,11,54.5,7,12,58.3,1,3,33.3,1,3,4,5,1,0,0,0,0,3
../kbl_data/2024-2025,S45G01N54,고양 소노,Away,김영훈,3,0,1,0.0,1,4,25.0,1,5,20.0,0,0,0.0,0,1,1,1,1,0,0,0,0,1
../kbl_data/2024-2025,S45G01N54,고양 소노,Away,최승욱,8,2,5,40.0,1,4,25.0,3,9,33.3,1,2,50.0,0,3,3,4,1,0,0,0,1,2
../kbl_data/2024-2025,S45G01N54,고양 소노,Away,김진유,8,1,1,100.0,2,3,66.7,3,4,75.0,0,0,0.0,0,0,0,0,0,0,0,0,2,3
../kbl_data/2024-2025,S45G01N54,고양 소노,Away,박진철,2,1,2,50.0,0,0,0.0,1,2,50.0,0,0,0.0,0,0,0,1,0,0,0,0,0,2
../kbl_data/2024-2025,S45G01N54,고양 소노,Away,조은후,0,0,1,0.0,0,0,0.0,0,1,0.0,0,0,0.0,0,0,0,1,0,0,0,0,0,0
../kbl_data/2024-2025,S45G01N54,고양 소노,Away,민기남,0,0,0,0.0,0,0,0.0,0,0,0.0,0,0,0.0,0,0,0,0,0,0,0,0,0,0
../kbl_data/2024-2025,S45G01N54,고양 소노,Away,디제이 번즈 Jr,20,9,16,56.2,0,1,0.0,9,17,52.9,2,2,100.0,3,7,10,4,0,1,0,0,2,3
../kbl_data/2024-2025,S45G01N55,서울 SK,Home,김선형,9,2,7,28.6,0,1,0.0,2,8,25.0,5,5,100.0,1,9,10,5,0,0,0,0,3,1
../kbl_data/2024-2025,S45G01N55,서울 SK,Home,오세근,5,1,3,33.3,1,2,50.0,2,5,40.0,0,0,0.0,0,0,0,0,0,0,0,0,0,0
../kbl_data/2024-2025,S45G01N55,서울 SK,Home,최부경,7,1,1,100.0,1,1,100.0,2,2,100.0,2,2,100.0,2,4,6,0,0,0,0,0,2,5
../kbl_data/2024-2025,S45G01N55,서울 SK,Home,최원혁,9,0,1,0.0,3,6,50.0,3,7,42.9,0,0,0.0,1,1,2,3,2,0,0,0,1,4
../kbl_data/2024-2025,S45G01N55,서울 SK,Home,장문호,0,0,0,0.0,0,1,0.0,0,1,0.0,0,0,0.0,0,0,0,0,0,0,0,0,0,1
../kbl_data/2024-2025,S45G01N55,서울 SK,Home,안영준,13,3,6,50.0,2,5,40.0,5,11,45.5,1,4,25.0,2,4,6,1,2,0,0,0,0,3
../kbl_data/2024-2025,S45G01N55,서울 SK,Home,자밀 워니,17,8,17,47.1,0,6,0.0,8,23,34.8,1,2,50.0,3,12,15,3,1,1,0,0,0,3
../kbl_data/2024-2025,S45G01N55,서울 SK,Home,김형빈,0,0,1,0.0,0,0,0.0,0,1,0.0,0,2,0.0,0,2,2,0,0,0,0,0,0,1
../kbl_data/2024-2025,S45G01N55,서울 SK,Home,아이재아 힉스,4,2,5,40.0,0,0,0.0,2,5,40.0,0,0,0.0,1,1,2,0,0,1,0,0,1,0
../kbl_data/2024-2025,S45G01N55,서울 SK,Home,박민우,0,0,0,0.0,0,0,0.0,0,0,0.0,0,0,0.0,0,0,0,0,0,0,0,0,0,0
../kbl_data/2024-2025,S45G01N55,서울 SK,Home,오재현,5,1,3,33.3,0,4,0.0,1,7,14.3,3,3,100.0,0,2,2,3,3,0,0,0,4,3
../kbl_data/2024-2025,S45G01N55,서울 SK,Home,고메즈 델 리아노,0,0,0,0.0,0,0,0.0,0,0,0.0,0,0,0.0,0,0,0,0,0,0,0,0,0,0
../kbl_data/2024-2025,S45G01N55,대구 한국가스공사,Away,차바위,3,0,0,0.0,1,2,50.0,1,2,50.0,0,0,0.0,1,2,3,0,1,0,0,0,0,3
../kbl_data/2024-2025,S45G01N55,대구 한국가스공사,Away,박지훈,1,0,0,0.0,0,0,0.0,0,0,0.0,1,2,50.0,0,1,1,0,0,0,0,0,0,0
../kbl_data/2024-2025,S45G01N55,대구 한국가스공사,Away,이대헌,0,0,3,0.0,0,2,0.0,0,5,0.0,0,0,0.0,0,0,0,0,0,0,1,0,1,0
../kbl_data/2024-2025,S45G01N55,대구 한국가스공사,Away,정성우,4,1,2,50.0,0,2,0.0,1,4,25.0,2,2,100.0,1,1,2,2,0,0,0,0,2,3
../kbl_data/2024-2025,S45G01N55,대구 한국가스공사,Away,김낙현,6,0,2,0.0,2,8,25.0,2,10,20.0,0,0,0.0,0,3,3,5,1,1,1,0,5,2
../kbl_data/2024-2025,S45G01N55,대구 한국가스공사,Away,양재혁,0,0,0,0.0,0,2,0.0,0,2,0.0,0,0,0.0,0,1,1,0,0,0,0,0,0,1
../kbl_data/2024-2025,S45G01N55,대구 한국가스공사,Away,곽정훈,5,1,2,50.0,1,2,50.0,2,4,50.0,0,0,0.0,0,1,1,0,0,0,0,0,0,1
../kbl_data/2024-2025,S45G01N55,대구 한국가스공사,Away,앤드류 니콜슨,27,6,12,50.0,2,7,28.6,8,19,42.1,9,11,81.8,4,8,12,0,1,0,0,2,1,3
../kbl_data/2024-2025,S45G01N55,대구 한국가스공사,Away,신승민,3,0,1,0.0,1,6,16.7,1,7,14.3,0,0,0.0,1,1,2,2,2,0,1,0,0,4
../kbl_data/2024-2025,S45G01N55,대구 한국가스공사,Away,샘조세프 벨란겔,11,4,6,66.7,1,6,16.7,5,12,41.7,0,0,0.0,0,6,6,5,2,0,0,0,2,3
../kbl_data/2024-2025,S45G01N55,대구 한국가스공사,Away,유슈 은도예,5,2,5,40.0,0,0,0.0,2,5,40.0,1,2,50.0,4,5,9,0,0,1,0,0,0,1
../kbl_data/2024-2025,S45G01N55,대구 한국가스공사,Away,신주영,2,1,1,100.0,0,1,0.0,1,2,50.0,0,0,0.0,0,2,2,0,0,0,0,0,0,0
../kbl_data/2024-2025,S45G01N56,안양 정관장,Home,송창용,0,0,0,0.0,0,2,0.0,0,2,0.0,0,0,0.0,1,1,2,0,0,0,0,0,0,1
../kbl_data/2024-2025,S45G01N56,안양 정관장,Home,배병준,14,0,2,0.0,4,8,50.0,4,10,40.0,2,2,100.0,0,1,1,2,0,0,0,0,1,3
../kbl_data/2024-2025,S45G01N56,안양 정관장,Home,정효근,5,2,5,40.0,0,6,0.0,2,11,18.2,1,2,50.0,1,9,10,3,2,2,0,0,4,3
../kbl_data/2024-2025,S45G01N56,안양 정관장,Home,이종현,3,1,1,100.0,0,0,0.0,1,1,100.0,1,2,50.0,1,3,4,1,0,0,0,0,0,0
../kbl_data/2024-2025,S45G01N56,안양 정관장,Home,박지훈,13,5,9,55.6,1,4,25.0,6,13,46.2,0,0,0.0,0,5,5,6,0,2,0,0,2,3
../kbl_data/2024-2025,S45G01N56,안양 정관장,Home,최성원,4,1,3,33.3,0,0,0.0,1,3,33.3,2,2,100.0,0,0,0,3,0,0,0,0,0,2
../kbl_data/2024-2025,S45G01N56,안양 정관장,Home,김준형,0,0,0,0.0,0,0,0.0,0,0,0.0,0,0,0.0,0,0,0,0,0,0,0,0,0,0
../kbl_data/2024-2025,S45G01N56,안양 정관장,Home,변준형,20,3,5,60.0,3,10,30.0,6,15,40.0,5,6,83.3,1,3,4,7,2,1,1,0,4,4
../kbl_data/2024-2025,S45G01N56,안양 정관장,Home,캐디 라렌,23,7,11,63.6,2,5,40.0,9,16,56.2,3,4,75.0,6,15,21,3,0,3,1,3,3,3
../kbl_data/2024-2025,S45G01N56,안양 정관장,Home,한승희,3,0,3,0.0,1,2,50.0,1,5,20.0,0,0,0.0,1,1,2,1,1,0,0,0,0,5
../kbl_data/2024-2025,S45G01N56,안양 정관장,Home,하비 고메즈,0,0,0,0.0,0,0,0.0,0,0,0.0,0,0,0.0,0,0,0,0,0,0,0,0,0,0
../kbl_data/2024-2025,S45G01N56,안양 정관장,Home,마이클 영 Jr,0,0,2,0.0,0,1,0.0,0,3,0.0,0,0,0.0,1,2,3,0,0,0,0,0,0,1
../kbl_data/2024-2025,S45G01N56,부산 KCC,Away,정창영,0,0,0,0.0,0,0,0.0,0,0,0.0,0,0,0.0,0,0,0,0,0,0,0,0,1,0
../kbl_data/2024-2025,S45G01N56,부산 KCC,Away,리온 윌리엄스,6,2,3,66.7,0,0,0.0,2,3,66.7,2,2,100.0,0,2,2,0,1,0,0,0,0,3
../kbl_data/2024-2025,S45G01N56,부산 KCC,Away,전준범,0,0,0,0.0,0,0,0.0,0,0,0.0,0,0,0.0,0,0,0,0,0,0,0,0,0,0
../kbl_data/2024-2025,S45G01N56,부산 KCC,Away,허웅,17,2,3,66.7,3,8,37.5,5,11,45.5,4,4,100.0,0,1,1,1,1,0,0,0,1,2
../kbl_data/2024-2025,S45G01N56,부산 KCC,Away,이승현,8,4,10,40.0,0,0,0.0,4,10,40.0,0,1,0.0,2,4,6,3,1,1,0,0,2,3
../kbl_data/2024-2025,S45G01N56,부산 KCC,Away,이호현,2,1,2,50.0,0,0,0.0,1,2,50.0,0,0,0.0,0,0,0,1,0,0,0,0,1,2
../kbl_data/2024-2025,S45G01N56,부산 KCC,Away,송교창,5,1,2,50.0,1,3,33.3,2,5,40.0,0,0,0.0,2,3,5,0,0,0,0,0,0,1
../kbl_data/2024-2025,S45G01N56,부산 KCC,Away,최준용,15,1,4,25.0,3,8,37.5,4,12,33.3,4,6,66.7,2,7,9,3,2,1,1,0,2,2
../kbl_data/2024-2025,S45G01N56,부산 KCC,Away,디온테 버튼,15,2,12,16.7,1,5,20.0,3,17,17.6,8,10,80.0,1,12,13,10,1,2,0,0,5,2
../kbl_data/2024-2025,S45G01N56,부산 KCC,Away,이근휘,3,0,0,0.0,1,3,33.3,1,3,33.3,0,0,0.0,0,0,0,0,1,0,0,0,0,0
../kbl_data/2024-2025,S45G01N56,부산 KCC,Away,김동현,3,0,1,0.0,1,4,25.0,1,5,20.0,0,0,0.0,0,2,2,2,0,1,0,0,1,4
../kbl_data/2024-2025,S45G01N56,부산 KCC,Away,캘빈 제프리 에피스톨라,5,1,1,100.0,1,2,50.0,2,3,66.7,0,0,0.0,0,3,3,2,2,1,0,0,0,0
../kbl_data/2024-2025,S45G01N57,수원 KT,Home,한희원,3,0,0,0.0,1,6,16.7,1,6,16.7,0,0,0.0,0,0,0,0,0,0,0,0,0,2
../kbl_data/2024-2025,S45G01N57,수원 KT,Home,최창진,0,0,0,0.0,0,2,0.0,0,2,0.0,0,0,0.0,1,0,1,3,0,0,0,0,0,0
../kbl_data/2024-2025,S45G01N57,수원 KT,Home,문성곤,20,0,0,0.0,6,7,85.7,6,7,85.7,2,4,50.0,4,5,9,3,2,0,0,0,1,2
../kbl_data/2024-2025,S45G01N57,수원 KT,Home,박준영,9,1,3,33.3,2,2,100.0,3,5,60.0,1,4,25.0,4,2,6,2,0,0,0,0,4,3
../kbl_data/2024-2025,S45G01N57,수원 KT,Home,최진광,14,4,7,57.1,2,9,22.2,6,16,37.5,0,0,0.0,0,1,1,3,1,0,0,0,0,1
../kbl_data/2024-2025,S45G01N57,수원 KT,Home,박지원,11,5,10,50.0,0,6,0.0,5,16,31.2,1,2,50.0,1,3,4,6,4,1,0,0,3,4
../kbl_data/2024-2025,S45G01N57,수원 KT,Home,이호준,0,0,0,0.0,0,0,0.0,0,0,0.0,0,0,0.0,0,0,0,0,0,0,0,0,0,0
../kbl_data/2024-2025,S45G01N57,수원 KT,Home,이두원,5,2,2,100.0,0,2,0.0,2,4,50.0,1,2,50.0,3,1,4,0,0,0,0,1,1,2
../kbl_data/2024-2025,S45G01N57,수원 KT,Home,박선웅,0,0,2,0.0,0,1,0.0,0,3,0.0,0,0,0.0,0,2,2,0,0,0,0,0,0,0
../kbl_data/2024-2025,S45G01N57,수원 KT,Home,고찬혁,0,0,0,0.0,0,1,0.0,0,1,0.0,0,0,0.0,0,0,0,0,0,0,0,0,0,0
../kbl_data/2024-2025,S45G01N57,수원 KT,Home,레이션 해먼즈,11,2,7,28.6,2,4,50.0,4,11,36.4,1,1,100.0,0,5,5,1,0,0,0,0,2,5
../kbl_data/2024-2025,S45G01N57,수원 KT,Home,조던 모건,0,0,0,0.0,0,0,0.0,0,0,0.0,0,0,0.0,0,1,1,1,0,0,0,0,1,1
../kbl_data/2024-2025,S45G01N57,울산 현대모비스,Away,함지훈,9,3,4,75.0,0,1,0.0,3,5,60.0,3,3,100.0,2,2,4,4,1,0,0,0,1,4
../kbl_data/2024-2025,S45G01N57,울산 현대모비스,Away,장재석,2,1,4,25.0,0,0,0.0,1,4,25.0,0,0,0.0,0,1,1,0,0,0,0,0,1,3
../kbl_data/2024-2025,S45G01N57,울산 현대모비스,Away,김지완,0,0,0,0.0,0,0,0.0,0,0,0.0,0,0,0.0,0,0,0,0,0,0,0,0,0,0
../kbl_data/2024-2025,S45G01N57,울산 현대모비스,Away,한호빈,3,0,0,0.0,1,4,25.0,1,4,25.0,0,0,0.0,1,1,2,0,3,0,0,0,1,0
../kbl_data/2024-2025,S45G01N57,울산 현대모비스,Away,서명진,7,1,2,50.0,1,3,33.3,2,5,40.0,2,3,66.7,1,0,1,1,0,0,0,0,1,0
../kbl_data/2024-2025,S45G01N57,울산 현대모비스,Away,숀 롱,14,6,13,46.2,0,0,0.0,6,13,46.2,2,6,33.3,6,6,12,4,0,2,0,1,2,4
../kbl_data/2024-2025,S45G01N57,울산 현대모비스,Away,이우석,8,1,2,50.0,2,6,33.3,3,8,37.5,0,0,0.0,2,5,7,4,1,0,0,0,1,3
../kbl_data/2024-2025,S45G01N57,울산 현대모비스,Away,이승우,0,0,0,0.0,0,0,0.0,0,0,0.0,0,0,0.0,0,0,0,0,0,0,0,0,0,0
../kbl_data/2024-2025,S45G01N57,울산 현대모비스,Away,신민석,0,0,0,0.0,0,2,0.0,0,2,0.0,0,0,0.0,0,1,1,2,1,0,0,0,1,1
../kbl_data/2024-2025,S45G01N57,울산 현대모비스,Away,게이지 프림,19,8,12,66.7,0,1,0.0,8,13,61.5,3,3,100.0,5,7,12,0,0,1,0,0,2,2
../kbl_data/2024-2025,S45G01N57,울산 현대모비스,Away,박무빈,15,4,6,66.7,2,5,40.0,6,11,54.5,1,2,50.0,1,2,3,2,1,0,1,0,1,2
../kbl_data/2024-2025,S45G01N57,울산 현대모비스,Away,미구엘 안드레 옥존,8,1,2,50.0,2,5,40.0,3,7,42.9,0,0,0.0,1,0,1,4,1,1,0,0,1,1
../kbl_data/2024-2025,S45G01N58,고양 소노,Home,함준후,0,0,0,0.0,0,0,0.0,0,0,0.0,0,0,0.0,0,0,0,0,0,0,0,0,0,0
../kbl_data/2024-2025,S45G01N58,고양 소노,Home,정희재,10,0,0,0.0,3,8,37.5,3,8,37.5,1,1,100.0,2,5,7,2,0,0,0,0,0,3
../kbl_data/2024-2025,S45G01N58,고양 소노,Home,임동섭,8,0,2,0.0,2,5,40.0,2,7,28.6,2,3,66.7,1,4,5,3,1,0,0,0,0,3
../kbl_data/2024-2025,S45G01N58,고양 소노,Home,김민욱,0,0,0,0.0,0,3,0.0,0,3,0.0,0,0,0.0,0,0,0,0,0,1,0,0,0,0
../kbl_data/2024-2025,S45G01N58,고양 소노,Home,이재도,26,6,6,100.0,3,6,50.0,9,12,75.0,5,5,100.0,1,2,3,5,1,0,0,0,0,1
../kbl_data/2024-2025,S45G01N58,고양 소노,Home,김영훈,2,1,1,100.0,0,0,0.0,1,1,100.0,0,0,0.0,0,0,0,0,0,0,0,0,0,1
../kbl_data/2024-2025,S45G01N58,고양 소노,Home,최승욱,5,0,4,0.0,1,4,25.0,1,8,12.5,2,3,66.7,1,0,1,1,0,0,0,0,2,1
../kbl_data/2024-2025,S45G01N58,고양 소노,Home,김진유,0,0,0,0.0,0,0,0.0,0,0,0.0,0,0,0.0,1,2,3,0,0,0,0,0,0,1
../kbl_data/2024-2025,S45G01N58,고양 소노,Home,박진철,0,0,0,0.0,0,0,0.0,0,0,0.0,0,0,0.0,0,0,0,0,0,0,0,0,0,0
../kbl_data/2024-2025,S45G01N58,고양 소노,Home,조은후,0,0,0,0.0,0,0,0.0,0,0,0.0,0,0,0.0,1,0,1,1,0,0,0,0,0,1
../kbl_data/2024-2025,S45G01N58,고양 소노,Home,앨런 윌리엄스,16,7,17,41.2,0,0,0.0,7,17,41.2,2,5,40.0,6,4,10,4,0,1,0,0,6,5
../kbl_data/2024-2025,S45G01N58,고양 소노,Home,디제이 번즈 Jr,11,5,9,55.6,0,0,0.0,5,9,55.6,1,2,50.0,1,2,3,2,0,0,0,0,1,1
../kbl_data/2024-2025,S45G01N58,창원 LG,Away,허일영,6,3,4,75.0,0,1,0.0,3,5,60.0,0,0,0.0,1,2,3,0,0,0,0,0,0,2
../kbl_data/2024-2025,S45G01N58,창원 LG,Away,최진수,4,0,0,0.0,1,2,50.0,1,2,50.0,1,2,50.0,2,0,2,0,0,0,0,0,0,1
../kbl_data/2024-2025,S45G01N58,창원 LG,Away,장민국,0,0,0,0.0,0,0,0.0,0,0,0.0,0,0,0.0,0,0,0,0,0,0,0,0,0,0
../kbl_data/2024-2025,S45G01N58,창원 LG,Away,두경민,7,2,2,100.0,1,4,25.0,3,6,50.0,0,1,0.0,0,0,0,3,0,0,0,0,1,3
../kbl_data/2024-2025,S45G01N58,창원 LG,Away,전성현,8,1,3,33.3,1,4,25.0,2,7,28.6,3,3,100.0,0,1,1,1,0,0,0,0,0,1
../kbl_data/2024-2025,S45G01N58,창원 LG,Away,정인덕,3,0,0,0.0,1,2,50.0,1,2,50.0,0,0,0.0,0,0,0,0,0,1,0,0,0,2
../kbl_data/2024-2025,S45G01N58,창원 LG,Away,대릴 먼로,8,4,5,80.0,0,3,0.0,4,8,50.0,0,0,0.0,2,8,10,7,0,0,1,1,1,2
../kbl_data/2024-2025,S45G01N58,창원 LG,Away,박정현,13,4,7,57.1,1,2,50.0,5,9,55.6,2,2,100.0,1,1,2,1,2,0,1,0,0,1
../kbl_data/2024-2025,S45G01N58,창원 LG,Away,양준석,6,3,4,75.0,0,0,0.0,3,4,75.0,0,0,0.0,0,1,1,9,0,0,0,0,2,5
../kbl_data/2024-2025,S45G01N58,창원 LG,Away,유기상,10,2,4,50.0,2,5,40.0,4,9,44.4,0,0,0.0,1,0,1,0,0,1,0,0,0,2
../kbl_data/2024-2025,S45G01N58,창원 LG,Away,이경도,0,0,0,0.0,0,0,0.0,0,0,0.0,0,0,0.0,0,0,0,1,0,1,0,0,0,0
../kbl_data/2024-2025,S45G01N58,창원 LG,Away,칼 타마요,21,7,13,53.8,1,4,25.0,8,17,47.1,4,4,100.0,2,7,9,4,1,0,0,0,0,3
../kbl_data/2024-2025,S45G01N59,서울 삼성,Home,이정현,9,3,7,42.9,0,2,0.0,3,9,33.3,3,5,60.0,0,1,1,7,2,0,0,0,4,3
../kbl_data/2024-2025,S45G01N59,서울 삼성,Home,최현민,3,0,0,0.0,1,2,50.0,1,2,50.0,0,0,0.0,0,2,2,0,0,0,0,0,1,0
../kbl_data/2024-2025,S45G01N59,서울 삼성,Home,이원대,3,1,1,100.0,0,4,0.0,1,5,20.0,1,1,100.0,1,2,3,0,0,0,0,0,0,3
../kbl_data/2024-2025,S45G01N59,서울 삼성,Home,최성모,9,1,3,33.3,2,5,40.0,3,8,37.5,1,2,50.0,0,3,3,3,0,0,0,0,2,3
../kbl_data/2024-2025,S45G01N59,서울 삼성,Home,최승욱,4,2,2,100.0,0,0,0.0,2,2,100.0,0,0,0.0,4,4,8,0,2,0,0,0,0,3
../kbl_data/2024-2025,S45G01N59,서울 삼성,Home,김진용,0,0,0,0.0,0,0,0.0,0,0,0.0,0,0,0.0,0,0,0,0,0,0,0,0,0,0
../kbl_data/2024-2025,S45G01N59,서울 삼성,Home,김한솔,0,0,0,0.0,0,0,0.0,0,0,0.0,0,0,0.0,0,0,0,0,0,0,0,0,0,0
../kbl_data/2024-2025,S45G01N59,서울 삼성,Home,마커스 데릭슨,21,2,11,18.2,5,9,55.6,7,20,35.0,2,2,100.0,3,9,12,0,1,2,1,0,2,4
../kbl_data/2024-2025,S45G01N59,서울 삼성,Home,차민석,2,1,2,50.0,0,2,0.0,1,4,25.0,0,0,0.0,2,3,5,1,0,0,0,0,1,2
../kbl_data/2024-2025,S45G01N59,서울 삼성,Home,이원석,15,1,9,11.1,3,5,60.0,4,14,28.6,4,4,100.0,5,4,9,2,1,2,0,0,1,2
../kbl_data/2024-2025,S45G01N59,서울 삼성,Home,김근현,0,0,0,0.0,0,0,0.0,0,0,0.0,0,0,0.0,0,0,0,0,0,0,0,0,0,0
../kbl_data/2024-2025,S45G01N59,서울 삼성,Home,박승재,0,0,1,0.0,0,3,0.0,0,4,0.0,0,0,0.0,0,0,0,1,0,0,0,0,1,1
../kbl_data/2024-2025,S45G01N59,원주 DB,Away,이관희,3,0,1,0.0,1,2,50.0,1,3,33.3,0,0,0.0,0,0,0,1,0,0,0,0,0,1
../kbl_data/2024-2025,S45G01N59,원주 DB,Away,김시래,0,0,1,0.0,0,1,0.0,0,2,0.0,0,0,0.0,0,0,0,4,1,0,0,0,0,2
../kbl_data/2024-2025,S45G01N59,원주 DB,Away,서민수,14,1,2,50.0,4,8,50.0,5,10,50.0,0,0,0.0,3,4,7,2,1,0,0,0,1,1
../kbl_data/2024-2025,S45G01N59,원주 DB,Away,김영현,2,1,1,100.0,0,2,0.0,1,3,33.3,0,0,0.0,0,2,2,0,0,0,0,0,1,4
../kbl_data/2024-2025,S45G01N59,원주 DB,Away,박봉진,0,0,0,0.0,0,0,0.0,0,0,0.0,0,0,0.0,0,0,0,0,0,0,0,0,0,0
../kbl_data/2024-2025,S45G01N59,원주 DB,Away,강상재,2,1,1,100.0,0,2,0.0,1,3,33.3,0,0,0.0,0,4,4,0,0,0,0,0,2,1
../kbl_data/2024-2025,S45G01N59,원주 DB,Away,치나누 오누아쿠,20,5,13,38.5,0,2,0.0,5,15,33.3,10,12,83.3,5,9,14,3,1,1,0,0,0,2
../kbl_data/2024-2025,S45G01N59,원주 DB,Away,이용우,3,0,0,0.0,1,7,14.3,1,7,14.3,0,0,0.0,2,0,2,1,0,0,0,0,0,4
../kbl_data/2024-2025,S45G01N59,원주 DB,Away,이선 알바노,10,3,7,42.9,1,3,33.3,4,10,40.0,1,4,25.0,1,3,4,5,2,1,0,0,3,1
../kbl_data/2024-2025,S45G01N59,원주 DB,Away,박인웅,19,2,4,50.0,4,8,50.0,6,12,50.0,3,4,75.0,2,5,7,1,1,0,0,0,1,4
../kbl_data/2024-2025,S45G01N59,원주 DB,Away,로버트 카터,3,0,3,0.0,1,2,50.0,1,5,20.0,0,0,0.0,1,2,3,1,3,0,0,0,0,1
../kbl_data/2024-2025,S45G01N59,원주 DB,Away,김보배,0,0,0,0.0,0,0,0.0,0,0,0.0,0,0,0.0,0,0,0,0,0,0,0,0,0,0
../kbl_data/2024-2025,S45G01N60,서울 SK,Home,김선형,19,1,3,33.3,4,5,80.0,5,8,62.5,5,6,83.3,2,2,4,3,0,0,0,0,1,1
../kbl_data/2024-2025,S45G01N60,서울 SK,Home,오세근,8,3,4,75.0,0,3,0.0,3,7,42.9,2,2,100.0,1,5,6,1,0,0,0,0,0,4
../kbl_data/2024-2025,S45G01N60,서울 SK,Home,최부경,7,1,1,100.0,1,2,50.0,2,3,66.7,2,2,100.0,5,1,6,0,1,0,0,1,0,2
../kbl_data/2024-2025,S45G01N60,서울 SK,Home,최원혁,0,0,0,0.0,0,0,0.0,0,0,0.0,0,0,0.0,0,2,2,1,0,0,0,0,0,1
../kbl_data/2024-2025,S45G01N60,서울 SK,Home,장문호,3,0,0,0.0,1,3,33.3,1,3,33.3,0,0,0.0,0,0,0,0,0,0,0,0,0,0
../kbl_data/2024-2025,S45G01N60,서울 SK,Home,안영준,7,1,5,20.0,1,4,25.0,2,9,22.2,2,2,100.0,1,8,9,7,3,0,0,0,3,2
../kbl_data/2024-2025,S45G01N60,서울 SK,Home,자밀 워니,24,10,17,58.8,1,2,50.0,11,19,57.9,1,1,100.0,1,2,3,2,1,3,0,1,2,1
../kbl_data/2024-2025,S45G01N60,서울 SK,Home,김형빈,7,2,2,100.0,1,3,33.3,3,5,60.0,0,0,0.0,2,1,3,0,0,0,0,0,0,3
../kbl_data/2024-2025,S45G01N60,서울 SK,Home,아이재아 힉스,7,0,2,0.0,1,2,50.0,1,4,25.0,4,4,100.0,0,1,1,0,0,0,0,0,1,0
../kbl_data/2024-2025,S45G01N60,서울 SK,Home,박민우,5,1,1,100.0,1,2,50.0,2,3,66.7,0,0,0.0,1,0,1,0,0,0,0,0,0,1
../kbl_data/2024-2025,S45G01N60,서울 SK,Home,오재현,6,0,1,0.0,0,2,0.0,0,3,0.0,6,6,100.0,1,3,4,7,3,1,0,0,3,2
../kbl_data/2024-2025,S45G01N60,서울 SK,Home,고메즈 델 리아노,7,2,4,50.0,1,3,33.3,3,7,42.9,0,0,0.0,3,2,5,1,0,0,0,0,0,3
../kbl_data/2024-2025,S45G01N60,수원 KT,Away,한희원,6,3,4,75.0,0,5,0.0,3,9,33.3,0,0,0.0,1,2,3,1,0,0,0,0,2,4
../kbl_data/2024-2025,S45G01N60,수원 KT,Away,최창진,0,0,0,0.0,0,0,0.0,0,0,0.0,0,0,0.0,0,0,0,0,0,0,0,0,1,0
../kbl_data/2024-2025,S45G01N60,수원 KT,Away,문성곤,0,0,2,0.0,0,4,0.0,0,6,0.0,0,0,0.0,1,5,6,2,0,0,0,0,1,3
../kbl_data/2024-2025,S45G01N60,수원 KT,Away,박준영,13,4,8,50.0,1,2,50.0,5,10,50.0,2,2,100.0,4,2,6,0,0,0,0,0,3,2
../kbl_data/2024-2025,S45G01N60,수원 KT,Away,최진광,2,1,3,33.3,0,1,0.0,1,4,25.0,0,0,0.0,0,0,0,0,0,0,0,0,3,1
../kbl_data/2024-2025,S45G01N60,수원 KT,Away,박지원,8,0,2,0.0,2,5,40.0,2,7,28.6,2,2,100.0,1,2,3,3,2,0,2,0,2,3
../kbl_data/2024-2025,S45G01N60,수원 KT,Away,이호준,0,0,0,0.0,0,2,0.0,0,2,0.0,0,0,0.0,0,1,1,0,0,0,0,0,0,0
../kbl_data/2024-2025,S45G01N60,수원 KT,Away,이두원,2,1,3,33.3,0,0,0.0,1,3,33.3,0,0,0.0,0,1,1,0,0,0,0,0,0,2
../kbl_data/2024-2025,S45G01N60,수원 KT,Away,박선웅,1,0,1,0.0,0,2,0.0,0,3,0.0,1,2,50.0,1,1,2,0,1,0,0,0,0,0
../kbl_data/2024-2025,S45G01N60,수원 KT,Away,고찬혁,5,2,2,100.0,0,3,0.0,2,5,40.0,1,2,50.0,1,0,1,0,1,0,0,0,0,1
../kbl_data/2024-2025,S45G01N60,수원 KT,Away,레이션 해먼즈,19,7,8,87.5,0,8,0.0,7,16,43.8,5,6,83.3,2,4,6,2,1,0,0,0,2,3
../kbl_data/2024-2025,S45G01N60,수원 KT,Away,조환희,6,2,2,100.0,0,1,0.0,2,3,66.7,2,2,100.0,1,1,2,3,1,0,0,0,0,0
../kbl_data/2024-2025,S45G01N61,고양 소노,Home,함준후,0,0,0,0.0,0,0,0.0,0,0,0.0,0,0,0.0,0,0,0,0,0,0,0,0,0,0
../kbl_data/2024-2025,S45G01N61,고양 소노,Home,정희재,4,2,3,66.7,0,6,0.0,2,9,22.2,0,0,0.0,1,3,4,4,0,0,0,0,0,4
../kbl_data/2024-2025,S45G01N61,고양 소노,Home,임동섭,6,0,1,0.0,2,2,100.0,2,3,66.7,0,0,0.0,0,1,1,0,0,0,0,0,2,4
../kbl_data/2024-2025,S45G01N61,고양 소노,Home,김민욱,3,0,1,0.0,1,3,33.3,1,4,25.0,0,0,0.0,0,0,0,0,0,0,0,0,0,2
../kbl_data/2024-2025,S45G01N61,고양 소노,Home,이재도,15,1,1,100.0,3,10,30.0,4,11,36.4,4,4,100.0,1,4,5,4,2,0,0,0,3,0
../kbl_data/2024-2025,S45G01N61,고양 소노,Home,최승욱,10,2,4,50.0,2,3,66.7,4,7,57.1,0,0,0.0,1,0,1,3,2,0,0,0,1,2
../kbl_data/2024-2025,S45G01N61,고양 소노,Home,김진유,0,0,0,0.0,0,0,0.0,0,0,0.0,0,0,0.0,0,0,0,0,0,0,0,0,0,0
../kbl_data/2024-2025,S45G01N61,고양 소노,Home,박종하,2,1,2,50.0,0,2,0.0,1,4,25.0,0,0,0.0,0,0,0,0,0,0,0,0,0,0
../kbl_data/2024-2025,S45G01N61,고양 소노,Home,민기남,0,0,0,0.0,0,1,0.0,0,1,0.0,0,0,0.0,0,0,0,0,0,0,0,0,0,1
../kbl_data/2024-2025,S45G01N61,고양 소노,Home,앨런 윌리엄스,1,0,4,0.0,0,0,0.0,0,4,0.0,1,2,50.0,0,7,7,1,0,0,0,0,1,0
../kbl_data/2024-2025,S45G01N61,고양 소노,Home,디제이 번즈 Jr,10,5,10,50.0,0,0,0.0,5,10,50.0,0,0,0.0,2,6,8,2,2,0,0,0,3,4
../kbl_data/2024-2025,S45G01N61,고양 소노,Home,이근준,16,2,5,40.0,4,8,50.0,6,13,46.2,0,0,0.0,2,5,7,0,0,0,0,0,0,4
../kbl_data/2024-2025,S45G01N61,부산 KCC,Away,정창영,3,0,2,0.0,1,3,33.3,1,5,20.0,0,0,0.0,0,2,2,1,2,0,0,0,0,1
../kbl_data/2024-2025,S45G01N61,부산 KCC,Away,리온 윌리엄스,10,4,5,80.0,0,0,0.0,4,5,80.0,2,2,100.0,2,4,6,0,0,0,0,0,0,3
../kbl_data/2024-2025,S45G01N61,부산 KCC,Away,전준범,12,0,1,0.0,4,6,66.7,4,7,57.1,0,0,0.0,0,1,1,0,0,0,0,0,1,3
../kbl_data/2024-2025,S45G01N61,부산 KCC,Away,허웅,0,0,0,0.0,0,3,0.0,0,3,0.0,0,0,0.0,1,1,2,2,0,0,0,0,1,0
../kbl_data/2024-2025,S45G01N61,부산 KCC,Away,이승현,8,4,9,44.4,0,0,0.0,4,9,44.4,0,0,0.0,2,1,3,1,0,0,0,0,0,1
../kbl_data/2024-2025,S45G01N61,부산 KCC,Away,이호현,2,0,0,0.0,0,0,0.0,0,0,0.0,2,2,100.0,0,0,0,2,1,0,0,0,3,1
../kbl_data/2024-2025,S45G01N61,부산 KCC,Away,송교창,0,0,0,0.0,0,0,0.0,0,0,0.0,0,0,0.0,0,0,0,0,0,0,0,0,0,0
../kbl_data/2024-2025,S45G01N61,부산 KCC,Away,최준용,10,2,8,25.0,1,5,20.0,3,13,23.1,3,7,42.9,0,2,2,6,0,2,0,0,2,1
../kbl_data/2024-2025,S45G01N61,부산 KCC,Away,디온테 버튼,29,9,18,50.0,1,2,50.0,10,20,50.0,8,9,88.9,4,16,20,3,0,0,0,1,0,1
../kbl_data/2024-2025,S45G01N61,부산 KCC,Away,이근휘,0,0,0,0.0,0,1,0.0,0,1,0.0,0,0,0.0,0,1,1,0,0,0,0,0,1,0
../kbl_data/2024-2025,S45G01N61,부산 KCC,Away,김동현,0,0,0,0.0,0,0,0.0,0,0,0.0,0,0,0.0,0,1,1,0,0,0,0,0,1,2
../kbl_data/2024-2025,S45G01N61,부산 KCC,Away,캘빈 제프리 에피스톨라,0,0,1,0.0,0,0,0.0,0,1,0.0,0,0,0.0,0,0,0,1,0,0,1,0,0,4
../kbl_data/2024-2025,S45G01N62,대구 한국가스공사,Home,차바위,3,0,0,0.0,1,2,50.0,1,2,50.0,0,0,0.0,1,1,2,1,1,0,0,0,1,3
../kbl_data/2024-2025,S45G01N62,대구 한국가스공사,Home,박지훈,28,8,18,44.4,4,10,40.0,12,28,42.9,0,0,0.0,6,6,12,12,4,2,0,0,4,8
../kbl_data/2024-2025,S45G01N62,대구 한국가스공사,Home,이대헌,15,4,11,36.4,2,5,40.0,6,16,37.5,1,2,50.0,2,2,4,2,2,0,0,0,0,2
../kbl_data/2024-2025,S45G01N62,대구 한국가스공사,Home,정성우,12,0,1,0.0,3,5,60.0,3,6,50.0,3,4,75.0,1,1,2,2,2,0,0,0,3,5
../kbl_data/2024-2025,S45G01N62,대구 한국가스공사,Home,김철욱,0,0,1,0.0,0,0,0.0,0,1,0.0,0,0,0.0,0,0,0,0,0,0,0,0,0,1
../kbl_data/2024-2025,S45G01N62,대구 한국가스공사,Home,김낙현,6,0,2,0.0,2,6,33.3,2,8,25.0,0,0,0.0,1,0,1,2,0,0,0,0,1,2
../kbl_data/2024-2025,S45G01N62,대구 한국가스공사,Home,곽정훈,0,0,2,0.0,0,0,0.0,0,2,0.0,0,0,0.0,1,1,2,0,0,0,1,0,0,0
../kbl_data/2024-2025,S45G01N62,대구 한국가스공사,Home,앤드류 니콜슨,18,2,14,14.3,4,8,50.0,6,22,27.3,2,2,100.0,4,6,10,1,2,0,0,0,1,1
../kbl_data/2024-2025,S45G01N62,대구 한국가스공사,Home,신승민,3,0,0,0.0,1,3,33.3,1,3,33.3,0,0,0.0,2,1,3,2,1,0,0,0,0,2
../kbl_data/2024-2025,S45G01N62,대구 한국가스공사,Home,샘조세프 벨란겔,13,2,3,66.7,2,6,33.3,4,9,44.4,3,4,75.0,0,3,3,5,0,1,0,0,1,4
../kbl_data/2024-2025,S45G01N62,대구 한국가스공사,Home,유슈 은도예,13,4,5,80.0,1,1,100.0,5,6,83.3,2,3,66.7,1,6,7,4,0,2,0,1,0,2
../kbl_data/2024-2025,S45G01N62,대구 한국가스공사,Home,신주영,0,0,0,0.0,0,0,0.0,0,0,0.0,0,0,0.0,0,0,0,0,0,0,0,0,0,0
../kbl_data/2024-2025,S45G01N62,안양 정관장,Away,송창용,0,0,0,0.0,0,1,0.0,0,1,0.0,0,0,0.0,0,0,0,0,0,0,0,0,0,2
../kbl_data/2024-2025,S45G01N62,안양 정관장,Away,배병준,15,2,3,66.7,3,6,50.0,5,9,55.6,2,2,100.0,0,2,2,2,0,0,1,0,2,4
../kbl_data/2024-2025,S45G01N62,안양 정관장,Away,정효근,14,3,4,75.0,1,1,100.0,4,5,80.0,5,5,100.0,2,6,8,1,0,0,0,1,1,2
../kbl_data/2024-2025,S45G01N62,안양 정관장,Away,이종현,2,0,1,0.0,0,1,0.0,0,2,0.0,2,2,100.0,0,2,2,1,0,0,0,0,0,0
../kbl_data/2024-2025,S45G01N62,안양 정관장,Away,박지훈,28,8,18,44.4,4,10,40.0,12,28,42.9,0,0,0.0,6,6,12,12,4,2,0,0,4,8
../kbl_data/2024-2025,S45G01N62,안양 정관장,Away,최성원,0,0,1,0.0,0,2,0.0,0,3,0.0,0,0,0.0,0,0,0,0,0,0,0,0,0,0
../kbl_data/2024-2025,S45G01N62,안양 정관장,Away,변준형,10,4,4,100.0,0,7,0.0,4,11,36.4,2,2,100.0,1,4,5,3,0,0,0,0,3,2
../kbl_data/2024-2025,S45G01N62,안양 정관장,Away,캐디 라렌,15,5,8,62.5,1,2,50.0,6,10,60.0,2,3,66.7,0,12,12,2,0,7,0,1,4,3
../kbl_data/2024-2025,S45G01N62,안양 정관장,Away,박찬호,0,0,0,0.0,0,0,0.0,0,0,0.0,0,0,0.0,0,0,0,0,0,0,0,0,0,0
../kbl_data/2024-2025,S45G01N62,안양 정관장,Away,한승희,10,3,6,50.0,1,1,100.0,4,7,57.1,1,2,50.0,1,3,4,3,0,0,0,0,1,4
../kbl_data/2024-2025,S45G01N62,안양 정관장,Away,하비 고메즈,0,0,0,0.0,0,0,0.0,0,0,0.0,0,0,0.0,0,0,0,0,0,0,0,0,0,0
../kbl_data/2024-2025,S45G01N62,안양 정관장,Away,박정웅,0,0,0,0.0,0,0,0.0,0,0,0.0,0,0,0.0,0,0,0,0,0,0,0,0,0,0
../kbl_data/2024-2025,S45G01N63,서울 삼성,Home,이정현,19,7,10,70.0,1,5,20.0,8,15,53.3,2,4,50.0,1,3,4,4,2,0,0,0,2,2
../kbl_data/2024-2025,S45G01N63,서울 삼성,Home,최현민,2,1,1,100.0,0,1,0.0,1,2,50.0,0,0,0.0,2,0,2,2,2,0,0,0,1,2
../kbl_data/2024-2025,S45G01N63,서울 삼성,Home,이원대,0,0,2,0.0,0,1,0.0,0,3,0.0,0,0,0.0,0,2,2,0,2,0,0,0,0,1
../kbl_data/2024-2025,S45G01N63,서울 삼성,Home,최성모,14,2,3,66.7,3,7,42.9,5,10,50.0,1,1,100.0,0,2,2,6,1,1,0,0,4,3
../kbl_data/2024-2025,S45G01N63,서울 삼성,Home,최승욱,4,2,3,66.7,0,2,0.0,2,5,40.0,0,1,0.0,2,2,4,0,0,0,0,0,0,1
../kbl_data/2024-2025,S45G01N63,서울 삼성,Home,김한솔,0,0,0,0.0,0,0,0.0,0,0,0.0,0,0,0.0,0,0,0,0,0,0,0,0,0,0
../kbl_data/2024-2025,S45G01N63,서울 삼성,Home,마커스 데릭슨,9,4,7,57.1,0,5,0.0,4,12,33.3,1,2,50.0,3,2,5,0,1,1,0,0,0,3
../kbl_data/2024-2025,S45G01N63,서울 삼성,Home,차민석,2,1,1,100.0,0,2,0.0,1,3,33.3,0,0,0.0,1,2,3,0,0,0,0,0,2,3
../kbl_data/2024-2025,S45G01N63,서울 삼성,Home,이원석,15,5,13,38.5,0,1,0.0,5,14,35.7,5,7,71.4,2,5,7,0,1,2,0,0,0,2
../kbl_data/2024-2025,S45G01N63,서울 삼성,Home,저스틴 구탕,6,1,2,50.0,0,0,0.0,1,2,50.0,4,4,100.0,0,2,2,1,0,0,0,0,2,2
../kbl_data/2024-2025,S45G01N63,서울 삼성,Home,박승재,0,0,1,0.0,0,1,0.0,0,2,0.0,0,0,0.0,0,1,1,1,0,0,0,0,1,1
../kbl_data/2024-2025,S45G01N63,서울 삼성,Home,임동언,0,0,0,0.0,0,1,0.0,0,1,0.0,0,0,0.0,0,1,1,0,0,0,0,0,0,1
../kbl_data/2024-2025,S45G01N63,울산 현대모비스,Away,함지훈,9,4,7,57.1,0,0,0.0,4,7,57.1,1,4,25.0,3,4,7,4,0,0,0,0,0,4
../kbl_data/2024-2025,S45G01N63,울산 현대모비스,Away,장재석,4,1,3,33.3,0,0,0.0,1,3,33.3,2,2,100.0,1,0,1,2,0,0,0,1,0,3
../kbl_data/2024-2025,S45G01N63,울산 현대모비스,Away,김지완,0,0,0,0.0,0,0,0.0,0,0,0.0,0,0,0.0,0,0,0,1,0,0,0,0,0,0
../kbl_data/2024-2025,S45G01N63,울산 현대모비스,Away,한호빈,5,0,1,0.0,1,1,100.0,1,2,50.0,2,2,100.0,0,1,1,0,3,0,0,0,2,3
../kbl_data/2024-2025,S45G01N63,울산 현대모비스,Away,서명진,6,0,2,0.0,2,2,100.0,2,4,50.0,0,0,0.0,0,2,2,5,0,0,0,0,1,3
../kbl_data/2024-2025,S45G01N63,울산 현대모비스,Away,숀 롱,19,9,10,90.0,0,0,0.0,9,10,90.0,1,2,50.0,3,5,8,3,1,1,0,2,4,3
../kbl_data/2024-2025,S45G01N63,울산 현대모비스,Away,이우석,17,1,2,50.0,5,9,55.6,6,11,54.5,0,0,0.0,1,6,7,4,0,0,0,0,1,2
../kbl_data/2024-2025,S45G01N63,울산 현대모비스,Away,이승우,0,0,0,0.0,0,0,0.0,0,0,0.0,0,0,0.0,1,0,1,0,0,0,0,0,0,0
../kbl_data/2024-2025,S45G01N63,울산 현대모비스,Away,신민석,0,0,1,0.0,0,4,0.0,0,5,0.0,0,0,0.0,0,2,2,0,1,0,0,0,0,0
../kbl_data/2024-2025,S45G01N63,울산 현대모비스,Away,게이지 프림,11,3,12,25.0,0,1,0.0,3,13,23.1,5,6,83.3,1,4,5,1,1,1,0,2,1,1
../kbl_data/2024-2025,S45G01N63,울산 현대모비스,Away,박무빈,10,5,8,62.5,0,1,0.0,5,9,55.6,0,0,0.0,0,2,2,2,2,0,0,0,0,1
../kbl_data/2024-2025,S45G01N63,울산 현대모비스,Away,미구엘 안드레 옥존,6,0,2,0.0,2,3,66.7,2,5,40.0,0,0,0.0,0,2,2,1,1,0,0,0,1,1
../kbl_data/2024-2025,S45G01N64,대구 한국가스공사,Home,차바위,3,0,0,0.0,1,2,50.0,1,2,50.0,0,0,0.0,0,1,1,2,0,0,0,0,1,2
../kbl_data/2024-2025,S45G01N64,대구 한국가스공사,Home,박지훈,4,1,1,100.0,0,0,0.0,1,1,100.0,2,2,100.0,0,2,2,0,0,0,0,0,1,0
../kbl_data/2024-2025,S45G01N64,대구 한국가스공사,Home,이대헌,11,5,7,71.4,0,2,0.0,5,9,55.6,1,2,50.0,2,3,5,2,3,0,0,0,1,4
../kbl_data/2024-2025,S45G01N64,대구 한국가스공사,Home,정성우,5,1,1,100.0,1,1,100.0,2,2,100.0,0,1,0.0,0,5,5,4,2,0,0,0,1,4
../kbl_data/2024-2025,S45G01N64,대구 한국가스공사,Home,김낙현,0,0,0,0.0,0,2,0.0,0,2,0.0,0,0,0.0,1,1,2,1,0,0,0,0,1,2
../kbl_data/2024-2025,S45G01N64,대구 한국가스공사,Home,우동현,0,0,1,0.0,0,3,0.0,0,4,0.0,0,0,0.0,0,1,1,0,0,0,0,0,0,0
../kbl_data/2024-2025,S45G01N64,대구 한국가스공사,Home,곽정훈,0,0,0,0.0,0,2,0.0,0,2,0.0,0,0,0.0,0,2,2,1,0,0,0,0,0,2
../kbl_data/2024-2025,S45G01N64,대구 한국가스공사,Home,앤드류 니콜슨,9,2,5,40.0,1,2,50.0,3,7,42.9,2,5,40.0,0,3,3,2,0,1,0,0,0,1
../kbl_data/2024-2025,S45G01N64,대구 한국가스공사,Home,신승민,25,4,6,66.7,5,6,83.3,9,12,75.0,2,4,50.0,4,2,6,2,1,0,0,0,2,0
../kbl_data/2024-2025,S45G01N64,대구 한국가스공사,Home,샘조세프 벨란겔,14,3,5,60.0,1,3,33.3,4,8,50.0,5,5,100.0,0,4,4,6,0,0,0,0,2,2
../kbl_data/2024-2025,S45G01N64,대구 한국가스공사,Home,유슈 은도예,13,5,6,83.3,0,1,0.0,5,7,71.4,3,6,50.0,1,7,8,2,2,0,0,1,3,2
../kbl_data/2024-2025,S45G01N64,대구 한국가스공사,Home,신주영,1,0,0,0.0,0,1,0.0,0,1,0.0,1,2,50.0,0,1,1,0,0,0,0,0,1,1
../kbl_data/2024-2025,S45G01N64,고양 소노,Away,정희재,4,0,4,0.0,1,2,50.0,1,6,16.7,1,2,50.0,1,2,3,0,0,0,0,0,0,3
../kbl_data/2024-2025,S45G01N64,고양 소노,Away,임동섭,3,1,1,100.0,0,1,0.0,1,2,50.0,1,2,50.0,0,0,0,0,1,0,0,0,0,0
../kbl_data/2024-2025,S45G01N64,고양 소노,Away,김민욱,9,0,1,0.0,2,5,40.0,2,6,33.3,3,4,75.0,1,5,6,2,1,0,0,0,1,2
../kbl_data/2024-2025,S45G01N64,고양 소노,Away,이재도,12,3,5,60.0,2,5,40.0,5,10,50.0,0,0,0.0,0,2,2,3,2,0,0,0,4,1
../kbl_data/2024-2025,S45G01N64,고양 소노,Away,최승욱,8,1,4,25.0,2,3,66.7,3,7,42.9,0,0,0.0,1,4,5,0,0,0,0,0,0,2
../kbl_data/2024-2025,S45G01N64,고양 소노,Away,김진유,0,0,0,0.0,0,2,0.0,0,2,0.0,0,0,0.0,1,1,2,0,0,0,0,0,1,2
../kbl_data/2024-2025,S45G01N64,고양 소노,Away,박진철,0,0,1,0.0,0,0,0.0,0,1,0.0,0,0,0.0,1,0,1,0,0,0,0,0,0,1
../kbl_data/2024-2025,S45G01N64,고양 소노,Away,박종하,2,1,2,50.0,0,2,0.0,1,4,25.0,0,0,0.0,0,0,0,1,0,0,0,0,3,4
../kbl_data/2024-2025,S45G01N64,고양 소노,Away,민기남,5,1,2,50.0,1,3,33.3,2,5,40.0,0,0,0.0,1,0,1,1,1,0,0,0,1,2
../kbl_data/2024-2025,S45G01N64,고양 소노,Away,디제이 번즈 Jr,17,7,12,58.3,0,0,0.0,7,12,58.3,3,4,75.0,0,4,4,4,0,0,0,0,1,1
../kbl_data/2024-2025,S45G01N64,고양 소노,Away,이근준,3,0,0,0.0,1,4,25.0,1,4,25.0,0,0,0.0,0,2,2,0,1,0,0,0,0,3
../kbl_data/2024-2025,S45G01N64,고양 소노,Away,서동원,0,0,0,0.0,0,1,0.0,0,1,0.0,0,0,0.0,0,0,0,0,0,0,0,0,0,1
../kbl_data/2024-2025,S45G01N65,원주 DB,Home,이관희,19,3,3,100.0,4,9,44.4,7,12,58.3,1,3,33.3,0,3,3,0,2,1,0,0,0,3
../kbl_data/2024-2025,S45G01N65,원주 DB,Home,김시래,6,3,3,100.0,0,0,0.0,3,3,100.0,0,0,0.0,0,0,0,2,0,0,0,0,4,3
../kbl_data/2024-2025,S45G01N65,원주 DB,Home,서민수,8,1,1,100.0,2,2,100.0,3,3,100.0,0,1,0.0,1,0,1,1,0,0,0,0,0,4
../kbl_data/2024-2025,S45G01N65,원주 DB,Home,김영현,3,0,0,0.0,1,3,33.3,1,3,33.3,0,0,0.0,1,1,2,0,1,0,0,0,0,0
../kbl_data/2024-2025,S45G01N65,원주 DB,Home,박봉진,2,1,1,100.0,0,2,0.0,1,3,33.3,0,0,0.0,1,0,1,3,3,0,1,0,0,1
../kbl_data/2024-2025,S45G01N65,원주 DB,Home,강상재,2,1,2,50.0,0,1,0.0,1,3,33.3,0,0,0.0,2,5,7,2,0,0,0,0,0,1
../kbl_data/2024-2025,S45G01N65,원주 DB,Home,치나누 오누아쿠,10,5,8,62.5,0,2,0.0,5,10,50.0,0,0,0.0,0,3,3,2,2,1,0,1,3,1
../kbl_data/2024-2025,S45G01N65,원주 DB,Home,이용우,8,1,1,100.0,2,5,40.0,3,6,50.0,0,0,0.0,0,5,5,4,1,0,0,0,0,2
../kbl_data/2024-2025,S45G01N65,원주 DB,Home,이선 알바노,21,3,7,42.9,5,7,71.4,8,14,57.1,0,0,0.0,1,4,5,6,2,0,0,0,1,3
../kbl_data/2024-2025,S45G01N65,원주 DB,Home,박인웅,8,1,3,33.3,2,3,66.7,3,6,50.0,0,0,0.0,0,1,1,0,1,0,0,0,0,1
../kbl_data/2024-2025,S45G01N65,원주 DB,Home,로버트 카터,9,2,3,66.7,1,4,25.0,3,7,42.9,2,2,100.0,0,4,4,8,1,1,0,0,1,1
../kbl_data/2024-2025,S45G01N65,원주 DB,Home,김보배,2,1,4,25.0,0,0,0.0,1,4,25.0,0,0,0.0,0,1,1,1,0,1,0,0,0,0
../kbl_data/2024-2025,S45G01N65,안양 정관장,Away,정준원,4,1,1,100.0,0,0,0.0,1,1,100.0,2,2,100.0,0,0,0,0,1,0,0,0,0,1
../kbl_data/2024-2025,S45G01N65,안양 정관장,Away,배병준,0,0,1,0.0,0,3,0.0,0,4,0.0,0,0,0.0,3,2,5,1,0,0,0,0,1,1
../kbl_data/2024-2025,S45G01N65,안양 정관장,Away,정효근,10,4,5,80.0,0,2,0.0,4,7,57.1,2,2,100.0,3,2,5,1,1,1,0,0,1,2
../kbl_data/2024-2025,S45G01N65,안양 정관장,Away,이종현,2,1,2,50.0,0,1,0.0,1,3,33.3,0,0,0.0,0,1,1,2,0,0,0,0,0,0
../kbl_data/2024-2025,S45G01N65,안양 정관장,Away,박지훈,14,5,5,100.0,0,3,0.0,5,8,62.5,4,4,100.0,0,4,4,5,3,0,0,0,1,5
../kbl_data/2024-2025,S45G01N65,안양 정관장,Away,최성원,2,1,3,33.3,0,1,0.0,1,4,25.0,0,0,0.0,0,0,0,6,1,0,0,0,0,0
../kbl_data/2024-2025,S45G01N65,안양 정관장,Away,변준형,2,1,5,20.0,0,6,0.0,1,11,9.1,0,0,0.0,0,0,0,3,1,0,0,0,2,1
../kbl_data/2024-2025,S45G01N65,안양 정관장,Away,캐디 라렌,16,4,8,50.0,1,5,20.0,5,13,38.5,5,6,83.3,0,9,9,0,1,2,0,1,2,1
../kbl_data/2024-2025,S45G01N65,안양 정관장,Away,한승희,8,1,2,50.0,1,2,50.0,2,4,50.0,3,3,100.0,2,3,5,0,0,0,0,0,3,3
../kbl_data/2024-2025,S45G01N65,안양 정관장,Away,하비 고메즈,2,1,2,50.0,0,0,0.0,1,2,50.0,0,0,0.0,1,1,2,0,0,0,0,0,1,1
../kbl_data/2024-2025,S45G01N65,안양 정관장,Away,마이클 영 Jr,2,1,5,20.0,0,1,0.0,1,6,16.7,0,0,0.0,0,7,7,1,0,0,0,0,2,0
../kbl_data/2024-2025,S45G01N65,안양 정관장,Away,박정웅,5,2,6,33.3,0,0,0.0,2,6,33.3,1,2,50.0,3,0,3,0,0,0,0,0,2,2
../kbl_data/2024-2025,S45G01N66,울산 현대모비스,Home,함지훈,2,1,2,50.0,0,1,0.0,1,3,33.3,0,0,0.0,1,2,3,2,0,0,0,0,0,1
../kbl_data/2024-2025,S45G01N66,울산 현대모비스,Home,장재석,12,5,9,55.6,0,0,0.0,5,9,55.6,2,2,100.0,0,5,5,2,3,0,0,1,1,2
../kbl_data/2024-2025,S45G01N66,울산 현대모비스,Home,김지완,0,0,0,0.0,0,0,0.0,0,0,0.0,0,0,0.0,0,0,0,0,0,0,0,0,0,2
../kbl_data/2024-2025,S45G01N66,울산 현대모비스,Home,한호빈,8,1,3,33.3,2,3,66.7,3,6,50.0,0,0,0.0,0,2,2,2,2,0,0,0,1,2
../kbl_data/2024-2025,S45G01N66,울산 현대모비스,Home,서명진,6,2,3,66.7,0,3,0.0,2,6,33.3,2,2,100.0,0,2,2,8,0,0,0,0,2,1
../kbl_data/2024-2025,S45G01N66,울산 현대모비스,Home,숀 롱,22,8,10,80.0,0,1,0.0,8,11,72.7,6,8,75.0,2,11,13,0,0,0,0,2,1,2
../kbl_data/2024-2025,S45G01N66,울산 현대모비스,Home,이우석,2,0,4,0.0,0,3,0.0,0,7,0.0,2,2,100.0,0,1,1,2,2,0,1,0,2,3
../kbl_data/2024-2025,S45G01N66,울산 현대모비스,Home,이승우,0,0,0,0.0,0,0,0.0,0,0,0.0,0,0,0.0,0,0,0,0,0,0,0,0,0,0
../kbl_data/2024-2025,S45G01N66,울산 현대모비스,Home,신민석,0,0,1,0.0,0,0,0.0,0,1,0.0,0,0,0.0,0,0,0,1,0,0,0,0,0,0
../kbl_data/2024-2025,S45G01N66,울산 현대모비스,Home,게이지 프림,18,9,13,69.2,0,2,0.0,9,15,60.0,0,0,0.0,1,5,6,0,2,0,0,0,0,1
../kbl_data/2024-2025,S45G01N66,울산 현대모비스,Home,박무빈,8,4,6,66.7,0,0,0.0,4,6,66.7,0,0,0.0,1,2,3,3,0,0,1,0,1,1
../kbl_data/2024-2025,S45G01N66,울산 현대모비스,Home,미구엘 안드레 옥존,5,2,4,50.0,0,1,0.0,2,5,40.0,1,2,50.0,1,1,2,1,1,0,1,0,0,3
../kbl_data/2024-2025,S45G01N66,창원 LG,Away,허일영,1,0,0,0.0,0,0,0.0,0,0,0.0,1,2,50.0,0,1,1,0,0,0,0,0,0,0
../kbl_data/2024-2025,S45G01N66,창원 LG,Away,장민국,0,0,0,0.0,0,0,0.0,0,0,0.0,0,0,0.0,0,0,0,0,0,0,0,0,0,0
../kbl_data/2024-2025,S45G01N66,창원 LG,Away,한상혁,5,1,1,100.0,1,3,33.3,2,4,50.0,0,0,0.0,0,1,1,5,0,0,0,0,3,0
../kbl_data/2024-2025,S45G01N66,창원 LG,Away,전성현,11,1,4,25.0,3,6,50.0,4,10,40.0,0,0,0.0,0,0,0,1,1,0,0,0,1,2
../kbl_data/2024-2025,S45G01N66,창원 LG,Away,정인덕,2,1,1,100.0,0,1,0.0,1,2,50.0,0,0,0.0,0,0,0,0,1,0,0,0,0,0
../kbl_data/2024-2025,S45G01N66,창원 LG,Away,대릴 먼로,6,2,3,66.7,0,0,0.0,2,3,66.7,2,2,100.0,0,3,3,1,0,0,0,0,1,3
../kbl_data/2024-2025,S45G01N66,창원 LG,Away,박정현,2,1,4,25.0,0,0,0.0,1,4,25.0,0,0,0.0,1,3,4,0,0,0,0,0,2,3
../kbl_data/2024-2025,S45G01N66,창원 LG,Away,아셈 마레이,14,7,12,58.3,0,0,0.0,7,12,58.3,0,2,0.0,4,9,13,2,2,0,0,0,1,5
../kbl_data/2024-2025,S45G01N66,창원 LG,Away,양준석,12,1,8,12.5,3,5,60.0,4,13,30.8,1,2,50.0,1,0,1,9,0,1,0,0,2,2
../kbl_data/2024-2025,S45G01N66,창원 LG,Away,유기상,10,2,3,66.7,2,6,33.3,4,9,44.4,0,0,0.0,0,5,5,0,1,0,0,0,1,2
../kbl_data/2024-2025,S45G01N66,창원 LG,Away,이경도,0,0,0,0.0,0,0,0.0,0,0,0.0,0,0,0.0,0,0,0,0,0,0,0,0,0,0
../kbl_data/2024-2025,S45G01N66,창원 LG,Away,칼 타마요,12,6,10,60.0,0,3,0.0,6,13,46.2,0,0,0.0,3,3,6,1,0,0,0,0,2,4
../kbl_data/2024-2025,S45G01N67,대구 한국가스공사,Home,차바위,3,0,0,0.0,0,1,0.0,0,1,0.0,3,4,75.0,0,1,1,0,0,0,0,0,0,1
../kbl_data/2024-2025,S45G01N67,대구 한국가스공사,Home,박지훈,0,0,0,0.0,0,0,0.0,0,0,0.0,0,0,0.0,0,0,0,0,0,0,0,0,0,0
../kbl_data/2024-2025,S45G01N67,대구 한국가스공사,Home,이대헌,10,5,9,55.6,0,2,0.0,5,11,45.5,0,0,0.0,3,1,4,1,1,0,0,0,1,3
../kbl_data/2024-2025,S45G01N67,대구 한국가스공사,Home,정성우,2,1,2,50.0,0,1,0.0,1,3,33.3,0,0,0.0,0,1,1,3,2,0,2,0,4,3
../kbl_data/2024-2025,S45G01N67,대구 한국가스공사,Home,김낙현,6,0,0,0.0,2,4,50.0,2,4,50.0,0,0,0.0,1,0,1,2,0,0,0,0,1,1
../kbl_data/2024-2025,S45G01N67,대구 한국가스공사,Home,우동현,0,0,0,0.0,0,0,0.0,0,0,0.0,0,0,0.0,1,1,2,1,1,0,0,0,1,0
../kbl_data/2024-2025,S45G01N67,대구 한국가스공사,Home,곽정훈,2,1,2,50.0,0,2,0.0,1,4,25.0,0,0,0.0,2,2,4,0,1,0,0,0,0,2
../kbl_data/2024-2025,S45G01N67,대구 한국가스공사,Home,앤드류 니콜슨,8,2,7,28.6,1,4,25.0,3,11,27.3,1,2,50.0,0,7,7,1,0,0,0,0,1,1
../kbl_data/2024-2025,S45G01N67,대구 한국가스공사,Home,신승민,4,2,4,50.0,0,4,0.0,2,8,25.0,0,0,0.0,0,4,4,4,2,0,0,0,1,3
../kbl_data/2024-2025,S45G01N67,대구 한국가스공사,Home,샘조세프 벨란겔,7,2,6,33.3,1,3,33.3,3,9,33.3,0,0,0.0,0,2,2,3,1,0,0,0,2,1
../kbl_data/2024-2025,S45G01N67,대구 한국가스공사,Home,유슈 은도예,12,4,8,50.0,0,1,0.0,4,9,44.4,4,5,80.0,1,3,4,1,1,1,0,0,2,2
../kbl_data/2024-2025,S45G01N67,대구 한국가스공사,Home,신주영,5,1,2,50.0,1,3,33.3,2,5,40.0,0,0,0.0,0,0,0,1,0,1,0,0,0,0
../kbl_data/2024-2025,S45G01N67,서울 삼성,Away,이정현,5,1,5,20.0,1,5,20.0,2,10,20.0,0,0,0.0,0,3,3,6,0,0,0,0,2,3
../kbl_data/2024-2025,S45G01N67,서울 삼성,Away,최현민,8,1,1,100.0,2,2,100.0,3,3,100.0,0,0,0.0,0,0,0,1,0,0,0,0,0,2
../kbl_data/2024-2025,S45G01N67,서울 삼성,Away,이원대,5,1,4,25.0,1,2,50.0,2,6,33.3,0,0,0.0,0,3,3,4,1,0,0,0,2,1
../kbl_data/2024-2025,S45G01N67,서울 삼성,Away,최성모,14,4,7,57.1,1,4,25.0,5,11,45.5,3,4,75.0,2,5,7,2,0,0,1,0,3,2
../kbl_data/2024-2025,S45G01N67,서울 삼성,Away,최승욱,2,1,1,100.0,0,3,0.0,1,4,25.0,0,0,0.0,0,3,3,0,0,0,0,0,0,4
../kbl_data/2024-2025,S45G01N67,서울 삼성,Away,김한솔,0,0,0,0.0,0,1,0.0,0,1,0.0,0,0,0.0,0,0,0,0,0,0,0,0,0,0
../kbl_data/2024-2025,S45G01N67,서울 삼성,Away,마커스 데릭슨,13,3,8,37.5,2,2,100.0,5,10,50.0,1,2,50.0,1,5,6,0,1,1,1,0,3,3
../kbl_data/2024-2025,S45G01N67,서울 삼성,Away,차민석,0,0,1,0.0,0,0,0.0,0,1,0.0,0,0,0.0,0,0,0,0,0,0,0,0,0,1
../kbl_data/2024-2025,S45G01N67,서울 삼성,Away,이원석,18,9,10,90.0,0,1,0.0,9,11,81.8,0,0,0.0,4,7,11,2,2,3,0,1,2,1
../kbl_data/2024-2025,S45G01N67,서울 삼성,Away,저스틴 구탕,3,1,2,50.0,0,1,0.0,1,3,33.3,1,1,100.0,0,4,4,0,0,0,0,0,1,3
../kbl_data/2024-2025,S45G01N67,서울 삼성,Away,박승재,6,0,0,0.0,2,4,50.0,2,4,50.0,0,0,0.0,0,3,3,1,1,0,0,0,2,1
../kbl_data/2024-2025,S45G01N67,서울 삼성,Away,황영찬,0,0,0,0.0,0,0,0.0,0,0,0.0,0,0,0.0,0,0,0,0,0,0,0,0,0,0
../kbl_data/2024-2025,S45G01N68,안양 정관장,Home,송창용,0,0,0,0.0,0,0,0.0,0,0,0.0,0,0,0.0,0,0,0,0,0,0,0,0,0,0
../kbl_data/2024-2025,S45G01N68,안양 정관장,Home,배병준,16,0,6,0.0,4,9,44.4,4,15,26.7,4,4,100.0,0,3,3,2,1,0,0,0,2,2
../kbl_data/2024-2025,S45G01N68,안양 정관장,Home,정효근,0,0,2,0.0,0,0,0.0,0,2,0.0,0,0,0.0,0,1,1,0,0,0,0,0,0,0
../kbl_data/2024-2025,S45G01N68,안양 정관장,Home,이종현,2,1,1,100.0,0,1,0.0,1,2,50.0,0,0,0.0,4,3,7,1,0,1,0,0,3,1
../kbl_data/2024-2025,S45G01N68,안양 정관장,Home,박지훈,4,0,2,0.0,1,2,50.0,1,4,25.0,1,2,50.0,1,5,6,7,1,4,0,0,1,4
../kbl_data/2024-2025,S45G01N68,안양 정관장,Home,최성원,0,0,0,0.0,0,0,0.0,0,0,0.0,0,0,0.0,0,0,0,0,0,0,0,0,1,0
../kbl_data/2024-2025,S45G01N68,안양 정관장,Home,변준형,14,2,5,40.0,3,6,50.0,5,11,45.5,1,2,50.0,0,2,2,5,1,1,0,0,1,3
../kbl_data/2024-2025,S45G01N68,안양 정관장,Home,캐디 라렌,20,10,14,71.4,0,1,0.0,10,15,66.7,0,0,0.0,1,10,11,1,0,0,0,1,7,2
../kbl_data/2024-2025,S45G01N68,안양 정관장,Home,한승희,5,2,4,50.0,0,1,0.0,2,5,40.0,1,2,50.0,1,9,10,0,0,0,0,0,2,4
../kbl_data/2024-2025,S45G01N68,안양 정관장,Home,하비 고메즈,4,2,3,66.7,0,2,0.0,2,5,40.0,0,0,0.0,1,3,4,2,1,0,0,0,0,1
../kbl_data/2024-2025,S45G01N68,안양 정관장,Home,마이클 영 Jr,2,1,3,33.3,0,1,0.0,1,4,25.0,0,0,0.0,1,1,2,1,0,0,0,0,0,0
../kbl_data/2024-2025,S45G01N68,안양 정관장,Home,박정웅,2,1,1,100.0,0,0,0.0,1,1,100.0,0,0,0.0,0,0,0,0,0,0,0,0,0,0
../kbl_data/2024-2025,S45G01N68,서울 SK,Away,김선형,17,4,7,57.1,3,4,75.0,7,11,63.6,0,0,0.0,0,1,1,5,1,0,0,0,3,3
../kbl_data/2024-2025,S45G01N68,서울 SK,Away,오세근,7,2,4,50.0,1,3,33.3,3,7,42.9,0,0,0.0,1,1,2,1,0,0,0,0,0,3
../kbl_data/2024-2025,S45G01N68,서울 SK,Away,최부경,5,2,3,66.7,0,1,0.0,2,4,50.0,1,1,100.0,1,2,3,2,0,0,1,0,0,2
../kbl_data/2024-2025,S45G01N68,서울 SK,Away,최원혁,0,0,0,0.0,0,1,0.0,0,1,0.0,0,0,0.0,0,0,0,0,0,0,0,0,0,2
../kbl_data/2024-2025,S45G01N68,서울 SK,Away,장문호,0,0,0,0.0,0,2,0.0,0,2,0.0,0,0,0.0,0,1,1,0,0,0,0,0,0,0
../kbl_data/2024-2025,S45G01N68,서울 SK,Away,안영준,7,2,8,25.0,0,4,0.0,2,12,16.7,3,6,50.0,1,8,9,3,2,0,0,0,2,1
../kbl_data/2024-2025,S45G01N68,서울 SK,Away,자밀 워니,18,5,10,50.0,2,5,40.0,7,15,46.7,2,2,100.0,1,11,12,2,4,0,0,0,1,2
../kbl_data/2024-2025,S45G01N68,서울 SK,Away,김형빈,0,0,1,0.0,0,0,0.0,0,1,0.0,0,0,0.0,0,0,0,0,0,0,0,0,0,0
../kbl_data/2024-2025,S45G01N68,서울 SK,Away,아이재아 힉스,4,2,2,100.0,0,0,0.0,2,2,100.0,0,0,0.0,0,0,0,0,1,0,0,1,0,1
../kbl_data/2024-2025,S45G01N68,서울 SK,Away,박민우,0,0,0,0.0,0,0,0.0,0,0,0.0,0,0,0.0,0,0,0,0,0,0,0,0,0,0
../kbl_data/2024-2025,S45G01N68,서울 SK,Away,오재현,15,6,9,66.7,1,7,14.3,7,16,43.8,0,1,0.0,0,1,1,3,3,0,0,0,0,3
../kbl_data/2024-2025,S45G01N68,서울 SK,Away,고메즈 델 리아노,0,0,0,0.0,0,1,0.0,0,1,0.0,0,0,0.0,1,1,2,0,0,0,0,0,0,2
../kbl_data/2024-2025,S45G01N69,고양 소노,Home,함준후,0,0,0,0.0,0,0,0.0,0,0,0.0,0,0,0.0,0,0,0,0,0,0,0,0,0,0
../kbl_data/2024-2025,S45G01N69,고양 소노,Home,정희재,2,0,0,0.0,0,1,0.0,0,1,0.0,2,2,100.0,1,3,4,1,0,0,0,0,0,4
../kbl_data/2024-2025,S45G01N69,고양 소노,Home,임동섭,2,1,1,100.0,0,2,0.0,1,3,33.3,0,0,0.0,1,0,1,0,0,0,0,0,3,1
../kbl_data/2024-2025,S45G01N69,고양 소노,Home,김민욱,13,2,2,100.0,3,5,60.0,5,7,71.4,0,0,0.0,0,1,1,1,0,0,0,0,0,0
../kbl_data/2024-2025,S45G01N69,고양 소노,Home,이재도,8,1,2,50.0,2,10,20.0,3,12,25.0,0,0,0.0,0,0,0,1,1,0,0,0,2,4
../kbl_data/2024-2025,S45G01N69,고양 소노,Home,최승욱,6,0,1,0.0,2,4,50.0,2,5,40.0,0,0,0.0,0,4,4,2,0,1,0,0,1,0
../kbl_data/2024-2025,S45G01N69,고양 소노,Home,김진유,0,0,0,0.0,0,0,0.0,0,0,0.0,0,0,0.0,0,0,0,1,0,0,0,0,0,2
../kbl_data/2024-2025,S45G01N69,고양 소노,Home,박종하,0,0,0,0.0,0,0,0.0,0,0,0.0,0,0,0.0,0,1,1,2,0,0,0,0,1,0
../kbl_data/2024-2025,S45G01N69,고양 소노,Home,민기남,3,0,0,0.0,1,1,100.0,1,1,100.0,0,0,0.0,0,0,0,1,0,0,0,0,0,1
../kbl_data/2024-2025,S45G01N69,고양 소노,Home,앨런 윌리엄스,9,2,7,28.6,0,0,0.0,2,7,28.6,5,6,83.3,1,4,5,0,1,0,0,0,2,2
../kbl_data/2024-2025,S45G01N69,고양 소노,Home,디제이 번즈 Jr,15,7,10,70.0,0,0,0.0,7,10,70.0,1,2,50.0,1,6,7,2,0,1,0,0,2,1
../kbl_data/2024-2025,S45G01N69,고양 소노,Home,이근준,6,0,0,0.0,2,4,50.0,2,4,50.0,0,0,0.0,1,5,6,0,1,1,0,0,0,3
../kbl_data/2024-2025,S45G01N69,수원 KT,Away,한희원,9,1,5,20.0,2,8,25.0,3,13,23.1,1,2,50.0,1,1,2,2,0,0,0,0,0,4
../kbl_data/2024-2025,S45G01N69,수원 KT,Away,최창진,3,0,2,0.0,0,3,0.0,0,5,0.0,3,4,75.0,1,2,3,3,0,0,0,0,0,2
../kbl_data/2024-2025,S45G01N69,수원 KT,Away,문성곤,3,0,0,0.0,1,4,25.0,1,4,25.0,0,0,0.0,1,1,2,0,1,0,0,0,1,1
../kbl_data/2024-2025,S45G01N69,수원 KT,Away,박준영,18,4,7,57.1,3,8,37.5,7,15,46.7,1,2,50.0,4,3,7,3,1,0,1,0,1,2
../kbl_data/2024-2025,S45G01N69,수원 KT,Away,최진광,0,0,0,0.0,0,0,0.0,0,0,0.0,0,0,0.0,0,0,0,0,0,0,0,0,0,0
../kbl_data/2024-2025,S45G01N69,수원 KT,Away,박지원,10,2,4,50.0,2,7,28.6,4,11,36.4,0,0,0.0,0,3,3,5,1,1,0,0,1,4
../kbl_data/2024-2025,S45G01N69,수원 KT,Away,이두원,0,0,0,0.0,0,2,0.0,0,2,0.0,0,0,0.0,0,3,3,0,0,0,0,0,0,0
../kbl_data/2024-2025,S45G01N69,수원 KT,Away,박선웅,0,0,0,0.0,0,0,0.0,0,0,0.0,0,0,0.0,0,0,0,0,0,0,0,0,0,0
../kbl_data/2024-2025,S45G01N69,수원 KT,Away,고찬혁,0,0,0,0.0,0,0,0.0,0,0,0.0,0,0,0.0,0,0,0,0,0,0,0,0,0,0
../kbl_data/2024-2025,S45G01N69,수원 KT,Away,문정현,16,3,5,60.0,3,5,60.0,6,10,60.0,1,1,100.0,3,2,5,1,0,0,0,0,0,3
../kbl_data/2024-2025,S45G01N69,수원 KT,Away,레이션 해먼즈,13,4,7,57.1,1,4,25.0,5,11,45.5,2,3,66.7,4,7,11,1,2,0,0,0,1,3
../kbl_data/2024-2025,S45G01N69,수원 KT,Away,조환희,0,0,0,0.0,0,0,0.0,0,0,0.0,0,0,0.0,0,0,0,0,0,0,0,0,0,0
../kbl_data/2024-2025,S45G01N70,울산 현대모비스,Home,함지훈,7,1,3,33.3,1,1,100.0,2,4,50.0,2,2,100.0,4,1,5,3,1,1,0,0,0,2
../kbl_data/2024-2025,S45G01N70,울산 현대모비스,Home,장재석,2,1,2,50.0,0,0,0.0,1,2,50.0,0,0,0.0,0,0,0,2,1,0,0,0,1,3
../kbl_data/2024-2025,S45G01N70,울산 현대모비스,Home,김지완,0,0,0,0.0,0,0,0.0,0,0,0.0,0,0,0.0,0,0,0,0,0,0,0,0,0,0
../kbl_data/2024-2025,S45G01N70,울산 현대모비스,Home,한호빈,0,0,0,0.0,0,3,0.0,0,3,0.0,0,0,0.0,1,0,1,2,0,0,0,0,0,2
../kbl_data/2024-2025,S45G01N70,울산 현대모비스,Home,서명진,20,1,1,100.0,6,10,60.0,7,11,63.6,0,0,0.0,1,3,4,3,1,0,0,0,1,3
../kbl_data/2024-2025,S45G01N70,울산 현대모비스,Home,숀 롱,13,6,10,60.0,0,0,0.0,6,10,60.0,1,2,50.0,3,6,9,3,0,0,0,3,2,1
../kbl_data/2024-2025,S45G01N70,울산 현대모비스,Home,이우석,26,4,8,50.0,6,13,46.2,10,21,47.6,0,0,0.0,1,5,6,6,1,0,0,0,1,1
../kbl_data/2024-2025,S45G01N70,울산 현대모비스,Home,이승우,0,0,0,0.0,0,0,0.0,0,0,0.0,0,0,0.0,0,0,0,0,0,0,0,0,0,0
../kbl_data/2024-2025,S45G01N70,울산 현대모비스,Home,신민석,0,0,0,0.0,0,0,0.0,0,0,0.0,0,0,0.0,0,0,0,0,0,0,0,0,0,0
../kbl_data/2024-2025,S45G01N70,울산 현대모비스,Home,게이지 프림,14,5,11,45.5,0,0,0.0,5,11,45.5,4,4,100.0,3,4,7,1,0,0,0,0,0,1
../kbl_data/2024-2025,S45G01N70,울산 현대모비스,Home,박무빈,7,2,5,40.0,1,2,50.0,3,7,42.9,0,0,0.0,0,0,0,4,1,0,1,0,1,2
../kbl_data/2024-2025,S45G01N70,울산 현대모비스,Home,미구엘 안드레 옥존,0,0,0,0.0,0,3,0.0,0,3,0.0,0,0,0.0,0,0,0,0,0,0,0,0,0,1
../kbl_data/2024-2025,S45G01N70,대구 한국가스공사,Away,차바위,3,0,0,0.0,1,1,100.0,1,1,100.0,0,0,0.0,1,1,2,1,0,0,0,0,0,2
../kbl_data/2024-2025,S45G01N70,대구 한국가스공사,Away,박지훈,9,1,1,100.0,2,4,50.0,3,5,60.0,1,1,100.0,0,0,0,3,0,0,0,0,0,3
../kbl_data/2024-2025,S45G01N70,대구 한국가스공사,Away,이대헌,8,4,5,80.0,0,2,0.0,4,7,57.1,0,0,0.0,5,5,10,2,0,0,0,0,1,0
../kbl_data/2024-2025,S45G01N70,대구 한국가스공사,Away,김철욱,2,1,1,100.0,0,0,0.0,1,1,100.0,0,0,0.0,0,0,0,0,0,0,0,0,0,3
../kbl_data/2024-2025,S45G01N70,대구 한국가스공사,Away,우동현,0,0,0,0.0,0,3,0.0,0,3,0.0,0,0,0.0,0,0,0,3,0,0,0,0,0,0
../kbl_data/2024-2025,S45G01N70,대구 한국가스공사,Away,곽정훈,3,0,0,0.0,1,2,50.0,1,2,50.0,0,0,0.0,0,0,0,0,0,0,0,0,1,2
../kbl_data/2024-2025,S45G01N70,대구 한국가스공사,Away,앤드류 니콜슨,21,8,16,50.0,1,2,50.0,9,18,50.0,2,2,100.0,3,9,12,0,0,0,1,1,1,3
../kbl_data/2024-2025,S45G01N70,대구 한국가스공사,Away,신승민,4,2,5,40.0,0,2,0.0,2,7,28.6,0,0,0.0,2,0,2,5,0,0,0,0,1,3
../kbl_data/2024-2025,S45G01N70,대구 한국가스공사,Away,샘조세프 벨란겔,25,4,10,40.0,5,8,62.5,9,18,50.0,2,2,100.0,0,6,6,4,1,0,0,0,4,2
../kbl_data/2024-2025,S45G01N70,대구 한국가스공사,Away,유슈 은도예,10,1,3,33.3,2,2,100.0,3,5,60.0,2,2,100.0,1,2,3,1,0,0,0,0,1,2
../kbl_data/2024-2025,S45G01N70,대구 한국가스공사,Away,안세영,0,0,0,0.0,0,0,0.0,0,0,0.0,0,0,0.0,0,0,0,0,0,0,0,0,0,0
../kbl_data/2024-2025,S45G01N70,대구 한국가스공사,Away,손준,0,0,1,0.0,0,0,0.0,0,1,0.0,0,0,0.0,0,0,0,0,0,0,0,0,0,0
../kbl_data/2024-2025,S45G01N71,서울 삼성,Home,이정현,11,1,2,50.0,2,8,25.0,3,10,30.0,3,4,75.0,1,6,7,4,1,0,0,0,3,3
../kbl_data/2024-2025,S45G01N71,서울 삼성,Home,최현민,5,1,5,20.0,1,3,33.3,2,8,25.0,0,0,0.0,2,6,8,2,0,0,0,0,1,4
../kbl_data/2024-2025,S45G01N71,서울 삼성,Home,최성모,3,0,2,0.0,1,3,33.3,1,5,20.0,0,0,0.0,0,1,1,1,0,1,0,0,1,2
../kbl_data/2024-2025,S45G01N71,서울 삼성,Home,최승욱,6,3,4,75.0,0,1,0.0,3,5,60.0,0,0,0.0,0,5,5,2,0,1,1,0,1,1
../kbl_data/2024-2025,S45G01N71,서울 삼성,Home,김진용,0,0,0,0.0,0,0,0.0,0,0,0.0,0,0,0.0,0,0,0,0,0,0,0,0,0,0
../kbl_data/2024-2025,S45G01N71,서울 삼성,Home,김한솔,0,0,0,0.0,0,0,0.0,0,0,0.0,0,0,0.0,0,0,0,1,0,0,0,0,0,1
../kbl_data/2024-2025,S45G01N71,서울 삼성,Home,마커스 데릭슨,16,3,6,50.0,2,8,25.0,5,14,35.7,4,4,100.0,2,9,11,1,0,0,0,0,2,3
../kbl_data/2024-2025,S45G01N71,서울 삼성,Home,차민석,0,0,3,0.0,0,2,0.0,0,5,0.0,0,0,0.0,3,2,5,0,0,0,0,0,1,2
../kbl_data/2024-2025,S45G01N71,서울 삼성,Home,저스틴 구탕,13,4,7,57.1,1,4,25.0,5,11,45.5,2,2,100.0,1,1,2,2,2,0,0,0,1,2
../kbl_data/2024-2025,S45G01N71,서울 삼성,Home,박승재,5,1,4,25.0,1,4,25.0,2,8,25.0,0,0,0.0,1,1,2,2,0,0,0,0,2,2
../kbl_data/2024-2025,S45G01N71,서울 삼성,Home,임동언,0,0,0,0.0,0,0,0.0,0,0,0.0,0,0,0.0,0,0,0,0,0,0,0,0,0,0
../kbl_data/2024-2025,S45G01N71,서울 삼성,Home,황영찬,2,1,1,100.0,0,1,0.0,1,2,50.0,0,0,0.0,0,0,0,0,0,1,0,0,1,3
../kbl_data/2024-2025,S45G01N71,부산 KCC,Away,정창영,5,1,1,100.0,1,4,25.0,2,5,40.0,0,0,0.0,0,1,1,1,1,0,0,0,0,2
../kbl_data/2024-2025,S45G01N71,부산 KCC,Away,리온 윌리엄스,15,6,12,50.0,0,1,0.0,6,13,46.2,3,4,75.0,2,8,10,2,5,2,0,0,2,3
../kbl_data/2024-2025,S45G01N71,부산 KCC,Away,전준범,0,0,0,0.0,0,2,0.0,0,2,0.0,0,0,0.0,1,2,3,1,1,0,1,0,0,3
../kbl_data/2024-2025,S45G01N71,부산 KCC,Away,허웅,20,5,9,55.6,3,5,60.0,8,14,57.1,1,1,100.0,0,1,1,5,0,0,0,0,1,1
../kbl_data/2024-2025,S45G01N71,부산 KCC,Away,이승현,6,2,5,40.0,0,0,0.0,2,5,40.0,2,2,100.0,1,4,5,1,0,0,0,0,1,2
../kbl_data/2024-2025,S45G01N71,부산 KCC,Away,이호현,3,1,3,33.3,0,1,0.0,1,4,25.0,1,2,50.0,0,6,6,5,1,0,1,0,0,1
../kbl_data/2024-2025,S45G01N71,부산 KCC,Away,최준용,19,8,14,57.1,0,2,0.0,8,16,50.0,3,5,60.0,3,4,7,7,0,1,0,0,0,2
../kbl_data/2024-2025,S45G01N71,부산 KCC,Away,디온테 버튼,3,0,3,0.0,1,3,33.3,1,6,16.7,0,0,0.0,0,1,1,0,1,0,0,0,1,3
../kbl_data/2024-2025,S45G01N71,부산 KCC,Away,이근휘,3,0,0,0.0,1,3,33.3,1,3,33.3,0,0,0.0,0,0,0,0,0,0,0,0,0,0
../kbl_data/2024-2025,S45G01N71,부산 KCC,Away,김동현,0,0,1,0.0,0,1,0.0,0,2,0.0,0,0,0.0,0,0,0,0,0,0,0,0,0,0
../kbl_data/2024-2025,S45G01N71,부산 KCC,Away,캘빈 제프리 에피스톨라,4,0,0,0.0,1,2,50.0,1,2,50.0,1,2,50.0,0,2,2,1,1,0,0,0,0,1
../kbl_data/2024-2025,S45G01N71,부산 KCC,Away,이주영,0,0,0,0.0,0,0,0.0,0,0,0.0,0,0,0.0,0,0,0,0,0,0,0,0,0,0
../kbl_data/2024-2025,S45G01N72,창원 LG,Home,허일영,2,1,2,50.0,0,1,0.0,1,3,33.3,0,0,0.0,0,2,2,1,1,0,0,0,1,2
../kbl_data/2024-2025,S45G01N72,창원 LG,Home,장민국,6,0,0,0.0,2,7,28.6,2,7,28.6,0,0,0.0,2,1,3,0,0,1,1,0,1,0
../kbl_data/2024-2025,S45G01N72,창원 LG,Home,한상혁,8,0,2,0.0,1,3,33.3,1,5,20.0,5,6,83.3,0,1,1,4,1,0,0,0,0,1
../kbl_data/2024-2025,S45G01N72,창원 LG,Home,전성현,0,0,1,0.0,0,2,0.0,0,3,0.0,0,0,0.0,0,1,1,1,0,0,0,0,0,0
../kbl_data/2024-2025,S45G01N72,창원 LG,Home,정인덕,3,0,1,0.0,1,2,50.0,1,3,33.3,0,0,0.0,1,0,1,1,1,0,0,0,0,3
../kbl_data/2024-2025,S45G01N72,창원 LG,Home,대릴 먼로,2,1,4,25.0,0,0,0.0,1,4,25.0,0,0,0.0,0,2,2,0,0,0,0,0,1,1
../kbl_data/2024-2025,S45G01N72,창원 LG,Home,박정현,0,0,0,0.0,0,0,0.0,0,0,0.0,0,0,0.0,0,0,0,0,0,0,0,0,0,0
../kbl_data/2024-2025,S45G01N72,창원 LG,Home,아셈 마레이,17,7,9,77.8,0,0,0.0,7,9,77.8,3,6,50.0,5,16,21,6,1,1,0,1,2,3
../kbl_data/2024-2025,S45G01N72,창원 LG,Home,양준석,17,4,9,44.4,3,5,60.0,7,14,50.0,0,0,0.0,1,1,2,3,1,0,1,0,2,4
../kbl_data/2024-2025,S45G01N72,창원 LG,Home,유기상,13,1,5,20.0,3,5,60.0,4,10,40.0,2,2,100.0,3,0,3,3,2,0,0,0,1,1
../kbl_data/2024-2025,S45G01N72,창원 LG,Home,이경도,0,0,0,0.0,0,0,0.0,0,0,0.0,0,0,0.0,0,0,0,0,0,0,0,0,0,1
../kbl_data/2024-2025,S45G01N72,창원 LG,Home,칼 타마요,8,4,7,57.1,0,2,0.0,4,9,44.4,0,2,0.0,1,3,4,0,1,0,0,0,0,2
../kbl_data/2024-2025,S45G01N72,원주 DB,Away,이관희,9,1,4,25.0,2,2,100.0,3,6,50.0,1,4,25.0,1,3,4,0,0,0,0,0,1,2
../kbl_data/2024-2025,S45G01N72,원주 DB,Away,김시래,0,0,1,0.0,0,0,0.0,0,1,0.0,0,0,0.0,0,0,0,1,0,0,0,0,2,1
../kbl_data/2024-2025,S45G01N72,원주 DB,Away,서민수,0,0,0,0.0,0,2,0.0,0,2,0.0,0,0,0.0,0,2,2,0,0,0,0,0,0,2
../kbl_data/2024-2025,S45G01N72,원주 DB,Away,김영현,0,0,0,0.0,0,0,0.0,0,0,0.0,0,0,0.0,0,0,0,0,1,0,0,0,0,1
../kbl_data/2024-2025,S45G01N72,원주 DB,Away,박봉진,0,0,0,0.0,0,1,0.0,0,1,0.0,0,0,0.0,0,0,0,0,0,0,0,0,0,0
../kbl_data/2024-2025,S45G01N72,원주 DB,Away,강상재,5,1,3,33.3,1,3,33.3,2,6,33.3,0,0,0.0,0,3,3,0,0,0,0,0,1,1
../kbl_data/2024-2025,S45G01N72,원주 DB,Away,치나누 오누아쿠,12,6,14,42.9,0,1,0.0,6,15,40.0,0,2,0.0,1,8,9,2,2,1,0,3,2,4
../kbl_data/2024-2025,S45G01N72,원주 DB,Away,이용우,3,0,0,0.0,1,2,50.0,1,2,50.0,0,0,0.0,0,0,0,0,0,0,0,0,0,1
../kbl_data/2024-2025,S45G01N72,원주 DB,Away,이선 알바노,26,5,13,38.5,4,6,66.7,9,19,47.4,4,4,100.0,2,4,6,5,0,0,0,0,1,0
../kbl_data/2024-2025,S45G01N72,원주 DB,Away,박인웅,14,2,2,100.0,3,7,42.9,5,9,55.6,1,1,100.0,3,2,5,1,0,0,0,0,3,3
../kbl_data/2024-2025,S45G01N72,원주 DB,Away,로버트 카터,5,0,2,0.0,1,3,33.3,1,5,20.0,2,2,100.0,3,1,4,8,0,0,0,0,1,5
../kbl_data/2024-2025,S45G01N72,원주 DB,Away,김보배,0,0,0,0.0,0,0,0.0,0,0,0.0,0,0,0.0,0,0,0,0,0,0,0,0,0,0
../kbl_data/2024-2025,S45G01N73,수원 KT,Home,한희원,5,1,1,100.0,1,9,11.1,2,10,20.0,0,0,0.0,1,4,5,0,2,0,0,0,1,4
../kbl_data/2024-2025,S45G01N73,수원 KT,Home,최창진,2,1,1,100.0,0,1,0.0,1,2,50.0,0,0,0.0,1,2,3,1,0,0,0,0,1,3
../kbl_data/2024-2025,S45G01N73,수원 KT,Home,문성곤,0,0,1,0.0,0,1,0.0,0,2,0.0,0,0,0.0,1,6,7,2,1,0,0,0,1,1
../kbl_data/2024-2025,S45G01N73,수원 KT,Home,박준영,7,2,6,33.3,1,5,20.0,3,11,27.3,0,0,0.0,8,2,10,0,2,0,0,0,3,3
../kbl_data/2024-2025,S45G01N73,수원 KT,Home,최진광,0,0,0,0.0,0,0,0.0,0,0,0.0,0,0,0.0,0,0,0,0,0,0,0,0,0,0
../kbl_data/2024-2025,S45G01N73,수원 KT,Home,박지원,11,4,6,66.7,0,2,0.0,4,8,50.0,3,3,100.0,1,4,5,3,4,0,0,0,2,3
../kbl_data/2024-2025,S45G01N73,수원 KT,Home,이두원,0,0,0,0.0,0,0,0.0,0,0,0.0,0,0,0.0,0,0,0,0,1,0,0,0,0,1
../kbl_data/2024-2025,S45G01N73,수원 KT,Home,박선웅,0,0,0,0.0,0,1,0.0,0,1,0.0,0,0,0.0,0,0,0,0,0,0,0,0,0,0
../kbl_data/2024-2025,S45G01N73,수원 KT,Home,고찬혁,0,0,0,0.0,0,0,0.0,0,0,0.0,0,0,0.0,0,0,0,0,0,0,0,0,1,0
../kbl_data/2024-2025,S45G01N73,수원 KT,Home,문정현,9,3,7,42.9,1,5,20.0,4,12,33.3,0,0,0.0,5,3,8,1,0,0,0,0,2,4
../kbl_data/2024-2025,S45G01N73,수원 KT,Home,레이션 해먼즈,26,10,21,47.6,1,11,9.1,11,32,34.4,3,4,75.0,5,6,11,2,1,1,0,0,2,1
../kbl_data/2024-2025,S45G01N73,수원 KT,Home,조환희,0,0,0,0.0,0,0,0.0,0,0,0.0,0,0,0.0,0,0,0,0,0,0,0,0,0,0
../kbl_data/2024-2025,S45G01N73,부산 KCC,Away,정창영,7,2,2,100.0,1,4,25.0,3,6,50.0,0,0,0.0,1,4,5,1,1,0,2,0,1,3
../kbl_data/2024-2025,S45G01N73,부산 KCC,Away,리온 윌리엄스,2,0,1,0.0,0,0,0.0,0,1,0.0,2,2,100.0,1,2,3,1,0,0,0,0,1,2
../kbl_data/2024-2025,S45G01N73,부산 KCC,Away,전준범,3,1,1,100.0,0,2,0.0,1,3,33.3,1,2,50.0,2,0,2,1,0,0,0,0,1,1
../kbl_data/2024-2025,S45G01N73,부산 KCC,Away,허웅,8,1,4,25.0,1,3,33.3,2,7,28.6,3,3,100.0,0,3,3,5,0,0,0,0,2,1
../kbl_data/2024-2025,S45G01N73,부산 KCC,Away,이승현,4,2,8,25.0,0,0,0.0,2,8,25.0,0,0,0.0,1,3,4,0,1,0,0,0,1,2
../kbl_data/2024-2025,S45G01N73,부산 KCC,Away,이호현,1,0,1,0.0,0,1,0.0,0,2,0.0,1,2,50.0,0,1,1,0,0,0,0,0,1,2
../kbl_data/2024-2025,S45G01N73,부산 KCC,Away,최준용,7,1,6,16.7,1,5,20.0,2,11,18.2,2,3,66.7,3,8,11,1,0,4,0,0,1,1
../kbl_data/2024-2025,S45G01N73,부산 KCC,Away,디온테 버튼,24,5,10,50.0,4,9,44.4,9,19,47.4,2,2,100.0,0,5,5,1,0,1,0,0,5,1
../kbl_data/2024-2025,S45G01N73,부산 KCC,Away,이근휘,0,0,0,0.0,0,0,0.0,0,0,0.0,0,0,0.0,0,0,0,0,0,0,0,0,0,0
../kbl_data/2024-2025,S45G01N73,부산 KCC,Away,김동현,0,0,0,0.0,0,1,0.0,0,1,0.0,0,0,0.0,1,1,2,0,2,0,0,0,0,1
../kbl_data/2024-2025,S45G01N73,부산 KCC,Away,캘빈 제프리 에피스톨라,2,1,2,50.0,0,1,0.0,1,3,33.3,0,0,0.0,1,1,2,2,0,0,0,0,0,1
../kbl_data/2024-2025,S45G01N73,부산 KCC,Away,이주영,0,0,0,0.0,0,0,0.0,0,0,0.0,0,0,0.0,0,0,0,0,0,0,0,0,0,0
../kbl_data/2024-2025,S45G01N74,고양 소노,Home,정희재,11,1,1,100.0,2,6,33.3,3,7,42.9,3,4,75.0,2,3,5,3,0,0,0,0,1,4
../kbl_data/2024-2025,S45G01N74,고양 소노,Home,김민욱,0,0,0,0.0,0,3,0.0,0,3,0.0,0,0,0.0,1,1,2,0,1,1,0,0,1,2
../kbl_data/2024-2025,S45G01N74,고양 소노,Home,이재도,19,6,7,85.7,2,4,50.0,8,11,72.7,1,1,100.0,0,0,0,10,1,0,0,0,1,1
../kbl_data/2024-2025,S45G01N74,고양 소노,Home,최승욱,5,1,1,100.0,1,2,50.0,2,3,66.7,0,0,0.0,0,4,4,5,1,0,0,0,0,2
../kbl_data/2024-2025,S45G01N74,고양 소노,Home,김진유,0,0,0,0.0,0,3,0.0,0,3,0.0,0,0,0.0,0,2,2,0,0,0,0,0,0,3
../kbl_data/2024-2025,S45G01N74,고양 소노,Home,박종하,2,1,1,100.0,0,0,0.0,1,1,100.0,0,0,0.0,0,0,0,1,0,0,0,0,2,1
../kbl_data/2024-2025,S45G01N74,고양 소노,Home,민기남,3,0,1,0.0,1,4,25.0,1,5,20.0,0,0,0.0,0,0,0,0,0,0,2,0,1,0
../kbl_data/2024-2025,S45G01N74,고양 소노,Home,앨런 윌리엄스,26,10,17,58.8,1,2,50.0,11,19,57.9,3,4,75.0,2,8,10,3,1,0,0,0,5,2
../kbl_data/2024-2025,S45G01N74,고양 소노,Home,디제이 번즈 Jr,4,2,5,40.0,0,0,0.0,2,5,40.0,0,0,0.0,0,0,0,1,1,0,0,0,0,4
../kbl_data/2024-2025,S45G01N74,고양 소노,Home,이근준,11,1,1,100.0,2,8,25.0,3,9,33.3,3,5,60.0,3,3,6,1,0,1,0,0,0,3
../kbl_data/2024-2025,S45G01N74,고양 소노,Home,서동원,0,0,0,0.0,0,0,0.0,0,0,0.0,0,0,0.0,0,0,0,0,0,0,0,0,0,0
../kbl_data/2024-2025,S45G01N74,고양 소노,Home,정성조,0,0,0,0.0,0,0,0.0,0,0,0.0,0,0,0.0,0,0,0,0,0,0,0,0,0,0
../kbl_data/2024-2025,S45G01N74,서울 SK,Away,김선형,25,4,7,57.1,4,7,57.1,8,14,57.1,5,5,100.0,0,1,1,4,1,0,0,0,2,3
../kbl_data/2024-2025,S45G01N74,서울 SK,Away,오세근,6,1,2,50.0,1,2,50.0,2,4,50.0,1,2,50.0,1,3,4,2,0,0,0,0,0,0
../kbl_data/2024-2025,S45G01N74,서울 SK,Away,최부경,2,0,0,0.0,0,2,0.0,0,2,0.0,2,2,100.0,1,2,3,0,2,0,0,0,1,1
../kbl_data/2024-2025,S45G01N74,서울 SK,Away,최원혁,3,0,1,0.0,1,1,100.0,1,2,50.0,0,0,0.0,1,0,1,0,0,0,0,0,0,4
../kbl_data/2024-2025,S45G01N74,서울 SK,Away,장문호,0,0,0,0.0,0,0,0.0,0,0,0.0,0,0,0.0,0,0,0,0,0,0,0,0,0,0
../kbl_data/2024-2025,S45G01N74,서울 SK,Away,안영준,18,4,6,66.7,1,2,50.0,5,8,62.5,7,7,100.0,0,3,3,3,0,2,0,0,3,2
../kbl_data/2024-2025,S45G01N74,서울 SK,Away,자밀 워니,27,6,16,37.5,5,7,71.4,11,23,47.8,0,0,0.0,3,9,12,4,2,1,0,3,4,0
../kbl_data/2024-2025,S45G01N74,서울 SK,Away,김형빈,5,0,0,0.0,1,1,100.0,1,1,100.0,2,2,100.0,0,0,0,0,0,0,0,0,0,1
../kbl_data/2024-2025,S45G01N74,서울 SK,Away,아이재아 힉스,4,1,1,100.0,0,1,0.0,1,2,50.0,2,4,50.0,1,1,2,1,2,1,0,0,0,1
../kbl_data/2024-2025,S45G01N74,서울 SK,Away,박민우,0,0,0,0.0,0,0,0.0,0,0,0.0,0,0,0.0,0,0,0,0,0,0,0,0,0,0
../kbl_data/2024-2025,S45G01N74,서울 SK,Away,오재현,2,1,3,33.3,0,4,0.0,1,7,14.3,0,0,0.0,2,4,6,7,1,0,0,0,2,4
../kbl_data/2024-2025,S45G01N74,서울 SK,Away,고메즈 델 리아노,0,0,0,0.0,0,0,0.0,0,0,0.0,0,0,0.0,0,0,0,0,0,0,0,0,0,0
../kbl_data/2024-2025,S45G01N75,울산 현대모비스,Home,함지훈,6,3,3,100.0,0,2,0.0,3,5,60.0,0,0,0.0,0,1,1,1,0,0,0,0,2,3
../kbl_data/2024-2025,S45G01N75,울산 현대모비스,Home,장재석,4,2,3,66.7,0,0,0.0,2,3,66.7,0,0,0.0,0,3,3,1,0,2,0,0,1,2
../kbl_data/2024-2025,S45G01N75,울산 현대모비스,Home,김지완,2,1,1,100.0,0,1,0.0,1,2,50.0,0,0,0.0,0,0,0,0,0,0,0,0,0,0
../kbl_data/2024-2025,S45G01N75,울산 현대모비스,Home,한호빈,2,1,1,100.0,0,4,0.0,1,5,20.0,0,0,0.0,1,1,2,2,1,0,0,0,0,3
../kbl_data/2024-2025,S45G01N75,울산 현대모비스,Home,서명진,8,1,3,33.3,2,6,33.3,3,9,33.3,0,0,0.0,0,1,1,2,1,0,0,0,0,1
../kbl_data/2024-2025,S45G01N75,울산 현대모비스,Home,숀 롱,28,12,20,60.0,0,1,0.0,12,21,57.1,4,9,44.4,8,4,12,5,0,1,0,2,1,3
../kbl_data/2024-2025,S45G01N75,울산 현대모비스,Home,이우석,10,3,6,50.0,1,7,14.3,4,13,30.8,1,2,50.0,0,5,5,2,1,0,1,0,1,2
../kbl_data/2024-2025,S45G01N75,울산 현대모비스,Home,이승우,2,1,3,33.3,0,1,0.0,1,4,25.0,0,0,0.0,2,2,4,0,0,0,0,0,0,2
../kbl_data/2024-2025,S45G01N75,울산 현대모비스,Home,신민석,6,0,0,0.0,2,3,66.7,2,3,66.7,0,0,0.0,0,0,0,0,0,0,0,0,0,0
../kbl_data/2024-2025,S45G01N75,울산 현대모비스,Home,게이지 프림,0,0,3,0.0,0,0,0.0,0,3,0.0,0,0,0.0,0,1,1,0,0,0,0,0,0,0
../kbl_data/2024-2025,S45G01N75,울산 현대모비스,Home,박무빈,0,0,2,0.0,0,0,0.0,0,2,0.0,0,0,0.0,0,0,0,2,0,0,1,0,1,3
../kbl_data/2024-2025,S45G01N75,울산 현대모비스,Home,미구엘 안드레 옥존,3,0,2,0.0,1,5,20.0,1,7,14.3,0,0,0.0,1,3,4,1,0,0,0,0,1,2
../kbl_data/2024-2025,S45G01N75,안양 정관장,Away,배병준,8,1,2,50.0,2,5,40.0,3,7,42.9,0,0,0.0,1,2,3,2,2,0,0,0,0,2
../kbl_data/2024-2025,S45G01N75,안양 정관장,Away,정효근,5,1,3,33.3,1,1,100.0,2,4,50.0,0,0,0.0,0,1,1,1,0,0,0,0,0,2
../kbl_data/2024-2025,S45G01N75,안양 정관장,Away,이종현,11,1,5,20.0,3,4,75.0,4,9,44.4,0,0,0.0,0,2,2,0,1,2,0,0,2,3
../kbl_data/2024-2025,S45G01N75,안양 정관장,Away,박지훈,18,8,8,100.0,0,1,0.0,8,9,88.9,2,3,66.7,0,5,5,10,0,1,0,0,2,2
../kbl_data/2024-2025,S45G01N75,안양 정관장,Away,최성원,15,2,6,33.3,3,6,50.0,5,12,41.7,2,2,100.0,0,2,2,4,1,1,0,0,0,3
../kbl_data/2024-2025,S45G01N75,안양 정관장,Away,김준형,0,0,0,0.0,0,0,0.0,0,0,0.0,0,0,0.0,0,0,0,0,0,0,0,0,1,0
../kbl_data/2024-2025,S45G01N75,안양 정관장,Away,변준형,7,2,3,66.7,0,1,0.0,2,4,50.0,3,4,75.0,0,4,4,2,1,0,0,0,0,1
../kbl_data/2024-2025,S45G01N75,안양 정관장,Away,캐디 라렌,16,6,8,75.0,1,5,20.0,7,13,53.8,1,2,50.0,2,16,18,3,0,2,0,2,0,4
../kbl_data/2024-2025,S45G01N75,안양 정관장,Away,한승희,4,2,2,100.0,0,0,0.0,2,2,100.0,0,0,0.0,0,1,1,0,0,1,0,0,0,1
../kbl_data/2024-2025,S45G01N75,안양 정관장,Away,하비 고메즈,5,1,2,50.0,1,1,100.0,2,3,66.7,0,0,0.0,1,0,1,0,0,0,0,0,0,1
../kbl_data/2024-2025,S45G01N75,안양 정관장,Away,마이클 영 Jr,4,2,3,66.7,0,0,0.0,2,3,66.7,0,2,0.0,1,1,2,0,0,0,0,0,0,3
../kbl_data/2024-2025,S45G01N75,안양 정관장,Away,박정웅,2,1,2,50.0,0,0,0.0,1,2,50.0,0,0,0.0,0,0,0,1,0,0,0,0,1,0
../kbl_data/2024-2025,S45G01N76,대구 한국가스공사,Home,차바위,0,0,0,0.0,0,0,0.0,0,0,0.0,0,0,0.0,0,0,0,0,0,0,0,0,0,1
../kbl_data/2024-2025,S45G01N76,대구 한국가스공사,Home,박지훈,3,0,1,0.0,0,0,0.0,0,1,0.0,3,3,100.0,0,0,0,1,0,0,0,0,0,3
../kbl_data/2024-2025,S45G01N76,대구 한국가스공사,Home,이대헌,5,0,5,0.0,0,2,0.0,0,7,0.0,5,6,83.3,4,1,5,1,0,0,0,0,0,1
../kbl_data/2024-2025,S45G01N76,대구 한국가스공사,Home,정성우,9,3,6,50.0,1,1,100.0,4,7,57.1,0,0,0.0,0,1,1,3,2,0,1,0,1,2
../kbl_data/2024-2025,S45G01N76,대구 한국가스공사,Home,김낙현,16,3,3,100.0,2,5,40.0,5,8,62.5,4,6,66.7,0,0,0,5,1,0,0,0,0,1
../kbl_data/2024-2025,S45G01N76,대구 한국가스공사,Home,양재혁,4,1,2,50.0,0,1,0.0,1,3,33.3,2,2,100.0,0,3,3,0,1,0,0,0,0,2
../kbl_data/2024-2025,S45G01N76,대구 한국가스공사,Home,곽정훈,0,0,0,0.0,0,0,0.0,0,0,0.0,0,0,0.0,0,0,0,0,0,0,0,0,0,0
../kbl_data/2024-2025,S45G01N76,대구 한국가스공사,Home,앤드류 니콜슨,19,5,11,45.5,1,3,33.3,6,14,42.9,6,6,100.0,2,8,10,0,2,0,0,0,0,3
../kbl_data/2024-2025,S45G01N76,대구 한국가스공사,Home,신승민,6,2,4,50.0,0,1,0.0,2,5,40.0,2,2,100.0,1,2,3,1,0,0,0,0,0,3
../kbl_data/2024-2025,S45G01N76,대구 한국가스공사,Home,샘조세프 벨란겔,12,2,5,40.0,1,5,20.0,3,10,30.0,5,6,83.3,0,2,2,3,3,0,0,0,1,3
../kbl_data/2024-2025,S45G01N76,대구 한국가스공사,Home,유슈 은도예,11,4,5,80.0,0,0,0.0,4,5,80.0,3,4,75.0,1,6,7,1,0,0,0,1,3,4
../kbl_data/2024-2025,S45G01N76,대구 한국가스공사,Home,손준,0,0,0,0.0,0,0,0.0,0,0,0.0,0,0,0.0,0,0,0,0,0,0,0,0,1,2
../kbl_data/2024-2025,S45G01N76,창원 LG,Away,허일영,6,0,1,0.0,2,7,28.6,2,8,25.0,0,0,0.0,0,1,1,1,0,0,0,0,0,2
../kbl_data/2024-2025,S45G01N76,창원 LG,Away,장민국,0,0,0,0.0,0,1,0.0,0,1,0.0,0,0,0.0,1,1,2,0,0,0,0,0,0,3
../kbl_data/2024-2025,S45G01N76,창원 LG,Away,한상혁,0,0,0,0.0,0,0,0.0,0,0,0.0,0,0,0.0,0,0,0,3,0,0,0,0,2,2
../kbl_data/2024-2025,S45G01N76,창원 LG,Away,정인덕,11,1,2,50.0,3,4,75.0,4,6,66.7,0,0,0.0,1,1,2,0,0,0,0,0,1,5
../kbl_data/2024-2025,S45G01N76,창원 LG,Away,대릴 먼로,2,1,2,50.0,0,0,0.0,1,2,50.0,0,0,0.0,1,1,2,2,0,0,0,0,4,0
../kbl_data/2024-2025,S45G01N76,창원 LG,Away,박정현,6,2,4,50.0,0,0,0.0,2,4,50.0,2,4,50.0,1,1,2,1,0,0,0,0,0,2
../kbl_data/2024-2025,S45G01N76,창원 LG,Away,아셈 마레이,19,5,9,55.6,0,0,0.0,5,9,55.6,9,14,64.3,5,9,14,8,0,1,1,0,1,4
../kbl_data/2024-2025,S45G01N76,창원 LG,Away,양준석,8,4,8,50.0,0,4,0.0,4,12,33.3,0,0,0.0,0,1,1,8,1,0,1,0,3,4
../kbl_data/2024-2025,S45G01N76,창원 LG,Away,유기상,13,2,5,40.0,3,10,30.0,5,15,33.3,0,0,0.0,2,4,6,2,0,0,0,0,1,2
../kbl_data/2024-2025,S45G01N76,창원 LG,Away,이경도,3,0,0,0.0,1,1,100.0,1,1,100.0,0,0,0.0,1,0,1,1,0,0,0,0,0,1
../kbl_data/2024-2025,S45G01N76,창원 LG,Away,칼 타마요,10,3,7,42.9,1,1,100.0,4,8,50.0,1,2,50.0,3,4,7,1,0,0,0,0,0,3
../kbl_data/2024-2025,S45G01N76,창원 LG,Away,최형찬,0,0,0,0.0,0,1,0.0,0,1,0.0,0,0,0.0,1,0,1,0,0,0,0,0,0,0
../kbl_data/2024-2025,S45G01N77,부산 KCC,Home,정창영,9,2,5,40.0,1,2,50.0,3,7,42.9,2,2,100.0,0,3,3,4,1,0,0,0,3,3
../kbl_data/2024-2025,S45G01N77,부산 KCC,Home,리온 윌리엄스,21,9,15,60.0,1,2,50.0,10,17,58.8,0,0,0.0,6,8,14,3,2,0,1,0,2,3
../kbl_data/2024-2025,S45G01N77,부산 KCC,Home,전준범,0,0,0,0.0,0,0,0.0,0,0,0.0,0,0,0.0,0,0,0,0,0,0,0,0,0,0
../kbl_data/2024-2025,S45G01N77,부산 KCC,Home,허웅,3,0,1,0.0,1,9,11.1,1,10,10.0,0,0,0.0,0,2,2,6,1,0,0,0,7,3
../kbl_data/2024-2025,S45G01N77,부산 KCC,Home,이승현,0,0,0,0.0,0,0,0.0,0,0,0.0,0,0,0.0,1,2,3,1,0,0,0,0,0,0
../kbl_data/2024-2025,S45G01N77,부산 KCC,Home,이호현,5,2,3,66.7,0,0,0.0,2,3,66.7,1,2,50.0,0,0,0,1,0,0,0,0,1,0
../kbl_data/2024-2025,S45G01N77,부산 KCC,Home,최준용,42,10,20,50.0,6,9,66.7,16,29,55.2,4,5,80.0,3,10,13,4,0,2,0,1,2,0
../kbl_data/2024-2025,S45G01N77,부산 KCC,Home,디온테 버튼,0,0,0,0.0,0,0,0.0,0,0,0.0,0,0,0.0,0,0,0,0,0,0,0,0,0,0
../kbl_data/2024-2025,S45G01N77,부산 KCC,Home,이근휘,0,0,1,0.0,0,0,0.0,0,1,0.0,0,0,0.0,0,2,2,1,0,0,0,0,1,1
../kbl_data/2024-2025,S45G01N77,부산 KCC,Home,김동현,0,0,0,0.0,0,0,0.0,0,0,0.0,0,0,0.0,0,0,0,1,0,0,0,0,0,0
../kbl_data/2024-2025,S45G01N77,부산 KCC,Home,캘빈 제프리 에피스톨라,0,0,3,0.0,0,0,0.0,0,3,0.0,0,0,0.0,0,4,4,7,5,0,0,0,1,5
../kbl_data/2024-2025,S45G01N77,부산 KCC,Home,이주영,0,0,0,0.0,0,0,0.0,0,0,0.0,0,0,0.0,0,0,0,0,0,0,0,0,0,0
../kbl_data/2024-2025,S45G01N77,서울 SK,Away,김선형,8,4,7,57.1,0,5,0.0,4,12,33.3,0,0,0.0,2,2,4,1,2,0,0,0,2,0
../kbl_data/2024-2025,S45G01N77,서울 SK,Away,오세근,4,2,4,50.0,0,0,0.0,2,4,50.0,0,0,0.0,1,1,2,0,0,0,0,0,0,1
../kbl_data/2024-2025,S45G01N77,서울 SK,Away,최부경,2,1,1,100.0,0,2,0.0,1,3,33.3,0,0,0.0,1,3,4,1,0,0,0,0,1,5
../kbl_data/2024-2025,S45G01N77,서울 SK,Away,최원혁,5,1,1,100.0,1,1,100.0,2,2,100.0,0,0,0.0,2,0,2,3,2,0,0,0,0,4
../kbl_data/2024-2025,S45G01N77,서울 SK,Away,장문호,0,0,0,0.0,0,0,0.0,0,0,0.0,0,0,0.0,0,0,0,0,0,0,0,0,0,0
../kbl_data/2024-2025,S45G01N77,서울 SK,Away,안영준,12,2,4,50.0,2,7,28.6,4,11,36.4,2,4,50.0,1,3,4,4,1,0,0,0,6,3
../kbl_data/2024-2025,S45G01N77,서울 SK,Away,자밀 워니,33,13,24,54.2,2,6,33.3,15,30,50.0,1,2,50.0,6,13,19,3,3,2,0,4,4,2
../kbl_data/2024-2025,S45G01N77,서울 SK,Away,김형빈,5,1,1,100.0,1,2,50.0,2,3,66.7,0,0,0.0,0,2,2,0,0,0,0,0,0,3
../kbl_data/2024-2025,S45G01N77,서울 SK,Away,아이재아 힉스,0,0,0,0.0,0,0,0.0,0,0,0.0,0,0,0.0,0,0,0,0,0,0,0,0,0,0
../kbl_data/2024-2025,S45G01N77,서울 SK,Away,박민우,0,0,0,0.0,0,0,0.0,0,0,0.0,0,0,0.0,0,0,0,0,0,0,0,0,0,0
../kbl_data/2024-2025,S45G01N77,서울 SK,Away,오재현,5,1,3,33.3,1,7,14.3,2,10,20.0,0,2,0.0,0,2,2,6,3,0,0,0,3,1
../kbl_data/2024-2025,S45G01N77,서울 SK,Away,고메즈 델 리아노,0,0,0,0.0,0,0,0.0,0,0,0.0,0,0,0.0,0,0,0,0,0,0,0,0,0,0
../kbl_data/2024-2025,S45G01N78,안양 정관장,Home,송창용,0,0,0,0.0,0,0,0.0,0,0,0.0,0,0,0.0,0,0,0,0,0,0,0,0,0,0
../kbl_data/2024-2025,S45G01N78,안양 정관장,Home,배병준,12,1,2,50.0,2,11,18.2,3,13,23.1,4,4,100.0,0,4,4,3,2,1,0,0,1,3
../kbl_data/2024-2025,S45G01N78,안양 정관장,Home,정효근,7,3,4,75.0,0,2,0.0,3,6,50.0,1,6,16.7,1,4,5,1,4,1,0,0,1,3
../kbl_data/2024-2025,S45G01N78,안양 정관장,Home,이종현,0,0,2,0.0,0,0,0.0,0,2,0.0,0,0,0.0,0,2,2,1,0,0,0,0,2,1
../kbl_data/2024-2025,S45G01N78,안양 정관장,Home,박지훈,13,5,7,71.4,0,2,0.0,5,9,55.6,3,4,75.0,3,3,6,2,1,1,1,0,1,3
../kbl_data/2024-2025,S45G01N78,안양 정관장,Home,최성원,7,2,3,66.7,1,4,25.0,3,7,42.9,0,0,0.0,0,0,0,1,1,0,0,0,2,2
../kbl_data/2024-2025,S45G01N78,안양 정관장,Home,변준형,10,5,5,100.0,0,6,0.0,5,11,45.5,0,0,0.0,2,5,7,3,1,0,0,0,3,2
../kbl_data/2024-2025,S45G01N78,안양 정관장,Home,캐디 라렌,14,4,7,57.1,1,1,100.0,5,8,62.5,3,4,75.0,0,4,4,2,3,0,0,3,3,4
../kbl_data/2024-2025,S45G01N78,안양 정관장,Home,한승희,2,1,1,100.0,0,1,0.0,1,2,50.0,0,0,0.0,1,1,2,2,0,0,1,0,0,1
../kbl_data/2024-2025,S45G01N78,안양 정관장,Home,하비 고메즈,0,0,0,0.0,0,0,0.0,0,0,0.0,0,0,0.0,0,0,0,1,0,0,0,0,0,1
../kbl_data/2024-2025,S45G01N78,안양 정관장,Home,마이클 영 Jr,5,2,2,100.0,0,0,0.0,2,2,100.0,1,2,50.0,0,0,0,0,0,0,0,0,2,2
../kbl_data/2024-2025,S45G01N78,안양 정관장,Home,박정웅,3,0,0,0.0,1,2,50.0,1,2,50.0,0,0,0.0,0,0,0,0,0,0,0,0,0,1
../kbl_data/2024-2025,S45G01N78,서울 삼성,Away,이정현,20,3,5,60.0,4,8,50.0,7,13,53.8,2,2,100.0,0,2,2,7,1,0,0,0,4,3
../kbl_data/2024-2025,S45G01N78,서울 삼성,Away,최현민,0,0,1,0.0,0,2,0.0,0,3,0.0,0,0,0.0,1,2,3,0,0,0,0,0,0,1
../kbl_data/2024-2025,S45G01N78,서울 삼성,Away,이원대,0,0,2,0.0,0,2,0.0,0,4,0.0,0,0,0.0,0,2,2,2,1,0,0,0,0,2
../kbl_data/2024-2025,S45G01N78,서울 삼성,Away,최성모,17,2,4,50.0,3,8,37.5,5,12,41.7,4,5,80.0,0,6,6,2,2,0,1,0,4,4
../kbl_data/2024-2025,S45G01N78,서울 삼성,Away,최승욱,6,3,5,60.0,0,1,0.0,3,6,50.0,0,0,0.0,2,3,5,1,2,0,1,0,1,4
../kbl_data/2024-2025,S45G01N78,서울 삼성,Away,마커스 데릭슨,6,0,0,0.0,2,5,40.0,2,5,40.0,0,0,0.0,1,5,6,1,0,0,0,0,1,4
../kbl_data/2024-2025,S45G01N78,서울 삼성,Away,차민석,0,0,0,0.0,0,0,0.0,0,0,0.0,0,0,0.0,0,0,0,0,0,0,0,0,0,0
../kbl_data/2024-2025,S45G01N78,서울 삼성,Away,이원석,23,8,10,80.0,0,1,0.0,8,11,72.7,7,9,77.8,4,8,12,4,2,0,0,0,3,3
../kbl_data/2024-2025,S45G01N78,서울 삼성,Away,저스틴 구탕,3,1,2,50.0,0,1,0.0,1,3,33.3,1,2,50.0,0,0,0,0,1,0,0,0,2,1
../kbl_data/2024-2025,S45G01N78,서울 삼성,Away,박승재,0,0,0,0.0,0,0,0.0,0,0,0.0,0,0,0.0,0,0,0,0,0,0,0,0,2,0
../kbl_data/2024-2025,S45G01N78,서울 삼성,Away,임동언,0,0,0,0.0,0,0,0.0,0,0,0.0,0,0,0.0,0,0,0,0,0,0,0,0,0,0
../kbl_data/2024-2025,S45G01N78,서울 삼성,Away,빈센트 에드워즈,5,1,3,33.3,1,3,33.3,2,6,33.3,0,0,0.0,0,1,1,0,0,0,0,0,1,2
../kbl_data/2024-2025,S45G01N79,대구 한국가스공사,Home,차바위,0,0,0,0.0,0,1,0.0,0,1,0.0,0,0,0.0,0,0,0,0,0,0,0,0,1,3
../kbl_data/2024-2025,S45G01N79,대구 한국가스공사,Home,박지훈,9,0,0,0.0,3,5,60.0,3,5,60.0,0,0,0.0,0,0,0,0,0,0,0,0,1,2
../kbl_data/2024-2025,S45G01N79,대구 한국가스공사,Home,이대헌,0,0,2,0.0,0,0,0.0,0,2,0.0,0,0,0.0,1,2,3,0,1,0,0,0,1,1
../kbl_data/2024-2025,S45G01N79,대구 한국가스공사,Home,정성우,3,0,2,0.0,1,2,50.0,1,4,25.0,0,0,0.0,0,2,2,3,0,0,0,0,2,2
../kbl_data/2024-2025,S45G01N79,대구 한국가스공사,Home,김낙현,16,0,2,0.0,4,7,57.1,4,9,44.4,4,4,100.0,1,1,2,1,0,0,0,0,2,2
../kbl_data/2024-2025,S45G01N79,대구 한국가스공사,Home,양재혁,0,0,1,0.0,0,0,0.0,0,1,0.0,0,0,0.0,0,1,1,1,0,0,0,0,0,4
../kbl_data/2024-2025,S45G01N79,대구 한국가스공사,Home,곽정훈,0,0,0,0.0,0,4,0.0,0,4,0.0,0,0,0.0,0,3,3,0,1,0,0,0,0,2
../kbl_data/2024-2025,S45G01N79,대구 한국가스공사,Home,앤드류 니콜슨,13,5,11,45.5,1,6,16.7,6,17,35.3,0,0,0.0,4,2,6,2,0,0,0,0,0,0
../kbl_data/2024-2025,S45G01N79,대구 한국가스공사,Home,신승민,2,1,3,33.3,0,6,0.0,1,9,11.1,0,0,0.0,0,0,0,0,0,0,0,0,1,1
../kbl_data/2024-2025,S45G01N79,대구 한국가스공사,Home,샘조세프 벨란겔,13,3,5,60.0,2,8,25.0,5,13,38.5,1,2,50.0,0,5,5,6,2,0,1,0,3,2
../kbl_data/2024-2025,S45G01N79,대구 한국가스공사,Home,유슈 은도예,21,8,11,72.7,0,0,0.0,8,11,72.7,5,5,100.0,4,2,6,0,1,1,0,3,1,3
../kbl_data/2024-2025,S45G01N79,대구 한국가스공사,Home,신주영,1,0,0,0.0,0,2,0.0,0,2,0.0,1,2,50.0,0,5,5,2,1,0,0,0,0,1
../kbl_data/2024-2025,S45G01N79,부산 KCC,Away,정창영,0,0,0,0.0,0,0,0.0,0,0,0.0,0,0,0.0,0,0,0,0,0,0,0,0,0,0
../kbl_data/2024-2025,S45G01N79,부산 KCC,Away,리온 윌리엄스,0,0,0,0.0,0,0,0.0,0,0,0.0,0,0,0.0,0,0,0,0,0,0,0,0,0,0
../kbl_data/2024-2025,S45G01N79,부산 KCC,Away,전준범,1,0,1,0.0,0,1,0.0,0,2,0.0,1,2,50.0,1,0,1,0,0,0,0,0,1,1
../kbl_data/2024-2025,S45G01N79,부산 KCC,Away,허웅,22,3,5,60.0,4,6,66.7,7,11,63.6,4,4,100.0,0,3,3,6,0,0,0,0,1,1
../kbl_data/2024-2025,S45G01N79,부산 KCC,Away,이승현,16,5,9,55.6,2,3,66.7,7,12,58.3,0,0,0.0,2,5,7,1,0,3,0,0,3,2
../kbl_data/2024-2025,S45G01N79,부산 KCC,Away,이호현,0,0,0,0.0,0,2,0.0,0,2,0.0,0,0,0.0,1,6,7,6,1,0,0,0,2,3
../kbl_data/2024-2025,S45G01N79,부산 KCC,Away,최준용,6,3,4,75.0,0,3,0.0,3,7,42.9,0,0,0.0,3,8,11,3,1,0,0,0,3,2
../kbl_data/2024-2025,S45G01N79,부산 KCC,Away,디온테 버튼,46,17,23,73.9,2,7,28.6,19,30,63.3,6,9,66.7,2,8,10,4,4,2,0,2,2,4
../kbl_data/2024-2025,S45G01N79,부산 KCC,Away,이근휘,3,0,0,0.0,1,1,100.0,1,1,100.0,0,0,0.0,0,3,3,0,0,0,0,0,0,0
../kbl_data/2024-2025,S45G01N79,부산 KCC,Away,김동현,2,1,2,50.0,0,0,0.0,1,2,50.0,0,0,0.0,0,2,2,0,0,0,0,0,1,2
../kbl_data/2024-2025,S45G01N79,부산 KCC,Away,캘빈 제프리 에피스톨라,2,1,3,33.3,0,1,0.0,1,4,25.0,0,0,0.0,0,1,1,3,1,0,0,0,1,3
../kbl_data/2024-2025,S45G01N79,부산 KCC,Away,이주영,2,1,1,100.0,0,1,0.0,1,2,50.0,0,0,0.0,0,0,0,1,0,0,0,0,0,1
../kbl_data/2024-2025,S45G01N80,울산 현대모비스,Home,함지훈,7,2,3,66.7,1,1,100.0,3,4,75.0,0,0,0.0,3,1,4,9,2,1,0,0,1,2
../kbl_data/2024-2025,S45G01N80,울산 현대모비스,Home,장재석,2,1,1,100.0,0,0,0.0,1,1,100.0,0,0,0.0,1,1,2,1,0,0,0,0,3,2
../kbl_data/2024-2025,S45G01N80,울산 현대모비스,Home,김지완,0,0,0,0.0,0,0,0.0,0,0,0.0,0,0,0.0,0,0,0,0,0,0,0,0,0,0
../kbl_data/2024-2025,S45G01N80,울산 현대모비스,Home,한호빈,5,1,1,100.0,1,4,25.0,2,5,40.0,0,0,0.0,1,3,4,2,1,1,0,0,0,4
../kbl_data/2024-2025,S45G01N80,울산 현대모비스,Home,서명진,16,2,2,100.0,4,6,66.7,6,8,75.0,0,0,0.0,0,5,5,2,0,0,0,0,4,3
../kbl_data/2024-2025,S45G01N80,울산 현대모비스,Home,숀 롱,4,2,3,66.7,0,0,0.0,2,3,66.7,0,2,0.0,1,0,1,1,0,0,0,0,1,3
../kbl_data/2024-2025,S45G01N80,울산 현대모비스,Home,이우석,14,5,7,71.4,1,5,20.0,6,12,50.0,1,2,50.0,0,1,1,3,3,0,0,0,1,0
../kbl_data/2024-2025,S45G01N80,울산 현대모비스,Home,이승우,0,0,0,0.0,0,0,0.0,0,0,0.0,0,0,0.0,0,0,0,0,0,0,0,0,0,0
../kbl_data/2024-2025,S45G01N80,울산 현대모비스,Home,신민석,0,0,0,0.0,0,0,0.0,0,0,0.0,0,0,0.0,0,0,0,0,0,0,0,0,0,0
../kbl_data/2024-2025,S45G01N80,울산 현대모비스,Home,게이지 프림,28,7,18,38.9,2,4,50.0,9,22,40.9,8,9,88.9,2,6,8,3,2,2,0,0,2,0
../kbl_data/2024-2025,S45G01N80,울산 현대모비스,Home,박무빈,4,2,2,100.0,0,2,0.0,2,4,50.0,0,0,0.0,1,0,1,0,0,0,0,0,1,2
../kbl_data/2024-2025,S45G01N80,울산 현대모비스,Home,미구엘 안드레 옥존,7,3,5,60.0,0,3,0.0,3,8,37.5,1,1,100.0,0,1,1,0,0,0,0,0,0,0
../kbl_data/2024-2025,S45G01N80,원주 DB,Away,이관희,0,0,1,0.0,0,4,0.0,0,5,0.0,0,0,0.0,0,0,0,0,0,0,0,0,0,0
../kbl_data/2024-2025,S45G01N80,원주 DB,Away,김시래,0,0,1,0.0,0,0,0.0,0,1,0.0,0,0,0.0,1,2,3,6,1,0,0,0,0,2
../kbl_data/2024-2025,S45G01N80,원주 DB,Away,서민수,2,1,1,100.0,0,5,0.0,1,6,16.7,0,0,0.0,2,2,4,5,0,1,1,0,0,4
../kbl_data/2024-2025,S45G01N80,원주 DB,Away,김영현,0,0,0,0.0,0,0,0.0,0,0,0.0,0,0,0.0,0,0,0,0,0,0,0,0,0,0
../kbl_data/2024-2025,S45G01N80,원주 DB,Away,박봉진,0,0,0,0.0,0,0,0.0,0,0,0.0,0,0,0.0,0,0,0,0,0,0,0,0,0,0
../kbl_data/2024-2025,S45G01N80,원주 DB,Away,강상재,8,4,4,100.0,0,0,0.0,4,4,100.0,0,0,0.0,2,5,7,1,2,0,0,0,1,1
../kbl_data/2024-2025,S45G01N80,원주 DB,Away,치나누 오누아쿠,27,11,14,78.6,0,2,0.0,11,16,68.8,5,5,100.0,2,5,7,0,0,0,0,1,5,2
../kbl_data/2024-2025,S45G01N80,원주 DB,Away,이용우,0,0,0,0.0,0,0,0.0,0,0,0.0,0,0,0.0,0,0,0,0,0,0,0,0,0,0
../kbl_data/2024-2025,S45G01N80,원주 DB,Away,이선 알바노,25,5,9,55.6,4,7,57.1,9,16,56.2,3,4,75.0,2,2,4,6,4,0,0,0,8,1
../kbl_data/2024-2025,S45G01N80,원주 DB,Away,박인웅,10,3,6,50.0,1,4,25.0,4,10,40.0,1,1,100.0,1,2,3,0,0,0,0,0,1,2
../kbl_data/2024-2025,S45G01N80,원주 DB,Away,로버트 카터,12,5,8,62.5,0,3,0.0,5,11,45.5,2,2,100.0,0,5,5,2,0,1,0,1,0,3
../kbl_data/2024-2025,S45G01N80,원주 DB,Away,김보배,0,0,0,0.0,0,0,0.0,0,0,0.0,0,0,0.0,0,0,0,0,0,0,0,0,0,0
../kbl_data/2024-2025,S45G01N81,고양 소노,Home,함준후,0,0,0,0.0,0,1,0.0,0,1,0.0,0,0,0.0,0,0,0,1,0,0,0,0,1,0
../kbl_data/2024-2025,S45G01N81,고양 소노,Home,정희재,5,0,0,0.0,1,7,14.3,1,7,14.3,2,4,50.0,1,1,2,1,0,0,1,0,0,3
../kbl_data/2024-2025,S45G01N81,고양 소노,Home,임동섭,0,0,0,0.0,0,0,0.0,0,0,0.0,0,2,0.0,0,0,0,0,0,0,0,0,0,0
../kbl_data/2024-2025,S45G01N81,고양 소노,Home,이재도,11,1,5,20.0,1,7,14.3,2,12,16.7,6,6,100.0,2,2,4,3,3,0,1,0,3,1
../kbl_data/2024-2025,S45G01N81,고양 소노,Home,최승욱,42,14,22,63.6,4,20,20.0,18,42,42.9,2,4,50.0,2,12,14,2,0,0,4,0,4,8
../kbl_data/2024-2025,S45G01N81,고양 소노,Home,김진유,2,1,2,50.0,0,1,0.0,1,3,33.3,0,0,0.0,1,0,1,1,2,0,0,0,0,2
../kbl_data/2024-2025,S45G01N81,고양 소노,Home,이정현,58,16,24,66.7,6,30,20.0,22,54,40.7,8,8,100.0,0,8,8,12,12,0,2,0,10,14
../kbl_data/2024-2025,S45G01N81,고양 소노,Home,민기남,0,0,0,0.0,0,0,0.0,0,0,0.0,0,0,0.0,0,0,0,0,0,0,0,0,0,0
../kbl_data/2024-2025,S45G01N81,고양 소노,Home,앨런 윌리엄스,18,6,16,37.5,0,0,0.0,6,16,37.5,6,6,100.0,6,12,18,5,2,0,0,0,4,3
../kbl_data/2024-2025,S45G01N81,고양 소노,Home,디제이 번즈 Jr,4,2,4,50.0,0,0,0.0,2,4,50.0,0,0,0.0,1,0,1,1,0,0,0,0,0,1
../kbl_data/2024-2025,S45G01N81,고양 소노,Home,이근준,9,0,0,0.0,2,2,100.0,2,2,100.0,3,3,100.0,3,0,3,2,2,0,0,0,2,2
../kbl_data/2024-2025,S45G01N81,고양 소노,Home,정성조,0,0,0,0.0,0,0,0.0,0,0,0.0,0,0,0.0,0,0,0,0,0,0,0,0,0,0
../kbl_data/2024-2025,S45G01N81,서울 삼성,Away,이정현,58,16,24,66.7,6,30,20.0,22,54,40.7,8,8,100.0,0,8,8,12,12,0,2,0,10,14
../kbl_data/2024-2025,S45G01N81,서울 삼성,Away,최현민,4,2,2,100.0,0,1,0.0,2,3,66.7,0,2,0.0,0,1,1,0,0,0,0,0,0,1
../kbl_data/2024-2025,S45G01N81,서울 삼성,Away,이원대,0,0,0,0.0,0,0,0.0,0,0,0.0,0,0,0.0,0,0,0,0,1,0,0,0,3,1
../kbl_data/2024-2025,S45G01N81,서울 삼성,Away,최성모,4,2,2,100.0,0,5,0.0,2,7,28.6,0,0,0.0,1,2,3,6,0,0,0,0,4,4
../kbl_data/2024-2025,S45G01N81,서울 삼성,Away,최승욱,42,14,22,63.6,4,20,20.0,18,42,42.9,2,4,50.0,2,12,14,2,0,0,4,0,4,8
../kbl_data/2024-2025,S45G01N81,서울 삼성,Away,마커스 데릭슨,15,5,5,100.0,1,1,100.0,6,6,100.0,2,3,66.7,0,3,3,0,1,3,0,1,1,3
../kbl_data/2024-2025,S45G01N81,서울 삼성,Away,차민석,4,1,1,100.0,0,0,0.0,1,1,100.0,2,2,100.0,1,0,1,0,0,0,0,0,1,2
../kbl_data/2024-2025,S45G01N81,서울 삼성,Away,이원석,4,0,4,0.0,0,0,0.0,0,4,0.0,4,4,100.0,2,4,6,0,1,0,0,0,3,4
../kbl_data/2024-2025,S45G01N81,서울 삼성,Away,저스틴 구탕,11,2,2,100.0,2,2,100.0,4,4,100.0,1,2,50.0,1,8,9,4,1,0,0,0,0,3
../kbl_data/2024-2025,S45G01N81,서울 삼성,Away,박승재,0,0,2,0.0,0,0,0.0,0,2,0.0,0,0,0.0,0,1,1,3,0,0,0,0,0,3
../kbl_data/2024-2025,S45G01N81,서울 삼성,Away,임동언,0,0,0,0.0,0,0,0.0,0,0,0.0,0,0,0.0,0,0,0,0,0,0,0,0,0,0
../kbl_data/2024-2025,S45G01N81,서울 삼성,Away,빈센트 에드워즈,14,2,3,66.7,2,4,50.0,4,7,57.1,4,4,100.0,2,2,4,1,0,0,0,0,3,0
../kbl_data/2024-2025,S45G01N82,안양 정관장,Home,정준원,0,0,0,0.0,0,0,0.0,0,0,0.0,0,0,0.0,0,2,2,0,0,0,0,0,0,0
../kbl_data/2024-2025,S45G01N82,안양 정관장,Home,배병준,2,1,1,100.0,0,5,0.0,1,6,16.7,0,0,0.0,0,2,2,0,1,1,1,0,1,0
../kbl_data/2024-2025,S45G01N82,안양 정관장,Home,정효근,19,4,7,57.1,3,5,60.0,7,12,58.3,2,4,50.0,3,3,6,4,0,0,0,0,2,4
../kbl_data/2024-2025,S45G01N82,안양 정관장,Home,이종현,0,0,0,0.0,0,0,0.0,0,0,0.0,0,0,0.0,0,1,1,0,0,0,0,0,0,0
../kbl_data/2024-2025,S45G01N82,안양 정관장,Home,박지훈,9,3,7,42.9,1,4,25.0,4,11,36.4,0,0,0.0,0,1,1,0,3,0,0,0,1,3
../kbl_data/2024-2025,S45G01N82,안양 정관장,Home,최성원,5,1,3,33.3,1,4,25.0,2,7,28.6,0,0,0.0,0,0,0,3,1,0,0,0,2,1
../kbl_data/2024-2025,S45G01N82,안양 정관장,Home,변준형,7,3,8,37.5,0,5,0.0,3,13,23.1,1,1,100.0,1,5,6,4,0,1,0,0,4,1
../kbl_data/2024-2025,S45G01N82,안양 정관장,Home,캐디 라렌,20,5,7,71.4,2,5,40.0,7,12,58.3,4,5,80.0,3,10,13,4,0,0,0,2,2,3
../kbl_data/2024-2025,S45G01N82,안양 정관장,Home,한승희,0,0,0,0.0,0,0,0.0,0,0,0.0,0,2,0.0,0,1,1,0,0,0,0,0,0,4
../kbl_data/2024-2025,S45G01N82,안양 정관장,Home,하비 고메즈,4,2,2,100.0,0,0,0.0,2,2,100.0,0,1,0.0,0,1,1,1,0,0,0,0,0,0
../kbl_data/2024-2025,S45G01N82,안양 정관장,Home,마이클 영 Jr,0,0,2,0.0,0,1,0.0,0,3,0.0,0,0,0.0,1,1,2,1,0,0,0,0,0,4
../kbl_data/2024-2025,S45G01N82,안양 정관장,Home,박정웅,2,1,1,100.0,0,0,0.0,1,1,100.0,0,0,0.0,0,0,0,0,0,0,0,0,0,0
../kbl_data/2024-2025,S45G01N82,창원 LG,Away,허일영,0,0,0,0.0,0,0,0.0,0,0,0.0,0,0,0.0,0,0,0,0,0,0,0,0,0,0
../kbl_data/2024-2025,S45G01N82,창원 LG,Away,장민국,3,0,1,0.0,1,1,100.0,1,2,50.0,0,0,0.0,0,1,1,0,0,0,0,0,0,1
../kbl_data/2024-2025,S45G01N82,창원 LG,Away,한상혁,0,0,0,0.0,0,0,0.0,0,0,0.0,0,0,0.0,0,0,0,0,1,0,0,0,1,2
../kbl_data/2024-2025,S45G01N82,창원 LG,Away,전성현,0,0,1,0.0,0,4,0.0,0,5,0.0,0,0,0.0,0,0,0,1,0,0,0,0,2,0
../kbl_data/2024-2025,S45G01N82,창원 LG,Away,정인덕,0,0,2,0.0,0,2,0.0,0,4,0.0,0,0,0.0,0,2,2,2,4,1,0,0,0,1
../kbl_data/2024-2025,S45G01N82,창원 LG,Away,대릴 먼로,10,4,5,80.0,0,0,0.0,4,5,80.0,2,2,100.0,5,9,14,2,0,0,0,0,4,2
../kbl_data/2024-2025,S45G01N82,창원 LG,Away,박정현,0,0,2,0.0,0,0,0.0,0,2,0.0,0,0,0.0,0,0,0,0,0,0,0,0,0,1
../kbl_data/2024-2025,S45G01N82,창원 LG,Away,아셈 마레이,12,4,5,80.0,0,0,0.0,4,5,80.0,4,6,66.7,1,7,8,5,1,0,0,0,1,3
../kbl_data/2024-2025,S45G01N82,창원 LG,Away,양준석,14,4,7,57.1,2,2,100.0,6,9,66.7,0,0,0.0,1,2,3,2,2,0,1,0,0,5
../kbl_data/2024-2025,S45G01N82,창원 LG,Away,유기상,12,3,4,75.0,2,11,18.2,5,15,33.3,0,0,0.0,2,2,4,2,0,1,1,0,0,3
../kbl_data/2024-2025,S45G01N82,창원 LG,Away,이경도,2,0,1,0.0,0,0,0.0,0,1,0.0,2,2,100.0,0,0,0,0,0,0,0,0,0,3
../kbl_data/2024-2025,S45G01N82,창원 LG,Away,칼 타마요,26,11,17,64.7,0,2,0.0,11,19,57.9,4,4,100.0,1,6,7,2,1,1,0,0,0,1
../kbl_data/2024-2025,S45G01N83,부산 KCC,Home,정창영,0,0,2,0.0,0,1,0.0,0,3,0.0,0,0,0.0,0,0,0,0,0,0,0,0,0,1
../kbl_data/2024-2025,S45G01N83,부산 KCC,Home,리온 윌리엄스,5,2,3,66.7,0,1,0.0,2,4,50.0,1,1,100.0,2,3,5,0,0,0,0,0,0,0
../kbl_data/2024-2025,S45G01N83,부산 KCC,Home,전준범,0,0,0,0.0,0,0,0.0,0,0,0.0,0,0,0.0,0,0,0,0,0,0,0,0,0,0
../kbl_data/2024-2025,S45G01N83,부산 KCC,Home,허웅,32,6,9,66.7,6,9,66.7,12,18,66.7,2,2,100.0,0,2,2,4,1,0,0,0,4,3
../kbl_data/2024-2025,S45G01N83,부산 KCC,Home,이승현,6,3,6,50.0,0,2,0.0,3,8,37.5,0,0,0.0,1,2,3,4,0,0,0,0,0,3
../kbl_data/2024-2025,S45G01N83,부산 KCC,Home,이호현,7,2,2,100.0,1,1,100.0,3,3,100.0,0,0,0.0,0,3,3,1,0,0,0,0,3,4
../kbl_data/2024-2025,S45G01N83,부산 KCC,Home,최준용,17,4,5,80.0,3,8,37.5,7,13,53.8,0,0,0.0,2,4,6,2,0,0,0,0,1,2
../kbl_data/2024-2025,S45G01N83,부산 KCC,Home,디온테 버튼,21,7,10,70.0,2,7,28.6,9,17,52.9,1,2,50.0,1,4,5,4,3,2,0,0,1,3
../kbl_data/2024-2025,S45G01N83,부산 KCC,Home,이근휘,0,0,0,0.0,0,0,0.0,0,0,0.0,0,0,0.0,0,0,0,0,0,0,0,0,0,0
../kbl_data/2024-2025,S45G01N83,부산 KCC,Home,김동현,0,0,0,0.0,0,1,0.0,0,1,0.0,0,0,0.0,0,1,1,0,0,0,0,0,0,2
../kbl_data/2024-2025,S45G01N83,부산 KCC,Home,캘빈 제프리 에피스톨라,0,0,0,0.0,0,0,0.0,0,0,0.0,0,0,0.0,0,0,0,1,2,0,0,0,2,0
../kbl_data/2024-2025,S45G01N83,부산 KCC,Home,이주영,0,0,0,0.0,0,0,0.0,0,0,0.0,0,0,0.0,0,0,0,0,0,0,0,0,0,0
../kbl_data/2024-2025,S45G01N83,원주 DB,Away,이관희,6,0,2,0.0,2,2,100.0,2,4,50.0,0,0,0.0,0,2,2,0,0,0,0,0,1,0
../kbl_data/2024-2025,S45G01N83,원주 DB,Away,김시래,0,0,1,0.0,0,1,0.0,0,2,0.0,0,0,0.0,0,0,0,0,0,0,0,0,0,0
../kbl_data/2024-2025,S45G01N83,원주 DB,Away,서민수,16,2,2,100.0,4,9,44.4,6,11,54.5,0,0,0.0,1,3,4,6,1,0,0,0,1,4
../kbl_data/2024-2025,S45G01N83,원주 DB,Away,김영현,6,0,1,0.0,2,5,40.0,2,6,33.3,0,0,0.0,0,0,0,2,0,0,0,0,1,4
../kbl_data/2024-2025,S45G01N83,원주 DB,Away,박봉진,0,0,0,0.0,0,0,0.0,0,0,0.0,0,0,0.0,0,0,0,0,0,0,0,0,0,0
../kbl_data/2024-2025,S45G01N83,원주 DB,Away,강상재,14,6,8,75.0,0,1,0.0,6,9,66.7,2,2,100.0,5,3,8,3,1,0,0,0,2,3
../kbl_data/2024-2025,S45G01N83,원주 DB,Away,치나누 오누아쿠,12,4,11,36.4,0,1,0.0,4,12,33.3,4,6,66.7,3,6,9,4,2,0,0,0,0,1
../kbl_data/2024-2025,S45G01N83,원주 DB,Away,이용우,0,0,0,0.0,0,0,0.0,0,0,0.0,0,0,0.0,0,0,0,0,0,0,0,0,0,0
../kbl_data/2024-2025,S45G01N83,원주 DB,Away,정호영,0,0,0,0.0,0,0,0.0,0,0,0.0,0,0,0.0,0,0,0,0,0,0,0,0,0,0
../kbl_data/2024-2025,S45G01N83,원주 DB,Away,이선 알바노,25,7,10,70.0,3,9,33.3,10,19,52.6,2,3,66.7,0,2,2,3,6,0,0,0,2,1
../kbl_data/2024-2025,S45G01N83,원주 DB,Away,박인웅,6,3,3,100.0,0,3,0.0,3,6,50.0,0,0,0.0,2,2,4,0,0,0,0,0,1,2
../kbl_data/2024-2025,S45G01N83,원주 DB,Away,로버트 카터,7,2,3,66.7,1,1,100.0,3,4,75.0,0,0,0.0,2,5,7,2,1,0,0,0,2,1
../kbl_data/2024-2025,S45G01N84,수원 KT,Home,한희원,3,0,2,0.0,1,3,33.3,1,5,20.0,0,0,0.0,0,1,1,0,0,1,0,0,0,5
../kbl_data/2024-2025,S45G01N84,수원 KT,Home,최창진,5,0,0,0.0,1,5,20.0,1,5,20.0,2,2,100.0,0,2,2,0,0,0,0,0,2,0
../kbl_data/2024-2025,S45G01N84,수원 KT,Home,문성곤,0,0,0,0.0,0,0,0.0,0,0,0.0,0,0,0.0,1,2,3,3,1,0,0,0,0,0
../kbl_data/2024-2025,S45G01N84,수원 KT,Home,이현석,3,0,0,0.0,1,2,50.0,1,2,50.0,0,0,0.0,0,2,2,0,0,0,0,0,0,4
../kbl_data/2024-2025,S45G01N84,수원 KT,Home,박준영,19,5,9,55.6,1,2,50.0,6,11,54.5,6,8,75.0,2,2,4,2,0,1,0,0,1,3
../kbl_data/2024-2025,S45G01N84,수원 KT,Home,최진광,0,0,0,0.0,0,0,0.0,0,0,0.0,0,0,0.0,0,0,0,0,0,0,0,0,0,0
../kbl_data/2024-2025,S45G01N84,수원 KT,Home,박지원,10,3,7,42.9,1,4,25.0,4,11,36.4,1,2,50.0,2,2,4,5,1,1,0,0,2,3
../kbl_data/2024-2025,S45G01N84,수원 KT,Home,하윤기,8,4,4,100.0,0,0,0.0,4,4,100.0,0,0,0.0,1,3,4,1,0,0,0,0,0,1
../kbl_data/2024-2025,S45G01N84,수원 KT,Home,이두원,2,0,2,0.0,0,1,0.0,0,3,0.0,2,2,100.0,2,1,3,1,2,0,0,0,1,1
../kbl_data/2024-2025,S45G01N84,수원 KT,Home,박선웅,0,0,0,0.0,0,0,0.0,0,0,0.0,0,0,0.0,0,0,0,0,0,0,0,0,0,0
../kbl_data/2024-2025,S45G01N84,수원 KT,Home,문정현,23,6,7,85.7,3,6,50.0,9,13,69.2,2,3,66.7,2,2,4,4,0,0,0,0,3,2
../kbl_data/2024-2025,S45G01N84,수원 KT,Home,레이션 해먼즈,10,3,8,37.5,1,5,20.0,4,13,30.8,1,2,50.0,2,5,7,0,0,0,0,0,1,4
../kbl_data/2024-2025,S45G01N84,대구 한국가스공사,Away,김동량,0,0,1,0.0,0,0,0.0,0,1,0.0,0,0,0.0,1,2,3,1,0,0,0,0,0,0
../kbl_data/2024-2025,S45G01N84,대구 한국가스공사,Away,차바위,3,0,1,0.0,1,3,33.3,1,4,25.0,0,0,0.0,1,2,3,1,0,0,0,0,0,3
../kbl_data/2024-2025,S45G01N84,대구 한국가스공사,Away,박지훈,0,0,0,0.0,0,0,0.0,0,0,0.0,0,0,0.0,0,0,0,0,0,0,0,0,1,1
../kbl_data/2024-2025,S45G01N84,대구 한국가스공사,Away,이대헌,4,2,4,50.0,0,0,0.0,2,4,50.0,0,0,0.0,0,2,2,1,0,0,0,0,3,5
../kbl_data/2024-2025,S45G01N84,대구 한국가스공사,Away,정성우,2,1,5,20.0,0,2,0.0,1,7,14.3,0,1,0.0,0,2,2,5,0,0,0,0,0,3
../kbl_data/2024-2025,S45G01N84,대구 한국가스공사,Away,김철욱,6,0,0,0.0,2,2,100.0,2,2,100.0,0,0,0.0,0,2,2,1,0,0,0,0,0,3
../kbl_data/2024-2025,S45G01N84,대구 한국가스공사,Away,김낙현,16,2,5,40.0,3,5,60.0,5,10,50.0,3,3,100.0,0,0,0,6,1,0,0,0,0,1
../kbl_data/2024-2025,S45G01N84,대구 한국가스공사,Away,양재혁,0,0,0,0.0,0,0,0.0,0,0,0.0,0,0,0.0,0,0,0,0,0,0,0,0,0,0
../kbl_data/2024-2025,S45G01N84,대구 한국가스공사,Away,앤드류 니콜슨,29,10,16,62.5,1,2,50.0,11,18,61.1,6,7,85.7,3,0,3,0,0,1,0,0,2,0
../kbl_data/2024-2025,S45G01N84,대구 한국가스공사,Away,신승민,11,2,4,50.0,1,2,50.0,3,6,50.0,4,4,100.0,0,5,5,2,1,0,0,0,0,2
../kbl_data/2024-2025,S45G01N84,대구 한국가스공사,Away,샘조세프 벨란겔,2,1,3,33.3,0,2,0.0,1,5,20.0,0,0,0.0,1,2,3,3,0,0,0,0,1,2
../kbl_data/2024-2025,S45G01N84,대구 한국가스공사,Away,유슈 은도예,14,3,6,50.0,1,1,100.0,4,7,57.1,5,6,83.3,3,6,9,1,0,0,0,1,1,2
../kbl_data/2024-2025,S45G01N85,서울 SK,Home,김선형,14,5,10,50.0,1,5,20.0,6,15,40.0,1,1,100.0,2,3,5,6,1,0,0,0,2,0
../kbl_data/2024-2025,S45G01N85,서울 SK,Home,오세근,6,0,3,0.0,2,3,66.7,2,6,33.3,0,0,0.0,1,1,2,0,0,0,0,0,0,2
../kbl_data/2024-2025,S45G01N85,서울 SK,Home,최부경,7,3,6,50.0,0,0,0.0,3,6,50.0,1,2,50.0,1,1,2,1,1,0,0,0,0,2
../kbl_data/2024-2025,S45G01N85,서울 SK,Home,최원혁,13,2,3,66.7,3,3,100.0,5,6,83.3,0,0,0.0,1,1,2,1,1,0,0,0,0,5
../kbl_data/2024-2025,S45G01N85,서울 SK,Home,장문호,0,0,0,0.0,0,0,0.0,0,0,0.0,0,0,0.0,1,0,1,0,0,0,0,0,0,0
../kbl_data/2024-2025,S45G01N85,서울 SK,Home,안영준,9,3,5,60.0,1,3,33.3,4,8,50.0,0,0,0.0,1,2,3,4,0,0,0,0,2,2
../kbl_data/2024-2025,S45G01N85,서울 SK,Home,자밀 워니,28,12,17,70.6,1,6,16.7,13,23,56.5,1,2,50.0,3,6,9,5,2,0,0,1,0,2
../kbl_data/2024-2025,S45G01N85,서울 SK,Home,김형빈,0,0,1,0.0,0,0,0.0,0,1,0.0,0,0,0.0,1,2,3,0,0,0,0,0,0,0
../kbl_data/2024-2025,S45G01N85,서울 SK,Home,아이재아 힉스,3,1,2,50.0,0,0,0.0,1,2,50.0,1,2,50.0,1,0,1,0,0,0,0,0,1,2
../kbl_data/2024-2025,S45G01N85,서울 SK,Home,박민우,0,0,0,0.0,0,0,0.0,0,0,0.0,0,0,0.0,0,0,0,0,0,0,0,0,0,0
../kbl_data/2024-2025,S45G01N85,서울 SK,Home,오재현,9,0,4,0.0,3,5,60.0,3,9,33.3,0,0,0.0,1,2,3,4,2,1,0,0,2,3
../kbl_data/2024-2025,S45G01N85,서울 SK,Home,고메즈 델 리아노,0,0,0,0.0,0,0,0.0,0,0,0.0,0,0,0.0,0,0,0,0,0,0,0,0,0,0
../kbl_data/2024-2025,S45G01N85,울산 현대모비스,Away,함지훈,6,2,4,50.0,0,1,0.0,2,5,40.0,2,2,100.0,2,1,3,3,2,0,0,0,3,1
../kbl_data/2024-2025,S45G01N85,울산 현대모비스,Away,장재석,0,0,0,0.0,0,0,0.0,0,0,0.0,0,0,0.0,0,0,0,0,0,0,0,0,0,0
../kbl_data/2024-2025,S45G01N85,울산 현대모비스,Away,김지완,0,0,0,0.0,0,0,0.0,0,0,0.0,0,0,0.0,0,0,0,0,0,0,0,0,0,0
../kbl_data/2024-2025,S45G01N85,울산 현대모비스,Away,한호빈,6,0,0,0.0,2,2,100.0,2,2,100.0,0,0,0.0,1,1,2,2,0,0,0,0,0,2
../kbl_data/2024-2025,S45G01N85,울산 현대모비스,Away,서명진,7,2,3,66.7,1,5,20.0,3,8,37.5,0,0,0.0,0,2,2,8,0,0,0,0,1,3
../kbl_data/2024-2025,S45G01N85,울산 현대모비스,Away,숀 롱,10,5,7,71.4,0,0,0.0,5,7,71.4,0,0,0.0,1,3,4,0,0,0,0,0,2,0
../kbl_data/2024-2025,S45G01N85,울산 현대모비스,Away,이우석,19,2,4,50.0,5,12,41.7,7,16,43.8,0,0,0.0,0,4,4,5,1,2,0,0,2,2
../kbl_data/2024-2025,S45G01N85,울산 현대모비스,Away,이승우,0,0,0,0.0,0,0,0.0,0,0,0.0,0,0,0.0,0,0,0,0,0,0,0,0,0,0
../kbl_data/2024-2025,S45G01N85,울산 현대모비스,Away,신민석,8,1,1,100.0,2,5,40.0,3,6,50.0,0,0,0.0,0,1,1,0,0,0,0,0,1,3
../kbl_data/2024-2025,S45G01N85,울산 현대모비스,Away,게이지 프림,21,7,10,70.0,1,1,100.0,8,11,72.7,4,5,80.0,4,3,7,2,1,2,0,1,1,2
../kbl_data/2024-2025,S45G01N85,울산 현대모비스,Away,박무빈,6,1,1,100.0,1,2,50.0,2,3,66.7,1,2,50.0,0,4,4,3,1,0,0,0,0,0
../kbl_data/2024-2025,S45G01N85,울산 현대모비스,Away,미구엘 안드레 옥존,7,1,4,25.0,1,3,33.3,2,7,28.6,2,2,100.0,0,0,0,2,1,1,0,0,1,2
../kbl_data/2024-2025,S45G01N86,부산 KCC,Home,정창영,2,1,3,33.3,0,1,0.0,1,4,25.0,0,0,0.0,0,0,0,1,0,0,1,0,0,2
../kbl_data/2024-2025,S45G01N86,부산 KCC,Home,리온 윌리엄스,4,2,5,40.0,0,1,0.0,2,6,33.3,0,0,0.0,0,6,6,1,0,1,0,0,0,4
../kbl_data/2024-2025,S45G01N86,부산 KCC,Home,전준범,0,0,0,0.0,0,0,0.0,0,0,0.0,0,0,0.0,0,0,0,0,0,0,0,0,0,0
../kbl_data/2024-2025,S45G01N86,부산 KCC,Home,허웅,12,3,8,37.5,2,6,33.3,5,14,35.7,0,0,0.0,0,0,0,2,1,0,0,0,1,1
../kbl_data/2024-2025,S45G01N86,부산 KCC,Home,이승현,12,6,12,50.0,0,0,0.0,6,12,50.0,0,0,0.0,2,3,5,0,0,0,0,0,1,0
../kbl_data/2024-2025,S45G01N86,부산 KCC,Home,이호현,4,2,3,66.7,0,1,0.0,2,4,50.0,0,0,0.0,1,2,3,1,1,0,0,0,1,1
../kbl_data/2024-2025,S45G01N86,부산 KCC,Home,최준용,13,1,7,14.3,2,8,25.0,3,15,20.0,5,6,83.3,1,9,10,5,1,2,0,0,4,2
../kbl_data/2024-2025,S45G01N86,부산 KCC,Home,디온테 버튼,2,1,3,33.3,0,0,0.0,1,3,33.3,0,0,0.0,1,2,3,2,1,0,0,1,2,0
../kbl_data/2024-2025,S45G01N86,부산 KCC,Home,이근휘,0,0,0,0.0,0,1,0.0,0,1,0.0,0,0,0.0,0,0,0,0,0,0,0,0,0,0
../kbl_data/2024-2025,S45G01N86,부산 KCC,Home,김동현,3,0,1,0.0,0,0,0.0,0,1,0.0,3,4,75.0,0,0,0,0,1,0,0,0,0,2
../kbl_data/2024-2025,S45G01N86,부산 KCC,Home,캘빈 제프리 에피스톨라,0,0,0,0.0,0,0,0.0,0,0,0.0,0,0,0.0,0,0,0,0,0,0,0,0,2,2
../kbl_data/2024-2025,S45G01N86,부산 KCC,Home,이주영,0,0,0,0.0,0,0,0.0,0,0,0.0,0,0,0.0,0,0,0,0,0,0,0,0,0,0
../kbl_data/2024-2025,S45G01N86,창원 LG,Away,허일영,0,0,0,0.0,0,1,0.0,0,1,0.0,0,0,0.0,0,0,0,0,0,0,0,0,0,3
../kbl_data/2024-2025,S45G01N86,창원 LG,Away,장민국,0,0,0,0.0,0,1,0.0,0,1,0.0,0,0,0.0,0,1,1,0,0,0,0,0,0,2
../kbl_data/2024-2025,S45G01N86,창원 LG,Away,한상혁,0,0,0,0.0,0,0,0.0,0,0,0.0,0,0,0.0,0,0,0,0,0,0,0,0,0,0
../kbl_data/2024-2025,S45G01N86,창원 LG,Away,전성현,6,0,0,0.0,2,5,40.0,2,5,40.0,0,0,0.0,0,0,0,0,0,0,0,0,1,1
../kbl_data/2024-2025,S45G01N86,창원 LG,Away,정인덕,3,0,1,0.0,1,7,14.3,1,8,12.5,0,0,0.0,1,3,4,2,1,1,0,0,1,0
../kbl_data/2024-2025,S45G01N86,창원 LG,Away,대릴 먼로,6,3,4,75.0,0,0,0.0,3,4,75.0,0,0,0.0,2,6,8,1,1,0,0,0,0,1
../kbl_data/2024-2025,S45G01N86,창원 LG,Away,박정현,2,1,3,33.3,0,0,0.0,1,3,33.3,0,0,0.0,1,1,2,0,0,0,0,0,0,0
../kbl_data/2024-2025,S45G01N86,창원 LG,Away,아셈 마레이,12,5,11,45.5,0,0,0.0,5,11,45.5,2,5,40.0,5,8,13,2,4,0,0,1,2,0
../kbl_data/2024-2025,S45G01N86,창원 LG,Away,양준석,9,4,5,80.0,0,3,0.0,4,8,50.0,1,1,100.0,1,3,4,4,1,0,0,0,3,3
../kbl_data/2024-2025,S45G01N86,창원 LG,Away,유기상,12,0,1,0.0,4,7,57.1,4,8,50.0,0,0,0.0,0,3,3,1,0,0,0,0,1,4
../kbl_data/2024-2025,S45G01N86,창원 LG,Away,이경도,5,1,2,50.0,1,2,50.0,2,4,50.0,0,0,0.0,0,2,2,0,0,0,0,0,1,3
../kbl_data/2024-2025,S45G01N86,창원 LG,Away,칼 타마요,19,8,12,66.7,1,4,25.0,9,16,56.2,0,0,0.0,1,3,4,5,3,0,0,0,0,2
../kbl_data/2024-2025,S45G01N87,안양 정관장,Home,배병준,10,1,2,50.0,1,4,25.0,2,6,33.3,5,5,100.0,0,2,2,3,0,0,0,0,4,3
../kbl_data/2024-2025,S45G01N87,안양 정관장,Home,정효근,19,3,4,75.0,3,4,75.0,6,8,75.0,4,4,100.0,0,2,2,1,0,1,0,0,0,3
../kbl_data/2024-2025,S45G01N87,안양 정관장,Home,이종현,3,0,1,0.0,0,1,0.0,0,2,0.0,3,4,75.0,2,2,4,2,0,0,0,0,1,1
../kbl_data/2024-2025,S45G01N87,안양 정관장,Home,박지훈,13,4,7,57.1,1,2,50.0,5,9,55.6,2,2,100.0,2,3,5,3,0,0,0,0,1,3
../kbl_data/2024-2025,S45G01N87,안양 정관장,Home,최성원,0,0,0,0.0,0,0,0.0,0,0,0.0,0,0,0.0,0,1,1,1,0,0,0,0,1,0
../kbl_data/2024-2025,S45G01N87,안양 정관장,Home,변준형,7,2,5,40.0,1,3,33.3,3,8,37.5,0,0,0.0,1,1,2,7,0,1,0,0,4,2
../kbl_data/2024-2025,S45G01N87,안양 정관장,Home,캐디 라렌,13,5,5,100.0,0,3,0.0,5,8,62.5,3,4,75.0,0,11,11,4,0,1,0,3,1,2
../kbl_data/2024-2025,S45G01N87,안양 정관장,Home,김경원,0,0,0,0.0,0,0,0.0,0,0,0.0,0,0,0.0,0,0,0,0,0,0,0,0,0,0
../kbl_data/2024-2025,S45G01N87,안양 정관장,Home,한승희,1,0,0,0.0,0,0,0.0,0,0,0.0,1,2,50.0,0,0,0,0,0,0,1,0,0,2
../kbl_data/2024-2025,S45G01N87,안양 정관장,Home,하비 고메즈,13,2,2,100.0,3,4,75.0,5,6,83.3,0,0,0.0,0,3,3,0,0,1,0,0,5,2
../kbl_data/2024-2025,S45G01N87,안양 정관장,Home,마이클 영 Jr,0,0,0,0.0,0,0,0.0,0,0,0.0,0,0,0.0,0,0,0,0,0,0,0,0,0,0
../kbl_data/2024-2025,S45G01N87,안양 정관장,Home,박정웅,0,0,1,0.0,0,1,0.0,0,2,0.0,0,0,0.0,0,1,1,0,1,1,0,0,0,0
../kbl_data/2024-2025,S45G01N87,고양 소노,Away,정희재,4,2,2,100.0,0,5,0.0,2,7,28.6,0,0,0.0,1,4,5,2,1,0,0,0,0,4
../kbl_data/2024-2025,S45G01N87,고양 소노,Away,이재도,13,4,5,80.0,1,4,25.0,5,9,55.6,2,2,100.0,0,2,2,7,1,0,0,0,1,2
../kbl_data/2024-2025,S45G01N87,고양 소노,Away,최승욱,8,1,2,50.0,2,6,33.3,3,8,37.5,0,0,0.0,3,0,3,0,3,0,0,0,0,3
../kbl_data/2024-2025,S45G01N87,고양 소노,Away,김진유,4,2,2,100.0,0,2,0.0,2,4,50.0,0,0,0.0,3,1,4,1,2,0,0,0,0,4
../kbl_data/2024-2025,S45G01N87,고양 소노,Away,이정현,27,3,12,25.0,6,12,50.0,9,24,37.5,3,3,100.0,0,1,1,6,2,0,0,0,0,3
../kbl_data/2024-2025,S45G01N87,고양 소노,Away,백지웅,0,0,0,0.0,0,0,0.0,0,0,0.0,0,0,0.0,0,0,0,0,0,0,0,0,0,0
../kbl_data/2024-2025,S45G01N87,고양 소노,Away,박종하,0,0,0,0.0,0,2,0.0,0,2,0.0,0,0,0.0,0,0,0,0,1,0,1,0,1,0
../kbl_data/2024-2025,S45G01N87,고양 소노,Away,민기남,0,0,0,0.0,0,0,0.0,0,0,0.0,0,0,0.0,0,0,0,0,0,0,0,0,0,0
../kbl_data/2024-2025,S45G01N87,고양 소노,Away,앨런 윌리엄스,15,5,15,33.3,0,0,0.0,5,15,33.3,5,5,100.0,4,9,13,1,0,2,0,0,1,2
../kbl_data/2024-2025,S45G01N87,고양 소노,Away,디제이 번즈 Jr,4,2,4,50.0,0,0,0.0,2,4,50.0,0,0,0.0,3,0,3,0,0,0,0,0,1,1
../kbl_data/2024-2025,S45G01N87,고양 소노,Away,이근준,3,0,0,0.0,1,3,33.3,1,3,33.3,0,0,0.0,2,0,2,0,2,0,0,0,0,1
../kbl_data/2024-2025,S45G01N87,고양 소노,Away,서동원,0,0,0,0.0,0,0,0.0,0,0,0.0,0,0,0.0,0,0,0,0,0,0,0,0,0,0
../kbl_data/2024-2025,S45G01N88,서울 SK,Home,김선형,10,3,5,60.0,0,3,0.0,3,8,37.5,4,6,66.7,2,0,2,4,0,0,0,0,0,4
../kbl_data/2024-2025,S45G01N88,서울 SK,Home,오세근,17,3,3,100.0,3,5,60.0,6,8,75.0,2,2,100.0,1,3,4,1,0,0,0,0,0,2
../kbl_data/2024-2025,S45G01N88,서울 SK,Home,최부경,2,0,1,0.0,0,0,0.0,0,1,0.0,2,2,100.0,1,2,3,2,0,0,0,0,0,2
../kbl_data/2024-2025,S45G01N88,서울 SK,Home,최원혁,3,0,0,0.0,1,5,20.0,1,5,20.0,0,0,0.0,0,1,1,2,0,0,0,0,0,5
../kbl_data/2024-2025,S45G01N88,서울 SK,Home,장문호,0,0,0,0.0,0,1,0.0,0,1,0.0,0,0,0.0,0,0,0,0,0,0,0,0,0,1
../kbl_data/2024-2025,S45G01N88,서울 SK,Home,안영준,7,2,3,66.7,0,2,0.0,2,5,40.0,3,4,75.0,1,3,4,2,0,0,0,0,2,4
../kbl_data/2024-2025,S45G01N88,서울 SK,Home,자밀 워니,30,10,20,50.0,2,5,40.0,12,25,48.0,4,5,80.0,4,13,17,4,1,3,0,0,2,2
../kbl_data/2024-2025,S45G01N88,서울 SK,Home,김형빈,0,0,0,0.0,0,1,0.0,0,1,0.0,0,0,0.0,0,0,0,0,0,1,1,0,0,0
../kbl_data/2024-2025,S45G01N88,서울 SK,Home,아이재아 힉스,8,3,4,75.0,0,1,0.0,3,5,60.0,2,4,50.0,0,0,0,1,0,0,0,0,0,0
../kbl_data/2024-2025,S45G01N88,서울 SK,Home,박민우,0,0,0,0.0,0,0,0.0,0,0,0.0,0,0,0.0,0,0,0,0,0,0,0,0,0,0
../kbl_data/2024-2025,S45G01N88,서울 SK,Home,오재현,7,1,1,100.0,1,5,20.0,2,6,33.3,2,2,100.0,0,2,2,6,1,1,1,0,3,3
../kbl_data/2024-2025,S45G01N88,서울 SK,Home,고메즈 델 리아노,0,0,0,0.0,0,0,0.0,0,0,0.0,0,0,0.0,0,0,0,0,0,0,0,0,0,0
../kbl_data/2024-2025,S45G01N88,서울 삼성,Away,이정현,17,7,10,70.0,0,5,0.0,7,15,46.7,3,3,100.0,1,2,3,6,1,0,0,0,2,2
../kbl_data/2024-2025,S45G01N88,서울 삼성,Away,최현민,6,0,1,0.0,0,1,0.0,0,2,0.0,6,6,100.0,0,1,1,2,0,0,0,0,1,2
../kbl_data/2024-2025,S45G01N88,서울 삼성,Away,이원대,6,2,3,66.7,0,0,0.0,2,3,66.7,2,3,66.7,0,1,1,0,0,0,0,0,1,0
../kbl_data/2024-2025,S45G01N88,서울 삼성,Away,최성모,13,2,3,66.7,1,4,25.0,3,7,42.9,6,7,85.7,1,2,3,1,0,0,0,0,1,4
../kbl_data/2024-2025,S45G01N88,서울 삼성,Away,최승욱,4,2,4,50.0,0,0,0.0,2,4,50.0,0,0,0.0,1,0,1,1,0,0,0,0,1,1
../kbl_data/2024-2025,S45G01N88,서울 삼성,Away,마커스 데릭슨,10,3,3,100.0,1,4,25.0,4,7,57.1,1,2,50.0,1,8,9,1,1,0,1,0,0,3
../kbl_data/2024-2025,S45G01N88,서울 삼성,Away,차민석,0,0,0,0.0,0,1,0.0,0,1,0.0,0,0,0.0,0,0,0,0,0,0,0,0,0,2
../kbl_data/2024-2025,S45G01N88,서울 삼성,Away,이원석,25,7,10,70.0,1,2,50.0,8,12,66.7,8,8,100.0,2,5,7,0,1,1,0,0,0,3
../kbl_data/2024-2025,S45G01N88,서울 삼성,Away,저스틴 구탕,7,2,7,28.6,1,2,50.0,3,9,33.3,0,0,0.0,1,2,3,2,2,0,0,0,1,5
../kbl_data/2024-2025,S45G01N88,서울 삼성,Away,박승재,0,0,0,0.0,0,0,0.0,0,0,0.0,0,0,0.0,0,0,0,0,0,0,0,0,0,0
../kbl_data/2024-2025,S45G01N88,서울 삼성,Away,임동언,0,0,0,0.0,0,0,0.0,0,0,0.0,0,0,0.0,0,0,0,0,0,0,0,0,0,0
../kbl_data/2024-2025,S45G01N88,서울 삼성,Away,빈센트 에드워즈,0,0,2,0.0,0,1,0.0,0,3,0.0,0,0,0.0,0,3,3,0,0,0,0,0,0,1
../kbl_data/2024-2025,S45G01N89,원주 DB,Home,이관희,3,0,1,0.0,1,7,14.3,1,8,12.5,0,0,0.0,1,1,2,1,0,0,0,0,0,0
../kbl_data/2024-2025,S45G01N89,원주 DB,Home,김시래,2,0,0,0.0,0,0,0.0,0,0,0.0,2,4,50.0,0,1,1,1,1,0,0,0,0,1
../kbl_data/2024-2025,S45G01N89,원주 DB,Home,서민수,9,0,0,0.0,3,6,50.0,3,6,50.0,0,0,0.0,3,5,8,3,0,0,0,0,1,3
../kbl_data/2024-2025,S45G01N89,원주 DB,Home,김영현,0,0,0,0.0,0,0,0.0,0,0,0.0,0,0,0.0,0,0,0,0,0,0,0,0,1,0
../kbl_data/2024-2025,S45G01N89,원주 DB,Home,박봉진,0,0,0,0.0,0,0,0.0,0,0,0.0,0,0,0.0,0,0,0,0,0,0,0,0,0,0
../kbl_data/2024-2025,S45G01N89,원주 DB,Home,강상재,17,7,10,70.0,1,3,33.3,8,13,61.5,0,0,0.0,2,5,7,1,0,0,0,0,0,4
../kbl_data/2024-2025,S45G01N89,원주 DB,Home,치나누 오누아쿠,17,6,8,75.0,1,1,100.0,7,9,77.8,2,7,28.6,3,13,16,5,1,1,0,1,5,3
../kbl_data/2024-2025,S45G01N89,원주 DB,Home,이용우,0,0,0,0.0,0,0,0.0,0,0,0.0,0,0,0.0,0,0,0,0,0,0,0,0,0,0
../kbl_data/2024-2025,S45G01N89,원주 DB,Home,이선 알바노,13,4,10,40.0,0,4,0.0,4,14,28.6,5,7,71.4,0,2,2,6,3,0,0,0,1,2
../kbl_data/2024-2025,S45G01N89,원주 DB,Home,박인웅,6,0,1,0.0,2,2,100.0,2,3,66.7,0,0,0.0,0,1,1,0,1,0,0,0,4,3
../kbl_data/2024-2025,S45G01N89,원주 DB,Home,로버트 카터,5,1,3,33.3,1,2,50.0,2,5,40.0,0,0,0.0,1,3,4,1,0,0,0,0,1,0
../kbl_data/2024-2025,S45G01N89,원주 DB,Home,김보배,0,0,0,0.0,0,0,0.0,0,0,0.0,0,0,0.0,0,0,0,0,0,0,0,0,0,0
../kbl_data/2024-2025,S45G01N89,수원 KT,Away,한희원,12,0,0,0.0,4,10,40.0,4,10,40.0,0,0,0.0,0,1,1,0,0,0,0,0,0,2
../kbl_data/2024-2025,S45G01N89,수원 KT,Away,최창진,0,0,0,0.0,0,1,0.0,0,1,0.0,0,0,0.0,0,1,1,0,0,0,0,0,0,0
../kbl_data/2024-2025,S45G01N89,수원 KT,Away,문성곤,1,0,2,0.0,0,2,0.0,0,4,0.0,1,2,50.0,6,2,8,3,3,0,0,0,1,2
../kbl_data/2024-2025,S45G01N89,수원 KT,Away,이현석,0,0,0,0.0,0,0,0.0,0,0,0.0,0,0,0.0,0,0,0,0,0,0,0,0,0,0
../kbl_data/2024-2025,S45G01N89,수원 KT,Away,박준영,9,0,7,0.0,3,7,42.9,3,14,21.4,0,4,0.0,4,2,6,3,0,0,1,0,0,2
../kbl_data/2024-2025,S45G01N89,수원 KT,Away,최진광,2,1,1,100.0,0,0,0.0,1,1,100.0,0,2,0.0,0,1,1,1,1,0,0,0,1,2
../kbl_data/2024-2025,S45G01N89,수원 KT,Away,박지원,10,2,8,25.0,2,4,50.0,4,12,33.3,0,0,0.0,2,3,5,5,1,1,0,0,2,3
../kbl_data/2024-2025,S45G01N89,수원 KT,Away,이호준,0,0,0,0.0,0,0,0.0,0,0,0.0,0,0,0.0,0,0,0,0,0,0,0,0,0,0
../kbl_data/2024-2025,S45G01N89,수원 KT,Away,하윤기,0,0,3,0.0,0,0,0.0,0,3,0.0,0,0,0.0,1,1,2,0,0,0,0,0,0,1
../kbl_data/2024-2025,S45G01N89,수원 KT,Away,박선웅,0,0,0,0.0,0,0,0.0,0,0,0.0,0,0,0.0,0,0,0,0,0,0,0,0,0,0
../kbl_data/2024-2025,S45G01N89,수원 KT,Away,문정현,10,4,7,57.1,0,4,0.0,4,11,36.4,2,2,100.0,3,1,4,2,0,0,0,0,1,3
../kbl_data/2024-2025,S45G01N89,수원 KT,Away,레이션 해먼즈,22,5,13,38.5,3,5,60.0,8,18,44.4,3,4,75.0,2,9,11,2,2,0,0,0,2,4
../kbl_data/2024-2025,S45G01N90,창원 LG,Home,허일영,10,2,2,100.0,2,6,33.3,4,8,50.0,0,0,0.0,0,1,1,1,1,0,0,0,1,3
../kbl_data/2024-2025,S45G01N90,창원 LG,Home,장민국,4,0,0,0.0,1,2,50.0,1,2,50.0,1,2,50.0,2,0,2,0,0,0,0,0,0,1
../kbl_data/2024-2025,S45G01N90,창원 LG,Home,한상혁,2,1,1,100.0,0,1,0.0,1,2,50.0,0,0,0.0,0,0,0,1,0,0,0,0,0,1
../kbl_data/2024-2025,S45G01N90,창원 LG,Home,전성현,5,1,1,100.0,1,5,20.0,2,6,33.3,0,0,0.0,0,0,0,3,0,0,0,0,1,2
../kbl_data/2024-2025,S45G01N90,창원 LG,Home,정인덕,7,2,3,66.7,1,2,50.0,3,5,60.0,0,0,0.0,0,0,0,0,0,0,0,0,0,1
../kbl_data/2024-2025,S45G01N90,창원 LG,Home,대릴 먼로,4,2,3,66.7,0,0,0.0,2,3,66.7,0,0,0.0,1,6,7,3,1,0,0,0,0,0
../kbl_data/2024-2025,S45G01N90,창원 LG,Home,박정현,2,1,1,100.0,0,0,0.0,1,1,100.0,0,0,0.0,1,2,3,0,0,0,0,0,0,0
../kbl_data/2024-2025,S45G01N90,창원 LG,Home,아셈 마레이,23,9,18,50.0,0,0,0.0,9,18,50.0,5,11,45.5,8,8,16,2,3,0,0,0,1,2
../kbl_data/2024-2025,S45G01N90,창원 LG,Home,양준석,8,2,4,50.0,1,2,50.0,3,6,50.0,1,1,100.0,0,3,3,2,2,0,0,0,2,3
../kbl_data/2024-2025,S45G01N90,창원 LG,Home,유기상,8,0,2,0.0,2,5,40.0,2,7,28.6,2,2,100.0,0,1,1,4,0,2,0,0,1,3
../kbl_data/2024-2025,S45G01N90,창원 LG,Home,이경도,0,0,0,0.0,0,0,0.0,0,0,0.0,0,0,0.0,0,0,0,0,0,0,0,0,2,0
../kbl_data/2024-2025,S45G01N90,창원 LG,Home,칼 타마요,17,7,16,43.8,1,3,33.3,8,19,42.1,0,0,0.0,8,2,10,6,0,1,0,0,0,4
../kbl_data/2024-2025,S45G01N90,서울 삼성,Away,이정현,10,5,10,50.0,0,0,0.0,5,10,50.0,0,0,0.0,0,2,2,5,1,0,0,0,1,3
../kbl_data/2024-2025,S45G01N90,서울 삼성,Away,최현민,3,0,0,0.0,1,2,50.0,1,2,50.0,0,0,0.0,2,1,3,0,1,0,0,0,0,0
../kbl_data/2024-2025,S45G01N90,서울 삼성,Away,이원대,2,1,3,33.3,0,0,0.0,1,3,33.3,0,0,0.0,0,2,2,0,0,0,0,0,0,1
../kbl_data/2024-2025,S45G01N90,서울 삼성,Away,최성모,15,1,3,33.3,3,4,75.0,4,7,57.1,4,6,66.7,0,4,4,4,1,0,0,0,2,3
../kbl_data/2024-2025,S45G01N90,서울 삼성,Away,최승욱,2,0,6,0.0,0,3,0.0,0,9,0.0,2,2,100.0,2,0,2,0,0,1,0,0,0,0
../kbl_data/2024-2025,S45G01N90,서울 삼성,Away,마커스 데릭슨,6,0,0,0.0,2,3,66.7,2,3,66.7,0,0,0.0,0,2,2,1,0,0,0,0,1,4
../kbl_data/2024-2025,S45G01N90,서울 삼성,Away,차민석,0,0,2,0.0,0,1,0.0,0,3,0.0,0,0,0.0,1,1,2,1,1,0,0,0,1,0
../kbl_data/2024-2025,S45G01N90,서울 삼성,Away,이원석,12,6,10,60.0,0,2,0.0,6,12,50.0,0,0,0.0,3,3,6,0,1,0,0,2,2,3
../kbl_data/2024-2025,S45G01N90,서울 삼성,Away,저스틴 구탕,17,6,7,85.7,1,1,100.0,7,8,87.5,2,4,50.0,1,4,5,3,0,0,0,1,1,3
../kbl_data/2024-2025,S45G01N90,서울 삼성,Away,박승재,4,0,1,0.0,1,1,100.0,1,2,50.0,1,2,50.0,0,1,1,0,1,0,0,0,0,1
../kbl_data/2024-2025,S45G01N90,서울 삼성,Away,임동언,2,1,1,100.0,0,0,0.0,1,1,100.0,0,0,0.0,0,0,0,0,1,0,0,0,0,0
../kbl_data/2024-2025,S45G01N90,서울 삼성,Away,빈센트 에드워즈,3,1,4,25.0,0,2,0.0,1,6,16.7,1,2,50.0,1,2,3,2,0,0,0,0,2,0
../kbl_data/2024-2025,S45G01N91,고양 소노,Home,정희재,6,0,1,0.0,1,3,33.3,1,4,25.0,3,4,75.0,0,2,2,1,2,0,0,0,3,5
../kbl_data/2024-2025,S45G01N91,고양 소노,Home,임동섭,0,0,0,0.0,0,0,0.0,0,0,0.0,0,0,0.0,0,0,0,0,0,0,0,0,0,1
../kbl_data/2024-2025,S45G01N91,고양 소노,Home,이재도,8,0,5,0.0,2,3,66.7,2,8,25.0,2,2,100.0,0,1,1,2,0,1,0,0,2,1
../kbl_data/2024-2025,S45G01N91,고양 소노,Home,최승욱,5,2,3,66.7,0,3,0.0,2,6,33.3,1,2,50.0,1,1,2,3,0,0,0,0,1,4
../kbl_data/2024-2025,S45G01N91,고양 소노,Home,김진유,0,0,0,0.0,0,0,0.0,0,0,0.0,0,0,0.0,2,3,5,0,0,1,0,0,0,3
../kbl_data/2024-2025,S45G01N91,고양 소노,Home,박진철,0,0,0,0.0,0,0,0.0,0,0,0.0,0,0,0.0,0,0,0,0,0,0,0,0,0,0
../kbl_data/2024-2025,S45G01N91,고양 소노,Home,이정현,28,7,9,77.8,4,9,44.4,11,18,61.1,2,2,100.0,0,4,4,6,2,0,2,0,2,2
../kbl_data/2024-2025,S45G01N91,고양 소노,Home,앨런 윌리엄스,18,7,16,43.8,0,0,0.0,7,16,43.8,4,4,100.0,5,15,20,2,0,2,0,0,2,3
../kbl_data/2024-2025,S45G01N91,고양 소노,Home,디제이 번즈 Jr,4,2,4,50.0,0,0,0.0,2,4,50.0,0,1,0.0,1,1,2,1,0,0,0,0,0,1
../kbl_data/2024-2025,S45G01N91,고양 소노,Home,이근준,3,0,1,0.0,1,6,16.7,1,7,14.3,0,0,0.0,1,6,7,2,2,1,0,0,1,2
../kbl_data/2024-2025,S45G01N91,고양 소노,Home,서동원,0,0,0,0.0,0,0,0.0,0,0,0.0,0,0,0.0,0,0,0,0,0,0,0,0,0,0
../kbl_data/2024-2025,S45G01N91,고양 소노,Home,정성조,3,0,0,0.0,1,1,100.0,1,1,100.0,0,0,0.0,0,0,0,0,0,0,0,0,0,0
../kbl_data/2024-2025,S45G01N91,수원 KT,Away,한희원,0,0,1,0.0,0,6,0.0,0,7,0.0,0,0,0.0,0,0,0,1,0,0,1,0,0,2
../kbl_data/2024-2025,S45G01N91,수원 KT,Away,최창진,5,1,2,50.0,1,2,50.0,2,4,50.0,0,0,0.0,1,0,1,2,0,0,1,0,2,1
../kbl_data/2024-2025,S45G01N91,수원 KT,Away,문성곤,0,0,0,0.0,0,1,0.0,0,1,0.0,0,0,0.0,0,2,2,0,0,0,0,0,0,1
../kbl_data/2024-2025,S45G01N91,수원 KT,Away,이현석,0,0,0,0.0,0,1,0.0,0,1,0.0,0,0,0.0,0,1,1,1,0,0,0,0,0,2
../kbl_data/2024-2025,S45G01N91,수원 KT,Away,박준영,12,4,9,44.4,1,3,33.3,5,12,41.7,1,2,50.0,2,3,5,4,0,0,0,0,0,2
../kbl_data/2024-2025,S45G01N91,수원 KT,Away,최진광,8,0,3,0.0,2,3,66.7,2,6,33.3,2,2,100.0,0,1,1,1,0,0,0,0,1,2
../kbl_data/2024-2025,S45G01N91,수원 KT,Away,박지원,4,2,3,66.7,0,4,0.0,2,7,28.6,0,0,0.0,3,3,6,1,1,1,0,0,1,2
../kbl_data/2024-2025,S45G01N91,수원 KT,Away,하윤기,7,1,3,33.3,0,0,0.0,1,3,33.3,5,6,83.3,3,3,6,0,0,0,0,0,1,2
../kbl_data/2024-2025,S45G01N91,수원 KT,Away,박선웅,7,2,2,100.0,1,3,33.3,3,5,60.0,0,0,0.0,0,0,0,0,1,0,0,0,0,1
../kbl_data/2024-2025,S45G01N91,수원 KT,Away,문정현,0,0,1,0.0,0,1,0.0,0,2,0.0,0,0,0.0,0,1,1,1,1,0,0,0,0,1
../kbl_data/2024-2025,S45G01N91,수원 KT,Away,레이션 해먼즈,7,2,3,66.7,1,4,25.0,3,7,42.9,0,0,0.0,0,4,4,0,0,0,0,0,3,4
../kbl_data/2024-2025,S45G01N91,수원 KT,Away,이스마엘 로메로,8,4,9,44.4,0,0,0.0,4,9,44.4,0,2,0.0,0,7,7,1,3,1,0,1,2,3
../kbl_data/2024-2025,S45G01N92,울산 현대모비스,Home,함지훈,9,4,7,57.1,0,0,0.0,4,7,57.1,1,2,50.0,3,3,6,5,1,0,0,0,1,1
../kbl_data/2024-2025,S45G01N92,울산 현대모비스,Home,장재석,6,3,6,50.0,0,0,0.0,3,6,50.0,0,2,0.0,1,0,1,1,0,0,0,1,0,4
../kbl_data/2024-2025,S45G01N92,울산 현대모비스,Home,한호빈,9,0,0,0.0,3,5,60.0,3,5,60.0,0,0,0.0,0,2,2,2,2,0,0,0,0,4
../kbl_data/2024-2025,S45G01N92,울산 현대모비스,Home,김국찬,0,0,0,0.0,0,1,0.0,0,1,0.0,0,0,0.0,0,0,0,0,0,0,0,0,0,0
../kbl_data/2024-2025,S45G01N92,울산 현대모비스,Home,서명진,12,2,4,50.0,2,7,28.6,4,11,36.4,2,2,100.0,1,3,4,2,1,0,0,0,1,1
../kbl_data/2024-2025,S45G01N92,울산 현대모비스,Home,숀 롱,14,5,8,62.5,0,0,0.0,5,8,62.5,4,5,80.0,1,7,8,2,0,0,0,0,4,0
../kbl_data/2024-2025,S45G01N92,울산 현대모비스,Home,이우석,5,1,1,100.0,1,4,25.0,2,5,40.0,0,0,0.0,1,5,6,2,0,0,0,0,1,2
../kbl_data/2024-2025,S45G01N92,울산 현대모비스,Home,이승우,0,0,0,0.0,0,0,0.0,0,0,0.0,0,0,0.0,0,0,0,0,0,0,0,0,0,0
../kbl_data/2024-2025,S45G01N92,울산 현대모비스,Home,신민석,5,1,2,50.0,1,4,25.0,2,6,33.3,0,0,0.0,0,5,5,2,1,1,0,0,1,2
../kbl_data/2024-2025,S45G01N92,울산 현대모비스,Home,게이지 프림,14,5,10,50.0,0,1,0.0,5,11,45.5,4,6,66.7,2,3,5,3,0,0,0,0,1,1
../kbl_data/2024-2025,S45G01N92,울산 현대모비스,Home,박무빈,2,1,5,20.0,0,1,0.0,1,6,16.7,0,0,0.0,0,1,1,3,0,0,0,0,0,1
../kbl_data/2024-2025,S45G01N92,울산 현대모비스,Home,미구엘 안드레 옥존,5,0,0,0.0,1,1,100.0,1,1,100.0,2,2,100.0,0,0,0,0,0,0,0,0,0,0
../kbl_data/2024-2025,S45G01N92,서울 삼성,Away,이정현,5,1,4,25.0,1,5,20.0,2,9,22.2,0,0,0.0,0,3,3,5,0,1,0,0,1,3
../kbl_data/2024-2025,S45G01N92,서울 삼성,Away,최현민,0,0,1,0.0,0,2,0.0,0,3,0.0,0,0,0.0,0,1,1,2,1,0,0,0,0,0
../kbl_data/2024-2025,S45G01N92,서울 삼성,Away,이원대,5,1,1,100.0,1,2,50.0,2,3,66.7,0,0,0.0,0,0,0,1,1,0,0,0,0,1
../kbl_data/2024-2025,S45G01N92,서울 삼성,Away,최성모,20,3,5,60.0,3,4,75.0,6,9,66.7,5,6,83.3,0,1,1,4,0,0,0,0,1,3
../kbl_data/2024-2025,S45G01N92,서울 삼성,Away,최승욱,5,1,2,50.0,1,3,33.3,2,5,40.0,0,0,0.0,1,1,2,0,0,0,0,0,0,0
../kbl_data/2024-2025,S45G01N92,서울 삼성,Away,김한솔,2,1,2,50.0,0,0,0.0,1,2,50.0,0,0,0.0,0,0,0,0,0,0,0,0,0,1
../kbl_data/2024-2025,S45G01N92,서울 삼성,Away,마커스 데릭슨,9,4,6,66.7,0,2,0.0,4,8,50.0,1,3,33.3,0,7,7,3,0,0,0,0,2,4
../kbl_data/2024-2025,S45G01N92,서울 삼성,Away,차민석,13,3,5,60.0,2,5,40.0,5,10,50.0,1,1,100.0,2,6,8,0,0,0,0,0,3,4
../kbl_data/2024-2025,S45G01N92,서울 삼성,Away,저스틴 구탕,18,6,8,75.0,2,3,66.7,8,11,72.7,0,1,0.0,0,3,3,0,1,0,0,0,1,1
../kbl_data/2024-2025,S45G01N92,서울 삼성,Away,박승재,0,0,0,0.0,0,0,0.0,0,0,0.0,0,0,0.0,0,0,0,0,0,0,0,0,0,0
../kbl_data/2024-2025,S45G01N92,서울 삼성,Away,임동언,0,0,0,0.0,0,0,0.0,0,0,0.0,0,0,0.0,0,0,0,0,0,0,0,0,0,0
../kbl_data/2024-2025,S45G01N92,서울 삼성,Away,빈센트 에드워즈,2,1,3,33.3,0,2,0.0,1,5,20.0,0,0,0.0,0,2,2,2,0,0,0,0,1,3
../kbl_data/2024-2025,S45G01N93,원주 DB,Home,이관희,6,0,0,0.0,2,3,66.7,2,3,66.7,0,0,0.0,0,1,1,2,1,0,0,0,0,1
../kbl_data/2024-2025,S45G01N93,원주 DB,Home,김시래,2,1,2,50.0,0,0,0.0,1,2,50.0,0,0,0.0,0,1,1,0,0,0,0,0,0,0
../kbl_data/2024-2025,S45G01N93,원주 DB,Home,서민수,9,0,1,0.0,3,6,50.0,3,7,42.9,0,0,0.0,2,2,4,2,1,0,0,0,1,4
../kbl_data/2024-2025,S45G01N93,원주 DB,Home,김영현,0,0,0,0.0,0,0,0.0,0,0,0.0,0,0,0.0,0,0,0,0,0,0,0,0,0,0
../kbl_data/2024-2025,S45G01N93,원주 DB,Home,박봉진,0,0,0,0.0,0,2,0.0,0,2,0.0,0,0,0.0,0,1,1,0,0,0,0,0,0,0
../kbl_data/2024-2025,S45G01N93,원주 DB,Home,강상재,7,2,8,25.0,1,2,50.0,3,10,30.0,0,0,0.0,2,6,8,3,0,1,0,0,1,1
../kbl_data/2024-2025,S45G01N93,원주 DB,Home,이용우,9,1,3,33.3,2,5,40.0,3,8,37.5,1,2,50.0,1,1,2,0,0,0,0,0,1,0
../kbl_data/2024-2025,S45G01N93,원주 DB,Home,정호영,0,0,0,0.0,0,0,0.0,0,0,0.0,0,0,0.0,0,0,0,0,0,0,0,0,1,0
../kbl_data/2024-2025,S45G01N93,원주 DB,Home,이선 알바노,14,3,7,42.9,2,4,50.0,5,11,45.5,2,2,100.0,3,4,7,6,0,0,0,0,3,2
../kbl_data/2024-2025,S45G01N93,원주 DB,Home,박인웅,9,0,1,0.0,3,5,60.0,3,6,50.0,0,0,0.0,2,0,2,0,1,0,0,0,1,2
../kbl_data/2024-2025,S45G01N93,원주 DB,Home,로버트 카터,15,4,12,33.3,2,5,40.0,6,17,35.3,1,2,50.0,2,11,13,3,3,2,0,0,3,3
../kbl_data/2024-2025,S45G01N93,원주 DB,Home,김보배,3,1,1,100.0,0,0,0.0,1,1,100.0,1,2,50.0,1,1,2,0,1,0,0,0,1,1
../kbl_data/2024-2025,S45G01N93,안양 정관장,Away,배병준,7,2,3,66.7,1,3,33.3,3,6,50.0,0,0,0.0,0,6,6,0,1,1,0,0,2,0
../kbl_data/2024-2025,S45G01N93,안양 정관장,Away,정효근,12,5,7,71.4,0,2,0.0,5,9,55.6,2,2,100.0,1,4,5,2,1,0,0,1,0,1
../kbl_data/2024-2025,S45G01N93,안양 정관장,Away,이종현,0,0,2,0.0,0,1,0.0,0,3,0.0,0,0,0.0,0,0,0,1,0,0,0,0,0,0
../kbl_data/2024-2025,S45G01N93,안양 정관장,Away,박지훈,6,3,5,60.0,0,4,0.0,3,9,33.3,0,0,0.0,0,1,1,4,0,0,0,0,1,3
../kbl_data/2024-2025,S45G01N93,안양 정관장,Away,최성원,3,0,2,0.0,1,2,50.0,1,4,25.0,0,0,0.0,1,3,4,1,0,0,0,0,1,2
../kbl_data/2024-2025,S45G01N93,안양 정관장,Away,변준형,3,0,4,0.0,1,5,20.0,1,9,11.1,0,0,0.0,1,0,1,2,1,1,1,0,1,0
../kbl_data/2024-2025,S45G01N93,안양 정관장,Away,캐디 라렌,12,5,8,62.5,0,3,0.0,5,11,45.5,2,4,50.0,6,9,15,3,0,0,0,2,0,2
../kbl_data/2024-2025,S45G01N93,안양 정관장,Away,김경원,0,0,0,0.0,0,0,0.0,0,0,0.0,0,0,0.0,0,0,0,0,0,0,0,0,0,0
../kbl_data/2024-2025,S45G01N93,안양 정관장,Away,한승희,2,1,3,33.3,0,0,0.0,1,3,33.3,0,0,0.0,0,0,0,0,0,0,0,0,1,2
../kbl_data/2024-2025,S45G01N93,안양 정관장,Away,클리프 알렉산더,4,2,4,50.0,0,0,0.0,2,4,50.0,0,0,0.0,1,2,3,0,0,0,0,0,0,1
../kbl_data/2024-2025,S45G01N93,안양 정관장,Away,하비 고메즈,8,0,1,0.0,2,6,33.3,2,7,28.6,2,2,100.0,0,2,2,1,0,0,0,0,1,2
../kbl_data/2024-2025,S45G01N93,안양 정관장,Away,박정웅,0,0,0,0.0,0,1,0.0,0,1,0.0,0,0,0.0,0,0,0,0,2,0,0,0,1,1
../kbl_data/2024-2025,S45G01N94,창원 LG,Home,허일영,0,0,0,0.0,0,0,0.0,0,0,0.0,0,0,0.0,0,0,0,0,0,0,0,0,0,1
../kbl_data/2024-2025,S45G01N94,창원 LG,Home,장민국,0,0,0,0.0,0,1,0.0,0,1,0.0,0,0,0.0,0,2,2,1,0,0,0,0,1,1
../kbl_data/2024-2025,S45G01N94,창원 LG,Home,한상혁,3,0,0,0.0,1,2,50.0,1,2,50.0,0,0,0.0,0,2,2,0,0,0,0,0,0,3
../kbl_data/2024-2025,S45G01N94,창원 LG,Home,전성현,17,1,2,50.0,4,6,66.7,5,8,62.5,3,4,75.0,0,1,1,0,0,0,0,0,3,1
../kbl_data/2024-2025,S45G01N94,창원 LG,Home,정인덕,6,2,3,66.7,0,1,0.0,2,4,50.0,2,2,100.0,0,4,4,2,2,0,0,0,0,2
../kbl_data/2024-2025,S45G01N94,창원 LG,Home,대릴 먼로,0,0,0,0.0,0,0,0.0,0,0,0.0,0,0,0.0,0,1,1,1,0,0,0,0,0,0
../kbl_data/2024-2025,S45G01N94,창원 LG,Home,박정현,0,0,2,0.0,0,0,0.0,0,2,0.0,0,0,0.0,0,1,1,0,0,0,0,0,1,1
../kbl_data/2024-2025,S45G01N94,창원 LG,Home,아셈 마레이,19,7,14,50.0,0,0,0.0,7,14,50.0,5,6,83.3,5,14,19,6,2,0,0,0,1,3
../kbl_data/2024-2025,S45G01N94,창원 LG,Home,양준석,11,3,3,100.0,1,3,33.3,4,6,66.7,2,2,100.0,1,3,4,6,0,0,0,0,3,3
../kbl_data/2024-2025,S45G01N94,창원 LG,Home,유기상,17,4,5,80.0,3,4,75.0,7,9,77.8,0,0,0.0,0,3,3,1,0,1,0,0,2,3
../kbl_data/2024-2025,S45G01N94,창원 LG,Home,이경도,0,0,0,0.0,0,0,0.0,0,0,0.0,0,0,0.0,0,0,0,0,0,0,0,0,0,0
../kbl_data/2024-2025,S45G01N94,창원 LG,Home,칼 타마요,13,5,10,50.0,1,3,33.3,6,13,46.2,0,0,0.0,1,1,2,4,0,0,0,0,4,2
../kbl_data/2024-2025,S45G01N94,부산 KCC,Away,정창영,5,1,5,20.0,1,3,33.3,2,8,25.0,0,0,0.0,0,1,1,6,1,0,0,0,2,3
../kbl_data/2024-2025,S45G01N94,부산 KCC,Away,리온 윌리엄스,21,8,9,88.9,0,1,0.0,8,10,80.0,5,6,83.3,1,3,4,0,5,1,0,0,0,2
../kbl_data/2024-2025,S45G01N94,부산 KCC,Away,전준범,0,0,1,0.0,0,0,0.0,0,1,0.0,0,0,0.0,1,0,1,0,0,0,0,0,1,0
../kbl_data/2024-2025,S45G01N94,부산 KCC,Away,허웅,14,4,5,80.0,2,7,28.6,6,12,50.0,0,0,0.0,0,1,1,7,0,1,0,0,0,2
../kbl_data/2024-2025,S45G01N94,부산 KCC,Away,이승현,14,6,10,60.0,0,1,0.0,6,11,54.5,2,2,100.0,0,3,3,3,0,1,0,0,0,3
../kbl_data/2024-2025,S45G01N94,부산 KCC,Away,이호현,7,2,4,50.0,1,1,100.0,3,5,60.0,0,0,0.0,0,1,1,1,0,0,0,0,1,3
../kbl_data/2024-2025,S45G01N94,부산 KCC,Away,최준용,0,0,0,0.0,0,0,0.0,0,0,0.0,0,0,0.0,0,0,0,0,0,0,0,0,0,0
../kbl_data/2024-2025,S45G01N94,부산 KCC,Away,디온테 버튼,11,1,3,33.3,2,4,50.0,3,7,42.9,3,6,50.0,0,2,2,3,4,0,0,0,2,1
../kbl_data/2024-2025,S45G01N94,부산 KCC,Away,이근휘,0,0,0,0.0,0,2,0.0,0,2,0.0,0,0,0.0,0,0,0,0,1,0,0,0,0,0
../kbl_data/2024-2025,S45G01N94,부산 KCC,Away,김동현,0,0,1,0.0,0,1,0.0,0,2,0.0,0,0,0.0,0,1,1,0,1,0,0,0,0,2
../kbl_data/2024-2025,S45G01N94,부산 KCC,Away,캘빈 제프리 에피스톨라,2,1,3,33.3,0,0,0.0,1,3,33.3,0,2,0.0,0,2,2,2,0,0,0,0,0,1
../kbl_data/2024-2025,S45G01N94,부산 KCC,Away,이주영,0,0,0,0.0,0,1,0.0,0,1,0.0,0,0,0.0,0,0,0,0,0,0,0,0,0,0
../kbl_data/2024-2025,S45G01N95,수원 KT,Home,한희원,8,1,1,100.0,2,3,66.7,3,4,75.0,0,0,0.0,0,1,1,0,0,0,0,0,1,5
../kbl_data/2024-2025,S45G01N95,수원 KT,Home,최창진,7,0,0,0.0,0,2,0.0,0,2,0.0,7,8,87.5,0,5,5,2,0,0,0,0,1,2
../kbl_data/2024-2025,S45G01N95,수원 KT,Home,이현석,6,0,0,0.0,2,4,50.0,2,4,50.0,0,0,0.0,2,5,7,2,1,1,0,0,0,5
../kbl_data/2024-2025,S45G01N95,수원 KT,Home,박준영,15,4,7,57.1,2,3,66.7,6,10,60.0,1,2,50.0,1,9,10,2,3,0,0,0,5,2
../kbl_data/2024-2025,S45G01N95,수원 KT,Home,최진광,18,4,4,100.0,3,5,60.0,7,9,77.8,1,2,50.0,0,0,0,2,0,0,0,0,1,1
../kbl_data/2024-2025,S45G01N95,수원 KT,Home,박지원,0,0,1,0.0,0,1,0.0,0,2,0.0,0,0,0.0,0,0,0,1,0,0,0,0,1,0
../kbl_data/2024-2025,S45G01N95,수원 KT,Home,하윤기,4,2,2,100.0,0,0,0.0,2,2,100.0,0,0,0.0,0,2,2,0,0,1,0,0,3,1
../kbl_data/2024-2025,S45G01N95,수원 KT,Home,박선웅,0,0,0,0.0,0,0,0.0,0,0,0.0,0,0,0.0,0,0,0,0,0,0,0,0,0,1
../kbl_data/2024-2025,S45G01N95,수원 KT,Home,문정현,3,0,4,0.0,1,1,100.0,1,5,20.0,0,0,0.0,3,0,3,4,0,0,0,0,2,1
../kbl_data/2024-2025,S45G01N95,수원 KT,Home,레이션 해먼즈,26,7,11,63.6,1,8,12.5,8,19,42.1,9,11,81.8,1,9,10,3,0,1,0,0,3,1
../kbl_data/2024-2025,S45G01N95,수원 KT,Home,박성재,0,0,0,0.0,0,0,0.0,0,0,0.0,0,0,0.0,0,0,0,1,0,0,0,0,0,1
../kbl_data/2024-2025,S45G01N95,수원 KT,Home,이스마엘 로메로,1,0,0,0.0,0,0,0.0,0,0,0.0,1,2,50.0,0,2,2,0,0,0,0,0,2,0
../kbl_data/2024-2025,S45G01N95,대구 한국가스공사,Away,김동량,0,0,2,0.0,0,0,0.0,0,2,0.0,0,0,0.0,0,0,0,0,0,0,0,0,1,1
../kbl_data/2024-2025,S45G01N95,대구 한국가스공사,Away,차바위,0,0,0,0.0,0,0,0.0,0,0,0.0,0,0,0.0,0,0,0,0,0,0,0,0,0,1
../kbl_data/2024-2025,S45G01N95,대구 한국가스공사,Away,박지훈,0,0,0,0.0,0,2,0.0,0,2,0.0,0,0,0.0,0,0,0,1,0,0,0,0,0,0
../kbl_data/2024-2025,S45G01N95,대구 한국가스공사,Away,정성우,19,5,7,71.4,3,5,60.0,8,12,66.7,0,0,0.0,1,1,2,5,3,0,1,0,1,3
../kbl_data/2024-2025,S45G01N95,대구 한국가스공사,Away,김철욱,0,0,0,0.0,0,0,0.0,0,0,0.0,0,0,0.0,0,2,2,0,1,0,0,0,0,2
../kbl_data/2024-2025,S45G01N95,대구 한국가스공사,Away,김낙현,9,3,4,75.0,1,5,20.0,4,9,44.4,0,0,0.0,0,0,0,3,0,0,1,0,0,4
../kbl_data/2024-2025,S45G01N95,대구 한국가스공사,Away,양재혁,3,0,0,0.0,1,3,33.3,1,3,33.3,0,0,0.0,0,0,0,1,3,0,0,0,0,2
../kbl_data/2024-2025,S45G01N95,대구 한국가스공사,Away,곽정훈,3,0,1,0.0,1,1,100.0,1,2,50.0,0,0,0.0,2,1,3,0,1,0,1,0,1,3
../kbl_data/2024-2025,S45G01N95,대구 한국가스공사,Away,앤드류 니콜슨,25,8,12,66.7,3,5,60.0,11,17,64.7,0,0,0.0,4,4,8,3,1,1,0,2,1,2
../kbl_data/2024-2025,S45G01N95,대구 한국가스공사,Away,신승민,16,2,6,33.3,3,11,27.3,5,17,29.4,3,4,75.0,0,5,5,1,0,0,1,0,4,2
../kbl_data/2024-2025,S45G01N95,대구 한국가스공사,Away,샘조세프 벨란겔,9,2,9,22.2,1,4,25.0,3,13,23.1,2,4,50.0,1,4,5,4,1,0,0,0,0,4
../kbl_data/2024-2025,S45G01N95,대구 한국가스공사,Away,유슈 은도예,2,1,3,33.3,0,0,0.0,1,3,33.3,0,0,0.0,0,1,1,0,1,0,0,0,0,0
../kbl_data/2024-2025,S45G01N96,고양 소노,Home,정희재,16,3,3,100.0,2,5,40.0,5,8,62.5,4,5,80.0,0,2,2,3,0,0,0,0,0,2
../kbl_data/2024-2025,S45G01N96,고양 소노,Home,임동섭,0,0,0,0.0,0,2,0.0,0,2,0.0,0,0,0.0,2,0,2,0,0,0,0,0,0,2
../kbl_data/2024-2025,S45G01N96,고양 소노,Home,이재도,13,2,4,50.0,3,6,50.0,5,10,50.0,0,0,0.0,0,4,4,5,0,0,0,0,2,3
../kbl_data/2024-2025,S45G01N96,고양 소노,Home,최승욱,16,4,6,66.7,2,14,14.3,6,20,30.0,2,4,50.0,6,8,14,8,2,0,0,0,4,6
../kbl_data/2024-2025,S45G01N96,고양 소노,Home,김진유,4,2,2,100.0,0,0,0.0,2,2,100.0,0,0,0.0,0,1,1,0,0,0,0,0,0,1
../kbl_data/2024-2025,S45G01N96,고양 소노,Home,박진철,0,0,0,0.0,0,1,0.0,0,1,0.0,0,0,0.0,1,0,1,0,0,0,0,0,0,0
../kbl_data/2024-2025,S45G01N96,고양 소노,Home,이정현,44,8,16,50.0,6,20,30.0,14,36,38.9,10,14,71.4,0,12,12,14,8,0,2,0,18,10
../kbl_data/2024-2025,S45G01N96,고양 소노,Home,앨런 윌리엄스,27,11,14,78.6,0,1,0.0,11,15,73.3,5,6,83.3,3,9,12,3,3,1,0,0,3,3
../kbl_data/2024-2025,S45G01N96,고양 소노,Home,디제이 번즈 Jr,4,2,3,66.7,0,1,0.0,2,4,50.0,0,0,0.0,0,4,4,2,1,0,0,0,0,1
../kbl_data/2024-2025,S45G01N96,고양 소노,Home,이근준,2,0,0,0.0,0,2,0.0,0,2,0.0,2,2,100.0,2,1,3,1,0,0,0,0,0,2
../kbl_data/2024-2025,S45G01N96,고양 소노,Home,서동원,0,0,3,0.0,0,0,0.0,0,3,0.0,0,0,0.0,1,0,1,0,0,0,0,0,1,0
../kbl_data/2024-2025,S45G01N96,고양 소노,Home,정성조,2,1,2,50.0,0,2,0.0,1,4,25.0,0,0,0.0,1,2,3,0,0,0,0,0,1,1
../kbl_data/2024-2025,S45G01N96,서울 삼성,Away,이정현,44,8,16,50.0,6,20,30.0,14,36,38.9,10,14,71.4,0,12,12,14,8,0,2,0,18,10
../kbl_data/2024-2025,S45G01N96,서울 삼성,Away,최현민,14,1,1,100.0,4,5,80.0,5,6,83.3,0,0,0.0,0,2,2,0,1,0,0,0,0,2
../kbl_data/2024-2025,S45G01N96,서울 삼성,Away,이원대,3,0,1,0.0,1,3,33.3,1,4,25.0,0,0,0.0,1,1,2,3,0,1,0,0,0,1
../kbl_data/2024-2025,S45G01N96,서울 삼성,Away,최성모,3,0,2,0.0,1,5,20.0,1,7,14.3,0,0,0.0,0,1,1,1,1,0,0,0,2,2
../kbl_data/2024-2025,S45G01N96,서울 삼성,Away,최승욱,16,4,6,66.7,2,14,14.3,6,20,30.0,2,4,50.0,6,8,14,8,2,0,0,0,4,6
../kbl_data/2024-2025,S45G01N96,서울 삼성,Away,마커스 데릭슨,3,1,3,33.3,0,1,0.0,1,4,25.0,1,1,100.0,1,4,5,0,1,0,1,0,0,5
../kbl_data/2024-2025,S45G01N96,서울 삼성,Away,차민석,0,0,0,0.0,0,1,0.0,0,1,0.0,0,2,0.0,0,4,4,1,0,0,0,0,0,0
../kbl_data/2024-2025,S45G01N96,서울 삼성,Away,이원석,3,1,3,33.3,0,1,0.0,1,4,25.0,1,2,50.0,2,5,7,0,0,0,0,0,1,3
../kbl_data/2024-2025,S45G01N96,서울 삼성,Away,저스틴 구탕,13,5,8,62.5,1,5,20.0,6,13,46.2,0,0,0.0,0,0,0,1,2,1,0,0,0,3
../kbl_data/2024-2025,S45G01N96,서울 삼성,Away,박승재,0,0,1,0.0,0,1,0.0,0,2,0.0,0,0,0.0,0,3,3,0,0,0,0,0,0,1
../kbl_data/2024-2025,S45G01N96,서울 삼성,Away,임동언,0,0,1,0.0,0,0,0.0,0,1,0.0,0,0,0.0,0,0,0,0,0,0,0,0,0,0
../kbl_data/2024-2025,S45G01N96,서울 삼성,Away,빈센트 에드워즈,5,0,4,0.0,1,5,20.0,1,9,11.1,2,2,100.0,2,3,5,2,1,1,0,0,1,0
../kbl_data/2024-2025,S45G01N97,안양 정관장,Home,배병준,14,3,7,42.9,2,4,50.0,5,11,45.5,2,2,100.0,0,2,2,3,1,0,0,0,0,0
../kbl_data/2024-2025,S45G01N97,안양 정관장,Home,정효근,4,2,2,100.0,0,2,0.0,2,4,50.0,0,0,0.0,0,1,1,0,0,0,0,0,1,2
../kbl_data/2024-2025,S45G01N97,안양 정관장,Home,이종현,5,1,2,50.0,1,2,50.0,2,4,50.0,0,0,0.0,1,5,6,4,0,2,0,0,0,5
../kbl_data/2024-2025,S45G01N97,안양 정관장,Home,박지훈,17,4,8,50.0,3,4,75.0,7,12,58.3,0,0,0.0,0,3,3,5,2,0,0,0,2,4
../kbl_data/2024-2025,S45G01N97,안양 정관장,Home,최성원,8,1,2,50.0,1,3,33.3,2,5,40.0,3,3,100.0,1,0,1,1,2,0,0,0,0,1
../kbl_data/2024-2025,S45G01N97,안양 정관장,Home,김준형,0,0,0,0.0,0,0,0.0,0,0,0.0,0,0,0.0,0,0,0,0,0,0,0,0,0,0
../kbl_data/2024-2025,S45G01N97,안양 정관장,Home,변준형,2,1,2,50.0,0,2,0.0,1,4,25.0,0,2,0.0,0,1,1,2,0,1,0,0,2,2
../kbl_data/2024-2025,S45G01N97,안양 정관장,Home,캐디 라렌,6,2,8,25.0,0,1,0.0,2,9,22.2,2,2,100.0,6,4,10,2,0,0,0,1,2,2
../kbl_data/2024-2025,S45G01N97,안양 정관장,Home,한승희,0,0,0,0.0,0,0,0.0,0,0,0.0,0,0,0.0,0,0,0,0,0,0,0,0,0,0
../kbl_data/2024-2025,S45G01N97,안양 정관장,Home,클리프 알렉산더,2,1,4,25.0,0,0,0.0,1,4,25.0,0,0,0.0,0,2,2,0,0,0,0,0,1,0
../kbl_data/2024-2025,S45G01N97,안양 정관장,Home,하비 고메즈,15,0,3,0.0,5,8,62.5,5,11,45.5,0,0,0.0,0,2,2,3,1,1,0,0,0,3
../kbl_data/2024-2025,S45G01N97,안양 정관장,Home,박정웅,0,0,1,0.0,0,0,0.0,0,1,0.0,0,0,0.0,0,0,0,0,0,0,0,0,0,0
../kbl_data/2024-2025,S45G01N97,서울 SK,Away,김선형,8,3,7,42.9,0,5,0.0,3,12,25.0,2,2,100.0,1,1,2,3,1,0,0,0,1,4
../kbl_data/2024-2025,S45G01N97,서울 SK,Away,오세근,6,0,0,0.0,2,4,50.0,2,4,50.0,0,0,0.0,1,2,3,0,1,0,0,0,1,1
../kbl_data/2024-2025,S45G01N97,서울 SK,Away,최부경,12,4,5,80.0,0,0,0.0,4,5,80.0,4,4,100.0,3,5,8,0,0,0,0,0,0,2
../kbl_data/2024-2025,S45G01N97,서울 SK,Away,최원혁,0,0,0,0.0,0,1,0.0,0,1,0.0,0,0,0.0,2,3,5,0,0,0,0,0,0,2
../kbl_data/2024-2025,S45G01N97,서울 SK,Away,장문호,0,0,0,0.0,0,0,0.0,0,0,0.0,0,0,0.0,0,0,0,0,0,0,0,0,0,0
../kbl_data/2024-2025,S45G01N97,서울 SK,Away,안영준,15,5,11,45.5,1,2,50.0,6,13,46.2,2,5,40.0,3,2,5,4,1,2,0,0,1,3
../kbl_data/2024-2025,S45G01N97,서울 SK,Away,자밀 워니,16,5,10,50.0,0,5,0.0,5,15,33.3,6,6,100.0,2,7,9,3,2,1,0,0,2,2
../kbl_data/2024-2025,S45G01N97,서울 SK,Away,김형빈,0,0,0,0.0,0,0,0.0,0,0,0.0,0,0,0.0,0,0,0,0,0,0,0,0,0,0
../kbl_data/2024-2025,S45G01N97,서울 SK,Away,아이재아 힉스,2,1,2,50.0,0,1,0.0,1,3,33.3,0,0,0.0,0,1,1,1,0,0,0,0,0,0
../kbl_data/2024-2025,S45G01N97,서울 SK,Away,오재현,18,6,10,60.0,2,5,40.0,8,15,53.3,0,0,0.0,6,3,9,5,1,0,0,0,3,3
../kbl_data/2024-2025,S45G01N97,서울 SK,Away,고메즈 델 리아노,0,0,0,0.0,0,0,0.0,0,0,0.0,0,0,0.0,0,0,0,0,0,0,0,0,0,0
../kbl_data/2024-2025,S45G01N97,서울 SK,Away,김태훈,0,0,0,0.0,0,0,0.0,0,0,0.0,0,0,0.0,0,1,1,0,0,0,0,0,0,1
../kbl_data/2024-2025,S45G01N98,원주 DB,Home,김시래,9,1,3,33.3,2,4,50.0,3,7,42.9,1,1,100.0,0,2,2,1,0,0,0,0,3,2
../kbl_data/2024-2025,S45G01N98,원주 DB,Home,서민수,6,1,1,100.0,1,3,33.3,2,4,50.0,1,1,100.0,0,1,1,3,0,1,0,0,2,3
../kbl_data/2024-2025,S45G01N98,원주 DB,Home,김영현,0,0,1,0.0,0,1,0.0,0,2,0.0,0,0,0.0,0,1,1,0,0,0,0,0,0,0
../kbl_data/2024-2025,S45G01N98,원주 DB,Home,박봉진,0,0,0,0.0,0,0,0.0,0,0,0.0,0,0,0.0,0,0,0,0,0,0,0,0,0,1
../kbl_data/2024-2025,S45G01N98,원주 DB,Home,강상재,8,4,6,66.7,0,0,0.0,4,6,66.7,0,0,0.0,3,7,10,2,1,0,0,0,1,1
../kbl_data/2024-2025,S45G01N98,원주 DB,Home,치나누 오누아쿠,16,5,9,55.6,1,2,50.0,6,11,54.5,3,5,60.0,5,6,11,2,0,0,0,1,0,4
../kbl_data/2024-2025,S45G01N98,원주 DB,Home,김훈,3,0,0,0.0,1,1,100.0,1,1,100.0,0,0,0.0,0,2,2,0,0,0,0,0,0,1
../kbl_data/2024-2025,S45G01N98,원주 DB,Home,이용우,2,1,1,100.0,0,3,0.0,1,4,25.0,0,0,0.0,0,1,1,1,0,0,0,0,3,1
../kbl_data/2024-2025,S45G01N98,원주 DB,Home,이선 알바노,24,7,14,50.0,3,5,60.0,10,19,52.6,1,1,100.0,2,3,5,5,1,0,0,0,0,1
../kbl_data/2024-2025,S45G01N98,원주 DB,Home,박인웅,4,2,3,66.7,0,2,0.0,2,5,40.0,0,0,0.0,2,0,2,1,0,0,0,0,2,1
../kbl_data/2024-2025,S45G01N98,원주 DB,Home,로버트 카터,21,6,10,60.0,3,5,60.0,9,15,60.0,0,0,0.0,4,3,7,3,2,0,0,1,2,2
../kbl_data/2024-2025,S45G01N98,원주 DB,Home,김보배,2,1,1,100.0,0,0,0.0,1,1,100.0,0,3,0.0,0,1,1,0,0,0,0,0,0,1
../kbl_data/2024-2025,S45G01N98,울산 현대모비스,Away,함지훈,3,0,0,0.0,1,3,33.3,1,3,33.3,0,0,0.0,3,0,3,1,0,0,0,0,2,0
../kbl_data/2024-2025,S45G01N98,울산 현대모비스,Away,장재석,4,2,5,40.0,0,0,0.0,2,5,40.0,0,0,0.0,1,0,1,0,0,0,0,0,2,2
../kbl_data/2024-2025,S45G01N98,울산 현대모비스,Away,한호빈,3,0,1,0.0,1,4,25.0,1,5,20.0,0,0,0.0,0,0,0,0,0,0,0,0,1,3
../kbl_data/2024-2025,S45G01N98,울산 현대모비스,Away,김국찬,7,2,3,66.7,1,4,25.0,3,7,42.9,0,0,0.0,1,2,3,0,1,1,0,0,1,1
../kbl_data/2024-2025,S45G01N98,울산 현대모비스,Away,서명진,3,0,1,0.0,1,3,33.3,1,4,25.0,0,0,0.0,0,0,0,1,0,0,0,0,0,1
../kbl_data/2024-2025,S45G01N98,울산 현대모비스,Away,숀 롱,5,2,5,40.0,0,0,0.0,2,5,40.0,1,2,50.0,2,2,4,0,0,0,0,0,1,3
../kbl_data/2024-2025,S45G01N98,울산 현대모비스,Away,이우석,5,1,3,33.3,1,2,50.0,2,5,40.0,0,1,0.0,1,2,3,4,0,1,0,0,2,1
../kbl_data/2024-2025,S45G01N98,울산 현대모비스,Away,이승우,0,0,0,0.0,0,0,0.0,0,0,0.0,0,2,0.0,0,2,2,1,1,0,0,0,0,0
../kbl_data/2024-2025,S45G01N98,울산 현대모비스,Away,신민석,8,2,4,50.0,1,4,25.0,3,8,37.5,1,2,50.0,1,3,4,2,0,1,0,0,0,3
../kbl_data/2024-2025,S45G01N98,울산 현대모비스,Away,게이지 프림,24,11,17,64.7,0,0,0.0,11,17,64.7,2,2,100.0,1,6,7,2,5,1,0,1,2,2
../kbl_data/2024-2025,S45G01N98,울산 현대모비스,Away,박무빈,2,1,5,20.0,0,1,0.0,1,6,16.7,0,0,0.0,0,2,2,2,0,0,0,0,0,2
../kbl_data/2024-2025,S45G01N98,울산 현대모비스,Away,미구엘 안드레 옥존,8,2,5,40.0,1,2,50.0,3,7,42.9,1,2,50.0,0,2,2,4,1,0,0,0,1,3
../kbl_data/2024-2025,S45G01N99,부산 KCC,Home,정창영,4,1,2,50.0,0,3,0.0,1,5,20.0,2,2,100.0,1,1,2,1,0,0,0,0,0,2
../kbl_data/2024-2025,S45G01N99,부산 KCC,Home,리온 윌리엄스,6,3,4,75.0,0,0,0.0,3,4,75.0,0,0,0.0,1,4,5,0,1,1,0,0,1,2
../kbl_data/2024-2025,S45G01N99,부산 KCC,Home,전준범,7,0,1,0.0,2,4,50.0,2,5,40.0,1,2,50.0,0,3,3,5,1,0,0,0,2,1
../kbl_data/2024-2025,S45G01N99,부산 KCC,Home,허웅,6,1,3,33.3,0,0,0.0,1,3,33.3,4,4,100.0,0,1,1,1,0,0,0,0,1,1
../kbl_data/2024-2025,S45G01N99,부산 KCC,Home,이승현,10,4,11,36.4,0,0,0.0,4,11,36.4,2,2,100.0,0,4,4,2,0,0,0,0,1,3
../kbl_data/2024-2025,S45G01N99,부산 KCC,Home,이호현,9,3,3,100.0,1,2,50.0,4,5,80.0,0,0,0.0,0,2,2,6,0,0,0,0,5,2
../kbl_data/2024-2025,S45G01N99,부산 KCC,Home,디온테 버튼,3,0,5,0.0,1,2,50.0,1,7,14.3,0,0,0.0,0,2,2,0,0,0,0,0,0,1
../kbl_data/2024-2025,S45G01N99,부산 KCC,Home,이근휘,24,0,0,0.0,8,10,80.0,8,10,80.0,0,0,0.0,0,2,2,0,0,0,0,0,1,1
../kbl_data/2024-2025,S45G01N99,부산 KCC,Home,김동현,0,0,1,0.0,0,1,0.0,0,2,0.0,0,0,0.0,0,0,0,1,0,0,0,0,0,1
../kbl_data/2024-2025,S45G01N99,부산 KCC,Home,여준형,2,1,2,50.0,0,0,0.0,1,2,50.0,0,0,0.0,0,2,2,0,0,0,0,0,0,0
../kbl_data/2024-2025,S45G01N99,부산 KCC,Home,캘빈 제프리 에피스톨라,0,0,2,0.0,0,1,0.0,0,3,0.0,0,0,0.0,0,3,3,0,0,0,0,0,0,2
../kbl_data/2024-2025,S45G01N99,부산 KCC,Home,이주영,0,0,0,0.0,0,0,0.0,0,0,0.0,0,0,0.0,0,0,0,0,0,0,0,0,0,0
../kbl_data/2024-2025,S45G01N99,대구 한국가스공사,Away,차바위,0,0,0,0.0,0,1,0.0,0,1,0.0,0,0,0.0,0,1,1,1,1,0,0,0,0,2
../kbl_data/2024-2025,S45G01N99,대구 한국가스공사,Away,박지훈,0,0,0,0.0,0,0,0.0,0,0,0.0,0,0,0.0,0,0,0,0,0,0,0,0,0,0
../kbl_data/2024-2025,S45G01N99,대구 한국가스공사,Away,정성우,4,2,4,50.0,0,1,0.0,2,5,40.0,0,0,0.0,1,2,3,3,1,0,1,0,1,4
../kbl_data/2024-2025,S45G01N99,대구 한국가스공사,Away,김낙현,2,1,2,50.0,0,2,0.0,1,4,25.0,0,0,0.0,1,0,1,1,1,0,0,0,0,0
../kbl_data/2024-2025,S45G01N99,대구 한국가스공사,Away,양재혁,0,0,0,0.0,0,0,0.0,0,0,0.0,0,0,0.0,0,2,2,0,0,0,0,0,0,4
../kbl_data/2024-2025,S45G01N99,대구 한국가스공사,Away,곽정훈,23,4,6,66.7,4,7,57.1,8,13,61.5,3,3,100.0,1,8,9,0,0,0,0,0,0,2
../kbl_data/2024-2025,S45G01N99,대구 한국가스공사,Away,앤드류 니콜슨,29,8,11,72.7,2,7,28.6,10,18,55.6,7,8,87.5,1,9,10,5,0,0,0,0,0,0
../kbl_data/2024-2025,S45G01N99,대구 한국가스공사,Away,신승민,17,3,4,75.0,3,6,50.0,6,10,60.0,2,2,100.0,0,3,3,5,0,1,0,0,1,3
../kbl_data/2024-2025,S45G01N99,대구 한국가스공사,Away,샘조세프 벨란겔,15,0,0,0.0,5,7,71.4,5,7,71.4,0,0,0.0,0,0,0,5,1,0,0,0,0,3
../kbl_data/2024-2025,S45G01N99,대구 한국가스공사,Away,유슈 은도예,3,0,0,0.0,0,0,0.0,0,0,0.0,3,4,75.0,1,2,3,1,0,1,0,0,0,0
../kbl_data/2024-2025,S45G01N99,대구 한국가스공사,Away,신주영,0,0,1,0.0,0,1,0.0,0,2,0.0,0,0,0.0,2,0,2,0,1,0,0,0,0,0
../kbl_data/2024-2025,S45G01N99,대구 한국가스공사,Away,손준,4,2,3,66.7,0,2,0.0,2,5,40.0,0,0,0.0,0,1,1,0,0,0,0,0,1,1
../kbl_data/2024-2025,S45G01N100,안양 정관장,Home,정준원,0,0,0,0.0,0,0,0.0,0,0,0.0,0,0,0.0,0,0,0,0,0,0,0,0,0,0
../kbl_data/2024-2025,S45G01N100,안양 정관장,Home,배병준,0,0,0,0.0,0,0,0.0,0,0,0.0,0,0,0.0,0,0,0,0,0,0,0,0,0,0
../kbl_data/2024-2025,S45G01N100,안양 정관장,Home,정효근,15,6,10,60.0,1,3,33.3,7,13,53.8,0,1,0.0,1,6,7,1,0,1,0,0,4,3
../kbl_data/2024-2025,S45G01N100,안양 정관장,Home,이종현,0,0,1,0.0,0,1,0.0,0,2,0.0,0,0,0.0,0,1,1,0,0,0,0,0,0,0
../kbl_data/2024-2025,S45G01N100,안양 정관장,Home,박지훈,11,2,4,50.0,1,4,25.0,3,8,37.5,4,4,100.0,0,5,5,5,1,0,1,0,3,1
../kbl_data/2024-2025,S45G01N100,안양 정관장,Home,최성원,8,2,5,40.0,1,2,50.0,3,7,42.9,1,1,100.0,0,0,0,3,3,0,0,0,1,3
../kbl_data/2024-2025,S45G01N100,안양 정관장,Home,변준형,0,0,1,0.0,0,1,0.0,0,2,0.0,0,0,0.0,0,0,0,2,0,0,0,0,1,2
../kbl_data/2024-2025,S45G01N100,안양 정관장,Home,캐디 라렌,11,4,7,57.1,0,0,0.0,4,7,57.1,3,4,75.0,5,10,15,1,0,0,0,1,3,3
../kbl_data/2024-2025,S45G01N100,안양 정관장,Home,한승희,0,0,1,0.0,0,0,0.0,0,1,0.0,0,0,0.0,0,1,1,0,0,0,0,0,0,1
../kbl_data/2024-2025,S45G01N100,안양 정관장,Home,클리프 알렉산더,7,2,5,40.0,1,1,100.0,3,6,50.0,0,0,0.0,1,1,2,0,0,0,0,0,0,1
../kbl_data/2024-2025,S45G01N100,안양 정관장,Home,하비 고메즈,0,0,1,0.0,0,2,0.0,0,3,0.0,0,0,0.0,0,0,0,1,0,0,0,0,2,1
../kbl_data/2024-2025,S45G01N100,안양 정관장,Home,박정웅,8,2,6,33.3,0,0,0.0,2,6,33.3,4,7,57.1,1,3,4,0,1,0,1,0,1,3
../kbl_data/2024-2025,S45G01N100,창원 LG,Away,허일영,4,2,3,66.7,0,1,0.0,2,4,50.0,0,0,0.0,0,0,0,0,0,0,0,0,0,1
../kbl_data/2024-2025,S45G01N100,창원 LG,Away,장민국,0,0,1,0.0,0,0,0.0,0,1,0.0,0,0,0.0,0,0,0,0,0,0,0,0,0,0
../kbl_data/2024-2025,S45G01N100,창원 LG,Away,한상혁,2,1,1,100.0,0,0,0.0,1,1,100.0,0,0,0.0,1,0,1,1,0,0,0,0,0,1
../kbl_data/2024-2025,S45G01N100,창원 LG,Away,전성현,3,0,0,0.0,1,7,14.3,1,7,14.3,0,0,0.0,0,0,0,1,0,0,0,0,2,2
../kbl_data/2024-2025,S45G01N100,창원 LG,Away,정인덕,13,1,2,50.0,3,4,75.0,4,6,66.7,2,2,100.0,0,4,4,0,0,0,0,0,0,3
../kbl_data/2024-2025,S45G01N100,창원 LG,Away,대릴 먼로,4,2,2,100.0,0,0,0.0,2,2,100.0,0,0,0.0,1,5,6,1,1,1,0,0,0,1
../kbl_data/2024-2025,S45G01N100,창원 LG,Away,박정현,4,1,1,100.0,0,0,0.0,1,1,100.0,2,2,100.0,0,1,1,1,2,0,0,0,0,2
../kbl_data/2024-2025,S45G01N100,창원 LG,Away,아셈 마레이,11,5,12,41.7,0,0,0.0,5,12,41.7,1,4,25.0,7,5,12,6,5,0,0,0,2,3
../kbl_data/2024-2025,S45G01N100,창원 LG,Away,양준석,9,3,5,60.0,1,5,20.0,4,10,40.0,0,0,0.0,0,0,0,6,0,0,1,0,2,2
../kbl_data/2024-2025,S45G01N100,창원 LG,Away,유기상,6,0,1,0.0,2,6,33.3,2,7,28.6,0,0,0.0,0,0,0,0,1,1,1,0,0,3
../kbl_data/2024-2025,S45G01N100,창원 LG,Away,이경도,0,0,0,0.0,0,1,0.0,0,1,0.0,0,0,0.0,0,0,0,0,0,0,0,0,0,0
../kbl_data/2024-2025,S45G01N100,창원 LG,Away,칼 타마요,13,5,15,33.3,1,4,25.0,6,19,31.6,0,0,0.0,6,6,12,4,1,0,0,0,3,3
../kbl_data/2024-2025,S45G01N101,원주 DB,Home,김시래,6,1,3,33.3,1,1,100.0,2,4,50.0,1,2,50.0,0,0,0,0,0,0,0,0,0,1
../kbl_data/2024-2025,S45G01N101,원주 DB,Home,서민수,1,0,1,0.0,0,4,0.0,0,5,0.0,1,2,50.0,2,6,8,2,2,0,0,0,0,3
../kbl_data/2024-2025,S45G01N101,원주 DB,Home,김영현,0,0,0,0.0,0,0,0.0,0,0,0.0,0,0,0.0,0,0,0,1,0,1,0,0,0,0
../kbl_data/2024-2025,S45G01N101,원주 DB,Home,박봉진,0,0,0,0.0,0,1,0.0,0,1,0.0,0,0,0.0,0,0,0,0,0,0,0,0,0,2
../kbl_data/2024-2025,S45G01N101,원주 DB,Home,강상재,6,3,4,75.0,0,0,0.0,3,4,75.0,0,0,0.0,2,0,2,1,0,0,0,0,1,0
../kbl_data/2024-2025,S45G01N101,원주 DB,Home,치나누 오누아쿠,17,7,12,58.3,0,2,0.0,7,14,50.0,3,7,42.9,4,12,16,3,2,3,0,2,7,2
../kbl_data/2024-2025,S45G01N101,원주 DB,Home,김훈,6,3,4,75.0,0,0,0.0,3,4,75.0,0,0,0.0,0,0,0,0,0,0,0,0,0,2
../kbl_data/2024-2025,S45G01N101,원주 DB,Home,이용우,6,1,2,50.0,1,4,25.0,2,6,33.3,1,2,50.0,1,3,4,2,1,0,0,0,1,2
../kbl_data/2024-2025,S45G01N101,원주 DB,Home,이선 알바노,25,7,12,58.3,3,5,60.0,10,17,58.8,2,4,50.0,0,2,2,6,1,0,0,0,3,1
../kbl_data/2024-2025,S45G01N101,원주 DB,Home,박인웅,5,1,2,50.0,1,1,100.0,2,3,66.7,0,0,0.0,1,0,1,0,0,0,0,0,0,3
../kbl_data/2024-2025,S45G01N101,원주 DB,Home,로버트 카터,5,1,2,50.0,1,3,33.3,2,5,40.0,0,0,0.0,0,4,4,3,0,0,0,0,1,1
../kbl_data/2024-2025,S45G01N101,원주 DB,Home,김보배,0,0,0,0.0,0,0,0.0,0,0,0.0,0,0,0.0,0,0,0,0,0,0,0,0,0,0
../kbl_data/2024-2025,S45G01N101,수원 KT,Away,한희원,3,1,2,50.0,0,0,0.0,1,2,50.0,1,3,33.3,0,0,0,0,0,0,0,0,0,0
../kbl_data/2024-2025,S45G01N101,수원 KT,Away,최창진,5,1,3,33.3,1,3,33.3,2,6,33.3,0,0,0.0,2,0,2,2,0,0,0,0,0,1
../kbl_data/2024-2025,S45G01N101,수원 KT,Away,이현석,4,0,0,0.0,1,2,50.0,1,2,50.0,1,2,50.0,0,2,2,1,1,0,1,0,0,3
../kbl_data/2024-2025,S45G01N101,수원 KT,Away,박준영,14,0,4,0.0,4,7,57.1,4,11,36.4,2,2,100.0,0,0,0,3,0,0,0,0,0,3
../kbl_data/2024-2025,S45G01N101,수원 KT,Away,최진광,9,3,8,37.5,1,4,25.0,4,12,33.3,0,0,0.0,0,0,0,4,1,0,0,0,3,3
../kbl_data/2024-2025,S45G01N101,수원 KT,Away,이윤기,0,0,0,0.0,0,1,0.0,0,1,0.0,0,0,0.0,1,1,2,0,0,0,0,0,0,0
../kbl_data/2024-2025,S45G01N101,수원 KT,Away,하윤기,8,4,9,44.4,0,0,0.0,4,9,44.4,0,0,0.0,1,2,3,1,0,0,0,0,0,2
../kbl_data/2024-2025,S45G01N101,수원 KT,Away,박선웅,0,0,0,0.0,0,0,0.0,0,0,0.0,0,0,0.0,0,0,0,0,0,0,0,0,0,0
../kbl_data/2024-2025,S45G01N101,수원 KT,Away,문정현,12,3,3,100.0,2,2,100.0,5,5,100.0,0,0,0.0,3,3,6,3,1,0,0,0,2,3
../kbl_data/2024-2025,S45G01N101,수원 KT,Away,레이션 해먼즈,20,7,12,58.3,2,7,28.6,9,19,47.4,0,0,0.0,2,16,18,1,2,1,0,0,4,2
../kbl_data/2024-2025,S45G01N101,수원 KT,Away,박성재,6,0,1,0.0,2,2,100.0,2,3,66.7,0,0,0.0,0,0,0,1,0,0,0,0,0,2
../kbl_data/2024-2025,S45G01N101,수원 KT,Away,이스마엘 로메로,0,0,2,0.0,0,0,0.0,0,2,0.0,0,2,0.0,2,1,3,0,1,0,0,0,0,1
../kbl_data/2024-2025,S45G01N102,수원 KT,Home,한희원,10,0,0,0.0,3,5,60.0,3,5,60.0,1,1,100.0,3,1,4,0,1,1,0,0,0,3
../kbl_data/2024-2025,S45G01N102,수원 KT,Home,최창진,5,1,1,100.0,1,2,50.0,2,3,66.7,0,0,0.0,2,1,3,2,0,0,0,0,1,1
../kbl_data/2024-2025,S45G01N102,수원 KT,Home,이현석,0,0,0,0.0,0,1,0.0,0,1,0.0,0,0,0.0,0,2,2,0,0,0,0,0,0,2
../kbl_data/2024-2025,S45G01N102,수원 KT,Home,박준영,17,3,5,60.0,2,3,66.7,5,8,62.5,5,6,83.3,1,3,4,1,0,1,0,0,1,3
../kbl_data/2024-2025,S45G01N102,수원 KT,Home,최진광,7,2,5,40.0,1,5,20.0,3,10,30.0,0,0,0.0,0,1,1,8,1,0,0,0,2,1
../kbl_data/2024-2025,S45G01N102,수원 KT,Home,이윤기,0,0,0,0.0,0,0,0.0,0,0,0.0,0,0,0.0,0,0,0,0,0,0,0,0,0,0
../kbl_data/2024-2025,S45G01N102,수원 KT,Home,하윤기,13,6,11,54.5,0,0,0.0,6,11,54.5,1,3,33.3,2,3,5,0,0,0,0,1,2,0
../kbl_data/2024-2025,S45G01N102,수원 KT,Home,박선웅,0,0,0,0.0,0,0,0.0,0,0,0.0,0,0,0.0,0,0,0,0,0,0,0,0,0,0
../kbl_data/2024-2025,S45G01N102,수원 KT,Home,문정현,6,3,6,50.0,0,1,0.0,3,7,42.9,0,0,0.0,1,3,4,2,1,0,0,1,2,0
../kbl_data/2024-2025,S45G01N102,수원 KT,Home,레이션 해먼즈,17,6,12,50.0,1,6,16.7,7,18,38.9,2,6,33.3,2,6,8,4,1,1,0,0,1,2
../kbl_data/2024-2025,S45G01N102,수원 KT,Home,박성재,6,0,1,0.0,2,2,100.0,2,3,66.7,0,0,0.0,1,0,1,1,1,0,0,0,1,2
../kbl_data/2024-2025,S45G01N102,수원 KT,Home,이스마엘 로메로,10,5,8,62.5,0,0,0.0,5,8,62.5,0,0,0.0,5,4,9,1,0,0,0,1,1,4
../kbl_data/2024-2025,S45G01N102,울산 현대모비스,Away,함지훈,8,4,6,66.7,0,1,0.0,4,7,57.1,0,0,0.0,1,1,2,2,0,0,0,0,0,3
../kbl_data/2024-2025,S45G01N102,울산 현대모비스,Away,장재석,3,1,1,100.0,0,0,0.0,1,1,100.0,1,2,50.0,0,1,1,0,0,0,0,0,0,2
../kbl_data/2024-2025,S45G01N102,울산 현대모비스,Away,한호빈,11,1,1,100.0,3,4,75.0,4,5,80.0,0,0,0.0,0,1,1,6,1,0,0,0,3,3
../kbl_data/2024-2025,S45G01N102,울산 현대모비스,Away,김준일,4,2,4,50.0,0,0,0.0,2,4,50.0,0,0,0.0,0,0,0,0,1,0,0,0,0,1
../kbl_data/2024-2025,S45G01N102,울산 현대모비스,Away,김국찬,2,1,2,50.0,0,1,0.0,1,3,33.3,0,0,0.0,0,4,4,0,2,0,0,0,0,1
../kbl_data/2024-2025,S45G01N102,울산 현대모비스,Away,서명진,11,4,7,57.1,1,5,20.0,5,12,41.7,0,0,0.0,1,2,3,4,1,0,0,0,1,0
../kbl_data/2024-2025,S45G01N102,울산 현대모비스,Away,숀 롱,12,4,9,44.4,0,0,0.0,4,9,44.4,4,7,57.1,6,4,10,0,0,1,0,1,1,0
../kbl_data/2024-2025,S45G01N102,울산 현대모비스,Away,이우석,10,2,3,66.7,2,6,33.3,4,9,44.4,0,0,0.0,0,4,4,3,2,0,0,0,2,1
../kbl_data/2024-2025,S45G01N102,울산 현대모비스,Away,신민석,2,1,2,50.0,0,2,0.0,1,4,25.0,0,0,0.0,1,0,1,0,0,0,0,0,0,1
../kbl_data/2024-2025,S45G01N102,울산 현대모비스,Away,게이지 프림,15,5,9,55.6,0,1,0.0,5,10,50.0,5,5,100.0,3,3,6,2,0,0,0,0,2,3
../kbl_data/2024-2025,S45G01N102,울산 현대모비스,Away,박무빈,0,0,3,0.0,0,1,0.0,0,4,0.0,0,0,0.0,1,2,3,4,0,0,0,0,0,1
../kbl_data/2024-2025,S45G01N102,울산 현대모비스,Away,미구엘 안드레 옥존,0,0,2,0.0,0,1,0.0,0,3,0.0,0,0,0.0,0,0,0,1,0,0,0,0,0,2
../kbl_data/2024-2025,S45G01N103,부산 KCC,Home,정창영,0,0,1,0.0,0,1,0.0,0,2,0.0,0,0,0.0,0,0,0,0,0,0,0,0,1,0
../kbl_data/2024-2025,S45G01N103,부산 KCC,Home,리온 윌리엄스,5,1,2,50.0,1,1,100.0,2,3,66.7,0,0,0.0,1,4,5,0,1,0,0,0,0,1
../kbl_data/2024-2025,S45G01N103,부산 KCC,Home,전준범,3,0,1,0.0,1,3,33.3,1,4,25.0,0,0,0.0,0,1,1,1,0,0,0,0,0,2
../kbl_data/2024-2025,S45G01N103,부산 KCC,Home,허웅,26,5,7,71.4,4,11,36.4,9,18,50.0,4,4,100.0,1,1,2,2,2,0,0,0,0,2
../kbl_data/2024-2025,S45G01N103,부산 KCC,Home,이승현,2,1,3,33.3,0,0,0.0,1,3,33.3,0,0,0.0,1,3,4,2,0,0,0,0,1,1
../kbl_data/2024-2025,S45G01N103,부산 KCC,Home,이호현,6,3,5,60.0,0,3,0.0,3,8,37.5,0,0,0.0,0,2,2,3,1,0,0,0,1,2
../kbl_data/2024-2025,S45G01N103,부산 KCC,Home,최준용,8,2,2,100.0,1,3,33.3,3,5,60.0,1,2,50.0,1,3,4,7,1,1,0,0,0,0
../kbl_data/2024-2025,S45G01N103,부산 KCC,Home,디온테 버튼,18,8,12,66.7,0,1,0.0,8,13,61.5,2,2,100.0,0,7,7,5,3,1,0,2,2,0
../kbl_data/2024-2025,S45G01N103,부산 KCC,Home,이근휘,9,0,1,0.0,3,7,42.9,3,8,37.5,0,0,0.0,2,0,2,0,0,0,0,0,0,2
../kbl_data/2024-2025,S45G01N103,부산 KCC,Home,김동현,10,2,3,66.7,2,4,50.0,4,7,57.1,0,0,0.0,3,5,8,2,1,0,0,0,1,3
../kbl_data/2024-2025,S45G01N103,부산 KCC,Home,캘빈 제프리 에피스톨라,5,1,2,50.0,1,1,100.0,2,3,66.7,0,0,0.0,1,3,4,1,1,0,0,0,0,3
../kbl_data/2024-2025,S45G01N103,부산 KCC,Home,이주영,2,1,2,50.0,0,2,0.0,1,4,25.0,0,0,0.0,0,0,0,0,0,0,0,0,0,0
../kbl_data/2024-2025,S45G01N103,안양 정관장,Away,배병준,7,1,1,100.0,1,8,12.5,2,9,22.2,2,2,100.0,1,2,3,1,0,0,0,0,1,0
../kbl_data/2024-2025,S45G01N103,안양 정관장,Away,정효근,6,3,5,60.0,0,1,0.0,3,6,50.0,0,0,0.0,0,1,1,4,0,0,0,0,3,2
../kbl_data/2024-2025,S45G01N103,안양 정관장,Away,이종현,0,0,1,0.0,0,0,0.0,0,1,0.0,0,0,0.0,1,2,3,0,2,1,0,0,2,2
../kbl_data/2024-2025,S45G01N103,안양 정관장,Away,박지훈,11,2,6,33.3,2,4,50.0,4,10,40.0,1,4,25.0,1,4,5,5,1,0,0,0,1,1
../kbl_data/2024-2025,S45G01N103,안양 정관장,Away,최성원,4,2,3,66.7,0,2,0.0,2,5,40.0,0,0,0.0,1,1,2,2,0,0,0,0,3,2
../kbl_data/2024-2025,S45G01N103,안양 정관장,Away,이우정,5,0,2,0.0,1,3,33.3,1,5,20.0,2,2,100.0,0,2,2,3,0,0,0,0,0,1
../kbl_data/2024-2025,S45G01N103,안양 정관장,Away,캐디 라렌,7,2,5,40.0,1,1,100.0,3,6,50.0,0,0,0.0,1,2,3,0,0,1,0,0,0,1
../kbl_data/2024-2025,S45G01N103,안양 정관장,Away,김경원,2,0,0,0.0,0,1,0.0,0,1,0.0,2,2,100.0,1,1,2,0,0,0,0,0,0,0
../kbl_data/2024-2025,S45G01N103,안양 정관장,Away,한승희,5,1,3,33.3,1,1,100.0,2,4,50.0,0,0,0.0,0,3,3,0,0,1,0,0,0,3
../kbl_data/2024-2025,S45G01N103,안양 정관장,Away,클리프 알렉산더,11,4,8,50.0,1,3,33.3,5,11,45.5,0,0,0.0,2,8,10,2,1,0,0,1,2,0
../kbl_data/2024-2025,S45G01N103,안양 정관장,Away,하비 고메즈,6,3,3,100.0,0,2,0.0,3,5,60.0,0,0,0.0,0,4,4,0,0,0,0,0,1,1
../kbl_data/2024-2025,S45G01N103,안양 정관장,Away,박정웅,4,2,2,100.0,0,1,0.0,2,3,66.7,0,0,0.0,0,0,0,1,0,0,0,0,0,0
../kbl_data/2024-2025,S45G01N104,고양 소노,Home,정희재,7,1,1,100.0,1,5,20.0,2,6,33.3,2,4,50.0,1,4,5,2,1,0,1,0,0,2
../kbl_data/2024-2025,S45G01N104,고양 소노,Home,임동섭,2,1,1,100.0,0,3,0.0,1,4,25.0,0,0,0.0,0,2,2,0,1,0,0,0,0,3
../kbl_data/2024-2025,S45G01N104,고양 소노,Home,이재도,17,4,8,50.0,3,7,42.9,7,15,46.7,0,0,0.0,1,2,3,5,1,0,0,0,1,3
../kbl_data/2024-2025,S45G01N104,고양 소노,Home,최승욱,14,1,4,25.0,4,5,80.0,5,9,55.6,0,0,0.0,0,1,1,1,1,1,0,0,1,3
../kbl_data/2024-2025,S45G01N104,고양 소노,Home,김진유,6,3,4,75.0,0,0,0.0,3,4,75.0,0,0,0.0,0,1,1,0,0,0,0,0,0,3
../kbl_data/2024-2025,S45G01N104,고양 소노,Home,박진철,0,0,0,0.0,0,0,0.0,0,0,0.0,0,0,0.0,0,0,0,0,0,0,0,0,0,0
../kbl_data/2024-2025,S45G01N104,고양 소노,Home,이정현,22,7,11,63.6,1,6,16.7,8,17,47.1,5,7,71.4,0,3,3,7,3,2,0,0,3,1
../kbl_data/2024-2025,S45G01N104,고양 소노,Home,디제이 번즈 Jr,17,8,13,61.5,0,0,0.0,8,13,61.5,1,2,50.0,2,7,9,4,1,3,0,0,1,1
../kbl_data/2024-2025,S45G01N104,고양 소노,Home,이근준,0,0,1,0.0,0,1,0.0,0,2,0.0,0,0,0.0,0,1,1,0,2,0,0,0,2,2
../kbl_data/2024-2025,S45G01N104,고양 소노,Home,서동원,0,0,0,0.0,0,0,0.0,0,0,0.0,0,0,0.0,0,0,0,0,0,0,0,0,0,0
../kbl_data/2024-2025,S45G01N104,고양 소노,Home,정성조,0,0,0,0.0,0,0,0.0,0,0,0.0,0,0,0.0,0,0,0,0,0,0,0,0,0,0
../kbl_data/2024-2025,S45G01N104,고양 소노,Home,알파 카바,2,1,3,33.3,0,0,0.0,1,3,33.3,0,0,0.0,0,2,2,1,0,0,0,1,0,1
../kbl_data/2024-2025,S45G01N104,원주 DB,Away,김시래,2,1,1,100.0,0,1,0.0,1,2,50.0,0,0,0.0,0,1,1,0,0,0,0,0,2,1
../kbl_data/2024-2025,S45G01N104,원주 DB,Away,서민수,2,1,2,50.0,0,3,0.0,1,5,20.0,0,0,0.0,1,1,2,1,0,1,0,0,1,2
../kbl_data/2024-2025,S45G01N104,원주 DB,Away,김영현,0,0,1,0.0,0,0,0.0,0,1,0.0,0,0,0.0,1,0,1,1,1,0,0,0,0,2
../kbl_data/2024-2025,S45G01N104,원주 DB,Away,박봉진,0,0,0,0.0,0,0,0.0,0,0,0.0,0,0,0.0,0,2,2,1,0,0,0,0,0,1
../kbl_data/2024-2025,S45G01N104,원주 DB,Away,치나누 오누아쿠,26,8,15,53.3,2,5,40.0,10,20,50.0,4,5,80.0,3,9,12,6,0,0,0,0,2,4
../kbl_data/2024-2025,S45G01N104,원주 DB,Away,김훈,6,0,0,0.0,2,3,66.7,2,3,66.7,0,0,0.0,1,0,1,0,0,0,0,0,0,0
../kbl_data/2024-2025,S45G01N104,원주 DB,Away,이용우,6,0,0,0.0,2,6,33.3,2,6,33.3,0,0,0.0,1,0,1,4,0,0,0,0,2,2
../kbl_data/2024-2025,S45G01N104,원주 DB,Away,정호영,0,0,0,0.0,0,0,0.0,0,0,0.0,0,0,0.0,0,0,0,0,0,0,0,0,0,0
../kbl_data/2024-2025,S45G01N104,원주 DB,Away,이선 알바노,21,6,12,50.0,2,8,25.0,8,20,40.0,3,5,60.0,4,5,9,8,3,2,0,0,3,3
../kbl_data/2024-2025,S45G01N104,원주 DB,Away,박인웅,16,2,4,50.0,3,7,42.9,5,11,45.5,3,4,75.0,4,3,7,0,0,0,0,0,2,1
../kbl_data/2024-2025,S45G01N104,원주 DB,Away,로버트 카터,0,0,0,0.0,0,1,0.0,0,1,0.0,0,0,0.0,0,2,2,0,0,1,0,0,2,1
../kbl_data/2024-2025,S45G01N104,원주 DB,Away,김보배,2,1,4,25.0,0,0,0.0,1,4,25.0,0,0,0.0,3,3,6,0,0,1,0,0,1,2
../kbl_data/2024-2025,S45G01N105,서울 SK,Home,김선형,13,3,5,60.0,1,2,50.0,4,7,57.1,4,5,80.0,1,4,5,3,0,0,0,0,1,3
../kbl_data/2024-2025,S45G01N105,서울 SK,Home,오세근,14,2,5,40.0,3,6,50.0,5,11,45.5,1,2,50.0,1,3,4,2,0,0,0,0,0,0
../kbl_data/2024-2025,S45G01N105,서울 SK,Home,최부경,2,1,1,100.0,0,0,0.0,1,1,100.0,0,0,0.0,1,2,3,1,1,0,0,0,0,2
../kbl_data/2024-2025,S45G01N105,서울 SK,Home,최원혁,3,0,0,0.0,1,2,50.0,1,2,50.0,0,0,0.0,1,1,2,0,0,0,0,0,0,4
../kbl_data/2024-2025,S45G01N105,서울 SK,Home,장문호,0,0,0,0.0,0,0,0.0,0,0,0.0,0,0,0.0,0,1,1,0,0,0,0,0,0,1
../kbl_data/2024-2025,S45G01N105,서울 SK,Home,안영준,14,3,5,60.0,2,9,22.2,5,14,35.7,2,2,100.0,0,6,6,1,1,0,0,0,3,2
../kbl_data/2024-2025,S45G01N105,서울 SK,Home,자밀 워니,13,6,17,35.3,0,2,0.0,6,19,31.6,1,2,50.0,0,13,13,2,2,1,0,1,4,1
../kbl_data/2024-2025,S45G01N105,서울 SK,Home,김형빈,0,0,0,0.0,0,0,0.0,0,0,0.0,0,0,0.0,0,0,0,0,0,0,0,0,0,0
../kbl_data/2024-2025,S45G01N105,서울 SK,Home,아이재아 힉스,4,2,2,100.0,0,0,0.0,2,2,100.0,0,0,0.0,0,0,0,3,0,0,0,0,0,1
../kbl_data/2024-2025,S45G01N105,서울 SK,Home,오재현,0,0,0,0.0,0,7,0.0,0,7,0.0,0,0,0.0,2,1,3,1,1,0,1,0,1,3
../kbl_data/2024-2025,S45G01N105,서울 SK,Home,고메즈 델 리아노,0,0,1,0.0,0,0,0.0,0,1,0.0,0,0,0.0,0,0,0,0,0,0,0,0,0,0
../kbl_data/2024-2025,S45G01N105,서울 SK,Home,김태훈,0,0,0,0.0,0,0,0.0,0,0,0.0,0,0,0.0,0,0,0,0,0,0,0,0,0,0
../kbl_data/2024-2025,S45G01N105,서울 삼성,Away,이정현,3,0,4,0.0,1,5,20.0,1,9,11.1,0,0,0.0,2,1,3,6,1,0,0,0,1,1
../kbl_data/2024-2025,S45G01N105,서울 삼성,Away,최현민,2,1,1,100.0,0,2,0.0,1,3,33.3,0,0,0.0,1,4,5,1,0,0,0,0,0,0
../kbl_data/2024-2025,S45G01N105,서울 삼성,Away,이원대,0,0,1,0.0,0,2,0.0,0,3,0.0,0,0,0.0,1,0,1,0,0,0,0,0,1,0
../kbl_data/2024-2025,S45G01N105,서울 삼성,Away,최성모,12,3,5,60.0,2,6,33.3,5,11,45.5,0,0,0.0,0,3,3,1,1,0,0,0,1,4
../kbl_data/2024-2025,S45G01N105,서울 삼성,Away,최승욱,2,1,1,100.0,0,0,0.0,1,1,100.0,0,0,0.0,0,0,0,1,0,0,1,0,0,0
../kbl_data/2024-2025,S45G01N105,서울 삼성,Away,마커스 데릭슨,14,0,4,0.0,4,7,57.1,4,11,36.4,2,2,100.0,3,4,7,0,1,1,0,0,4,4
../kbl_data/2024-2025,S45G01N105,서울 삼성,Away,차민석,0,0,0,0.0,0,1,0.0,0,1,0.0,0,0,0.0,0,2,2,0,2,0,0,0,0,2
../kbl_data/2024-2025,S45G01N105,서울 삼성,Away,이원석,12,4,8,50.0,0,3,0.0,4,11,36.4,4,4,100.0,2,10,12,3,0,0,0,0,1,3
../kbl_data/2024-2025,S45G01N105,서울 삼성,Away,저스틴 구탕,11,0,1,0.0,3,7,42.9,3,8,37.5,2,2,100.0,1,4,5,1,0,1,1,0,2,3
../kbl_data/2024-2025,S45G01N105,서울 삼성,Away,박승재,0,0,0,0.0,0,1,0.0,0,1,0.0,0,0,0.0,0,0,0,0,0,0,0,0,0,0
../kbl_data/2024-2025,S45G01N105,서울 삼성,Away,임동언,0,0,0,0.0,0,0,0.0,0,0,0.0,0,0,0.0,0,0,0,0,0,0,0,0,0,0
../kbl_data/2024-2025,S45G01N105,서울 삼성,Away,빈센트 에드워즈,4,2,4,50.0,0,3,0.0,2,7,28.6,0,0,0.0,0,1,1,2,0,0,0,0,1,1
../kbl_data/2024-2025,S45G01N106,대구 한국가스공사,Home,차바위,0,0,0,0.0,0,0,0.0,0,0,0.0,0,0,0.0,0,0,0,0,0,0,0,0,0,1
../kbl_data/2024-2025,S45G01N106,대구 한국가스공사,Home,박지훈,2,1,1,100.0,0,1,0.0,1,2,50.0,0,3,0.0,2,1,3,1,0,1,0,0,0,0
../kbl_data/2024-2025,S45G01N106,대구 한국가스공사,Home,이대헌,2,1,3,33.3,0,0,0.0,1,3,33.3,0,1,0.0,2,0,2,2,1,0,0,0,2,3
../kbl_data/2024-2025,S45G01N106,대구 한국가스공사,Home,정성우,9,0,1,0.0,3,6,50.0,3,7,42.9,0,2,0.0,0,0,0,2,1,0,0,0,2,1
../kbl_data/2024-2025,S45G01N106,대구 한국가스공사,Home,김낙현,4,2,7,28.6,0,2,0.0,2,9,22.2,0,0,0.0,0,1,1,2,0,0,0,0,1,3
../kbl_data/2024-2025,S45G01N106,대구 한국가스공사,Home,양재혁,0,0,0,0.0,0,2,0.0,0,2,0.0,0,0,0.0,0,1,1,1,0,0,0,0,0,4
../kbl_data/2024-2025,S45G01N106,대구 한국가스공사,Home,곽정훈,6,0,1,0.0,2,6,33.3,2,7,28.6,0,0,0.0,2,4,6,0,0,0,0,0,0,2
../kbl_data/2024-2025,S45G01N106,대구 한국가스공사,Home,앤드류 니콜슨,17,6,14,42.9,1,3,33.3,7,17,41.2,2,4,50.0,3,7,10,1,1,1,0,0,1,2
../kbl_data/2024-2025,S45G01N106,대구 한국가스공사,Home,신승민,3,1,3,33.3,0,4,0.0,1,7,14.3,1,2,50.0,0,2,2,0,0,0,0,0,0,1
../kbl_data/2024-2025,S45G01N106,대구 한국가스공사,Home,샘조세프 벨란겔,7,2,5,40.0,1,6,16.7,3,11,27.3,0,0,0.0,0,0,0,6,3,0,0,0,1,2
../kbl_data/2024-2025,S45G01N106,대구 한국가스공사,Home,유슈 은도예,4,2,3,66.7,0,0,0.0,2,3,66.7,0,0,0.0,2,3,5,0,0,0,0,1,1,3
../kbl_data/2024-2025,S45G01N106,대구 한국가스공사,Home,손준,0,0,2,0.0,0,2,0.0,0,4,0.0,0,0,0.0,2,1,3,0,0,0,0,0,0,0
../kbl_data/2024-2025,S45G01N106,창원 LG,Away,허일영,0,0,1,0.0,0,1,0.0,0,2,0.0,0,0,0.0,0,2,2,0,0,0,0,0,1,2
../kbl_data/2024-2025,S45G01N106,창원 LG,Away,장민국,6,0,0,0.0,2,4,50.0,2,4,50.0,0,0,0.0,0,0,0,0,0,0,0,0,0,1
../kbl_data/2024-2025,S45G01N106,창원 LG,Away,한상혁,0,0,1,0.0,0,0,0.0,0,1,0.0,0,0,0.0,0,0,0,1,0,0,1,0,0,0
../kbl_data/2024-2025,S45G01N106,창원 LG,Away,전성현,10,2,3,66.7,2,6,33.3,4,9,44.4,0,0,0.0,0,1,1,0,0,0,0,0,1,3
../kbl_data/2024-2025,S45G01N106,창원 LG,Away,정인덕,4,2,4,50.0,0,1,0.0,2,5,40.0,0,0,0.0,0,8,8,2,0,1,0,0,0,2
../kbl_data/2024-2025,S45G01N106,창원 LG,Away,대릴 먼로,9,2,3,66.7,0,0,0.0,2,3,66.7,5,5,100.0,1,2,3,3,0,0,0,0,0,2
../kbl_data/2024-2025,S45G01N106,창원 LG,Away,박정현,4,2,2,100.0,0,0,0.0,2,2,100.0,0,0,0.0,0,2,2,1,0,1,0,0,0,0
../kbl_data/2024-2025,S45G01N106,창원 LG,Away,아셈 마레이,17,6,8,75.0,0,0,0.0,6,8,75.0,5,7,71.4,5,7,12,6,0,0,0,0,1,3
../kbl_data/2024-2025,S45G01N106,창원 LG,Away,양준석,10,2,4,50.0,2,2,100.0,4,6,66.7,0,0,0.0,0,3,3,3,0,0,1,0,1,1
../kbl_data/2024-2025,S45G01N106,창원 LG,Away,유기상,2,1,3,33.3,0,4,0.0,1,7,14.3,0,0,0.0,2,2,4,2,0,0,1,0,1,2
../kbl_data/2024-2025,S45G01N106,창원 LG,Away,이경도,6,3,3,100.0,0,1,0.0,3,4,75.0,0,1,0.0,0,3,3,0,0,0,0,0,1,2
../kbl_data/2024-2025,S45G01N106,창원 LG,Away,칼 타마요,17,6,7,85.7,1,2,50.0,7,9,77.8,2,4,50.0,0,5,5,3,1,0,0,0,4,2
../kbl_data/2024-2025,S45G01N107,부산 KCC,Home,정창영,4,0,1,0.0,1,1,100.0,1,2,50.0,1,2,50.0,1,1,2,0,0,0,0,0,1,2
../kbl_data/2024-2025,S45G01N107,부산 KCC,Home,리온 윌리엄스,2,1,5,20.0,0,0,0.0,1,5,20.0,0,0,0.0,0,0,0,1,1,0,0,0,0,3
../kbl_data/2024-2025,S45G01N107,부산 KCC,Home,전준범,0,0,0,0.0,0,1,0.0,0,1,0.0,0,0,0.0,0,0,0,0,0,0,0,0,0,0
../kbl_data/2024-2025,S45G01N107,부산 KCC,Home,허웅,21,4,7,57.1,3,6,50.0,7,13,53.8,4,4,100.0,0,0,0,5,2,0,0,0,3,2
../kbl_data/2024-2025,S45G01N107,부산 KCC,Home,이승현,11,5,9,55.6,0,0,0.0,5,9,55.6,1,2,50.0,1,10,11,1,1,0,1,0,0,1
../kbl_data/2024-2025,S45G01N107,부산 KCC,Home,이호현,1,0,2,0.0,0,0,0.0,0,2,0.0,1,2,50.0,0,0,0,1,0,0,0,0,0,0
../kbl_data/2024-2025,S45G01N107,부산 KCC,Home,최준용,18,6,8,75.0,2,6,33.3,8,14,57.1,0,1,0.0,1,1,2,4,0,2,0,0,2,3
../kbl_data/2024-2025,S45G01N107,부산 KCC,Home,디온테 버튼,16,6,10,60.0,0,1,0.0,6,11,54.5,4,4,100.0,2,6,8,1,1,3,0,0,3,0
../kbl_data/2024-2025,S45G01N107,부산 KCC,Home,이근휘,3,0,0,0.0,1,5,20.0,1,5,20.0,0,0,0.0,0,0,0,0,0,0,0,0,0,1
../kbl_data/2024-2025,S45G01N107,부산 KCC,Home,김동현,0,0,1,0.0,0,1,0.0,0,2,0.0,0,0,0.0,1,1,2,1,1,0,0,0,0,0
../kbl_data/2024-2025,S45G01N107,부산 KCC,Home,캘빈 제프리 에피스톨라,3,0,1,0.0,1,2,50.0,1,3,33.3,0,0,0.0,0,2,2,1,0,0,0,0,0,2
../kbl_data/2024-2025,S45G01N107,부산 KCC,Home,이주영,0,0,0,0.0,0,0,0.0,0,0,0.0,0,0,0.0,0,0,0,0,0,0,0,0,0,0
../kbl_data/2024-2025,S45G01N107,울산 현대모비스,Away,함지훈,11,4,5,80.0,1,3,33.3,5,8,62.5,0,0,0.0,0,1,1,3,0,0,0,0,0,1
../kbl_data/2024-2025,S45G01N107,울산 현대모비스,Away,장재석,6,3,4,75.0,0,1,0.0,3,5,60.0,0,0,0.0,4,0,4,1,0,0,0,1,1,3
../kbl_data/2024-2025,S45G01N107,울산 현대모비스,Away,한호빈,9,0,0,0.0,3,7,42.9,3,7,42.9,0,0,0.0,2,1,3,1,3,0,0,0,1,2
../kbl_data/2024-2025,S45G01N107,울산 현대모비스,Away,김국찬,12,1,2,50.0,3,8,37.5,4,10,40.0,1,2,50.0,0,3,3,1,0,0,0,0,1,3
../kbl_data/2024-2025,S45G01N107,울산 현대모비스,Away,서명진,0,0,0,0.0,0,0,0.0,0,0,0.0,0,0,0.0,0,1,1,1,0,0,0,0,0,0
../kbl_data/2024-2025,S45G01N107,울산 현대모비스,Away,숀 롱,18,9,16,56.2,0,1,0.0,9,17,52.9,0,1,0.0,5,6,11,1,0,1,0,1,2,1
../kbl_data/2024-2025,S45G01N107,울산 현대모비스,Away,이우석,10,2,6,33.3,2,5,40.0,4,11,36.4,0,0,0.0,1,8,9,3,1,0,0,0,1,4
../kbl_data/2024-2025,S45G01N107,울산 현대모비스,Away,이승우,3,1,2,50.0,0,2,0.0,1,4,25.0,1,2,50.0,0,0,0,0,0,0,0,0,0,0
../kbl_data/2024-2025,S45G01N107,울산 현대모비스,Away,신민석,0,0,0,0.0,0,0,0.0,0,0,0.0,0,0,0.0,1,1,2,1,1,0,0,0,0,1
../kbl_data/2024-2025,S45G01N107,울산 현대모비스,Away,게이지 프림,21,8,19,42.1,1,1,100.0,9,20,45.0,2,3,66.7,8,6,14,4,0,1,0,1,2,3
../kbl_data/2024-2025,S45G01N107,울산 현대모비스,Away,박무빈,5,1,5,20.0,1,1,100.0,2,6,33.3,0,0,0.0,2,3,5,4,0,0,0,0,2,2
../kbl_data/2024-2025,S45G01N107,울산 현대모비스,Away,미구엘 안드레 옥존,0,0,0,0.0,0,1,0.0,0,1,0.0,0,0,0.0,1,0,1,2,0,0,0,0,0,0
../kbl_data/2024-2025,S45G01N108,원주 DB,Home,김시래,0,0,0,0.0,0,0,0.0,0,0,0.0,0,0,0.0,0,1,1,1,0,0,0,0,1,0
../kbl_data/2024-2025,S45G01N108,원주 DB,Home,서민수,5,1,2,50.0,1,3,33.3,2,5,40.0,0,0,0.0,0,6,6,1,0,1,0,0,0,4
../kbl_data/2024-2025,S45G01N108,원주 DB,Home,김영현,0,0,1,0.0,0,1,0.0,0,2,0.0,0,0,0.0,0,0,0,0,0,0,0,0,0,1
../kbl_data/2024-2025,S45G01N108,원주 DB,Home,박봉진,6,0,0,0.0,2,3,66.7,2,3,66.7,0,0,0.0,0,2,2,0,0,0,0,0,0,3
../kbl_data/2024-2025,S45G01N108,원주 DB,Home,치나누 오누아쿠,34,5,12,41.7,6,10,60.0,11,22,50.0,6,9,66.7,3,9,12,7,0,0,0,1,5,2
../kbl_data/2024-2025,S45G01N108,원주 DB,Home,이용우,0,0,0,0.0,0,1,0.0,0,1,0.0,0,0,0.0,1,0,1,0,0,0,0,0,0,3
../kbl_data/2024-2025,S45G01N108,원주 DB,Home,정호영,0,0,0,0.0,0,0,0.0,0,0,0.0,0,0,0.0,0,0,0,0,0,0,0,0,0,0
../kbl_data/2024-2025,S45G01N108,원주 DB,Home,이선 알바노,15,5,10,50.0,1,6,16.7,6,16,37.5,2,4,50.0,0,3,3,7,5,0,0,0,1,4
../kbl_data/2024-2025,S45G01N108,원주 DB,Home,박인웅,14,4,5,80.0,2,5,40.0,6,10,60.0,0,0,0.0,3,3,6,2,1,0,0,0,0,1
../kbl_data/2024-2025,S45G01N108,원주 DB,Home,최승빈,0,0,0,0.0,0,0,0.0,0,0,0.0,0,0,0.0,0,0,0,0,0,0,0,0,0,0
../kbl_data/2024-2025,S45G01N108,원주 DB,Home,로버트 카터,0,0,2,0.0,0,0,0.0,0,2,0.0,0,0,0.0,0,0,0,0,0,0,0,0,0,0
../kbl_data/2024-2025,S45G01N108,원주 DB,Home,김보배,6,3,5,60.0,0,0,0.0,3,5,60.0,0,0,0.0,2,4,6,0,0,0,0,1,1,1
../kbl_data/2024-2025,S45G01N108,서울 SK,Away,김선형,22,5,7,71.4,4,7,57.1,9,14,64.3,0,2,0.0,2,2,4,9,2,0,0,0,2,3
../kbl_data/2024-2025,S45G01N108,서울 SK,Away,오세근,6,0,1,0.0,2,5,40.0,2,6,33.3,0,0,0.0,0,3,3,1,0,0,0,0,1,1
../kbl_data/2024-2025,S45G01N108,서울 SK,Away,최부경,4,0,4,0.0,1,1,100.0,1,5,20.0,1,2,50.0,2,4,6,1,0,0,1,0,0,3
../kbl_data/2024-2025,S45G01N108,서울 SK,Away,최원혁,3,0,1,0.0,1,5,20.0,1,6,16.7,0,0,0.0,2,0,2,1,0,0,0,0,1,2
../kbl_data/2024-2025,S45G01N108,서울 SK,Away,장문호,0,0,0,0.0,0,0,0.0,0,0,0.0,0,0,0.0,0,0,0,0,0,0,0,0,0,0
../kbl_data/2024-2025,S45G01N108,서울 SK,Away,안영준,10,1,2,50.0,2,6,33.3,3,8,37.5,2,2,100.0,0,5,5,2,1,0,0,0,4,2
../kbl_data/2024-2025,S45G01N108,서울 SK,Away,자밀 워니,23,8,16,50.0,1,10,10.0,9,26,34.6,4,5,80.0,4,10,14,5,1,0,0,1,1,3
../kbl_data/2024-2025,S45G01N108,서울 SK,Away,김형빈,4,1,1,100.0,0,0,0.0,1,1,100.0,2,2,100.0,2,2,4,1,0,0,0,0,1,0
../kbl_data/2024-2025,S45G01N108,서울 SK,Away,아이재아 힉스,1,0,0,0.0,0,0,0.0,0,0,0.0,1,2,50.0,0,1,1,0,0,1,0,0,0,1
../kbl_data/2024-2025,S45G01N108,서울 SK,Away,박민우,0,0,0,0.0,0,0,0.0,0,0,0.0,0,0,0.0,0,0,0,0,0,0,0,0,0,0
../kbl_data/2024-2025,S45G01N108,서울 SK,Away,고메즈 델 리아노,2,1,1,100.0,0,0,0.0,1,1,100.0,0,0,0.0,0,0,0,0,0,0,0,0,0,0
../kbl_data/2024-2025,S45G01N108,서울 SK,Away,김태훈,0,0,0,0.0,0,0,0.0,0,0,0.0,0,0,0.0,0,0,0,0,0,0,0,0,0,0
../kbl_data/2024-2025,S45G01N109,창원 LG,Home,허일영,2,1,2,50.0,0,0,0.0,1,2,50.0,0,0,0.0,0,1,1,1,1,0,0,0,0,0
../kbl_data/2024-2025,S45G01N109,창원 LG,Home,장민국,6,0,0,0.0,2,5,40.0,2,5,40.0,0,0,0.0,0,0,0,0,0,1,0,0,0,1
../kbl_data/2024-2025,S45G01N109,창원 LG,Home,한상혁,0,0,0,0.0,0,0,0.0,0,0,0.0,0,0,0.0,0,0,0,0,0,0,0,0,0,0
../kbl_data/2024-2025,S45G01N109,창원 LG,Home,전성현,1,0,0,0.0,0,3,0.0,0,3,0.0,1,2,50.0,0,0,0,2,0,0,0,0,0,0
../kbl_data/2024-2025,S45G01N109,창원 LG,Home,정인덕,0,0,0,0.0,0,1,0.0,0,1,0.0,0,0,0.0,0,1,1,0,1,0,1,0,0,3
../kbl_data/2024-2025,S45G01N109,창원 LG,Home,대릴 먼로,2,1,2,50.0,0,1,0.0,1,3,33.3,0,0,0.0,3,3,6,2,0,0,0,0,0,2
../kbl_data/2024-2025,S45G01N109,창원 LG,Home,박정현,0,0,2,0.0,0,0,0.0,0,2,0.0,0,0,0.0,0,0,0,0,0,0,0,0,0,3
../kbl_data/2024-2025,S45G01N109,창원 LG,Home,아셈 마레이,21,9,16,56.2,0,0,0.0,9,16,56.2,3,7,42.9,5,7,12,3,4,1,0,0,4,1
../kbl_data/2024-2025,S45G01N109,창원 LG,Home,양준석,9,2,4,50.0,1,2,50.0,3,6,50.0,2,3,66.7,0,0,0,7,2,0,0,0,1,4
../kbl_data/2024-2025,S45G01N109,창원 LG,Home,유기상,3,0,2,0.0,1,4,25.0,1,6,16.7,0,0,0.0,1,2,3,1,0,0,0,0,0,1
../kbl_data/2024-2025,S45G01N109,창원 LG,Home,이경도,10,2,3,66.7,2,4,50.0,4,7,57.1,0,0,0.0,0,1,1,1,0,1,0,0,0,2
../kbl_data/2024-2025,S45G01N109,창원 LG,Home,칼 타마요,20,9,13,69.2,0,3,0.0,9,16,56.2,2,2,100.0,0,6,6,5,0,0,0,0,0,2
../kbl_data/2024-2025,S45G01N109,수원 KT,Away,한희원,8,1,1,100.0,2,6,33.3,3,7,42.9,0,0,0.0,1,2,3,1,0,0,0,0,0,1
../kbl_data/2024-2025,S45G01N109,수원 KT,Away,최창진,4,1,2,50.0,0,0,0.0,1,2,50.0,2,2,100.0,1,0,1,2,0,0,0,0,0,1
../kbl_data/2024-2025,S45G01N109,수원 KT,Away,이현석,0,0,0,0.0,0,1,0.0,0,1,0.0,0,0,0.0,0,3,3,1,0,0,0,0,0,1
../kbl_data/2024-2025,S45G01N109,수원 KT,Away,박준영,12,3,6,50.0,2,3,66.7,5,9,55.6,0,0,0.0,2,2,4,3,0,0,0,0,1,4
../kbl_data/2024-2025,S45G01N109,수원 KT,Away,최진광,5,1,2,50.0,1,7,14.3,2,9,22.2,0,0,0.0,0,3,3,3,0,0,0,0,4,3
../kbl_data/2024-2025,S45G01N109,수원 KT,Away,이윤기,0,0,0,0.0,0,0,0.0,0,0,0.0,0,0,0.0,0,0,0,0,0,0,0,0,0,0
../kbl_data/2024-2025,S45G01N109,수원 KT,Away,하윤기,11,5,8,62.5,0,0,0.0,5,8,62.5,1,6,16.7,1,4,5,0,0,0,0,0,1,2
../kbl_data/2024-2025,S45G01N109,수원 KT,Away,박선웅,0,0,0,0.0,0,0,0.0,0,0,0.0,0,0,0.0,0,0,0,0,0,0,0,0,0,0
../kbl_data/2024-2025,S45G01N109,수원 KT,Away,문정현,4,2,6,33.3,0,2,0.0,2,8,25.0,0,0,0.0,2,3,5,2,0,1,0,0,1,1
../kbl_data/2024-2025,S45G01N109,수원 KT,Away,레이션 해먼즈,18,4,5,80.0,1,7,14.3,5,12,41.7,7,8,87.5,1,6,7,3,2,1,0,0,2,3
../kbl_data/2024-2025,S45G01N109,수원 KT,Away,박성재,5,2,2,100.0,0,1,0.0,2,3,66.7,1,1,100.0,0,2,2,0,0,0,0,0,0,3
../kbl_data/2024-2025,S45G01N109,수원 KT,Away,이스마엘 로메로,5,1,3,33.3,1,1,100.0,2,4,50.0,0,0,0.0,1,2,3,0,0,0,0,0,1,1
../kbl_data/2024-2025,S45G01N110,대구 한국가스공사,Home,김동량,0,0,0,0.0,0,0,0.0,0,0,0.0,0,0,0.0,0,0,0,0,0,0,0,0,0,0
../kbl_data/2024-2025,S45G01N110,대구 한국가스공사,Home,차바위,2,1,2,50.0,0,1,0.0,1,3,33.3,0,0,0.0,1,1,2,0,0,0,0,0,0,2
../kbl_data/2024-2025,S45G01N110,대구 한국가스공사,Home,박지훈,2,1,1,100.0,0,4,0.0,1,5,20.0,0,0,0.0,0,1,1,0,0,0,1,0,0,3
../kbl_data/2024-2025,S45G01N110,대구 한국가스공사,Home,이대헌,5,1,4,25.0,1,3,33.3,2,7,28.6,0,0,0.0,2,4,6,1,0,0,0,0,0,2
../kbl_data/2024-2025,S45G01N110,대구 한국가스공사,Home,정성우,3,1,1,100.0,0,1,0.0,1,2,50.0,1,1,100.0,0,1,1,3,2,0,0,0,0,3
../kbl_data/2024-2025,S45G01N110,대구 한국가스공사,Home,김낙현,11,0,1,0.0,3,5,60.0,3,6,50.0,2,2,100.0,0,3,3,2,0,0,0,0,2,1
../kbl_data/2024-2025,S45G01N110,대구 한국가스공사,Home,양재혁,0,0,0,0.0,0,0,0.0,0,0,0.0,0,0,0.0,0,0,0,0,0,0,0,0,0,0
../kbl_data/2024-2025,S45G01N110,대구 한국가스공사,Home,곽정훈,3,0,1,0.0,1,3,33.3,1,4,25.0,0,0,0.0,0,2,2,0,0,1,0,0,1,1
../kbl_data/2024-2025,S45G01N110,대구 한국가스공사,Home,앤드류 니콜슨,31,9,15,60.0,3,6,50.0,12,21,57.1,4,10,40.0,3,5,8,0,1,1,0,0,1,1
../kbl_data/2024-2025,S45G01N110,대구 한국가스공사,Home,신승민,5,1,1,100.0,0,5,0.0,1,6,16.7,3,4,75.0,0,3,3,1,0,0,0,0,4,3
../kbl_data/2024-2025,S45G01N110,대구 한국가스공사,Home,샘조세프 벨란겔,12,4,6,66.7,0,0,0.0,4,6,66.7,4,4,100.0,0,1,1,5,3,0,0,0,1,4
../kbl_data/2024-2025,S45G01N110,대구 한국가스공사,Home,유슈 은도예,2,0,4,0.0,0,0,0.0,0,4,0.0,2,2,100.0,3,1,4,0,1,2,0,0,0,0
../kbl_data/2024-2025,S45G01N110,고양 소노,Away,정희재,3,0,1,0.0,1,4,25.0,1,5,20.0,0,0,0.0,2,3,5,5,0,0,0,0,4,4
../kbl_data/2024-2025,S45G01N110,고양 소노,Away,임동섭,0,0,0,0.0,0,1,0.0,0,1,0.0,0,0,0.0,0,1,1,1,2,0,0,0,0,2
../kbl_data/2024-2025,S45G01N110,고양 소노,Away,이재도,15,4,7,57.1,1,5,20.0,5,12,41.7,4,5,80.0,1,5,6,3,0,0,0,0,3,3
../kbl_data/2024-2025,S45G01N110,고양 소노,Away,최승욱,4,2,4,50.0,0,1,0.0,2,5,40.0,0,0,0.0,0,4,4,0,0,0,0,0,0,2
../kbl_data/2024-2025,S45G01N110,고양 소노,Away,김진유,2,1,1,100.0,0,0,0.0,1,1,100.0,0,0,0.0,0,1,1,0,0,0,0,0,0,0
../kbl_data/2024-2025,S45G01N110,고양 소노,Away,박진철,0,0,0,0.0,0,0,0.0,0,0,0.0,0,0,0.0,0,0,0,0,0,0,0,0,0,0
../kbl_data/2024-2025,S45G01N110,고양 소노,Away,이정현,15,5,7,71.4,1,9,11.1,6,16,37.5,2,2,100.0,2,1,3,5,0,0,0,0,4,2
../kbl_data/2024-2025,S45G01N110,고양 소노,Away,민기남,0,0,0,0.0,0,3,0.0,0,3,0.0,0,2,0.0,1,0,1,0,0,0,0,0,0,1
../kbl_data/2024-2025,S45G01N110,고양 소노,Away,디제이 번즈 Jr,6,3,7,42.9,0,0,0.0,3,7,42.9,0,0,0.0,1,4,5,1,1,1,0,0,1,4
../kbl_data/2024-2025,S45G01N110,고양 소노,Away,이근준,13,1,1,100.0,3,9,33.3,4,10,40.0,2,3,66.7,3,2,5,1,3,0,0,0,0,4
../kbl_data/2024-2025,S45G01N110,고양 소노,Away,정성조,0,0,0,0.0,0,0,0.0,0,0,0.0,0,0,0.0,0,0,0,0,0,0,0,0,0,0
../kbl_data/2024-2025,S45G01N110,고양 소노,Away,알파 카바,15,7,10,70.0,0,0,0.0,7,10,70.0,1,1,100.0,4,7,11,0,1,1,0,5,1,3
../kbl_data/2024-2025,S45G01N111,안양 정관장,Home,배병준,16,4,4,100.0,1,7,14.3,5,11,45.5,5,6,83.3,0,4,4,1,0,1,0,0,1,1
../kbl_data/2024-2025,S45G01N111,안양 정관장,Home,정효근,15,3,5,60.0,2,6,33.3,5,11,45.5,3,4,75.0,4,5,9,4,1,0,1,0,1,4
../kbl_data/2024-2025,S45G01N111,안양 정관장,Home,이종현,0,0,0,0.0,0,1,0.0,0,1,0.0,0,0,0.0,1,1,2,1,0,1,0,0,0,1
../kbl_data/2024-2025,S45G01N111,안양 정관장,Home,박지훈,12,4,9,44.4,0,2,0.0,4,11,36.4,4,4,100.0,4,5,9,8,2,0,0,0,2,4
../kbl_data/2024-2025,S45G01N111,안양 정관장,Home,최성원,6,0,1,0.0,2,8,25.0,2,9,22.2,0,0,0.0,0,0,0,1,1,0,0,0,1,0
../kbl_data/2024-2025,S45G01N111,안양 정관장,Home,이우정,3,0,2,0.0,1,2,50.0,1,4,25.0,0,0,0.0,0,0,0,1,0,0,0,0,0,1
../kbl_data/2024-2025,S45G01N111,안양 정관장,Home,캐디 라렌,16,7,12,58.3,0,2,0.0,7,14,50.0,2,3,66.7,2,4,6,1,0,3,0,2,3,3
../kbl_data/2024-2025,S45G01N111,안양 정관장,Home,김경원,0,0,0,0.0,0,0,0.0,0,0,0.0,0,0,0.0,0,1,1,0,0,0,0,0,0,0
../kbl_data/2024-2025,S45G01N111,안양 정관장,Home,한승희,7,3,3,100.0,0,1,0.0,3,4,75.0,1,1,100.0,0,0,0,0,0,0,0,0,2,3
../kbl_data/2024-2025,S45G01N111,안양 정관장,Home,클리프 알렉산더,3,0,0,0.0,1,2,50.0,1,2,50.0,0,0,0.0,0,1,1,0,0,0,0,0,0,0
../kbl_data/2024-2025,S45G01N111,안양 정관장,Home,하비 고메즈,0,0,1,0.0,0,1,0.0,0,2,0.0,0,0,0.0,0,0,0,0,0,0,0,0,0,0
../kbl_data/2024-2025,S45G01N111,안양 정관장,Home,박정웅,0,0,1,0.0,0,0,0.0,0,1,0.0,0,0,0.0,0,2,2,0,0,0,0,0,2,0
../kbl_data/2024-2025,S45G01N111,서울 삼성,Away,이정현,15,4,10,40.0,2,5,40.0,6,15,40.0,1,1,100.0,1,3,4,1,0,0,0,0,0,3
../kbl_data/2024-2025,S45G01N111,서울 삼성,Away,최현민,0,0,0,0.0,0,0,0.0,0,0,0.0,0,0,0.0,2,1,3,1,1,0,0,0,0,1
../kbl_data/2024-2025,S45G01N111,서울 삼성,Away,이원대,8,1,3,33.3,2,5,40.0,3,8,37.5,0,0,0.0,0,0,0,1,0,0,0,0,0,1
../kbl_data/2024-2025,S45G01N111,서울 삼성,Away,최성모,6,3,4,75.0,0,4,0.0,3,8,37.5,0,0,0.0,0,4,4,6,1,0,0,0,3,1
../kbl_data/2024-2025,S45G01N111,서울 삼성,Away,최승욱,9,3,4,75.0,1,3,33.3,4,7,57.1,0,0,0.0,2,2,4,0,1,0,1,0,0,1
../kbl_data/2024-2025,S45G01N111,서울 삼성,Away,김한솔,0,0,0,0.0,0,0,0.0,0,0,0.0,0,0,0.0,0,0,0,0,0,0,0,0,0,0
../kbl_data/2024-2025,S45G01N111,서울 삼성,Away,마커스 데릭슨,14,1,4,25.0,4,8,50.0,5,12,41.7,0,0,0.0,1,3,4,0,1,1,0,0,1,3
../kbl_data/2024-2025,S45G01N111,서울 삼성,Away,이원석,10,3,5,60.0,1,1,100.0,4,6,66.7,1,2,50.0,4,6,10,0,0,0,0,0,2,2
../kbl_data/2024-2025,S45G01N111,서울 삼성,Away,저스틴 구탕,23,7,8,87.5,3,4,75.0,10,12,83.3,0,0,0.0,1,3,4,4,4,1,0,2,0,3
../kbl_data/2024-2025,S45G01N111,서울 삼성,Away,박승재,3,0,0,0.0,1,2,50.0,1,2,50.0,0,0,0.0,0,0,0,8,0,0,0,0,1,3
../kbl_data/2024-2025,S45G01N111,서울 삼성,Away,임동언,3,0,0,0.0,1,1,100.0,1,1,100.0,0,0,0.0,0,0,0,0,0,0,0,0,0,1
../kbl_data/2024-2025,S45G01N111,서울 삼성,Away,빈센트 에드워즈,9,3,4,75.0,1,5,20.0,4,9,44.4,0,0,0.0,0,3,3,2,0,0,0,0,1,2
../kbl_data/2024-2025,S45G01N112,창원 LG,Home,허일영,10,2,3,66.7,2,5,40.0,4,8,50.0,0,0,0.0,2,1,3,0,2,0,0,0,0,3
../kbl_data/2024-2025,S45G01N112,창원 LG,Home,장민국,8,1,2,50.0,2,3,66.7,3,5,60.0,0,0,0.0,0,0,0,0,0,0,0,0,2,2
../kbl_data/2024-2025,S45G01N112,창원 LG,Home,한상혁,3,0,0,0.0,1,1,100.0,1,1,100.0,0,0,0.0,0,0,0,4,1,0,0,0,0,0
../kbl_data/2024-2025,S45G01N112,창원 LG,Home,전성현,6,0,2,0.0,2,6,33.3,2,8,25.0,0,0,0.0,0,0,0,2,1,0,0,0,0,0
../kbl_data/2024-2025,S45G01N112,창원 LG,Home,정인덕,11,1,2,50.0,3,4,75.0,4,6,66.7,0,0,0.0,0,2,2,3,1,0,0,0,0,0
../kbl_data/2024-2025,S45G01N112,창원 LG,Home,대릴 먼로,8,4,7,57.1,0,1,0.0,4,8,50.0,0,0,0.0,3,7,10,1,1,0,0,0,1,1
../kbl_data/2024-2025,S45G01N112,창원 LG,Home,박정현,6,2,5,40.0,0,0,0.0,2,5,40.0,2,2,100.0,0,2,2,1,0,0,0,0,0,2
../kbl_data/2024-2025,S45G01N112,창원 LG,Home,아셈 마레이,15,6,7,85.7,0,0,0.0,6,7,85.7,3,4,75.0,1,9,10,4,1,0,0,0,1,3
../kbl_data/2024-2025,S45G01N112,창원 LG,Home,양준석,4,2,3,66.7,0,2,0.0,2,5,40.0,0,0,0.0,0,2,2,8,0,0,0,0,0,2
../kbl_data/2024-2025,S45G01N112,창원 LG,Home,유기상,15,3,3,100.0,3,6,50.0,6,9,66.7,0,0,0.0,1,2,3,3,1,0,1,0,1,2
../kbl_data/2024-2025,S45G01N112,창원 LG,Home,이경도,6,3,5,60.0,0,1,0.0,3,6,50.0,0,0,0.0,1,2,3,0,1,0,0,0,1,3
../kbl_data/2024-2025,S45G01N112,창원 LG,Home,최형찬,2,0,1,0.0,0,2,0.0,0,3,0.0,2,2,100.0,0,0,0,0,0,0,0,0,0,1
../kbl_data/2024-2025,S45G01N112,원주 DB,Away,김시래,3,0,1,0.0,1,1,100.0,1,2,50.0,0,0,0.0,0,2,2,0,0,0,0,0,0,0
../kbl_data/2024-2025,S45G01N112,원주 DB,Away,서민수,0,0,0,0.0,0,3,0.0,0,3,0.0,0,0,0.0,1,2,3,1,2,0,0,0,0,2
../kbl_data/2024-2025,S45G01N112,원주 DB,Away,박봉진,2,1,1,100.0,0,1,0.0,1,2,50.0,0,0,0.0,0,0,0,1,0,0,0,0,1,1
../kbl_data/2024-2025,S45G01N112,원주 DB,Away,치나누 오누아쿠,12,3,6,50.0,1,3,33.3,4,9,44.4,3,6,50.0,2,5,7,3,0,0,0,0,2,3
../kbl_data/2024-2025,S45G01N112,원주 DB,Away,이용우,3,0,0,0.0,1,4,25.0,1,4,25.0,0,0,0.0,0,0,0,0,0,0,0,0,0,2
../kbl_data/2024-2025,S45G01N112,원주 DB,Away,정호영,10,3,5,60.0,1,5,20.0,4,10,40.0,1,2,50.0,2,3,5,1,0,0,0,0,0,3
../kbl_data/2024-2025,S45G01N112,원주 DB,Away,이선 알바노,8,3,7,42.9,0,4,0.0,3,11,27.3,2,3,66.7,1,2,3,3,2,0,0,0,4,1
../kbl_data/2024-2025,S45G01N112,원주 DB,Away,박인웅,13,4,4,100.0,1,5,20.0,5,9,55.6,2,2,100.0,3,3,6,0,0,0,0,0,1,2
../kbl_data/2024-2025,S45G01N112,원주 DB,Away,최승빈,0,0,0,0.0,0,1,0.0,0,1,0.0,0,2,0.0,0,0,0,0,0,0,0,0,1,0
../kbl_data/2024-2025,S45G01N112,원주 DB,Away,로버트 카터,5,2,6,33.3,0,4,0.0,2,10,20.0,1,2,50.0,2,4,6,1,0,1,0,0,2,0
../kbl_data/2024-2025,S45G01N112,원주 DB,Away,김보배,4,2,3,66.7,0,0,0.0,2,3,66.7,0,0,0.0,2,2,4,0,0,2,0,0,0,2
../kbl_data/2024-2025,S45G01N112,원주 DB,Away,백승엽,0,0,1,0.0,0,0,0.0,0,1,0.0,0,0,0.0,0,0,0,0,0,0,0,0,1,0
../kbl_data/2024-2025,S45G01N113,울산 현대모비스,Home,함지훈,6,3,6,50.0,0,0,0.0,3,6,50.0,0,0,0.0,3,1,4,2,0,0,0,0,1,3
../kbl_data/2024-2025,S45G01N113,울산 현대모비스,Home,장재석,0,0,0,0.0,0,0,0.0,0,0,0.0,0,0,0.0,0,2,2,0,0,0,0,0,0,0
../kbl_data/2024-2025,S45G01N113,울산 현대모비스,Home,김지완,0,0,0,0.0,0,0,0.0,0,0,0.0,0,0,0.0,0,0,0,1,0,0,0,0,0,1
../kbl_data/2024-2025,S45G01N113,울산 현대모비스,Home,한호빈,3,0,0,0.0,1,4,25.0,1,4,25.0,0,0,0.0,2,0,2,3,0,0,0,0,0,4
../kbl_data/2024-2025,S45G01N113,울산 현대모비스,Home,김국찬,4,1,1,100.0,0,3,0.0,1,4,25.0,2,2,100.0,0,4,4,0,0,0,0,0,0,4
../kbl_data/2024-2025,S45G01N113,울산 현대모비스,Home,숀 롱,20,5,10,50.0,0,0,0.0,5,10,50.0,10,12,83.3,5,10,15,2,1,0,0,1,1,2
../kbl_data/2024-2025,S45G01N113,울산 현대모비스,Home,이우석,21,0,0,0.0,7,11,63.6,7,11,63.6,0,1,0.0,1,3,4,4,1,0,0,0,3,3
../kbl_data/2024-2025,S45G01N113,울산 현대모비스,Home,이승우,0,0,1,0.0,0,0,0.0,0,1,0.0,0,0,0.0,0,0,0,0,0,0,0,0,0,1
../kbl_data/2024-2025,S45G01N113,울산 현대모비스,Home,신민석,7,2,2,100.0,1,2,50.0,3,4,75.0,0,0,0.0,1,1,2,2,1,0,0,0,0,1
../kbl_data/2024-2025,S45G01N113,울산 현대모비스,Home,게이지 프림,11,5,11,45.5,0,0,0.0,5,11,45.5,1,4,25.0,0,1,1,0,1,1,0,0,1,0
../kbl_data/2024-2025,S45G01N113,울산 현대모비스,Home,박무빈,12,1,8,12.5,3,5,60.0,4,13,30.8,1,1,100.0,1,4,5,3,0,0,0,0,1,3
../kbl_data/2024-2025,S45G01N113,울산 현대모비스,Home,미구엘 안드레 옥존,0,0,3,0.0,0,0,0.0,0,3,0.0,0,0,0.0,0,2,2,0,0,0,0,0,1,0
../kbl_data/2024-2025,S45G01N113,고양 소노,Away,정희재,1,0,0,0.0,0,1,0.0,0,1,0.0,1,2,50.0,0,2,2,0,0,0,0,0,0,0
../kbl_data/2024-2025,S45G01N113,고양 소노,Away,임동섭,0,0,2,0.0,0,1,0.0,0,3,0.0,0,2,0.0,3,2,5,0,0,0,0,0,0,5
../kbl_data/2024-2025,S45G01N113,고양 소노,Away,이재도,11,1,3,33.3,2,6,33.3,3,9,33.3,3,4,75.0,1,1,2,1,0,0,0,0,1,1
../kbl_data/2024-2025,S45G01N113,고양 소노,Away,최승욱,4,1,2,50.0,0,2,0.0,1,4,25.0,2,2,100.0,2,1,3,0,1,0,0,0,0,1
../kbl_data/2024-2025,S45G01N113,고양 소노,Away,김진유,0,0,1,0.0,0,0,0.0,0,1,0.0,0,0,0.0,1,0,1,0,0,0,0,0,0,0
../kbl_data/2024-2025,S45G01N113,고양 소노,Away,박진철,1,0,2,0.0,0,0,0.0,0,2,0.0,1,2,50.0,0,0,0,0,0,0,0,0,0,2
../kbl_data/2024-2025,S45G01N113,고양 소노,Away,이정현,21,3,7,42.9,3,13,23.1,6,20,30.0,6,8,75.0,0,5,5,11,2,0,0,0,1,2
../kbl_data/2024-2025,S45G01N113,고양 소노,Away,민기남,0,0,0,0.0,0,0,0.0,0,0,0.0,0,0,0.0,0,0,0,0,0,0,0,0,0,0
../kbl_data/2024-2025,S45G01N113,고양 소노,Away,디제이 번즈 Jr,22,11,15,73.3,0,0,0.0,11,15,73.3,0,0,0.0,1,4,5,1,1,1,0,0,1,2
../kbl_data/2024-2025,S45G01N113,고양 소노,Away,이근준,5,1,1,100.0,1,5,20.0,2,6,33.3,0,0,0.0,0,3,3,0,0,0,0,0,1,4
../kbl_data/2024-2025,S45G01N113,고양 소노,Away,정성조,0,0,0,0.0,0,1,0.0,0,1,0.0,0,0,0.0,0,1,1,0,0,0,0,0,0,1
../kbl_data/2024-2025,S45G01N113,고양 소노,Away,알파 카바,2,1,3,33.3,0,0,0.0,1,3,33.3,0,0,0.0,0,4,4,0,1,0,0,1,0,3
../kbl_data/2024-2025,S45G01N114,부산 KCC,Home,정창영,0,0,0,0.0,0,0,0.0,0,0,0.0,0,0,0.0,0,0,0,0,0,0,0,0,0,0
../kbl_data/2024-2025,S45G01N114,부산 KCC,Home,리온 윌리엄스,1,0,3,0.0,0,0,0.0,0,3,0.0,1,2,50.0,1,2,3,0,1,1,0,0,0,1
../kbl_data/2024-2025,S45G01N114,부산 KCC,Home,전준범,0,0,0,0.0,0,0,0.0,0,0,0.0,0,0,0.0,0,0,0,0,0,0,0,0,0,0
../kbl_data/2024-2025,S45G01N114,부산 KCC,Home,허웅,20,4,8,50.0,4,12,33.3,8,20,40.0,0,0,0.0,0,5,5,3,1,0,0,0,2,1
../kbl_data/2024-2025,S45G01N114,부산 KCC,Home,이승현,7,3,8,37.5,0,0,0.0,3,8,37.5,1,1,100.0,4,1,5,0,2,0,0,0,1,1
../kbl_data/2024-2025,S45G01N114,부산 KCC,Home,이호현,6,3,7,42.9,0,0,0.0,3,7,42.9,0,0,0.0,0,0,0,0,2,0,0,0,2,3
../kbl_data/2024-2025,S45G01N114,부산 KCC,Home,최준용,21,4,6,66.7,2,8,25.0,6,14,42.9,7,9,77.8,3,2,5,3,0,2,0,0,3,5
../kbl_data/2024-2025,S45G01N114,부산 KCC,Home,디온테 버튼,23,8,16,50.0,0,8,0.0,8,24,33.3,7,11,63.6,1,10,11,7,5,1,0,2,2,2
../kbl_data/2024-2025,S45G01N114,부산 KCC,Home,이근휘,6,0,0,0.0,2,2,100.0,2,2,100.0,0,0,0.0,0,1,1,0,0,0,0,0,0,2
../kbl_data/2024-2025,S45G01N114,부산 KCC,Home,김동현,2,1,2,50.0,0,3,0.0,1,5,20.0,0,0,0.0,1,2,3,4,1,0,1,0,0,2
../kbl_data/2024-2025,S45G01N114,부산 KCC,Home,캘빈 제프리 에피스톨라,0,0,0,0.0,0,0,0.0,0,0,0.0,0,0,0.0,1,2,3,0,0,0,0,0,1,1
../kbl_data/2024-2025,S45G01N114,부산 KCC,Home,이주영,0,0,0,0.0,0,0,0.0,0,0,0.0,0,0,0.0,0,0,0,0,0,0,0,0,0,0
../kbl_data/2024-2025,S45G01N114,서울 SK,Away,김선형,13,5,7,71.4,1,2,50.0,6,9,66.7,0,0,0.0,0,3,3,11,3,0,0,0,4,1
../kbl_data/2024-2025,S45G01N114,서울 SK,Away,오세근,6,0,0,0.0,2,4,50.0,2,4,50.0,0,0,0.0,0,3,3,1,0,0,0,0,0,1
../kbl_data/2024-2025,S45G01N114,서울 SK,Away,최부경,8,2,4,50.0,0,1,0.0,2,5,40.0,4,5,80.0,2,4,6,1,0,0,1,0,1,4
../kbl_data/2024-2025,S45G01N114,서울 SK,Away,최원혁,0,0,0,0.0,0,2,0.0,0,2,0.0,0,0,0.0,1,2,3,6,2,0,0,0,1,3
../kbl_data/2024-2025,S45G01N114,서울 SK,Away,장문호,0,0,0,0.0,0,0,0.0,0,0,0.0,0,0,0.0,0,0,0,0,0,0,0,0,0,1
../kbl_data/2024-2025,S45G01N114,서울 SK,Away,안영준,22,4,7,57.1,4,9,44.4,8,16,50.0,2,3,66.7,1,5,6,3,4,0,0,0,4,4
../kbl_data/2024-2025,S45G01N114,서울 SK,Away,자밀 워니,34,15,25,60.0,0,0,0.0,15,25,60.0,4,6,66.7,3,17,20,4,0,0,0,1,6,1
../kbl_data/2024-2025,S45G01N114,서울 SK,Away,김형빈,7,2,2,100.0,1,2,50.0,3,4,75.0,0,0,0.0,0,6,6,1,0,1,0,0,1,2
../kbl_data/2024-2025,S45G01N114,서울 SK,Away,아이재아 힉스,4,2,5,40.0,0,1,0.0,2,6,33.3,0,0,0.0,1,1,2,0,0,1,0,0,1,1
../kbl_data/2024-2025,S45G01N114,서울 SK,Away,오재현,2,1,3,33.3,0,0,0.0,1,3,33.3,0,0,0.0,0,3,3,2,0,0,0,0,3,3
../kbl_data/2024-2025,S45G01N114,서울 SK,Away,고메즈 델 리아노,0,0,0,0.0,0,0,0.0,0,0,0.0,0,0,0.0,0,0,0,0,0,0,0,0,0,0
../kbl_data/2024-2025,S45G01N114,서울 SK,Away,김태훈,0,0,0,0.0,0,0,0.0,0,0,0.0,0,0,0.0,0,0,0,0,0,0,0,0,0,0
../kbl_data/2024-2025,S45G01N115,울산 현대모비스,Home,함지훈,15,7,10,70.0,0,1,0.0,7,11,63.6,1,2,50.0,2,3,5,3,0,0,0,0,1,3
../kbl_data/2024-2025,S45G01N115,울산 현대모비스,Home,장재석,0,0,0,0.0,0,0,0.0,0,0,0.0,0,0,0.0,0,0,0,0,0,1,0,0,2,0
../kbl_data/2024-2025,S45G01N115,울산 현대모비스,Home,김지완,0,0,0,0.0,0,0,0.0,0,0,0.0,0,0,0.0,0,0,0,0,0,0,0,0,0,0
../kbl_data/2024-2025,S45G01N115,울산 현대모비스,Home,한호빈,6,0,0,0.0,2,3,66.7,2,3,66.7,0,0,0.0,0,2,2,2,0,0,0,0,0,3
../kbl_data/2024-2025,S45G01N115,울산 현대모비스,Home,김준일,4,2,2,100.0,0,0,0.0,2,2,100.0,0,0,0.0,1,1,2,2,1,1,0,0,1,0
../kbl_data/2024-2025,S45G01N115,울산 현대모비스,Home,김국찬,2,1,1,100.0,0,2,0.0,1,3,33.3,0,0,0.0,1,1,2,1,0,1,0,0,1,1
../kbl_data/2024-2025,S45G01N115,울산 현대모비스,Home,숀 롱,16,6,9,66.7,1,1,100.0,7,10,70.0,1,3,33.3,1,2,3,2,1,2,0,2,0,2
../kbl_data/2024-2025,S45G01N115,울산 현대모비스,Home,이우석,6,1,3,33.3,1,8,12.5,2,11,18.2,1,1,100.0,0,7,7,9,1,1,0,0,1,2
../kbl_data/2024-2025,S45G01N115,울산 현대모비스,Home,신민석,0,0,0,0.0,0,0,0.0,0,0,0.0,0,0,0.0,0,0,0,0,0,0,0,0,0,0
../kbl_data/2024-2025,S45G01N115,울산 현대모비스,Home,게이지 프림,14,7,8,87.5,0,0,0.0,7,8,87.5,0,0,0.0,1,3,4,2,1,0,0,2,1,1
../kbl_data/2024-2025,S45G01N115,울산 현대모비스,Home,박무빈,17,5,8,62.5,2,4,50.0,7,12,58.3,1,2,50.0,0,4,4,6,0,0,0,0,2,3
../kbl_data/2024-2025,S45G01N115,울산 현대모비스,Home,미구엘 안드레 옥존,8,3,4,75.0,0,2,0.0,3,6,50.0,2,2,100.0,0,3,3,1,0,0,1,0,2,1
../kbl_data/2024-2025,S45G01N115,대구 한국가스공사,Away,김동량,0,0,0,0.0,0,0,0.0,0,0,0.0,0,0,0.0,0,0,0,0,0,0,0,0,0,0
../kbl_data/2024-2025,S45G01N115,대구 한국가스공사,Away,차바위,3,0,0,0.0,1,1,100.0,1,1,100.0,0,0,0.0,1,1,2,2,0,0,0,0,0,1
../kbl_data/2024-2025,S45G01N115,대구 한국가스공사,Away,박지훈,0,0,1,0.0,0,1,0.0,0,2,0.0,0,0,0.0,0,1,1,0,0,0,0,0,0,2
../kbl_data/2024-2025,S45G01N115,대구 한국가스공사,Away,이대헌,7,1,1,100.0,1,3,33.3,2,4,50.0,2,2,100.0,2,1,3,3,1,1,0,0,2,1
../kbl_data/2024-2025,S45G01N115,대구 한국가스공사,Away,정성우,0,0,2,0.0,0,3,0.0,0,5,0.0,0,0,0.0,0,1,1,2,1,0,0,0,0,2
../kbl_data/2024-2025,S45G01N115,대구 한국가스공사,Away,김낙현,16,5,7,71.4,2,10,20.0,7,17,41.2,0,0,0.0,1,1,2,3,1,0,0,0,0,4
../kbl_data/2024-2025,S45G01N115,대구 한국가스공사,Away,양재혁,0,0,0,0.0,0,1,0.0,0,1,0.0,0,0,0.0,0,1,1,0,0,0,0,0,0,1
../kbl_data/2024-2025,S45G01N115,대구 한국가스공사,Away,곽정훈,5,1,1,100.0,1,2,50.0,2,3,66.7,0,0,0.0,2,1,3,0,0,0,0,0,0,2
../kbl_data/2024-2025,S45G01N115,대구 한국가스공사,Away,앤드류 니콜슨,19,5,7,71.4,3,6,50.0,8,13,61.5,0,0,0.0,0,8,8,0,0,0,0,0,2,2
../kbl_data/2024-2025,S45G01N115,대구 한국가스공사,Away,신승민,5,2,4,50.0,0,1,0.0,2,5,40.0,1,1,100.0,2,0,2,2,1,1,0,0,0,1
../kbl_data/2024-2025,S45G01N115,대구 한국가스공사,Away,샘조세프 벨란겔,23,4,7,57.1,5,9,55.6,9,16,56.2,0,0,0.0,0,1,1,3,2,0,0,0,2,2
../kbl_data/2024-2025,S45G01N115,대구 한국가스공사,Away,유슈 은도예,3,1,4,25.0,0,1,0.0,1,5,20.0,1,2,50.0,3,1,4,0,0,1,0,1,0,2
../kbl_data/2024-2025,S45G01N116,수원 KT,Home,한희원,8,2,2,100.0,1,3,33.3,3,5,60.0,1,3,33.3,0,2,2,0,0,0,0,0,0,4
../kbl_data/2024-2025,S45G01N116,수원 KT,Home,최창진,0,0,0,0.0,0,0,0.0,0,0,0.0,0,0,0.0,1,0,1,1,0,0,0,0,0,1
../kbl_data/2024-2025,S45G01N116,수원 KT,Home,문성곤,0,0,0,0.0,0,2,0.0,0,2,0.0,0,0,0.0,0,1,1,0,0,0,0,0,0,0
../kbl_data/2024-2025,S45G01N116,수원 KT,Home,이현석,0,0,2,0.0,0,1,0.0,0,3,0.0,0,0,0.0,0,2,2,1,1,0,0,0,0,3
../kbl_data/2024-2025,S45G01N116,수원 KT,Home,허훈,11,1,5,20.0,3,4,75.0,4,9,44.4,0,0,0.0,0,0,0,7,1,0,1,0,2,1
../kbl_data/2024-2025,S45G01N116,수원 KT,Home,박준영,4,2,3,66.7,0,2,0.0,2,5,40.0,0,0,0.0,1,0,1,1,0,0,0,0,1,2
../kbl_data/2024-2025,S45G01N116,수원 KT,Home,최진광,8,1,1,100.0,2,5,40.0,3,6,50.0,0,0,0.0,1,0,1,2,0,0,0,0,1,0
../kbl_data/2024-2025,S45G01N116,수원 KT,Home,하윤기,17,8,10,80.0,0,0,0.0,8,10,80.0,1,2,50.0,1,4,5,0,1,1,0,2,1,1
../kbl_data/2024-2025,S45G01N116,수원 KT,Home,문정현,7,1,6,16.7,1,1,100.0,2,7,28.6,2,2,100.0,2,2,4,7,2,0,0,0,1,4
../kbl_data/2024-2025,S45G01N116,수원 KT,Home,레이션 해먼즈,19,9,12,75.0,0,5,0.0,9,17,52.9,1,2,50.0,2,6,8,1,4,0,0,1,1,1
../kbl_data/2024-2025,S45G01N116,수원 KT,Home,박성재,6,0,2,0.0,2,3,66.7,2,5,40.0,0,0,0.0,0,1,1,1,0,0,0,0,1,1
../kbl_data/2024-2025,S45G01N116,수원 KT,Home,이스마엘 로메로,6,2,2,100.0,0,0,0.0,2,2,100.0,2,2,100.0,1,2,3,1,1,0,0,0,1,0
../kbl_data/2024-2025,S45G01N116,부산 KCC,Away,리온 윌리엄스,4,1,4,25.0,0,0,0.0,1,4,25.0,2,4,50.0,0,3,3,1,0,0,0,0,0,2
../kbl_data/2024-2025,S45G01N116,부산 KCC,Away,전준범,7,2,2,100.0,1,7,14.3,3,9,33.3,0,0,0.0,1,2,3,1,1,1,0,0,2,2
../kbl_data/2024-2025,S45G01N116,부산 KCC,Away,허웅,19,2,3,66.7,4,11,36.4,6,14,42.9,3,4,75.0,0,1,1,8,1,0,0,0,2,4
../kbl_data/2024-2025,S45G01N116,부산 KCC,Away,이승현,12,5,8,62.5,0,3,0.0,5,11,45.5,2,2,100.0,0,12,12,2,0,0,0,0,2,1
../kbl_data/2024-2025,S45G01N116,부산 KCC,Away,이호현,10,4,4,100.0,0,0,0.0,4,4,100.0,2,2,100.0,1,3,4,2,0,0,0,0,1,1
../kbl_data/2024-2025,S45G01N116,부산 KCC,Away,디온테 버튼,6,1,4,25.0,0,3,0.0,1,7,14.3,4,4,100.0,2,5,7,0,2,0,0,0,2,0
../kbl_data/2024-2025,S45G01N116,부산 KCC,Away,이근휘,6,0,0,0.0,2,5,40.0,2,5,40.0,0,0,0.0,0,0,0,1,3,0,0,0,1,1
../kbl_data/2024-2025,S45G01N116,부산 KCC,Away,김동현,0,0,0,0.0,0,0,0.0,0,0,0.0,0,0,0.0,0,0,0,0,0,0,0,0,2,1
../kbl_data/2024-2025,S45G01N116,부산 KCC,Away,여준형,2,1,2,50.0,0,0,0.0,1,2,50.0,0,0,0.0,1,0,1,0,1,0,0,0,1,1
../kbl_data/2024-2025,S45G01N116,부산 KCC,Away,캘빈 제프리 에피스톨라,2,1,2,50.0,0,0,0.0,1,2,50.0,0,0,0.0,2,1,3,2,0,1,0,0,1,3
../kbl_data/2024-2025,S45G01N116,부산 KCC,Away,이주영,0,0,0,0.0,0,0,0.0,0,0,0.0,0,0,0.0,0,0,0,0,0,0,0,0,0,0
../kbl_data/2024-2025,S45G01N116,부산 KCC,Away,이찬영,0,0,0,0.0,0,0,0.0,0,0,0.0,0,0,0.0,0,0,0,0,0,0,0,0,0,0
../kbl_data/2024-2025,S45G01N117,창원 LG,Home,허일영,11,4,4,100.0,1,5,20.0,5,9,55.6,0,2,0.0,2,2,4,0,1,1,0,0,0,3
../kbl_data/2024-2025,S45G01N117,창원 LG,Home,장민국,0,0,0,0.0,0,1,0.0,0,1,0.0,0,0,0.0,0,1,1,1,0,2,0,0,0,3
../kbl_data/2024-2025,S45G01N117,창원 LG,Home,한상혁,0,0,0,0.0,0,0,0.0,0,0,0.0,0,0,0.0,0,0,0,0,0,0,0,0,0,0
../kbl_data/2024-2025,S45G01N117,창원 LG,Home,전성현,6,0,1,0.0,2,5,40.0,2,6,33.3,0,0,0.0,0,0,0,1,0,0,0,0,0,0
../kbl_data/2024-2025,S45G01N117,창원 LG,Home,정인덕,2,1,3,33.3,0,2,0.0,1,5,20.0,0,0,0.0,1,3,4,0,0,0,0,0,1,5
../kbl_data/2024-2025,S45G01N117,창원 LG,Home,대릴 먼로,25,9,13,69.2,1,2,50.0,10,15,66.7,4,4,100.0,4,7,11,7,1,0,0,0,5,1
../kbl_data/2024-2025,S45G01N117,창원 LG,Home,박정현,2,1,2,50.0,0,0,0.0,1,2,50.0,0,0,0.0,0,0,0,1,0,0,0,0,2,2
../kbl_data/2024-2025,S45G01N117,창원 LG,Home,아셈 마레이,0,0,0,0.0,0,0,0.0,0,0,0.0,0,0,0.0,0,0,0,0,0,0,0,0,0,0
../kbl_data/2024-2025,S45G01N117,창원 LG,Home,양준석,17,5,9,55.6,2,4,50.0,7,13,53.8,1,1,100.0,3,2,5,9,2,0,0,0,0,4
../kbl_data/2024-2025,S45G01N117,창원 LG,Home,유기상,11,1,4,25.0,3,8,37.5,4,12,33.3,0,0,0.0,0,4,4,0,0,0,0,0,2,0
../kbl_data/2024-2025,S45G01N117,창원 LG,Home,이경도,0,0,0,0.0,0,0,0.0,0,0,0.0,0,0,0.0,0,0,0,0,1,0,0,0,1,1
../kbl_data/2024-2025,S45G01N117,창원 LG,Home,최형찬,0,0,0,0.0,0,0,0.0,0,0,0.0,0,0,0.0,0,0,0,0,0,0,0,0,0,0
../kbl_data/2024-2025,S45G01N117,서울 SK,Away,김선형,6,3,7,42.9,0,3,0.0,3,10,30.0,0,0,0.0,0,1,1,3,0,0,0,0,0,1
../kbl_data/2024-2025,S45G01N117,서울 SK,Away,오세근,6,3,3,100.0,0,3,0.0,3,6,50.0,0,0,0.0,0,1,1,0,0,0,0,0,0,2
../kbl_data/2024-2025,S45G01N117,서울 SK,Away,최부경,8,4,4,100.0,0,1,0.0,4,5,80.0,0,0,0.0,2,1,3,2,0,0,0,0,0,2
../kbl_data/2024-2025,S45G01N117,서울 SK,Away,최원혁,2,1,1,100.0,0,2,0.0,1,3,33.3,0,0,0.0,1,0,1,1,1,0,0,0,1,3
../kbl_data/2024-2025,S45G01N117,서울 SK,Away,장문호,0,0,0,0.0,0,0,0.0,0,0,0.0,0,0,0.0,0,0,0,0,0,0,0,0,0,0
../kbl_data/2024-2025,S45G01N117,서울 SK,Away,안영준,18,7,9,77.8,1,5,20.0,8,14,57.1,1,4,25.0,1,7,8,4,2,0,0,0,3,3
../kbl_data/2024-2025,S45G01N117,서울 SK,Away,자밀 워니,30,12,21,57.1,2,3,66.7,14,24,58.3,0,0,0.0,5,7,12,6,1,1,0,2,1,1
../kbl_data/2024-2025,S45G01N117,서울 SK,Away,김형빈,2,0,0,0.0,0,1,0.0,0,1,0.0,2,2,100.0,1,1,2,0,2,0,0,0,0,0
../kbl_data/2024-2025,S45G01N117,서울 SK,Away,아이재아 힉스,5,1,2,50.0,0,0,0.0,1,2,50.0,3,4,75.0,1,0,1,1,1,0,0,0,1,1
../kbl_data/2024-2025,S45G01N117,서울 SK,Away,박민우,0,0,0,0.0,0,0,0.0,0,0,0.0,0,0,0.0,0,0,0,0,0,0,0,0,0,0
../kbl_data/2024-2025,S45G01N117,서울 SK,Away,고메즈 델 리아노,0,0,1,0.0,0,1,0.0,0,2,0.0,0,0,0.0,0,1,1,0,0,0,0,0,0,1
../kbl_data/2024-2025,S45G01N117,서울 SK,Away,김태훈,0,0,1,0.0,0,1,0.0,0,2,0.0,0,0,0.0,1,1,2,1,0,0,0,0,1,0
../kbl_data/2024-2025,S45G01N118,안양 정관장,Home,송창용,0,0,0,0.0,0,0,0.0,0,0,0.0,0,0,0.0,0,0,0,0,0,0,0,0,0,0
../kbl_data/2024-2025,S45G01N118,안양 정관장,Home,배병준,15,2,5,40.0,2,6,33.3,4,11,36.4,5,5,100.0,0,5,5,2,2,1,1,0,1,3
../kbl_data/2024-2025,S45G01N118,안양 정관장,Home,정효근,3,1,4,25.0,0,2,0.0,1,6,16.7,1,2,50.0,1,4,5,2,0,0,0,0,0,3
../kbl_data/2024-2025,S45G01N118,안양 정관장,Home,이종현,0,0,0,0.0,0,0,0.0,0,0,0.0,0,0,0.0,0,0,0,0,0,0,0,0,0,0
../kbl_data/2024-2025,S45G01N118,안양 정관장,Home,박지훈,18,6,12,50.0,1,3,33.3,7,15,46.7,3,5,60.0,3,4,7,2,2,1,1,0,3,3
../kbl_data/2024-2025,S45G01N118,안양 정관장,Home,최성원,5,1,3,33.3,1,3,33.3,2,6,33.3,0,0,0.0,0,1,1,1,0,0,0,0,2,2
../kbl_data/2024-2025,S45G01N118,안양 정관장,Home,캐디 라렌,7,2,7,28.6,1,3,33.3,3,10,30.0,0,0,0.0,7,10,17,1,0,4,0,0,6,3
../kbl_data/2024-2025,S45G01N118,안양 정관장,Home,한승희,5,2,5,40.0,0,0,0.0,2,5,40.0,1,1,100.0,1,0,1,1,0,0,0,0,2,3
../kbl_data/2024-2025,S45G01N118,안양 정관장,Home,클리프 알렉산더,0,0,0,0.0,0,0,0.0,0,0,0.0,0,0,0.0,0,0,0,0,0,0,0,0,0,0
../kbl_data/2024-2025,S45G01N118,안양 정관장,Home,나성호,0,0,1,0.0,0,0,0.0,0,1,0.0,0,0,0.0,0,0,0,0,0,0,0,0,0,0
../kbl_data/2024-2025,S45G01N118,안양 정관장,Home,하비 고메즈,3,1,4,25.0,0,2,0.0,1,6,16.7,1,2,50.0,0,2,2,1,1,0,0,0,0,1
../kbl_data/2024-2025,S45G01N118,안양 정관장,Home,박정웅,3,0,1,0.0,1,3,33.3,1,4,25.0,0,0,0.0,0,0,0,1,1,0,0,0,2,2
../kbl_data/2024-2025,S45G01N118,고양 소노,Away,홍경기,0,0,0,0.0,0,1,0.0,0,1,0.0,0,0,0.0,0,0,0,0,0,0,0,0,1,0
../kbl_data/2024-2025,S45G01N118,고양 소노,Away,임동섭,6,0,2,0.0,2,7,28.6,2,9,22.2,0,0,0.0,4,7,11,3,0,1,1,0,0,4
../kbl_data/2024-2025,S45G01N118,고양 소노,Away,이재도,15,3,9,33.3,2,4,50.0,5,13,38.5,3,4,75.0,0,4,4,6,3,0,1,0,1,3
../kbl_data/2024-2025,S45G01N118,고양 소노,Away,김영훈,0,0,0,0.0,0,0,0.0,0,0,0.0,0,0,0.0,0,0,0,0,0,0,0,0,0,0
../kbl_data/2024-2025,S45G01N118,고양 소노,Away,최승욱,2,1,3,33.3,0,2,0.0,1,5,20.0,0,0,0.0,1,0,1,0,0,0,0,0,2,1
../kbl_data/2024-2025,S45G01N118,고양 소노,Away,김진유,2,1,1,100.0,0,0,0.0,1,1,100.0,0,0,0.0,1,1,2,0,0,1,0,0,0,2
../kbl_data/2024-2025,S45G01N118,고양 소노,Away,박진철,0,0,0,0.0,0,0,0.0,0,0,0.0,0,0,0.0,0,0,0,0,0,0,0,0,0,0
../kbl_data/2024-2025,S45G01N118,고양 소노,Away,이정현,15,3,9,33.3,1,5,20.0,4,14,28.6,6,6,100.0,0,4,4,5,2,0,1,0,3,1
../kbl_data/2024-2025,S45G01N118,고양 소노,Away,디제이 번즈 Jr,4,2,8,25.0,0,1,0.0,2,9,22.2,0,0,0.0,3,1,4,0,0,0,0,0,0,2
../kbl_data/2024-2025,S45G01N118,고양 소노,Away,이근준,11,2,5,40.0,2,3,66.7,4,8,50.0,1,2,50.0,1,5,6,0,2,0,0,0,1,3
../kbl_data/2024-2025,S45G01N118,고양 소노,Away,서동원,0,0,0,0.0,0,0,0.0,0,0,0.0,0,0,0.0,0,0,0,0,0,0,0,0,0,0
../kbl_data/2024-2025,S45G01N118,고양 소노,Away,알파 카바,7,3,7,42.9,0,0,0.0,3,7,42.9,1,2,50.0,3,4,7,3,1,2,0,0,3,5
../kbl_data/2024-2025,S45G01N119,서울 삼성,Home,이정현,10,2,3,66.7,2,6,33.3,4,9,44.4,0,0,0.0,0,5,5,6,1,0,0,0,4,2
../kbl_data/2024-2025,S45G01N119,서울 삼성,Home,최현민,9,1,3,33.3,2,5,40.0,3,8,37.5,1,2,50.0,1,2,3,0,0,0,0,0,0,3
../kbl_data/2024-2025,S45G01N119,서울 삼성,Home,이원대,1,0,1,0.0,0,2,0.0,0,3,0.0,1,1,100.0,0,1,1,2,0,0,0,0,0,2
../kbl_data/2024-2025,S45G01N119,서울 삼성,Home,최성모,12,2,5,40.0,2,6,33.3,4,11,36.4,2,2,100.0,1,1,2,5,2,1,0,0,3,2
../kbl_data/2024-2025,S45G01N119,서울 삼성,Home,최승욱,0,0,2,0.0,0,1,0.0,0,3,0.0,0,0,0.0,1,1,2,2,2,0,0,0,0,1
../kbl_data/2024-2025,S45G01N119,서울 삼성,Home,윤성원,3,0,0,0.0,1,1,100.0,1,1,100.0,0,0,0.0,0,2,2,0,0,0,0,0,0,2
../kbl_data/2024-2025,S45G01N119,서울 삼성,Home,차민석,0,0,0,0.0,0,0,0.0,0,0,0.0,0,0,0.0,0,0,0,0,0,0,0,0,0,0
../kbl_data/2024-2025,S45G01N119,서울 삼성,Home,이원석,14,5,7,71.4,0,1,0.0,5,8,62.5,4,5,80.0,1,3,4,1,0,0,0,0,1,3
../kbl_data/2024-2025,S45G01N119,서울 삼성,Home,저스틴 구탕,5,1,8,12.5,1,2,50.0,2,10,20.0,0,0,0.0,1,10,11,3,3,0,0,0,3,4
../kbl_data/2024-2025,S45G01N119,서울 삼성,Home,박승재,0,0,0,0.0,0,0,0.0,0,0,0.0,0,0,0.0,0,1,1,3,0,0,0,0,1,0
../kbl_data/2024-2025,S45G01N119,서울 삼성,Home,코피 코번,25,10,19,52.6,0,0,0.0,10,19,52.6,5,9,55.6,8,8,16,1,0,1,0,1,3,1
../kbl_data/2024-2025,S45G01N119,서울 삼성,Home,임동언,0,0,0,0.0,0,0,0.0,0,0,0.0,0,0,0.0,0,0,0,0,0,0,0,0,0,0
../kbl_data/2024-2025,S45G01N119,원주 DB,Away,이관희,21,5,6,83.3,3,8,37.5,8,14,57.1,2,2,100.0,0,1,1,1,0,0,0,0,1,1
../kbl_data/2024-2025,S45G01N119,원주 DB,Away,김시래,6,1,2,50.0,1,4,25.0,2,6,33.3,1,3,33.3,0,2,2,0,2,0,0,0,0,2
../kbl_data/2024-2025,S45G01N119,원주 DB,Away,서민수,5,1,1,100.0,1,5,20.0,2,6,33.3,0,0,0.0,1,8,9,0,0,4,1,0,0,4
../kbl_data/2024-2025,S45G01N119,원주 DB,Away,박봉진,2,1,2,50.0,0,1,0.0,1,3,33.3,0,0,0.0,3,1,4,1,1,0,0,0,0,4
../kbl_data/2024-2025,S45G01N119,원주 DB,Away,치나누 오누아쿠,16,3,7,42.9,2,3,66.7,5,10,50.0,4,6,66.7,2,9,11,6,1,1,0,1,3,4
../kbl_data/2024-2025,S45G01N119,원주 DB,Away,이윤수,0,0,0,0.0,0,0,0.0,0,0,0.0,0,0,0.0,0,0,0,0,0,0,0,0,0,0
../kbl_data/2024-2025,S45G01N119,원주 DB,Away,이용우,0,0,0,0.0,0,0,0.0,0,0,0.0,0,0,0.0,0,0,0,0,0,0,0,0,0,0
../kbl_data/2024-2025,S45G01N119,원주 DB,Away,정호영,5,2,3,66.7,0,0,0.0,2,3,66.7,1,1,100.0,1,0,1,1,0,0,0,0,1,1
../kbl_data/2024-2025,S45G01N119,원주 DB,Away,이선 알바노,17,3,13,23.1,2,6,33.3,5,19,26.3,5,8,62.5,1,4,5,11,3,0,0,0,4,3
../kbl_data/2024-2025,S45G01N119,원주 DB,Away,박인웅,8,1,2,50.0,2,5,40.0,3,7,42.9,0,0,0.0,0,0,0,1,1,0,0,0,0,1
../kbl_data/2024-2025,S45G01N119,원주 DB,Away,로버트 카터,0,0,0,0.0,0,2,0.0,0,2,0.0,0,0,0.0,0,2,2,3,1,0,0,0,1,1
../kbl_data/2024-2025,S45G01N119,원주 DB,Away,김보배,0,0,0,0.0,0,0,0.0,0,0,0.0,0,0,0.0,0,0,0,0,0,0,0,0,0,0
../kbl_data/2024-2025,S45G01N120,수원 KT,Home,한희원,8,1,2,50.0,2,4,50.0,3,6,50.0,0,0,0.0,0,3,3,0,1,1,0,0,0,2
../kbl_data/2024-2025,S45G01N120,수원 KT,Home,최창진,0,0,0,0.0,0,1,0.0,0,1,0.0,0,0,0.0,2,0,2,1,0,0,0,0,1,2
../kbl_data/2024-2025,S45G01N120,수원 KT,Home,문성곤,0,0,0,0.0,0,1,0.0,0,1,0.0,0,0,0.0,0,0,0,0,0,0,0,0,0,1
../kbl_data/2024-2025,S45G01N120,수원 KT,Home,이현석,0,0,0,0.0,0,1,0.0,0,1,0.0,0,0,0.0,0,0,0,0,1,0,0,0,0,0
../kbl_data/2024-2025,S45G01N120,수원 KT,Home,허훈,6,0,2,0.0,2,5,40.0,2,7,28.6,0,0,0.0,1,3,4,6,0,0,0,0,0,1
../kbl_data/2024-2025,S45G01N120,수원 KT,Home,박준영,2,0,0,0.0,0,2,0.0,0,2,0.0,2,2,100.0,2,0,2,2,0,0,0,0,0,0
../kbl_data/2024-2025,S45G01N120,수원 KT,Home,최진광,2,1,2,50.0,0,1,0.0,1,3,33.3,0,0,0.0,1,0,1,2,0,0,0,0,3,2
../kbl_data/2024-2025,S45G01N120,수원 KT,Home,하윤기,14,6,13,46.2,0,0,0.0,6,13,46.2,2,3,66.7,6,2,8,2,0,0,0,1,2,1
../kbl_data/2024-2025,S45G01N120,수원 KT,Home,문정현,0,0,2,0.0,0,0,0.0,0,2,0.0,0,0,0.0,0,1,1,1,0,0,0,0,1,1
../kbl_data/2024-2025,S45G01N120,수원 KT,Home,레이션 해먼즈,26,8,13,61.5,2,7,28.6,10,20,50.0,4,4,100.0,4,11,15,3,0,0,1,0,2,3
../kbl_data/2024-2025,S45G01N120,수원 KT,Home,박성재,10,2,4,50.0,2,6,33.3,4,10,40.0,0,0,0.0,0,3,3,1,0,0,0,0,0,3
../kbl_data/2024-2025,S45G01N120,수원 KT,Home,이스마엘 로메로,12,3,3,100.0,2,2,100.0,5,5,100.0,0,3,0.0,2,5,7,0,0,0,0,0,1,3
../kbl_data/2024-2025,S45G01N120,안양 정관장,Away,정준원,0,0,0,0.0,0,0,0.0,0,0,0.0,0,0,0.0,0,0,0,0,0,0,0,0,0,0
../kbl_data/2024-2025,S45G01N120,안양 정관장,Away,배병준,0,0,3,0.0,0,1,0.0,0,4,0.0,0,0,0.0,1,2,3,3,1,0,0,0,1,2
../kbl_data/2024-2025,S45G01N120,안양 정관장,Away,정효근,6,0,0,0.0,2,4,50.0,2,4,50.0,0,0,0.0,0,1,1,2,0,0,0,0,0,3
../kbl_data/2024-2025,S45G01N120,안양 정관장,Away,박지훈,16,4,9,44.4,2,4,50.0,6,13,46.2,2,2,100.0,0,4,4,7,3,0,0,0,2,3
../kbl_data/2024-2025,S45G01N120,안양 정관장,Away,최성원,2,1,1,100.0,0,4,0.0,1,5,20.0,0,0,0.0,0,2,2,0,1,0,0,0,1,1
../kbl_data/2024-2025,S45G01N120,안양 정관장,Away,캐디 라렌,18,7,14,50.0,1,4,25.0,8,18,44.4,1,2,50.0,6,10,16,0,1,1,0,1,2,3
../kbl_data/2024-2025,S45G01N120,안양 정관장,Away,김경원,0,0,0,0.0,0,0,0.0,0,0,0.0,0,0,0.0,0,0,0,0,0,0,0,0,0,1
../kbl_data/2024-2025,S45G01N120,안양 정관장,Away,박찬호,0,0,0,0.0,0,0,0.0,0,0,0.0,0,0,0.0,0,0,0,0,0,0,0,0,1,0
../kbl_data/2024-2025,S45G01N120,안양 정관장,Away,한승희,7,2,8,25.0,1,3,33.3,3,11,27.3,0,0,0.0,2,2,4,0,0,1,0,0,0,5
../kbl_data/2024-2025,S45G01N120,안양 정관장,Away,클리프 알렉산더,4,0,0,0.0,1,2,50.0,1,2,50.0,1,2,50.0,0,2,2,1,0,0,0,0,0,0
../kbl_data/2024-2025,S45G01N120,안양 정관장,Away,하비 고메즈,11,1,2,50.0,3,6,50.0,4,8,50.0,0,1,0.0,0,0,0,1,1,0,0,0,1,0
../kbl_data/2024-2025,S45G01N120,안양 정관장,Away,박정웅,0,0,1,0.0,0,0,0.0,0,1,0.0,0,0,0.0,0,0,0,0,0,0,0,0,0,2
../kbl_data/2024-2025,S45G01N121,서울 SK,Home,김선형,14,4,4,100.0,2,4,50.0,6,8,75.0,0,0,0.0,0,0,0,6,0,0,0,0,2,1
../kbl_data/2024-2025,S45G01N121,서울 SK,Home,오세근,9,3,6,50.0,1,4,25.0,4,10,40.0,0,0,0.0,1,0,1,1,2,0,0,0,2,3
../kbl_data/2024-2025,S45G01N121,서울 SK,Home,최부경,0,0,0,0.0,0,0,0.0,0,0,0.0,0,0,0.0,0,1,1,1,0,2,0,0,0,3
../kbl_data/2024-2025,S45G01N121,서울 SK,Home,최원혁,2,1,3,33.3,0,1,0.0,1,4,25.0,0,0,0.0,0,2,2,1,0,1,0,0,1,1
../kbl_data/2024-2025,S45G01N121,서울 SK,Home,장문호,0,0,0,0.0,0,0,0.0,0,0,0.0,0,0,0.0,1,1,2,0,0,0,0,0,0,0
../kbl_data/2024-2025,S45G01N121,서울 SK,Home,안영준,13,4,6,66.7,1,4,25.0,5,10,50.0,2,2,100.0,0,5,5,3,1,0,0,1,1,1
../kbl_data/2024-2025,S45G01N121,서울 SK,Home,자밀 워니,30,7,11,63.6,5,9,55.6,12,20,60.0,1,3,33.3,4,11,15,3,0,1,0,0,0,0
../kbl_data/2024-2025,S45G01N121,서울 SK,Home,아이재아 힉스,0,0,1,0.0,0,0,0.0,0,1,0.0,0,0,0.0,1,0,1,0,0,1,0,0,0,1
../kbl_data/2024-2025,S45G01N121,서울 SK,Home,박민우,0,0,0,0.0,0,0,0.0,0,0,0.0,0,0,0.0,0,0,0,0,0,0,0,0,0,0
../kbl_data/2024-2025,S45G01N121,서울 SK,Home,오재현,6,2,5,40.0,0,2,0.0,2,7,28.6,2,2,100.0,0,2,2,1,0,0,0,0,3,2
../kbl_data/2024-2025,S45G01N121,서울 SK,Home,고메즈 델 리아노,1,0,0,0.0,0,0,0.0,0,0,0.0,1,2,50.0,0,0,0,0,0,0,0,0,1,0
../kbl_data/2024-2025,S45G01N121,서울 SK,Home,김태훈,3,0,0,0.0,1,1,100.0,1,1,100.0,0,0,0.0,1,1,2,0,0,0,0,0,0,2
../kbl_data/2024-2025,S45G01N121,고양 소노,Away,홍경기,0,0,2,0.0,0,1,0.0,0,3,0.0,0,0,0.0,0,0,0,0,0,0,0,0,1,0
../kbl_data/2024-2025,S45G01N121,고양 소노,Away,임동섭,17,1,4,25.0,5,11,45.5,6,15,40.0,0,0,0.0,1,7,8,0,2,0,0,0,1,3
../kbl_data/2024-2025,S45G01N121,고양 소노,Away,이재도,15,3,6,50.0,3,9,33.3,6,15,40.0,0,0,0.0,0,1,1,8,0,0,0,0,1,1
../kbl_data/2024-2025,S45G01N121,고양 소노,Away,김영훈,1,0,0,0.0,0,0,0.0,0,0,0.0,1,2,50.0,0,0,0,0,0,0,0,0,0,0
../kbl_data/2024-2025,S45G01N121,고양 소노,Away,최승욱,8,4,5,80.0,0,1,0.0,4,6,66.7,0,0,0.0,2,2,4,2,2,0,0,0,0,4
../kbl_data/2024-2025,S45G01N121,고양 소노,Away,박진철,3,1,2,50.0,0,0,0.0,1,2,50.0,1,2,50.0,2,1,3,0,1,0,0,0,0,3
../kbl_data/2024-2025,S45G01N121,고양 소노,Away,박종하,5,1,4,25.0,1,4,25.0,2,8,25.0,0,0,0.0,0,2,2,0,3,0,0,0,3,2
../kbl_data/2024-2025,S45G01N121,고양 소노,Away,민기남,5,1,2,50.0,1,2,50.0,2,4,50.0,0,0,0.0,1,1,2,2,0,0,0,0,0,0
../kbl_data/2024-2025,S45G01N121,고양 소노,Away,디제이 번즈 Jr,14,7,11,63.6,0,0,0.0,7,11,63.6,0,0,0.0,1,4,5,6,0,1,0,0,1,2
../kbl_data/2024-2025,S45G01N121,고양 소노,Away,서동원,0,0,0,0.0,0,0,0.0,0,0,0.0,0,0,0.0,0,0,0,0,0,0,0,0,0,0
../kbl_data/2024-2025,S45G01N121,고양 소노,Away,정성조,0,0,0,0.0,0,0,0.0,0,0,0.0,0,0,0.0,0,0,0,0,0,0,0,0,0,0
../kbl_data/2024-2025,S45G01N121,고양 소노,Away,알파 카바,2,1,3,33.3,0,0,0.0,1,3,33.3,0,0,0.0,3,1,4,0,0,0,0,1,0,1
../kbl_data/2024-2025,S45G01N122,울산 현대모비스,Home,장재석,0,0,3,0.0,0,0,0.0,0,3,0.0,0,2,0.0,2,2,4,1,0,0,0,0,1,1
../kbl_data/2024-2025,S45G01N122,울산 현대모비스,Home,한호빈,5,0,0,0.0,1,3,33.3,1,3,33.3,2,4,50.0,1,2,3,3,0,0,0,0,0,2
../kbl_data/2024-2025,S45G01N122,울산 현대모비스,Home,김준일,0,0,2,0.0,0,0,0.0,0,2,0.0,0,0,0.0,0,3,3,1,0,0,0,0,1,3
../kbl_data/2024-2025,S45G01N122,울산 현대모비스,Home,김국찬,4,1,3,33.3,0,2,0.0,1,5,20.0,2,2,100.0,2,5,7,2,1,0,0,0,0,2
../kbl_data/2024-2025,S45G01N122,울산 현대모비스,Home,조한진,0,0,0,0.0,0,1,0.0,0,1,0.0,0,0,0.0,0,0,0,0,0,0,0,0,0,0
../kbl_data/2024-2025,S45G01N122,울산 현대모비스,Home,숀 롱,15,6,8,75.0,0,0,0.0,6,8,75.0,3,3,100.0,6,4,10,2,0,0,0,3,2,1
../kbl_data/2024-2025,S45G01N122,울산 현대모비스,Home,이우석,16,2,6,33.3,4,9,44.4,6,15,40.0,0,0,0.0,0,4,4,6,0,0,1,0,3,1
../kbl_data/2024-2025,S45G01N122,울산 현대모비스,Home,이승우,2,1,2,50.0,0,0,0.0,1,2,50.0,0,0,0.0,0,2,2,0,0,1,0,0,0,0
../kbl_data/2024-2025,S45G01N122,울산 현대모비스,Home,신민석,2,1,3,33.3,0,1,0.0,1,4,25.0,0,0,0.0,2,3,5,0,1,0,0,0,0,2
../kbl_data/2024-2025,S45G01N122,울산 현대모비스,Home,게이지 프림,24,7,10,70.0,1,2,50.0,8,12,66.7,7,7,100.0,5,5,10,4,0,0,0,0,1,0
../kbl_data/2024-2025,S45G01N122,울산 현대모비스,Home,박무빈,10,5,8,62.5,0,2,0.0,5,10,50.0,0,0,0.0,1,2,3,2,1,0,0,0,1,3
../kbl_data/2024-2025,S45G01N122,울산 현대모비스,Home,미구엘 안드레 옥존,7,0,2,0.0,1,2,50.0,1,4,25.0,4,4,100.0,0,2,2,0,1,0,0,0,1,2
../kbl_data/2024-2025,S45G01N122,창원 LG,Away,허일영,5,1,3,33.3,0,1,0.0,1,4,25.0,3,3,100.0,0,0,0,1,1,0,1,0,0,4
../kbl_data/2024-2025,S45G01N122,창원 LG,Away,최진수,5,0,1,0.0,1,4,25.0,1,5,20.0,2,2,100.0,2,4,6,1,0,0,0,0,1,4
../kbl_data/2024-2025,S45G01N122,창원 LG,Away,장민국,0,0,0,0.0,0,4,0.0,0,4,0.0,0,0,0.0,0,0,0,0,0,0,0,0,0,1
../kbl_data/2024-2025,S45G01N122,창원 LG,Away,한상혁,0,0,1,0.0,0,1,0.0,0,2,0.0,0,0,0.0,0,0,0,0,0,0,0,0,0,1
../kbl_data/2024-2025,S45G01N122,창원 LG,Away,전성현,18,1,3,33.3,5,10,50.0,6,13,46.2,1,1,100.0,0,0,0,3,0,0,0,0,0,1
../kbl_data/2024-2025,S45G01N122,창원 LG,Away,정인덕,0,0,1,0.0,0,2,0.0,0,3,0.0,0,0,0.0,1,1,2,1,0,0,0,0,0,1
../kbl_data/2024-2025,S45G01N122,창원 LG,Away,대릴 먼로,15,2,5,40.0,3,3,100.0,5,8,62.5,2,2,100.0,0,4,4,2,2,0,1,0,0,3
../kbl_data/2024-2025,S45G01N122,창원 LG,Away,박정현,8,4,9,44.4,0,1,0.0,4,10,40.0,0,0,0.0,0,0,0,1,0,1,0,0,1,5
../kbl_data/2024-2025,S45G01N122,창원 LG,Away,양준석,8,4,7,57.1,0,2,0.0,4,9,44.4,0,0,0.0,0,2,2,3,0,0,1,0,0,3
../kbl_data/2024-2025,S45G01N122,창원 LG,Away,유기상,3,0,2,0.0,1,6,16.7,1,8,12.5,0,0,0.0,1,4,5,1,0,0,1,0,2,2
../kbl_data/2024-2025,S45G01N122,창원 LG,Away,이경도,2,0,0,0.0,0,2,0.0,0,2,0.0,2,2,100.0,2,2,4,2,0,1,0,0,2,0
../kbl_data/2024-2025,S45G01N122,창원 LG,Away,최형찬,0,0,0,0.0,0,1,0.0,0,1,0.0,0,0,0.0,0,1,1,0,0,0,0,0,0,1
../kbl_data/2024-2025,S45G01N123,서울 삼성,Home,이정현,21,7,7,100.0,1,6,16.7,8,13,61.5,4,6,66.7,0,2,2,4,1,1,0,0,3,3
../kbl_data/2024-2025,S45G01N123,서울 삼성,Home,최현민,4,0,0,0.0,1,2,50.0,1,2,50.0,1,2,50.0,0,5,5,1,1,0,0,0,1,1
../kbl_data/2024-2025,S45G01N123,서울 삼성,Home,이원대,4,0,0,0.0,1,2,50.0,1,2,50.0,1,2,50.0,0,1,1,0,0,0,0,0,1,1
../kbl_data/2024-2025,S45G01N123,서울 삼성,Home,최성모,2,1,1,100.0,0,4,0.0,1,5,20.0,0,0,0.0,0,1,1,1,0,0,0,0,0,2
../kbl_data/2024-2025,S45G01N123,서울 삼성,Home,최승욱,5,2,2,100.0,0,2,0.0,2,4,50.0,1,2,50.0,0,0,0,0,0,0,0,0,0,2
../kbl_data/2024-2025,S45G01N123,서울 삼성,Home,윤성원,3,0,0,0.0,1,1,100.0,1,1,100.0,0,0,0.0,0,1,1,0,1,0,0,0,0,0
../kbl_data/2024-2025,S45G01N123,서울 삼성,Home,이원석,8,2,6,33.3,0,0,0.0,2,6,33.3,4,4,100.0,2,1,3,2,1,0,0,1,2,3
../kbl_data/2024-2025,S45G01N123,서울 삼성,Home,저스틴 구탕,12,3,4,75.0,1,3,33.3,4,7,57.1,3,4,75.0,0,0,0,3,1,0,0,0,2,2
../kbl_data/2024-2025,S45G01N123,서울 삼성,Home,박승재,5,2,2,100.0,0,2,0.0,2,4,50.0,1,1,100.0,0,1,1,3,1,0,0,0,2,0
../kbl_data/2024-2025,S45G01N123,서울 삼성,Home,코피 코번,9,3,10,30.0,0,0,0.0,3,10,30.0,3,4,75.0,3,6,9,0,0,0,0,2,3,4
../kbl_data/2024-2025,S45G01N123,서울 삼성,Home,임동언,0,0,0,0.0,0,0,0.0,0,0,0.0,0,0,0.0,0,0,0,0,0,0,0,0,0,0
../kbl_data/2024-2025,S45G01N123,서울 삼성,Home,황영찬,4,2,2,100.0,0,2,0.0,2,4,50.0,0,0,0.0,0,0,0,1,0,0,0,0,0,1
../kbl_data/2024-2025,S45G01N123,대구 한국가스공사,Away,차바위,6,0,3,0.0,2,3,66.7,2,6,33.3,0,0,0.0,3,2,5,5,2,0,0,0,1,3
../kbl_data/2024-2025,S45G01N123,대구 한국가스공사,Away,박지훈,2,1,1,100.0,0,0,0.0,1,1,100.0,0,0,0.0,1,1,2,0,0,0,0,0,0,0
../kbl_data/2024-2025,S45G01N123,대구 한국가스공사,Away,이대헌,4,2,4,50.0,0,1,0.0,2,5,40.0,0,0,0.0,2,0,2,0,0,0,0,0,0,3
../kbl_data/2024-2025,S45G01N123,대구 한국가스공사,Away,김낙현,11,3,5,60.0,1,4,25.0,4,9,44.4,2,3,66.7,1,3,4,6,1,0,0,0,3,2
../kbl_data/2024-2025,S45G01N123,대구 한국가스공사,Away,전현우,4,2,2,100.0,0,3,0.0,2,5,40.0,0,0,0.0,1,2,3,1,1,0,0,0,0,1
../kbl_data/2024-2025,S45G01N123,대구 한국가스공사,Away,양재혁,0,0,0,0.0,0,1,0.0,0,1,0.0,0,0,0.0,0,0,0,2,0,0,0,0,0,1
../kbl_data/2024-2025,S45G01N123,대구 한국가스공사,Away,곽정훈,0,0,0,0.0,0,3,0.0,0,3,0.0,0,0,0.0,0,1,1,0,0,0,0,0,0,2
../kbl_data/2024-2025,S45G01N123,대구 한국가스공사,Away,앤드류 니콜슨,22,2,4,50.0,4,5,80.0,6,9,66.7,6,6,100.0,1,3,4,2,2,0,1,0,0,1
../kbl_data/2024-2025,S45G01N123,대구 한국가스공사,Away,신승민,8,1,4,25.0,2,5,40.0,3,9,33.3,0,0,0.0,0,1,1,3,2,0,0,0,3,3
../kbl_data/2024-2025,S45G01N123,대구 한국가스공사,Away,샘조세프 벨란겔,36,6,7,85.7,6,10,60.0,12,17,70.6,6,7,85.7,0,3,3,8,3,0,0,0,1,2
../kbl_data/2024-2025,S45G01N123,대구 한국가스공사,Away,유슈 은도예,18,8,10,80.0,0,1,0.0,8,11,72.7,2,2,100.0,3,9,12,0,1,0,0,3,0,3
../kbl_data/2024-2025,S45G01N123,대구 한국가스공사,Away,신주영,3,0,0,0.0,1,1,100.0,1,1,100.0,0,0,0.0,0,0,0,1,0,0,0,0,1,3
../kbl_data/2024-2025,S45G01N124,부산 KCC,Home,리온 윌리엄스,6,3,4,75.0,0,1,0.0,3,5,60.0,0,0,0.0,2,2,4,0,0,0,0,0,2,3
../kbl_data/2024-2025,S45G01N124,부산 KCC,Home,전준범,12,0,0,0.0,4,5,80.0,4,5,80.0,0,0,0.0,0,3,3,2,0,0,1,0,0,2
../kbl_data/2024-2025,S45G01N124,부산 KCC,Home,허웅,7,0,0,0.0,1,4,25.0,1,4,25.0,4,4,100.0,0,2,2,3,3,0,0,0,1,2
../kbl_data/2024-2025,S45G01N124,부산 KCC,Home,이승현,20,10,13,76.9,0,0,0.0,10,13,76.9,0,0,0.0,1,2,3,2,0,1,0,0,1,1
../kbl_data/2024-2025,S45G01N124,부산 KCC,Home,이호현,8,3,4,75.0,0,1,0.0,3,5,60.0,2,2,100.0,0,2,2,4,1,0,0,0,1,1
../kbl_data/2024-2025,S45G01N124,부산 KCC,Home,디온테 버튼,26,9,17,52.9,2,7,28.6,11,24,45.8,2,2,100.0,3,6,9,2,3,1,0,2,4,3
../kbl_data/2024-2025,S45G01N124,부산 KCC,Home,이근휘,3,0,0,0.0,1,4,25.0,1,4,25.0,0,0,0.0,0,0,0,4,0,0,0,0,1,0
../kbl_data/2024-2025,S45G01N124,부산 KCC,Home,김동현,0,0,0,0.0,0,0,0.0,0,0,0.0,0,0,0.0,0,1,1,0,0,0,0,0,0,2
../kbl_data/2024-2025,S45G01N124,부산 KCC,Home,여준형,2,1,2,50.0,0,0,0.0,1,2,50.0,0,0,0.0,0,2,2,0,0,0,0,0,0,1
../kbl_data/2024-2025,S45G01N124,부산 KCC,Home,캘빈 제프리 에피스톨라,2,1,2,50.0,0,2,0.0,1,4,25.0,0,0,0.0,1,0,1,1,0,0,0,0,1,3
../kbl_data/2024-2025,S45G01N124,부산 KCC,Home,이주영,0,0,0,0.0,0,0,0.0,0,0,0.0,0,0,0.0,0,0,0,0,0,0,0,0,0,0
../kbl_data/2024-2025,S45G01N124,부산 KCC,Home,이찬영,0,0,0,0.0,0,0,0.0,0,0,0.0,0,0,0.0,0,0,0,0,0,0,0,0,0,0
../kbl_data/2024-2025,S45G01N124,원주 DB,Away,이관희,14,4,7,57.1,2,3,66.7,6,10,60.0,0,0,0.0,0,1,1,0,0,0,0,0,2,1
../kbl_data/2024-2025,S45G01N124,원주 DB,Away,김시래,3,1,2,50.0,0,0,0.0,1,2,50.0,1,2,50.0,0,0,0,1,0,0,1,0,0,1
../kbl_data/2024-2025,S45G01N124,원주 DB,Away,서민수,0,0,0,0.0,0,3,0.0,0,3,0.0,0,0,0.0,1,3,4,0,0,0,0,0,0,2
../kbl_data/2024-2025,S45G01N124,원주 DB,Away,박봉진,2,1,1,100.0,0,1,0.0,1,2,50.0,0,0,0.0,1,2,3,0,0,0,0,0,0,2
../kbl_data/2024-2025,S45G01N124,원주 DB,Away,치나누 오누아쿠,23,5,7,71.4,4,7,57.1,9,14,64.3,1,1,100.0,4,6,10,4,1,0,0,2,6,2
../kbl_data/2024-2025,S45G01N124,원주 DB,Away,이용우,0,0,0,0.0,0,1,0.0,0,1,0.0,0,0,0.0,0,0,0,1,0,0,0,0,0,0
../kbl_data/2024-2025,S45G01N124,원주 DB,Away,정호영,11,4,6,66.7,1,1,100.0,5,7,71.4,0,1,0.0,3,1,4,0,1,0,0,0,1,2
../kbl_data/2024-2025,S45G01N124,원주 DB,Away,이선 알바노,26,6,8,75.0,4,8,50.0,10,16,62.5,2,2,100.0,0,5,5,12,3,0,0,0,2,2
../kbl_data/2024-2025,S45G01N124,원주 DB,Away,박인웅,7,1,2,50.0,1,6,16.7,2,8,25.0,2,2,100.0,2,0,2,2,0,0,0,0,0,5
../kbl_data/2024-2025,S45G01N124,원주 DB,Away,로버트 카터,2,1,2,50.0,0,2,0.0,1,4,25.0,0,0,0.0,0,2,2,0,0,0,0,0,0,1
../kbl_data/2024-2025,S45G01N124,원주 DB,Away,김보배,0,0,0,0.0,0,0,0.0,0,0,0.0,0,0,0.0,0,0,0,0,0,0,0,0,0,0
../kbl_data/2024-2025,S45G01N124,원주 DB,Away,백승엽,0,0,0,0.0,0,0,0.0,0,0,0.0,0,0,0.0,0,0,0,0,0,0,0,0,0,0
../kbl_data/2024-2025,S45G01N125,창원 LG,Home,허일영,7,1,4,25.0,1,2,50.0,2,6,33.3,2,2,100.0,1,2,3,0,0,0,0,0,0,2
../kbl_data/2024-2025,S45G01N125,창원 LG,Home,최진수,0,0,1,0.0,0,0,0.0,0,1,0.0,0,0,0.0,0,0,0,0,0,0,0,0,0,1
../kbl_data/2024-2025,S45G01N125,창원 LG,Home,장민국,3,0,0,0.0,1,2,50.0,1,2,50.0,0,0,0.0,0,1,1,0,0,0,0,0,0,0
../kbl_data/2024-2025,S45G01N125,창원 LG,Home,한상혁,0,0,1,0.0,0,0,0.0,0,1,0.0,0,0,0.0,0,0,0,0,0,0,0,0,1,1
../kbl_data/2024-2025,S45G01N125,창원 LG,Home,전성현,3,0,0,0.0,1,2,50.0,1,2,50.0,0,0,0.0,0,1,1,0,1,0,0,0,1,0
../kbl_data/2024-2025,S45G01N125,창원 LG,Home,정인덕,5,1,1,100.0,1,2,50.0,2,3,66.7,0,0,0.0,0,1,1,1,0,0,0,0,0,1
../kbl_data/2024-2025,S45G01N125,창원 LG,Home,대릴 먼로,10,5,10,50.0,0,1,0.0,5,11,45.5,0,2,0.0,1,11,12,7,0,0,0,0,0,4
../kbl_data/2024-2025,S45G01N125,창원 LG,Home,박정현,0,0,2,0.0,0,1,0.0,0,3,0.0,0,0,0.0,4,0,4,0,1,0,0,0,0,0
../kbl_data/2024-2025,S45G01N125,창원 LG,Home,양준석,9,3,6,50.0,1,3,33.3,4,9,44.4,0,0,0.0,2,0,2,7,1,0,0,0,1,4
../kbl_data/2024-2025,S45G01N125,창원 LG,Home,유기상,13,1,4,25.0,3,6,50.0,4,10,40.0,2,3,66.7,0,3,3,3,1,1,0,0,0,2
../kbl_data/2024-2025,S45G01N125,창원 LG,Home,이경도,0,0,1,0.0,0,0,0.0,0,1,0.0,0,0,0.0,1,1,2,3,0,0,0,0,1,1
../kbl_data/2024-2025,S45G01N125,창원 LG,Home,칼 타마요,17,6,15,40.0,0,3,0.0,6,18,33.3,5,8,62.5,3,4,7,3,0,0,0,0,1,4
../kbl_data/2024-2025,S45G01N125,고양 소노,Away,홍경기,0,0,0,0.0,0,0,0.0,0,0,0.0,0,0,0.0,0,0,0,0,0,0,0,0,0,0
../kbl_data/2024-2025,S45G01N125,고양 소노,Away,임동섭,9,3,4,75.0,1,4,25.0,4,8,50.0,0,0,0.0,0,6,6,1,0,1,0,0,1,2
../kbl_data/2024-2025,S45G01N125,고양 소노,Away,이재도,7,2,4,50.0,1,4,25.0,3,8,37.5,0,0,0.0,0,1,1,5,0,0,0,0,1,1
../kbl_data/2024-2025,S45G01N125,고양 소노,Away,김영훈,0,0,0,0.0,0,2,0.0,0,2,0.0,0,0,0.0,0,1,1,0,0,0,0,0,1,3
../kbl_data/2024-2025,S45G01N125,고양 소노,Away,박진철,9,3,9,33.3,0,0,0.0,3,9,33.3,3,4,75.0,4,9,13,1,1,1,0,0,1,2
../kbl_data/2024-2025,S45G01N125,고양 소노,Away,백지웅,0,0,0,0.0,0,0,0.0,0,0,0.0,0,0,0.0,0,0,0,0,0,0,0,0,0,0
../kbl_data/2024-2025,S45G01N125,고양 소노,Away,박종하,0,0,1,0.0,0,2,0.0,0,3,0.0,0,0,0.0,0,0,0,2,0,0,0,0,0,1
../kbl_data/2024-2025,S45G01N125,고양 소노,Away,민기남,10,1,2,50.0,2,4,50.0,3,6,50.0,2,2,100.0,0,1,1,2,1,0,1,0,1,0
../kbl_data/2024-2025,S45G01N125,고양 소노,Away,디제이 번즈 Jr,18,9,16,56.2,0,0,0.0,9,16,56.2,0,0,0.0,1,4,5,1,0,0,0,0,5,4
../kbl_data/2024-2025,S45G01N125,고양 소노,Away,서동원,3,0,0,0.0,1,1,100.0,1,1,100.0,0,0,0.0,1,0,1,0,0,0,0,0,0,3
../kbl_data/2024-2025,S45G01N125,고양 소노,Away,정성조,2,0,0,0.0,0,2,0.0,0,2,0.0,2,2,100.0,1,3,4,2,1,2,0,0,0,2
../kbl_data/2024-2025,S45G01N125,고양 소노,Away,알파 카바,6,3,5,60.0,0,0,0.0,3,5,60.0,0,2,0.0,2,5,7,0,0,0,0,0,0,2
../kbl_data/2024-2025,S45G01N126,서울 SK,Home,김선형,15,5,8,62.5,1,8,12.5,6,16,37.5,2,2,100.0,2,2,4,4,0,0,0,0,1,3
../kbl_data/2024-2025,S45G01N126,서울 SK,Home,오세근,3,0,2,0.0,1,3,33.3,1,5,20.0,0,0,0.0,1,2,3,1,0,0,1,0,0,4
../kbl_data/2024-2025,S45G01N126,서울 SK,Home,최부경,1,0,1,0.0,0,0,0.0,0,1,0.0,1,1,100.0,1,2,3,2,2,0,0,0,1,3
../kbl_data/2024-2025,S45G01N126,서울 SK,Home,최원혁,3,0,0,0.0,1,3,33.3,1,3,33.3,0,0,0.0,3,1,4,2,1,1,0,0,2,3
../kbl_data/2024-2025,S45G01N126,서울 SK,Home,장문호,3,0,0,0.0,1,1,100.0,1,1,100.0,0,0,0.0,0,2,2,0,0,0,0,0,0,0
../kbl_data/2024-2025,S45G01N126,서울 SK,Home,안영준,12,3,5,60.0,1,4,25.0,4,9,44.4,3,8,37.5,1,1,2,0,1,0,0,0,0,2
../kbl_data/2024-2025,S45G01N126,서울 SK,Home,자밀 워니,25,8,20,40.0,2,11,18.2,10,31,32.3,3,6,50.0,6,12,18,3,0,2,0,1,2,1
../kbl_data/2024-2025,S45G01N126,서울 SK,Home,전성환,0,0,0,0.0,0,0,0.0,0,0,0.0,0,0,0.0,0,0,0,0,0,0,0,0,0,0
../kbl_data/2024-2025,S45G01N126,서울 SK,Home,아이재아 힉스,2,1,2,50.0,0,0,0.0,1,2,50.0,0,0,0.0,0,0,0,0,1,0,0,1,0,1
../kbl_data/2024-2025,S45G01N126,서울 SK,Home,박민우,0,0,0,0.0,0,0,0.0,0,0,0.0,0,0,0.0,0,0,0,0,0,0,0,0,0,0
../kbl_data/2024-2025,S45G01N126,서울 SK,Home,고메즈 델 리아노,2,1,2,50.0,0,0,0.0,1,2,50.0,0,0,0.0,1,0,1,1,1,0,0,0,0,1
../kbl_data/2024-2025,S45G01N126,서울 SK,Home,김태훈,1,0,0,0.0,0,2,0.0,0,2,0.0,1,2,50.0,1,0,1,0,0,0,0,0,0,1
../kbl_data/2024-2025,S45G01N126,수원 KT,Away,한희원,0,0,1,0.0,0,2,0.0,0,3,0.0,0,0,0.0,1,1,2,1,0,0,0,0,0,5
../kbl_data/2024-2025,S45G01N126,수원 KT,Away,최창진,0,0,0,0.0,0,0,0.0,0,0,0.0,0,0,0.0,1,0,1,1,0,0,0,0,0,0
../kbl_data/2024-2025,S45G01N126,수원 KT,Away,문성곤,0,0,0,0.0,0,0,0.0,0,0,0.0,0,0,0.0,0,0,0,0,1,1,0,0,0,0
../kbl_data/2024-2025,S45G01N126,수원 KT,Away,이현석,3,0,0,0.0,1,3,33.3,1,3,33.3,0,0,0.0,1,1,2,0,0,0,0,0,0,2
../kbl_data/2024-2025,S45G01N126,수원 KT,Away,허훈,10,2,7,28.6,2,7,28.6,4,14,28.6,0,0,0.0,1,0,1,9,0,0,0,0,3,1
../kbl_data/2024-2025,S45G01N126,수원 KT,Away,박준영,12,1,5,20.0,2,2,100.0,3,7,42.9,4,4,100.0,3,4,7,4,0,0,0,0,1,0
../kbl_data/2024-2025,S45G01N126,수원 KT,Away,최진광,0,0,0,0.0,0,0,0.0,0,0,0.0,0,0,0.0,0,0,0,0,0,0,0,0,1,1
../kbl_data/2024-2025,S45G01N126,수원 KT,Away,하윤기,6,2,7,28.6,0,0,0.0,2,7,28.6,2,2,100.0,1,1,2,0,0,0,0,0,1,1
../kbl_data/2024-2025,S45G01N126,수원 KT,Away,문정현,6,2,3,66.7,0,2,0.0,2,5,40.0,2,2,100.0,0,8,8,0,1,0,0,0,0,2
../kbl_data/2024-2025,S45G01N126,수원 KT,Away,레이션 해먼즈,21,7,10,70.0,1,6,16.7,8,16,50.0,4,4,100.0,0,8,8,0,0,0,0,0,3,4
../kbl_data/2024-2025,S45G01N126,수원 KT,Away,박성재,0,0,1,0.0,0,4,0.0,0,5,0.0,0,0,0.0,1,3,4,2,2,0,0,0,1,1
../kbl_data/2024-2025,S45G01N126,수원 KT,Away,이스마엘 로메로,5,2,4,50.0,0,1,0.0,2,5,40.0,1,2,50.0,0,4,4,0,1,0,0,0,0,2
../kbl_data/2024-2025,S45G01N127,안양 정관장,Home,송창용,2,1,1,100.0,0,1,0.0,1,2,50.0,0,0,0.0,0,1,1,0,1,0,0,0,0,1
../kbl_data/2024-2025,S45G01N127,안양 정관장,Home,배병준,18,2,5,40.0,4,6,66.7,6,11,54.5,2,2,100.0,0,4,4,3,0,0,0,0,1,1
../kbl_data/2024-2025,S45G01N127,안양 정관장,Home,정효근,6,3,7,42.9,0,4,0.0,3,11,27.3,0,0,0.0,0,4,4,5,0,1,0,0,1,5
../kbl_data/2024-2025,S45G01N127,안양 정관장,Home,이종현,1,0,0,0.0,0,1,0.0,0,1,0.0,1,2,50.0,1,4,5,3,0,0,0,0,0,2
../kbl_data/2024-2025,S45G01N127,안양 정관장,Home,박지훈,46,12,28,42.9,4,6,66.7,16,34,47.1,10,12,83.3,2,4,6,8,6,2,0,0,4,6
../kbl_data/2024-2025,S45G01N127,안양 정관장,Home,최성원,2,1,3,33.3,0,2,0.0,1,5,20.0,0,0,0.0,0,0,0,4,1,0,0,0,0,0
../kbl_data/2024-2025,S45G01N127,안양 정관장,Home,캐디 라렌,10,5,9,55.6,0,1,0.0,5,10,50.0,0,0,0.0,3,5,8,0,0,0,0,2,0,3
../kbl_data/2024-2025,S45G01N127,안양 정관장,Home,김경원,0,0,0,0.0,0,0,0.0,0,0,0.0,0,0,0.0,0,0,0,0,0,0,0,0,0,0
../kbl_data/2024-2025,S45G01N127,안양 정관장,Home,한승희,12,5,11,45.5,0,1,0.0,5,12,41.7,2,3,66.7,2,0,2,1,2,0,0,0,2,3
../kbl_data/2024-2025,S45G01N127,안양 정관장,Home,클리프 알렉산더,3,0,0,0.0,1,1,100.0,1,1,100.0,0,0,0.0,0,2,2,0,0,0,0,0,1,2
../kbl_data/2024-2025,S45G01N127,안양 정관장,Home,하비 고메즈,0,0,0,0.0,0,0,0.0,0,0,0.0,0,0,0.0,0,0,0,0,0,0,0,0,0,1
../kbl_data/2024-2025,S45G01N127,안양 정관장,Home,박정웅,0,0,0,0.0,0,0,0.0,0,0,0.0,0,0,0.0,0,0,0,0,0,0,0,0,0,0
../kbl_data/2024-2025,S45G01N127,대구 한국가스공사,Away,차바위,0,0,1,0.0,0,3,0.0,0,4,0.0,0,0,0.0,0,1,1,5,0,0,0,0,1,4
../kbl_data/2024-2025,S45G01N127,대구 한국가스공사,Away,박지훈,46,12,28,42.9,4,6,66.7,16,34,47.1,10,12,83.3,2,4,6,8,6,2,0,0,4,6
../kbl_data/2024-2025,S45G01N127,대구 한국가스공사,Away,이대헌,16,6,6,100.0,0,1,0.0,6,7,85.7,4,4,100.0,2,3,5,0,1,0,1,0,2,1
../kbl_data/2024-2025,S45G01N127,대구 한국가스공사,Away,정성우,6,1,1,100.0,1,2,50.0,2,3,66.7,1,2,50.0,0,1,1,6,0,0,0,0,3,2
../kbl_data/2024-2025,S45G01N127,대구 한국가스공사,Away,김낙현,0,0,0,0.0,0,1,0.0,0,1,0.0,0,0,0.0,0,1,1,0,0,0,0,0,1,1
../kbl_data/2024-2025,S45G01N127,대구 한국가스공사,Away,전현우,10,2,4,50.0,2,2,100.0,4,6,66.7,0,1,0.0,0,2,2,0,0,1,0,0,1,1
../kbl_data/2024-2025,S45G01N127,대구 한국가스공사,Away,양재혁,0,0,0,0.0,0,1,0.0,0,1,0.0,0,0,0.0,0,0,0,0,0,0,0,0,0,0
../kbl_data/2024-2025,S45G01N127,대구 한국가스공사,Away,곽정훈,3,0,0,0.0,1,2,50.0,1,2,50.0,0,0,0.0,0,0,0,0,0,0,0,0,0,2
../kbl_data/2024-2025,S45G01N127,대구 한국가스공사,Away,신승민,17,3,4,75.0,3,6,50.0,6,10,60.0,2,2,100.0,0,3,3,4,0,1,0,0,2,3
../kbl_data/2024-2025,S45G01N127,대구 한국가스공사,Away,샘조세프 벨란겔,11,4,6,66.7,1,8,12.5,5,14,35.7,0,0,0.0,1,2,3,7,2,0,1,0,2,3
../kbl_data/2024-2025,S45G01N127,대구 한국가스공사,Away,유슈 은도예,21,9,13,69.2,0,0,0.0,9,13,69.2,3,6,50.0,4,15,19,2,0,1,0,2,0,1
../kbl_data/2024-2025,S45G01N127,대구 한국가스공사,Away,신주영,0,0,0,0.0,0,0,0.0,0,0,0.0,0,0,0.0,0,0,0,0,0,0,0,0,0,0
../kbl_data/2024-2025,S45G01N128,서울 삼성,Home,이정현,11,4,7,57.1,1,6,16.7,5,13,38.5,0,0,0.0,1,3,4,4,1,0,0,0,5,3
../kbl_data/2024-2025,S45G01N128,서울 삼성,Home,최현민,16,0,1,0.0,5,7,71.4,5,8,62.5,1,2,50.0,0,2,2,0,0,0,0,0,0,2
../kbl_data/2024-2025,S45G01N128,서울 삼성,Home,이원대,2,1,2,50.0,0,1,0.0,1,3,33.3,0,0,0.0,0,1,1,1,0,0,0,0,0,4
../kbl_data/2024-2025,S45G01N128,서울 삼성,Home,최성모,14,2,4,50.0,3,5,60.0,5,9,55.6,1,2,50.0,0,6,6,10,1,0,0,0,0,4
../kbl_data/2024-2025,S45G01N128,서울 삼성,Home,윤성원,0,0,0,0.0,0,0,0.0,0,0,0.0,0,0,0.0,0,0,0,0,0,0,0,0,0,0
../kbl_data/2024-2025,S45G01N128,서울 삼성,Home,마커스 데릭슨,9,3,3,100.0,1,6,16.7,4,9,44.4,0,0,0.0,0,3,3,0,1,0,1,1,1,2
../kbl_data/2024-2025,S45G01N128,서울 삼성,Home,이원석,9,4,6,66.7,0,0,0.0,4,6,66.7,1,3,33.3,0,6,6,1,0,2,0,0,1,2
../kbl_data/2024-2025,S45G01N128,서울 삼성,Home,저스틴 구탕,14,7,9,77.8,0,1,0.0,7,10,70.0,0,0,0.0,0,4,4,7,3,0,0,4,2,2
../kbl_data/2024-2025,S45G01N128,서울 삼성,Home,박승재,2,1,1,100.0,0,0,0.0,1,1,100.0,0,0,0.0,0,1,1,1,0,0,0,0,1,2
../kbl_data/2024-2025,S45G01N128,서울 삼성,Home,코피 코번,9,4,10,40.0,0,0,0.0,4,10,40.0,1,1,100.0,4,9,13,1,0,0,0,1,1,0
../kbl_data/2024-2025,S45G01N128,서울 삼성,Home,임동언,0,0,0,0.0,0,0,0.0,0,0,0.0,0,0,0.0,0,0,0,0,0,0,0,0,0,0
../kbl_data/2024-2025,S45G01N128,서울 삼성,Home,황영찬,0,0,0,0.0,0,0,0.0,0,0,0.0,0,0,0.0,0,0,0,0,0,0,0,0,0,0
../kbl_data/2024-2025,S45G01N128,부산 KCC,Away,리온 윌리엄스,8,4,7,57.1,0,1,0.0,4,8,50.0,0,0,0.0,1,6,7,0,0,0,0,0,0,1
../kbl_data/2024-2025,S45G01N128,부산 KCC,Away,전준범,3,0,1,0.0,1,4,25.0,1,5,20.0,0,0,0.0,0,4,4,1,0,0,0,0,1,4
../kbl_data/2024-2025,S45G01N128,부산 KCC,Away,이승현,10,5,13,38.5,0,0,0.0,5,13,38.5,0,0,0.0,4,5,9,6,1,0,0,0,2,1
../kbl_data/2024-2025,S45G01N128,부산 KCC,Away,이호현,18,7,10,70.0,0,1,0.0,7,11,63.6,4,4,100.0,0,1,1,7,1,0,0,0,2,1
../kbl_data/2024-2025,S45G01N128,부산 KCC,Away,디온테 버튼,18,6,15,40.0,0,4,0.0,6,19,31.6,6,6,100.0,1,6,7,1,0,0,0,0,2,2
../kbl_data/2024-2025,S45G01N128,부산 KCC,Away,이근휘,1,0,0,0.0,0,3,0.0,0,3,0.0,1,2,50.0,0,3,3,2,1,0,0,0,0,3
../kbl_data/2024-2025,S45G01N128,부산 KCC,Away,김동현,8,2,3,66.7,1,3,33.3,3,6,50.0,1,2,50.0,1,2,3,0,3,1,0,0,1,3
../kbl_data/2024-2025,S45G01N128,부산 KCC,Away,송동훈,0,0,0,0.0,0,0,0.0,0,0,0.0,0,0,0.0,0,0,0,0,0,0,0,0,0,0
../kbl_data/2024-2025,S45G01N128,부산 KCC,Away,여준형,0,0,0,0.0,0,0,0.0,0,0,0.0,0,0,0.0,0,0,0,0,0,0,0,0,0,0
../kbl_data/2024-2025,S45G01N128,부산 KCC,Away,캘빈 제프리 에피스톨라,2,1,1,100.0,0,1,0.0,1,2,50.0,0,1,0.0,0,4,4,3,2,0,0,0,0,1
../kbl_data/2024-2025,S45G01N128,부산 KCC,Away,이주영,4,2,2,100.0,0,4,0.0,2,6,33.3,0,0,0.0,1,0,1,0,1,0,0,0,0,1
../kbl_data/2024-2025,S45G01N128,부산 KCC,Away,이찬영,0,0,0,0.0,0,0,0.0,0,0,0.0,0,0,0.0,0,0,0,0,0,0,0,0,0,0
../kbl_data/2024-2025,S45G01N129,서울 SK,Home,오세근,3,0,1,0.0,1,5,20.0,1,6,16.7,0,0,0.0,0,1,1,0,1,0,0,0,0,1
../kbl_data/2024-2025,S45G01N129,서울 SK,Home,최부경,4,1,1,100.0,0,1,0.0,1,2,50.0,2,2,100.0,1,3,4,1,1,0,0,0,1,1
../kbl_data/2024-2025,S45G01N129,서울 SK,Home,최원혁,8,2,5,40.0,0,0,0.0,2,5,40.0,4,6,66.7,2,4,6,4,1,0,1,0,1,4
../kbl_data/2024-2025,S45G01N129,서울 SK,Home,장문호,0,0,2,0.0,0,0,0.0,0,2,0.0,0,0,0.0,1,0,1,1,0,0,1,0,0,1
../kbl_data/2024-2025,S45G01N129,서울 SK,Home,안영준,15,5,10,50.0,1,2,50.0,6,12,50.0,2,4,50.0,1,7,8,1,2,1,0,0,3,3
../kbl_data/2024-2025,S45G01N129,서울 SK,Home,자밀 워니,22,8,17,47.1,1,6,16.7,9,23,39.1,3,5,60.0,2,8,10,1,0,1,0,0,3,3
../kbl_data/2024-2025,S45G01N129,서울 SK,Home,전성환,0,0,1,0.0,0,0,0.0,0,1,0.0,0,0,0.0,0,1,1,2,0,0,0,0,0,3
../kbl_data/2024-2025,S45G01N129,서울 SK,Home,아이재아 힉스,2,1,2,50.0,0,0,0.0,1,2,50.0,0,0,0.0,0,3,3,0,0,0,0,0,1,1
../kbl_data/2024-2025,S45G01N129,서울 SK,Home,박민우,3,0,0,0.0,1,2,50.0,1,2,50.0,0,0,0.0,0,1,1,0,0,0,0,0,0,0
../kbl_data/2024-2025,S45G01N129,서울 SK,Home,문가온,0,0,0,0.0,0,0,0.0,0,0,0.0,0,0,0.0,0,0,0,0,0,0,0,0,0,0
../kbl_data/2024-2025,S45G01N129,서울 SK,Home,고메즈 델 리아노,0,0,0,0.0,0,0,0.0,0,0,0.0,0,0,0.0,0,0,0,0,0,0,0,0,1,1
../kbl_data/2024-2025,S45G01N129,서울 SK,Home,김태훈,6,0,0,0.0,2,3,66.7,2,3,66.7,0,0,0.0,0,0,0,0,1,0,0,0,1,2
../kbl_data/2024-2025,S45G01N129,대구 한국가스공사,Away,차바위,0,0,1,0.0,0,1,0.0,0,2,0.0,0,0,0.0,0,1,1,1,0,0,0,0,1,1
../kbl_data/2024-2025,S45G01N129,대구 한국가스공사,Away,박지훈,0,0,0,0.0,0,0,0.0,0,0,0.0,0,0,0.0,0,0,0,0,0,0,0,0,0,0
../kbl_data/2024-2025,S45G01N129,대구 한국가스공사,Away,이대헌,13,2,5,40.0,3,4,75.0,5,9,55.6,0,0,0.0,2,5,7,2,0,0,1,0,1,1
../kbl_data/2024-2025,S45G01N129,대구 한국가스공사,Away,정성우,14,2,5,40.0,3,7,42.9,5,12,41.7,1,1,100.0,1,1,2,8,5,0,1,0,7,4
../kbl_data/2024-2025,S45G01N129,대구 한국가스공사,Away,우동현,0,0,0,0.0,0,5,0.0,0,5,0.0,0,0,0.0,0,0,0,0,0,0,0,0,0,4
../kbl_data/2024-2025,S45G01N129,대구 한국가스공사,Away,전현우,14,2,4,50.0,3,10,30.0,5,14,35.7,1,2,50.0,2,4,6,0,1,1,0,0,1,3
../kbl_data/2024-2025,S45G01N129,대구 한국가스공사,Away,양재혁,0,0,0,0.0,0,0,0.0,0,0,0.0,0,0,0.0,0,0,0,0,0,0,0,0,1,0
../kbl_data/2024-2025,S45G01N129,대구 한국가스공사,Away,곽정훈,2,0,0,0.0,0,3,0.0,0,3,0.0,2,2,100.0,0,0,0,0,0,0,0,0,0,2
../kbl_data/2024-2025,S45G01N129,대구 한국가스공사,Away,신승민,5,1,2,50.0,1,5,20.0,2,7,28.6,0,0,0.0,0,1,1,0,1,0,0,0,3,4
../kbl_data/2024-2025,S45G01N129,대구 한국가스공사,Away,유슈 은도예,4,0,3,0.0,1,1,100.0,1,4,25.0,1,2,50.0,4,10,14,3,0,1,0,0,2,2
../kbl_data/2024-2025,S45G01N129,대구 한국가스공사,Away,안세영,1,0,0,0.0,0,0,0.0,0,0,0.0,1,2,50.0,0,0,0,0,1,0,0,0,0,0
../kbl_data/2024-2025,S45G01N129,대구 한국가스공사,Away,신주영,2,1,2,50.0,0,1,0.0,1,3,33.3,0,0,0.0,0,4,4,0,0,0,0,0,0,1
../kbl_data/2024-2025,S45G01N130,울산 현대모비스,Home,장재석,4,2,4,50.0,0,0,0.0,2,4,50.0,0,0,0.0,1,3,4,1,1,2,0,0,0,3
../kbl_data/2024-2025,S45G01N130,울산 현대모비스,Home,김지완,2,1,1,100.0,0,0,0.0,1,1,100.0,0,0,0.0,0,0,0,0,0,0,0,0,1,0
../kbl_data/2024-2025,S45G01N130,울산 현대모비스,Home,한호빈,6,0,2,0.0,2,5,40.0,2,7,28.6,0,0,0.0,1,1,2,3,2,0,2,0,3,2
../kbl_data/2024-2025,S45G01N130,울산 현대모비스,Home,김준일,7,2,7,28.6,0,0,0.0,2,7,28.6,3,4,75.0,3,6,9,0,1,1,0,0,1,4
../kbl_data/2024-2025,S45G01N130,울산 현대모비스,Home,김국찬,2,1,1,100.0,0,1,0.0,1,2,50.0,0,0,0.0,0,3,3,1,0,0,0,0,1,3
../kbl_data/2024-2025,S45G01N130,울산 현대모비스,Home,숀 롱,20,7,10,70.0,0,1,0.0,7,11,63.6,6,7,85.7,5,4,9,6,0,0,0,2,1,0
../kbl_data/2024-2025,S45G01N130,울산 현대모비스,Home,이우석,13,4,5,80.0,1,6,16.7,5,11,45.5,2,2,100.0,0,3,3,4,1,0,0,0,3,0
../kbl_data/2024-2025,S45G01N130,울산 현대모비스,Home,이승우,0,0,0,0.0,0,0,0.0,0,0,0.0,0,0,0.0,0,0,0,0,0,0,0,0,0,0
../kbl_data/2024-2025,S45G01N130,울산 현대모비스,Home,신민석,0,0,0,0.0,0,0,0.0,0,0,0.0,0,0,0.0,0,0,0,0,0,0,0,0,0,1
../kbl_data/2024-2025,S45G01N130,울산 현대모비스,Home,게이지 프림,18,7,9,77.8,1,1,100.0,8,10,80.0,1,1,100.0,0,2,2,1,2,0,0,1,3,3
../kbl_data/2024-2025,S45G01N130,울산 현대모비스,Home,박무빈,17,7,9,77.8,0,2,0.0,7,11,63.6,3,3,100.0,0,1,1,6,0,0,0,0,2,3
../kbl_data/2024-2025,S45G01N130,울산 현대모비스,Home,미구엘 안드레 옥존,3,0,1,0.0,1,1,100.0,1,2,50.0,0,0,0.0,0,1,1,1,0,0,0,0,1,0
../kbl_data/2024-2025,S45G01N130,안양 정관장,Away,정준원,0,0,0,0.0,0,0,0.0,0,0,0.0,0,0,0.0,0,0,0,0,0,0,0,0,0,0
../kbl_data/2024-2025,S45G01N130,안양 정관장,Away,배병준,0,0,0,0.0,0,0,0.0,0,0,0.0,0,0,0.0,0,0,0,0,0,0,0,0,0,0
../kbl_data/2024-2025,S45G01N130,안양 정관장,Away,박지훈,13,3,8,37.5,2,6,33.3,5,14,35.7,1,2,50.0,0,1,1,8,7,1,0,0,5,4
../kbl_data/2024-2025,S45G01N130,안양 정관장,Away,최성원,11,3,4,75.0,1,5,20.0,4,9,44.4,2,2,100.0,1,0,1,5,1,0,0,0,2,1
../kbl_data/2024-2025,S45G01N130,안양 정관장,Away,캐디 라렌,16,7,12,58.3,0,4,0.0,7,16,43.8,2,4,50.0,3,9,12,3,1,1,0,3,5,4
../kbl_data/2024-2025,S45G01N130,안양 정관장,Away,김경원,0,0,0,0.0,0,1,0.0,0,1,0.0,0,0,0.0,1,0,1,0,0,0,0,0,0,0
../kbl_data/2024-2025,S45G01N130,안양 정관장,Away,박찬호,0,0,0,0.0,0,0,0.0,0,0,0.0,0,0,0.0,0,0,0,0,0,0,0,0,0,0
../kbl_data/2024-2025,S45G01N130,안양 정관장,Away,한승희,17,5,5,100.0,0,0,0.0,5,5,100.0,7,9,77.8,0,4,4,2,1,0,0,0,2,5
../kbl_data/2024-2025,S45G01N130,안양 정관장,Away,클리프 알렉산더,0,0,2,0.0,0,0,0.0,0,2,0.0,0,0,0.0,0,0,0,0,0,0,0,0,0,0
../kbl_data/2024-2025,S45G01N130,안양 정관장,Away,하비 고메즈,12,4,4,100.0,1,4,25.0,5,8,62.5,1,2,50.0,2,1,3,0,2,0,0,0,1,2
../kbl_data/2024-2025,S45G01N130,안양 정관장,Away,박정웅,0,0,1,0.0,0,1,0.0,0,2,0.0,0,0,0.0,1,1,2,3,0,0,0,0,0,2
../kbl_data/2024-2025,S45G01N130,안양 정관장,Away,소준혁,8,0,2,0.0,2,2,100.0,2,4,50.0,2,2,100.0,0,1,1,1,0,0,0,0,2,3
../kbl_data/2024-2025,S45G01N131,서울 삼성,Home,이정현,14,2,3,66.7,3,7,42.9,5,10,50.0,1,2,50.0,0,2,2,6,0,0,0,0,2,2
../kbl_data/2024-2025,S45G01N131,서울 삼성,Home,최현민,10,2,2,100.0,2,5,40.0,4,7,57.1,0,0,0.0,0,3,3,3,2,0,0,0,1,3
../kbl_data/2024-2025,S45G01N131,서울 삼성,Home,이원대,0,0,2,0.0,0,2,0.0,0,4,0.0,0,0,0.0,0,1,1,2,1,0,0,0,0,0
../kbl_data/2024-2025,S45G01N131,서울 삼성,Home,최성모,11,2,2,100.0,1,2,50.0,3,4,75.0,4,4,100.0,0,3,3,3,1,0,0,0,0,4
../kbl_data/2024-2025,S45G01N131,서울 삼성,Home,최승욱,0,0,2,0.0,0,1,0.0,0,3,0.0,0,0,0.0,1,3,4,0,0,1,0,0,0,0
../kbl_data/2024-2025,S45G01N131,서울 삼성,Home,윤성원,0,0,0,0.0,0,0,0.0,0,0,0.0,0,0,0.0,0,0,0,0,0,0,0,0,0,0
../kbl_data/2024-2025,S45G01N131,서울 삼성,Home,마커스 데릭슨,6,2,2,100.0,0,1,0.0,2,3,66.7,2,2,100.0,1,1,2,0,0,0,0,0,2,2
../kbl_data/2024-2025,S45G01N131,서울 삼성,Home,이원석,10,5,9,55.6,0,0,0.0,5,9,55.6,0,0,0.0,1,5,6,1,1,0,0,0,0,2
../kbl_data/2024-2025,S45G01N131,서울 삼성,Home,저스틴 구탕,15,6,9,66.7,1,2,50.0,7,11,63.6,0,2,0.0,0,6,6,3,0,1,1,1,1,2
../kbl_data/2024-2025,S45G01N131,서울 삼성,Home,박승재,2,1,2,50.0,0,2,0.0,1,4,25.0,0,0,0.0,0,0,0,2,0,0,0,0,1,1
../kbl_data/2024-2025,S45G01N131,서울 삼성,Home,코피 코번,24,7,9,77.8,0,0,0.0,7,9,77.8,10,12,83.3,4,5,9,0,1,0,0,0,0,1
../kbl_data/2024-2025,S45G01N131,서울 삼성,Home,황영찬,0,0,0,0.0,0,0,0.0,0,0,0.0,0,0,0.0,0,0,0,0,0,0,0,0,0,0
../kbl_data/2024-2025,S45G01N131,창원 LG,Away,허일영,9,0,0,0.0,3,4,75.0,3,4,75.0,0,0,0.0,1,0,1,1,0,0,0,0,1,2
../kbl_data/2024-2025,S45G01N131,창원 LG,Away,장민국,0,0,1,0.0,0,1,0.0,0,2,0.0,0,0,0.0,1,0,1,0,1,0,0,0,0,0
../kbl_data/2024-2025,S45G01N131,창원 LG,Away,한상혁,0,0,0,0.0,0,0,0.0,0,0,0.0,0,0,0.0,0,0,0,1,0,0,0,0,0,2
../kbl_data/2024-2025,S45G01N131,창원 LG,Away,전성현,2,1,2,50.0,0,3,0.0,1,5,20.0,0,0,0.0,0,0,0,0,0,0,0,0,0,0
../kbl_data/2024-2025,S45G01N131,창원 LG,Away,정인덕,6,0,1,0.0,2,4,50.0,2,5,40.0,0,0,0.0,0,1,1,1,0,0,0,0,0,2
../kbl_data/2024-2025,S45G01N131,창원 LG,Away,대릴 먼로,12,6,12,50.0,0,2,0.0,6,14,42.9,0,1,0.0,0,11,11,4,1,0,0,0,1,3
../kbl_data/2024-2025,S45G01N131,창원 LG,Away,박정현,0,0,0,0.0,0,0,0.0,0,0,0.0,0,0,0.0,0,0,0,0,0,0,0,0,0,0
../kbl_data/2024-2025,S45G01N131,창원 LG,Away,양준석,12,3,8,37.5,2,4,50.0,5,12,41.7,0,0,0.0,1,4,5,10,3,0,1,0,1,5
../kbl_data/2024-2025,S45G01N131,창원 LG,Away,유기상,3,0,3,0.0,1,4,25.0,1,7,14.3,0,0,0.0,1,1,2,3,0,0,0,0,1,2
../kbl_data/2024-2025,S45G01N131,창원 LG,Away,이경도,0,0,0,0.0,0,0,0.0,0,0,0.0,0,0,0.0,0,0,0,0,0,0,0,0,0,1
../kbl_data/2024-2025,S45G01N131,창원 LG,Away,칼 타마요,37,15,15,100.0,2,4,50.0,17,19,89.5,1,4,25.0,2,5,7,3,0,0,0,0,3,0
../kbl_data/2024-2025,S45G01N131,창원 LG,Away,브라이언 그리핀,7,3,3,100.0,0,1,0.0,3,4,75.0,1,2,50.0,1,1,2,0,0,0,0,1,1,5
../kbl_data/2024-2025,S45G01N132,고양 소노,Home,임동섭,16,2,5,40.0,4,8,50.0,6,13,46.2,0,0,0.0,0,5,5,3,0,0,0,0,0,2
../kbl_data/2024-2025,S45G01N132,고양 소노,Home,이재도,15,3,3,100.0,3,5,60.0,6,8,75.0,0,0,0.0,0,2,2,2,0,0,0,0,1,0
../kbl_data/2024-2025,S45G01N132,고양 소노,Home,최승욱,0,0,2,0.0,0,0,0.0,0,2,0.0,0,0,0.0,0,0,0,0,0,0,0,0,0,0
../kbl_data/2024-2025,S45G01N132,고양 소노,Home,박진철,0,0,2,0.0,0,0,0.0,0,2,0.0,0,0,0.0,1,0,1,1,1,1,0,0,0,3
../kbl_data/2024-2025,S45G01N132,고양 소노,Home,이정현,2,1,2,50.0,0,0,0.0,1,2,50.0,0,0,0.0,0,0,0,0,0,0,0,0,0,0
../kbl_data/2024-2025,S45G01N132,고양 소노,Home,박종하,6,1,2,50.0,1,5,20.0,2,7,28.6,1,2,50.0,0,0,0,1,1,0,0,0,3,1
../kbl_data/2024-2025,S45G01N132,고양 소노,Home,민기남,3,1,2,50.0,0,2,0.0,1,4,25.0,1,5,20.0,0,0,0,1,0,0,1,0,2,3
../kbl_data/2024-2025,S45G01N132,고양 소노,Home,디제이 번즈 Jr,7,3,7,42.9,0,0,0.0,3,7,42.9,1,2,50.0,0,3,3,5,0,0,0,0,2,0
../kbl_data/2024-2025,S45G01N132,고양 소노,Home,이근준,2,1,1,100.0,0,6,0.0,1,7,14.3,0,0,0.0,3,6,9,1,1,1,0,0,1,4
../kbl_data/2024-2025,S45G01N132,고양 소노,Home,서동원,0,0,0,0.0,0,0,0.0,0,0,0.0,0,0,0.0,1,1,2,0,0,0,0,0,0,1
../kbl_data/2024-2025,S45G01N132,고양 소노,Home,정성조,7,0,0,0.0,2,3,66.7,2,3,66.7,1,2,50.0,0,1,1,1,0,0,0,0,0,0
../kbl_data/2024-2025,S45G01N132,고양 소노,Home,알파 카바,10,4,5,80.0,0,0,0.0,4,5,80.0,2,3,66.7,3,2,5,1,1,1,0,0,1,1
../kbl_data/2024-2025,S45G01N132,부산 KCC,Away,리온 윌리엄스,18,6,8,75.0,1,3,33.3,7,11,63.6,3,3,100.0,2,10,12,0,2,0,0,0,3,5
../kbl_data/2024-2025,S45G01N132,부산 KCC,Away,전준범,9,0,0,0.0,3,3,100.0,3,3,100.0,0,0,0.0,0,1,1,1,0,0,0,0,0,1
../kbl_data/2024-2025,S45G01N132,부산 KCC,Away,이승현,15,5,13,38.5,1,1,100.0,6,14,42.9,2,2,100.0,1,4,5,5,0,0,0,0,2,0
../kbl_data/2024-2025,S45G01N132,부산 KCC,Away,이호현,5,1,1,100.0,1,1,100.0,2,2,100.0,0,0,0.0,0,1,1,6,0,0,0,0,0,1
../kbl_data/2024-2025,S45G01N132,부산 KCC,Away,디온테 버튼,0,0,0,0.0,0,0,0.0,0,0,0.0,0,0,0.0,0,0,0,0,0,0,0,0,0,0
../kbl_data/2024-2025,S45G01N132,부산 KCC,Away,이근휘,22,2,2,100.0,6,11,54.5,8,13,61.5,0,0,0.0,1,0,1,1,1,0,0,0,0,0
../kbl_data/2024-2025,S45G01N132,부산 KCC,Away,김동현,0,0,1,0.0,0,0,0.0,0,1,0.0,0,0,0.0,0,0,0,0,0,0,0,0,1,1
../kbl_data/2024-2025,S45G01N132,부산 KCC,Away,송동훈,0,0,0,0.0,0,1,0.0,0,1,0.0,0,0,0.0,0,1,1,0,1,0,0,0,1,1
../kbl_data/2024-2025,S45G01N132,부산 KCC,Away,여준형,5,1,2,50.0,1,1,100.0,2,3,66.7,0,0,0.0,0,3,3,0,0,0,0,0,0,2
../kbl_data/2024-2025,S45G01N132,부산 KCC,Away,캘빈 제프리 에피스톨라,10,1,2,50.0,2,2,100.0,3,4,75.0,2,2,100.0,0,1,1,5,2,0,0,0,1,3
../kbl_data/2024-2025,S45G01N132,부산 KCC,Away,이주영,9,3,5,60.0,1,2,50.0,4,7,57.1,0,0,0.0,1,2,3,4,1,0,0,0,0,5
../kbl_data/2024-2025,S45G01N132,부산 KCC,Away,이찬영,0,0,1,0.0,0,1,0.0,0,2,0.0,0,0,0.0,0,0,0,1,0,0,0,0,0,0
../kbl_data/2024-2025,S45G01N133,서울 SK,Home,오세근,8,1,3,33.3,2,3,66.7,3,6,50.0,0,0,0.0,0,0,0,0,0,0,0,0,0,1
../kbl_data/2024-2025,S45G01N133,서울 SK,Home,최부경,4,2,8,25.0,0,1,0.0,2,9,22.2,0,1,0.0,4,1,5,3,1,0,0,0,1,1
../kbl_data/2024-2025,S45G01N133,서울 SK,Home,최원혁,3,0,0,0.0,1,2,50.0,1,2,50.0,0,0,0.0,0,1,1,1,0,0,0,0,0,4
../kbl_data/2024-2025,S45G01N133,서울 SK,Home,장문호,0,0,0,0.0,0,0,0.0,0,0,0.0,0,0,0.0,0,0,0,0,0,0,0,0,0,0
../kbl_data/2024-2025,S45G01N133,서울 SK,Home,안영준,11,3,6,50.0,1,4,25.0,4,10,40.0,2,2,100.0,2,8,10,4,2,1,0,0,5,2
../kbl_data/2024-2025,S45G01N133,서울 SK,Home,자밀 워니,19,7,11,63.6,1,5,20.0,8,16,50.0,2,2,100.0,1,10,11,2,1,1,0,0,1,1
../kbl_data/2024-2025,S45G01N133,서울 SK,Home,전성환,0,0,0,0.0,0,0,0.0,0,0,0.0,0,0,0.0,0,0,0,0,0,0,0,0,0,0
../kbl_data/2024-2025,S45G01N133,서울 SK,Home,아이재아 힉스,7,2,4,50.0,1,2,50.0,3,6,50.0,0,0,0.0,2,2,4,0,0,2,0,0,1,2
../kbl_data/2024-2025,S45G01N133,서울 SK,Home,박민우,0,0,0,0.0,0,0,0.0,0,0,0.0,0,0,0.0,0,0,0,0,0,0,0,0,0,0
../kbl_data/2024-2025,S45G01N133,서울 SK,Home,오재현,17,5,11,45.5,1,7,14.3,6,18,33.3,4,4,100.0,2,3,5,5,2,0,1,0,2,1
../kbl_data/2024-2025,S45G01N133,서울 SK,Home,고메즈 델 리아노,4,2,4,50.0,0,0,0.0,2,4,50.0,0,0,0.0,1,1,2,1,0,0,0,0,0,1
../kbl_data/2024-2025,S45G01N133,서울 SK,Home,김태훈,3,0,1,0.0,1,2,50.0,1,3,33.3,0,0,0.0,2,3,5,0,0,0,0,0,1,4
../kbl_data/2024-2025,S45G01N133,울산 현대모비스,Away,장재석,2,1,3,33.3,0,0,0.0,1,3,33.3,0,0,0.0,0,4,4,2,0,2,0,0,0,2
../kbl_data/2024-2025,S45G01N133,울산 현대모비스,Away,김지완,0,0,0,0.0,0,0,0.0,0,0,0.0,0,0,0.0,0,0,0,0,0,0,0,0,0,0
../kbl_data/2024-2025,S45G01N133,울산 현대모비스,Away,한호빈,0,0,1,0.0,0,0,0.0,0,1,0.0,0,0,0.0,0,1,1,0,0,0,0,0,0,1
../kbl_data/2024-2025,S45G01N133,울산 현대모비스,Away,김준일,0,0,0,0.0,0,0,0.0,0,0,0.0,0,0,0.0,0,1,1,0,0,0,1,0,0,1
../kbl_data/2024-2025,S45G01N133,울산 현대모비스,Away,조한진,0,0,0,0.0,0,0,0.0,0,0,0.0,0,0,0.0,0,0,0,0,0,0,0,0,0,0
../kbl_data/2024-2025,S45G01N133,울산 현대모비스,Away,숀 롱,4,2,7,28.6,0,0,0.0,2,7,28.6,0,0,0.0,3,2,5,2,1,0,0,0,2,2
../kbl_data/2024-2025,S45G01N133,울산 현대모비스,Away,이우석,16,2,3,66.7,4,8,50.0,6,11,54.5,0,0,0.0,1,10,11,2,2,3,0,0,1,1
../kbl_data/2024-2025,S45G01N133,울산 현대모비스,Away,이승우,0,0,0,0.0,0,0,0.0,0,0,0.0,0,0,0.0,0,0,0,0,0,0,0,0,0,1
../kbl_data/2024-2025,S45G01N133,울산 현대모비스,Away,신민석,8,1,1,100.0,2,4,50.0,3,5,60.0,0,0,0.0,0,1,1,1,1,0,0,0,0,1
../kbl_data/2024-2025,S45G01N133,울산 현대모비스,Away,게이지 프림,7,2,10,20.0,0,1,0.0,2,11,18.2,3,6,50.0,3,1,4,2,0,0,0,0,4,3
../kbl_data/2024-2025,S45G01N133,울산 현대모비스,Away,박무빈,2,1,6,16.7,0,2,0.0,1,8,12.5,0,0,0.0,2,3,5,6,1,0,0,0,2,4
../kbl_data/2024-2025,S45G01N133,울산 현대모비스,Away,미구엘 안드레 옥존,31,5,8,62.5,6,12,50.0,11,20,55.0,3,4,75.0,1,4,5,3,1,0,0,0,2,3
../kbl_data/2024-2025,S45G01N134,대구 한국가스공사,Home,차바위,0,0,0,0.0,0,1,0.0,0,1,0.0,0,0,0.0,0,1,1,0,1,0,0,0,0,4
../kbl_data/2024-2025,S45G01N134,대구 한국가스공사,Home,박지훈,0,0,2,0.0,0,0,0.0,0,2,0.0,0,0,0.0,0,1,1,0,1,0,0,0,0,3
../kbl_data/2024-2025,S45G01N134,대구 한국가스공사,Home,이대헌,18,8,11,72.7,0,0,0.0,8,11,72.7,2,3,66.7,0,8,8,3,1,0,0,0,2,1
../kbl_data/2024-2025,S45G01N134,대구 한국가스공사,Home,정성우,3,1,1,100.0,0,3,0.0,1,4,25.0,1,1,100.0,0,3,3,2,0,0,0,0,3,3
../kbl_data/2024-2025,S45G01N134,대구 한국가스공사,Home,김철욱,3,0,1,0.0,1,2,50.0,1,3,33.3,0,0,0.0,0,0,0,0,0,0,0,0,0,0
../kbl_data/2024-2025,S45G01N134,대구 한국가스공사,Home,김낙현,24,2,5,40.0,6,8,75.0,8,13,61.5,2,2,100.0,0,2,2,5,2,1,0,0,4,0
../kbl_data/2024-2025,S45G01N134,대구 한국가스공사,Home,양재혁,0,0,0,0.0,0,0,0.0,0,0,0.0,0,2,0.0,0,0,0,0,0,0,0,0,0,3
../kbl_data/2024-2025,S45G01N134,대구 한국가스공사,Home,곽정훈,0,0,0,0.0,0,1,0.0,0,1,0.0,0,0,0.0,0,1,1,0,0,0,0,0,0,1
../kbl_data/2024-2025,S45G01N134,대구 한국가스공사,Home,신승민,3,0,0,0.0,1,7,14.3,1,7,14.3,0,0,0.0,1,2,3,2,0,0,0,0,0,1
../kbl_data/2024-2025,S45G01N134,대구 한국가스공사,Home,샘조세프 벨란겔,15,4,8,50.0,2,5,40.0,6,13,46.2,1,1,100.0,0,3,3,2,0,0,0,0,3,0
../kbl_data/2024-2025,S45G01N134,대구 한국가스공사,Home,유슈 은도예,17,5,9,55.6,2,2,100.0,7,11,63.6,1,2,50.0,6,11,17,2,1,1,0,2,1,3
../kbl_data/2024-2025,S45G01N134,대구 한국가스공사,Home,신주영,1,0,0,0.0,0,0,0.0,0,0,0.0,1,2,50.0,0,0,0,0,0,1,0,0,0,0
../kbl_data/2024-2025,S45G01N134,원주 DB,Away,이관희,6,1,3,33.3,1,2,50.0,2,5,40.0,1,2,50.0,1,0,1,0,0,1,0,0,0,0
../kbl_data/2024-2025,S45G01N134,원주 DB,Away,김시래,3,0,0,0.0,1,3,33.3,1,3,33.3,0,0,0.0,0,2,2,0,0,0,0,0,0,2
../kbl_data/2024-2025,S45G01N134,원주 DB,Away,서민수,4,2,2,100.0,0,2,0.0,2,4,50.0,0,0,0.0,3,4,7,0,2,0,0,0,1,3
../kbl_data/2024-2025,S45G01N134,원주 DB,Away,김영현,0,0,1,0.0,0,2,0.0,0,3,0.0,0,0,0.0,1,1,2,0,0,0,0,0,0,1
../kbl_data/2024-2025,S45G01N134,원주 DB,Away,박봉진,0,0,1,0.0,0,1,0.0,0,2,0.0,0,0,0.0,1,1,2,0,0,0,0,0,0,2
../kbl_data/2024-2025,S45G01N134,원주 DB,Away,치나누 오누아쿠,11,4,7,57.1,1,3,33.3,5,10,50.0,0,1,0.0,1,10,11,4,2,0,0,0,2,3
../kbl_data/2024-2025,S45G01N134,원주 DB,Away,이용우,0,0,0,0.0,0,1,0.0,0,1,0.0,0,0,0.0,1,1,2,1,0,0,0,0,0,0
../kbl_data/2024-2025,S45G01N134,원주 DB,Away,정호영,5,1,3,33.3,0,3,0.0,1,6,16.7,3,4,75.0,1,1,2,1,3,0,0,0,2,4
../kbl_data/2024-2025,S45G01N134,원주 DB,Away,이선 알바노,17,5,9,55.6,1,7,14.3,6,16,37.5,4,6,66.7,0,2,2,5,2,0,0,0,4,1
../kbl_data/2024-2025,S45G01N134,원주 DB,Away,박인웅,5,2,5,40.0,0,4,0.0,2,9,22.2,1,2,50.0,0,1,1,0,0,0,0,0,1,2
../kbl_data/2024-2025,S45G01N134,원주 DB,Away,로버트 카터,4,2,7,28.6,0,1,0.0,2,8,25.0,0,0,0.0,2,2,4,0,1,0,0,0,0,0
../kbl_data/2024-2025,S45G01N134,원주 DB,Away,김보배,6,2,2,100.0,0,0,0.0,2,2,100.0,2,2,100.0,0,2,2,1,0,0,0,0,1,2
../kbl_data/2024-2025,S45G01N135,수원 KT,Home,한희원,2,1,2,50.0,0,2,0.0,1,4,25.0,0,0,0.0,1,1,2,1,1,0,0,0,0,1
../kbl_data/2024-2025,S45G01N135,수원 KT,Home,문성곤,0,0,0,0.0,0,3,0.0,0,3,0.0,0,0,0.0,0,2,2,1,0,0,0,0,0,1
../kbl_data/2024-2025,S45G01N135,수원 KT,Home,이현석,0,0,0,0.0,0,0,0.0,0,0,0.0,0,0,0.0,0,1,1,0,1,0,0,0,0,0
../kbl_data/2024-2025,S45G01N135,수원 KT,Home,허훈,9,0,3,0.0,3,8,37.5,3,11,27.3,0,1,0.0,0,2,2,8,4,0,0,0,3,2
../kbl_data/2024-2025,S45G01N135,수원 KT,Home,박준영,16,4,6,66.7,2,5,40.0,6,11,54.5,2,4,50.0,1,5,6,1,0,0,0,0,2,3
../kbl_data/2024-2025,S45G01N135,수원 KT,Home,박지원,0,0,1,0.0,0,0,0.0,0,1,0.0,0,0,0.0,2,2,4,1,0,0,0,0,3,2
../kbl_data/2024-2025,S45G01N135,수원 KT,Home,하윤기,2,0,7,0.0,0,0,0.0,0,7,0.0,2,2,100.0,1,1,2,0,0,1,0,0,1,1
../kbl_data/2024-2025,S45G01N135,수원 KT,Home,이두원,0,0,0,0.0,0,0,0.0,0,0,0.0,0,0,0.0,0,0,0,0,0,0,0,0,0,0
../kbl_data/2024-2025,S45G01N135,수원 KT,Home,문정현,7,3,4,75.0,0,0,0.0,3,4,75.0,1,1,100.0,0,1,1,0,1,0,0,0,2,1
../kbl_data/2024-2025,S45G01N135,수원 KT,Home,박성재,5,1,1,100.0,1,3,33.3,2,4,50.0,0,0,0.0,3,0,3,0,0,0,0,0,2,1
../kbl_data/2024-2025,S45G01N135,수원 KT,Home,이스마엘 로메로,15,7,9,77.8,0,2,0.0,7,11,63.6,1,4,25.0,1,6,7,0,1,0,0,0,0,3
../kbl_data/2024-2025,S45G01N135,수원 KT,Home,조엘 카굴랑안,7,3,7,42.9,0,2,0.0,3,9,33.3,1,2,50.0,0,4,4,9,5,0,0,0,4,0
../kbl_data/2024-2025,S45G01N135,서울 삼성,Away,이정현,14,4,8,50.0,2,4,50.0,6,12,50.0,0,0,0.0,1,7,8,5,1,0,0,0,5,3
../kbl_data/2024-2025,S45G01N135,서울 삼성,Away,최현민,2,1,2,50.0,0,1,0.0,1,3,33.3,0,0,0.0,1,0,1,4,1,0,0,0,0,4
../kbl_data/2024-2025,S45G01N135,서울 삼성,Away,이원대,0,0,0,0.0,0,0,0.0,0,0,0.0,0,0,0.0,0,0,0,0,0,0,0,0,1,0
../kbl_data/2024-2025,S45G01N135,서울 삼성,Away,최성모,15,2,3,66.7,3,9,33.3,5,12,41.7,2,2,100.0,0,6,6,3,3,1,0,0,3,3
../kbl_data/2024-2025,S45G01N135,서울 삼성,Away,최승욱,6,3,3,100.0,0,2,0.0,3,5,60.0,0,0,0.0,0,0,0,0,2,1,1,0,0,0
../kbl_data/2024-2025,S45G01N135,서울 삼성,Away,윤성원,0,0,0,0.0,0,0,0.0,0,0,0.0,0,0,0.0,0,0,0,0,0,0,0,0,0,0
../kbl_data/2024-2025,S45G01N135,서울 삼성,Away,마커스 데릭슨,11,4,11,36.4,1,3,33.3,5,14,35.7,0,0,0.0,1,5,6,1,1,0,0,0,1,1
../kbl_data/2024-2025,S45G01N135,서울 삼성,Away,이원석,5,1,4,25.0,1,1,100.0,2,5,40.0,0,0,0.0,1,5,6,0,1,1,0,0,0,1
../kbl_data/2024-2025,S45G01N135,서울 삼성,Away,저스틴 구탕,11,1,4,25.0,3,3,100.0,4,7,57.1,0,0,0.0,0,1,1,4,2,1,0,0,3,4
../kbl_data/2024-2025,S45G01N135,서울 삼성,Away,박승재,0,0,0,0.0,0,1,0.0,0,1,0.0,0,0,0.0,0,2,2,1,0,0,0,0,2,1
../kbl_data/2024-2025,S45G01N135,서울 삼성,Away,코피 코번,14,6,6,100.0,0,0,0.0,6,6,100.0,2,3,66.7,1,5,6,1,0,1,0,2,1,1
../kbl_data/2024-2025,S45G01N135,서울 삼성,Away,황영찬,0,0,0,0.0,0,0,0.0,0,0,0.0,0,0,0.0,0,0,0,0,0,0,0,0,0,0
../kbl_data/2024-2025,S45G01N136,안양 정관장,Home,배병준,15,1,4,25.0,3,5,60.0,4,9,44.4,4,4,100.0,1,4,5,1,1,0,0,0,1,1
../kbl_data/2024-2025,S45G01N136,안양 정관장,Home,정효근,2,1,4,25.0,0,2,0.0,1,6,16.7,0,0,0.0,3,3,6,3,2,1,0,0,2,2
../kbl_data/2024-2025,S45G01N136,안양 정관장,Home,박지훈,15,3,6,50.0,3,8,37.5,6,14,42.9,0,0,0.0,1,3,4,2,3,1,1,0,2,4
../kbl_data/2024-2025,S45G01N136,안양 정관장,Home,디온테 버튼,20,5,9,55.6,1,8,12.5,6,17,35.3,7,7,100.0,2,7,9,9,2,1,0,0,5,4
../kbl_data/2024-2025,S45G01N136,안양 정관장,Home,최성원,2,1,2,50.0,0,0,0.0,1,2,50.0,0,0,0.0,0,0,0,0,0,0,0,0,0,0
../kbl_data/2024-2025,S45G01N136,안양 정관장,Home,김준형,0,0,0,0.0,0,0,0.0,0,0,0.0,0,0,0.0,0,0,0,0,0,0,0,0,0,0
../kbl_data/2024-2025,S45G01N136,안양 정관장,Home,김경원,0,0,0,0.0,0,1,0.0,0,1,0.0,0,0,0.0,0,0,0,0,0,0,0,0,0,0
../kbl_data/2024-2025,S45G01N136,안양 정관장,Home,한승희,15,6,12,50.0,0,2,0.0,6,14,42.9,3,3,100.0,4,1,5,1,1,0,0,0,0,4
../kbl_data/2024-2025,S45G01N136,안양 정관장,Home,클리프 알렉산더,0,0,0,0.0,0,0,0.0,0,0,0.0,0,0,0.0,0,0,0,0,0,0,0,0,0,2
../kbl_data/2024-2025,S45G01N136,안양 정관장,Home,하비 고메즈,13,2,3,66.7,3,7,42.9,5,10,50.0,0,0,0.0,2,3,5,1,0,1,0,0,1,1
../kbl_data/2024-2025,S45G01N136,안양 정관장,Home,박정웅,0,0,0,0.0,0,1,0.0,0,1,0.0,0,0,0.0,0,0,0,0,0,0,1,0,0,0
../kbl_data/2024-2025,S45G01N136,안양 정관장,Home,소준혁,0,0,0,0.0,0,0,0.0,0,0,0.0,0,0,0.0,0,0,0,0,0,0,0,0,0,0
../kbl_data/2024-2025,S45G01N136,창원 LG,Away,허일영,3,0,1,0.0,1,2,50.0,1,3,33.3,0,0,0.0,0,0,0,0,2,0,0,0,0,2
../kbl_data/2024-2025,S45G01N136,창원 LG,Away,장민국,0,0,0,0.0,0,1,0.0,0,1,0.0,0,0,0.0,0,0,0,0,0,0,1,0,0,4
../kbl_data/2024-2025,S45G01N136,창원 LG,Away,한상혁,0,0,0,0.0,0,0,0.0,0,0,0.0,0,0,0.0,0,0,0,0,0,0,0,0,0,0
../kbl_data/2024-2025,S45G01N136,창원 LG,Away,전성현,0,0,0,0.0,0,1,0.0,0,1,0.0,0,0,0.0,0,1,1,0,0,0,0,0,0,0
../kbl_data/2024-2025,S45G01N136,창원 LG,Away,정인덕,16,2,2,100.0,3,4,75.0,5,6,83.3,3,3,100.0,0,1,1,4,0,1,0,0,3,4
../kbl_data/2024-2025,S45G01N136,창원 LG,Away,대릴 먼로,13,5,10,50.0,0,1,0.0,5,11,45.5,3,5,60.0,1,11,12,6,3,0,0,0,3,3
../kbl_data/2024-2025,S45G01N136,창원 LG,Away,박정현,0,0,0,0.0,0,0,0.0,0,0,0.0,0,0,0.0,0,0,0,0,0,0,0,0,0,0
../kbl_data/2024-2025,S45G01N136,창원 LG,Away,양준석,2,1,5,20.0,0,1,0.0,1,6,16.7,0,0,0.0,1,1,2,6,0,0,1,0,4,2
../kbl_data/2024-2025,S45G01N136,창원 LG,Away,유기상,14,3,4,75.0,2,4,50.0,5,8,62.5,2,2,100.0,0,1,1,1,0,1,0,0,2,3
../kbl_data/2024-2025,S45G01N136,창원 LG,Away,이경도,0,0,0,0.0,0,0,0.0,0,0,0.0,0,0,0.0,0,0,0,0,0,0,0,0,1,0
../kbl_data/2024-2025,S45G01N136,창원 LG,Away,칼 타마요,31,12,20,60.0,2,3,66.7,14,23,60.9,1,2,50.0,2,6,8,1,2,1,0,0,1,3
../kbl_data/2024-2025,S45G01N136,창원 LG,Away,브라이언 그리핀,7,3,3,100.0,0,0,0.0,3,3,100.0,1,1,100.0,2,3,5,0,0,1,0,1,1,1
../kbl_data/2024-2025,S45G01N137,고양 소노,Home,임동섭,18,3,4,75.0,4,9,44.4,7,13,53.8,0,0,0.0,3,5,8,2,1,0,0,0,1,3
../kbl_data/2024-2025,S45G01N137,고양 소노,Home,이재도,13,2,4,50.0,3,9,33.3,5,13,38.5,0,0,0.0,1,3,4,5,1,0,0,0,2,1
../kbl_data/2024-2025,S45G01N137,고양 소노,Home,최승욱,0,0,0,0.0,0,1,0.0,0,1,0.0,0,0,0.0,1,0,1,0,0,0,0,0,0,1
../kbl_data/2024-2025,S45G01N137,고양 소노,Home,김진유,0,0,0,0.0,0,0,0.0,0,0,0.0,0,0,0.0,0,0,0,1,1,0,0,0,1,1
../kbl_data/2024-2025,S45G01N137,고양 소노,Home,박진철,3,1,2,50.0,0,0,0.0,1,2,50.0,1,2,50.0,1,2,3,1,1,0,0,0,3,2
../kbl_data/2024-2025,S45G01N137,고양 소노,Home,박종하,1,0,1,0.0,0,0,0.0,0,1,0.0,1,2,50.0,0,0,0,3,0,0,0,0,1,2
../kbl_data/2024-2025,S45G01N137,고양 소노,Home,민기남,8,1,1,100.0,2,4,50.0,3,5,60.0,0,0,0.0,1,1,2,4,0,0,0,0,0,3
../kbl_data/2024-2025,S45G01N137,고양 소노,Home,디제이 번즈 Jr,11,4,10,40.0,1,1,100.0,5,11,45.5,0,0,0.0,0,1,1,0,0,1,0,0,1,3
../kbl_data/2024-2025,S45G01N137,고양 소노,Home,이근준,0,0,0,0.0,0,3,0.0,0,3,0.0,0,0,0.0,0,1,1,0,0,0,0,0,1,5
../kbl_data/2024-2025,S45G01N137,고양 소노,Home,서동원,0,0,0,0.0,0,0,0.0,0,0,0.0,0,0,0.0,0,0,0,0,0,0,0,0,0,0
../kbl_data/2024-2025,S45G01N137,고양 소노,Home,정성조,2,1,1,100.0,0,3,0.0,1,4,25.0,0,2,0.0,0,0,0,2,2,0,0,0,2,1
../kbl_data/2024-2025,S45G01N137,고양 소노,Home,알파 카바,14,7,9,77.8,0,0,0.0,7,9,77.8,0,1,0.0,5,7,12,2,0,0,0,1,1,1
../kbl_data/2024-2025,S45G01N137,부산 KCC,Away,정창영,0,0,0,0.0,0,0,0.0,0,0,0.0,0,0,0.0,0,0,0,0,0,0,0,0,0,0
../kbl_data/2024-2025,S45G01N137,부산 KCC,Away,리온 윌리엄스,0,0,1,0.0,0,0,0.0,0,1,0.0,0,0,0.0,1,1,2,1,2,0,0,0,0,1
../kbl_data/2024-2025,S45G01N137,부산 KCC,Away,전준범,2,0,1,0.0,0,3,0.0,0,4,0.0,2,2,100.0,1,1,2,0,0,0,0,0,0,3
../kbl_data/2024-2025,S45G01N137,부산 KCC,Away,이승현,13,4,12,33.3,1,1,100.0,5,13,38.5,2,2,100.0,4,3,7,1,1,0,0,0,3,3
../kbl_data/2024-2025,S45G01N137,부산 KCC,Away,이호현,22,7,9,77.8,2,3,66.7,9,12,75.0,2,3,66.7,0,2,2,7,0,0,0,0,5,4
../kbl_data/2024-2025,S45G01N137,부산 KCC,Away,캐디 라렌,21,7,11,63.6,0,2,0.0,7,13,53.8,7,8,87.5,3,6,9,0,0,1,0,3,0,1
../kbl_data/2024-2025,S45G01N137,부산 KCC,Away,이근휘,0,0,0,0.0,0,1,0.0,0,1,0.0,0,0,0.0,0,2,2,0,0,0,0,0,0,1
../kbl_data/2024-2025,S45G01N137,부산 KCC,Away,김동현,8,3,5,60.0,0,3,0.0,3,8,37.5,2,2,100.0,0,2,2,1,5,0,1,0,0,3
../kbl_data/2024-2025,S45G01N137,부산 KCC,Away,여준형,0,0,0,0.0,0,0,0.0,0,0,0.0,0,0,0.0,0,0,0,0,0,0,0,0,0,0
../kbl_data/2024-2025,S45G01N137,부산 KCC,Away,캘빈 제프리 에피스톨라,3,0,0,0.0,1,2,50.0,1,2,50.0,0,0,0.0,0,2,2,0,0,0,0,0,0,0
../kbl_data/2024-2025,S45G01N137,부산 KCC,Away,이주영,4,2,3,66.7,0,0,0.0,2,3,66.7,0,0,0.0,1,0,1,0,0,0,0,0,1,2
../kbl_data/2024-2025,S45G01N137,부산 KCC,Away,이찬영,0,0,0,0.0,0,0,0.0,0,0,0.0,0,0,0.0,0,0,0,0,0,0,0,0,0,0
../kbl_data/2024-2025,S45G01N138,원주 DB,Home,이관희,3,0,0,0.0,1,5,20.0,1,5,20.0,0,0,0.0,0,5,5,4,1,2,0,0,0,3
../kbl_data/2024-2025,S45G01N138,원주 DB,Home,김시래,9,0,2,0.0,3,3,100.0,3,5,60.0,0,0,0.0,0,1,1,2,2,0,0,0,3,2
../kbl_data/2024-2025,S45G01N138,원주 DB,Home,서민수,2,0,0,0.0,0,7,0.0,0,7,0.0,2,2,100.0,3,2,5,2,0,1,1,0,2,5
../kbl_data/2024-2025,S45G01N138,원주 DB,Home,김영현,0,0,0,0.0,0,0,0.0,0,0,0.0,0,0,0.0,0,0,0,0,0,0,0,0,0,0
../kbl_data/2024-2025,S45G01N138,원주 DB,Home,치나누 오누아쿠,13,5,9,55.6,0,3,0.0,5,12,41.7,3,4,75.0,2,8,10,4,1,4,0,1,4,2
../kbl_data/2024-2025,S45G01N138,원주 DB,Home,김훈,0,0,0,0.0,0,0,0.0,0,0,0.0,0,0,0.0,0,0,0,0,0,0,0,0,0,0
../kbl_data/2024-2025,S45G01N138,원주 DB,Home,이용우,2,1,2,50.0,0,1,0.0,1,3,33.3,0,0,0.0,0,1,1,1,1,0,0,0,1,0
../kbl_data/2024-2025,S45G01N138,원주 DB,Home,정호영,0,0,2,0.0,0,0,0.0,0,2,0.0,0,0,0.0,0,1,1,0,0,0,0,0,1,1
../kbl_data/2024-2025,S45G01N138,원주 DB,Home,이선 알바노,20,4,6,66.7,2,5,40.0,6,11,54.5,6,8,75.0,0,5,5,3,1,0,0,0,6,3
../kbl_data/2024-2025,S45G01N138,원주 DB,Home,박인웅,12,3,6,50.0,2,4,50.0,5,10,50.0,0,0,0.0,1,1,2,0,1,0,0,0,0,1
../kbl_data/2024-2025,S45G01N138,원주 DB,Home,로버트 카터,2,0,5,0.0,0,2,0.0,0,7,0.0,2,2,100.0,2,4,6,1,0,0,0,0,2,0
../kbl_data/2024-2025,S45G01N138,원주 DB,Home,김보배,6,2,3,66.7,0,0,0.0,2,3,66.7,2,4,50.0,2,1,3,1,1,1,0,1,1,0
../kbl_data/2024-2025,S45G01N138,울산 현대모비스,Away,장재석,4,2,4,50.0,0,0,0.0,2,4,50.0,0,0,0.0,1,2,3,1,3,1,0,0,0,2
../kbl_data/2024-2025,S45G01N138,울산 현대모비스,Away,김지완,0,0,0,0.0,0,1,0.0,0,1,0.0,0,0,0.0,0,1,1,0,0,0,0,0,0,0
../kbl_data/2024-2025,S45G01N138,울산 현대모비스,Away,한호빈,2,1,1,100.0,0,0,0.0,1,1,100.0,0,0,0.0,0,3,3,0,1,0,0,0,0,3
../kbl_data/2024-2025,S45G01N138,울산 현대모비스,Away,김준일,8,3,7,42.9,0,0,0.0,3,7,42.9,2,2,100.0,4,0,4,1,0,2,0,0,1,1
../kbl_data/2024-2025,S45G01N138,울산 현대모비스,Away,조한진,0,0,0,0.0,0,1,0.0,0,1,0.0,0,0,0.0,0,0,0,0,0,0,0,0,0,1
../kbl_data/2024-2025,S45G01N138,울산 현대모비스,Away,숀 롱,25,12,18,66.7,0,1,0.0,12,19,63.2,1,1,100.0,5,6,11,2,2,1,0,7,2,1
../kbl_data/2024-2025,S45G01N138,울산 현대모비스,Away,이우석,12,3,6,50.0,2,4,50.0,5,10,50.0,0,0,0.0,0,2,2,3,1,0,0,0,0,1
../kbl_data/2024-2025,S45G01N138,울산 현대모비스,Away,이승우,11,4,8,50.0,1,2,50.0,5,10,50.0,0,0,0.0,3,3,6,0,3,0,0,0,2,3
../kbl_data/2024-2025,S45G01N138,울산 현대모비스,Away,신민석,2,1,2,50.0,0,2,0.0,1,4,25.0,0,0,0.0,1,2,3,1,1,0,0,0,0,2
../kbl_data/2024-2025,S45G01N138,울산 현대모비스,Away,게이지 프림,20,8,15,53.3,0,1,0.0,8,16,50.0,4,4,100.0,3,5,8,4,1,0,0,1,2,2
../kbl_data/2024-2025,S45G01N138,울산 현대모비스,Away,박무빈,8,4,7,57.1,0,1,0.0,4,8,50.0,0,2,0.0,0,5,5,5,3,0,0,0,1,2
../kbl_data/2024-2025,S45G01N138,울산 현대모비스,Away,미구엘 안드레 옥존,2,0,5,0.0,0,1,0.0,0,6,0.0,2,2,100.0,0,3,3,1,2,0,0,0,3,4
../kbl_data/2024-2025,S45G01N139,안양 정관장,Home,송창용,0,0,0,0.0,0,0,0.0,0,0,0.0,0,0,0.0,0,0,0,0,0,0,0,0,0,0
../kbl_data/2024-2025,S45G01N139,안양 정관장,Home,배병준,10,1,2,50.0,2,6,33.3,3,8,37.5,2,2,100.0,0,6,6,2,1,0,0,0,2,3
../kbl_data/2024-2025,S45G01N139,안양 정관장,Home,정효근,18,4,6,66.7,2,4,50.0,6,10,60.0,4,6,66.7,0,5,5,2,0,0,0,0,2,3
../kbl_data/2024-2025,S45G01N139,안양 정관장,Home,이종현,2,1,3,33.3,0,0,0.0,1,3,33.3,0,0,0.0,0,1,1,0,0,0,0,0,0,2
../kbl_data/2024-2025,S45G01N139,안양 정관장,Home,박지훈,20,4,6,66.7,4,4,100.0,8,10,80.0,0,0,0.0,2,10,12,14,0,0,0,0,6,12
../kbl_data/2024-2025,S45G01N139,안양 정관장,Home,디온테 버튼,12,6,15,40.0,0,3,0.0,6,18,33.3,0,0,0.0,1,9,10,5,1,0,0,0,2,2
../kbl_data/2024-2025,S45G01N139,안양 정관장,Home,이우정,0,0,0,0.0,0,0,0.0,0,0,0.0,0,0,0.0,0,0,0,0,0,0,0,0,0,0
../kbl_data/2024-2025,S45G01N139,안양 정관장,Home,한승희,6,2,4,50.0,0,0,0.0,2,4,50.0,2,2,100.0,2,1,3,0,0,0,0,0,1,1
../kbl_data/2024-2025,S45G01N139,안양 정관장,Home,클리프 알렉산더,4,1,3,33.3,0,2,0.0,1,5,20.0,2,2,100.0,1,1,2,0,1,0,0,0,0,1
../kbl_data/2024-2025,S45G01N139,안양 정관장,Home,하비 고메즈,12,3,6,50.0,2,4,50.0,5,10,50.0,0,0,0.0,2,2,4,0,0,2,0,0,2,2
../kbl_data/2024-2025,S45G01N139,안양 정관장,Home,박정웅,0,0,0,0.0,0,0,0.0,0,0,0.0,0,0,0.0,0,0,0,0,0,0,0,0,0,0
../kbl_data/2024-2025,S45G01N139,안양 정관장,Home,소준혁,0,0,0,0.0,0,1,0.0,0,1,0.0,0,0,0.0,0,1,1,0,0,0,0,0,0,3
../kbl_data/2024-2025,S45G01N139,대구 한국가스공사,Away,차바위,0,0,0,0.0,0,0,0.0,0,0,0.0,0,0,0.0,0,0,0,0,0,0,0,0,0,0
../kbl_data/2024-2025,S45G01N139,대구 한국가스공사,Away,박지훈,20,4,6,66.7,4,4,100.0,8,10,80.0,0,0,0.0,2,10,12,14,0,0,0,0,6,12
../kbl_data/2024-2025,S45G01N139,대구 한국가스공사,Away,이대헌,12,6,10,60.0,0,2,0.0,6,12,50.0,0,0,0.0,2,4,6,3,0,2,0,0,0,2
../kbl_data/2024-2025,S45G01N139,대구 한국가스공사,Away,정성우,0,0,0,0.0,0,3,0.0,0,3,0.0,0,0,0.0,0,0,0,3,0,0,1,0,1,2
../kbl_data/2024-2025,S45G01N139,대구 한국가스공사,Away,김철욱,0,0,0,0.0,0,1,0.0,0,1,0.0,0,0,0.0,1,0,1,0,0,0,0,0,0,1
../kbl_data/2024-2025,S45G01N139,대구 한국가스공사,Away,김낙현,9,0,2,0.0,3,13,23.1,3,15,20.0,0,0,0.0,1,0,1,3,0,0,0,0,1,1
../kbl_data/2024-2025,S45G01N139,대구 한국가스공사,Away,전현우,3,0,0,0.0,1,3,33.3,1,3,33.3,0,2,0.0,1,2,3,0,0,0,0,0,0,0
../kbl_data/2024-2025,S45G01N139,대구 한국가스공사,Away,양재혁,0,0,0,0.0,0,1,0.0,0,1,0.0,0,0,0.0,1,0,1,1,0,0,0,0,1,4
../kbl_data/2024-2025,S45G01N139,대구 한국가스공사,Away,곽정훈,0,0,0,0.0,0,0,0.0,0,0,0.0,0,0,0.0,0,0,0,0,0,0,0,0,0,1
../kbl_data/2024-2025,S45G01N139,대구 한국가스공사,Away,신승민,5,0,1,0.0,0,4,0.0,0,5,0.0,5,5,100.0,1,1,2,1,0,1,0,0,1,2
../kbl_data/2024-2025,S45G01N139,대구 한국가스공사,Away,샘조세프 벨란겔,10,4,10,40.0,0,7,0.0,4,17,23.5,2,2,100.0,0,0,0,4,3,0,0,0,1,2
../kbl_data/2024-2025,S45G01N139,대구 한국가스공사,Away,유슈 은도예,28,10,19,52.6,1,2,50.0,11,21,52.4,5,8,62.5,11,17,28,1,3,2,0,3,2,3
../kbl_data/2024-2025,S45G01N140,고양 소노,Home,임동섭,12,4,4,100.0,1,6,16.7,5,10,50.0,1,2,50.0,2,0,2,2,1,0,0,0,1,4
../kbl_data/2024-2025,S45G01N140,고양 소노,Home,이재도,3,0,2,0.0,1,6,16.7,1,8,12.5,0,0,0.0,0,4,4,5,0,0,0,0,1,1
../kbl_data/2024-2025,S45G01N140,고양 소노,Home,최승욱,0,0,0,0.0,0,1,0.0,0,1,0.0,0,0,0.0,0,0,0,1,0,0,0,0,0,1
../kbl_data/2024-2025,S45G01N140,고양 소노,Home,김진유,5,1,1,100.0,1,3,33.3,2,4,50.0,0,0,0.0,0,2,2,0,0,0,0,0,1,0
../kbl_data/2024-2025,S45G01N140,고양 소노,Home,박진철,2,1,4,25.0,0,0,0.0,1,4,25.0,0,0,0.0,1,3,4,2,2,0,0,0,0,0
../kbl_data/2024-2025,S45G01N140,고양 소노,Home,박종하,5,1,1,100.0,0,2,0.0,1,3,33.3,3,4,75.0,0,0,0,0,0,0,0,0,1,2
../kbl_data/2024-2025,S45G01N140,고양 소노,Home,민기남,9,0,0,0.0,3,5,60.0,3,5,60.0,0,0,0.0,0,1,1,1,1,0,0,0,3,2
../kbl_data/2024-2025,S45G01N140,고양 소노,Home,디제이 번즈 Jr,4,2,6,33.3,0,0,0.0,2,6,33.3,0,0,0.0,0,1,1,2,0,1,0,0,2,1
../kbl_data/2024-2025,S45G01N140,고양 소노,Home,이근준,3,0,2,0.0,1,5,20.0,1,7,14.3,0,0,0.0,2,5,7,1,2,1,0,0,1,3
../kbl_data/2024-2025,S45G01N140,고양 소노,Home,서동원,5,1,2,50.0,1,4,25.0,2,6,33.3,0,0,0.0,0,1,1,0,0,0,0,0,0,1
../kbl_data/2024-2025,S45G01N140,고양 소노,Home,알파 카바,3,1,6,16.7,0,0,0.0,1,6,16.7,1,2,50.0,6,3,9,1,0,0,0,1,3,2
../kbl_data/2024-2025,S45G01N140,고양 소노,Home,케빈 켐바오,6,0,0,0.0,2,5,40.0,2,5,40.0,0,0,0.0,0,1,1,0,0,0,0,0,0,0
../kbl_data/2024-2025,S45G01N140,서울 SK,Away,오세근,7,3,4,75.0,0,3,0.0,3,7,42.9,1,2,50.0,0,4,4,1,0,0,0,0,1,0
../kbl_data/2024-2025,S45G01N140,서울 SK,Away,최부경,8,1,3,33.3,2,3,66.7,3,6,50.0,0,0,0.0,2,0,2,0,0,1,0,0,0,1
../kbl_data/2024-2025,S45G01N140,서울 SK,Away,최원혁,2,1,1,100.0,0,1,0.0,1,2,50.0,0,0,0.0,0,2,2,3,3,0,0,0,2,1
../kbl_data/2024-2025,S45G01N140,서울 SK,Away,김지후,3,0,0,0.0,1,1,100.0,1,1,100.0,0,0,0.0,0,0,0,0,0,0,0,0,0,1
../kbl_data/2024-2025,S45G01N140,서울 SK,Away,안영준,13,3,6,50.0,2,5,40.0,5,11,45.5,1,2,50.0,2,5,7,2,2,3,0,1,1,2
../kbl_data/2024-2025,S45G01N140,서울 SK,Away,자밀 워니,13,4,9,44.4,1,5,20.0,5,14,35.7,2,2,100.0,1,9,10,3,1,0,0,1,2,1
../kbl_data/2024-2025,S45G01N140,서울 SK,Away,전성환,0,0,0,0.0,0,0,0.0,0,0,0.0,0,0,0.0,0,0,0,0,0,0,0,0,1,0
../kbl_data/2024-2025,S45G01N140,서울 SK,Away,아이재아 힉스,12,3,4,75.0,2,2,100.0,5,6,83.3,0,0,0.0,0,3,3,0,1,1,0,2,1,2
../kbl_data/2024-2025,S45G01N140,서울 SK,Away,박민우,3,0,1,0.0,1,1,100.0,1,2,50.0,0,0,0.0,0,0,0,0,0,0,0,0,0,0
../kbl_data/2024-2025,S45G01N140,서울 SK,Away,오재현,13,4,4,100.0,1,2,50.0,5,6,83.3,2,2,100.0,0,3,3,6,1,0,0,0,0,3
../kbl_data/2024-2025,S45G01N140,서울 SK,Away,고메즈 델 리아노,8,1,4,25.0,2,2,100.0,3,6,50.0,0,0,0.0,1,2,3,2,1,0,0,0,1,1
../kbl_data/2024-2025,S45G01N140,서울 SK,Away,김태훈,2,1,1,100.0,0,1,0.0,1,2,50.0,0,0,0.0,1,0,1,1,1,0,0,0,0,0
../kbl_data/2024-2025,S45G01N141,부산 KCC,Home,정창영,5,1,2,50.0,1,1,100.0,2,3,66.7,0,0,0.0,0,1,1,2,0,0,0,0,1,1
../kbl_data/2024-2025,S45G01N141,부산 KCC,Home,리온 윌리엄스,10,3,6,50.0,0,1,0.0,3,7,42.9,4,4,100.0,0,3,3,0,2,1,0,0,0,2
../kbl_data/2024-2025,S45G01N141,부산 KCC,Home,전준범,8,0,0,0.0,2,4,50.0,2,4,50.0,2,2,100.0,0,4,4,1,0,0,0,0,0,1
../kbl_data/2024-2025,S45G01N141,부산 KCC,Home,허웅,6,1,3,33.3,1,3,33.3,2,6,33.3,1,1,100.0,0,0,0,1,0,0,0,0,3,2
../kbl_data/2024-2025,S45G01N141,부산 KCC,Home,이승현,2,1,4,25.0,0,0,0.0,1,4,25.0,0,0,0.0,0,1,1,3,1,0,0,0,1,2
../kbl_data/2024-2025,S45G01N141,부산 KCC,Home,이호현,6,3,6,50.0,0,1,0.0,3,7,42.9,0,0,0.0,1,2,3,1,0,0,0,0,1,0
../kbl_data/2024-2025,S45G01N141,부산 KCC,Home,캐디 라렌,13,6,13,46.2,0,1,0.0,6,14,42.9,1,2,50.0,6,1,7,1,0,2,0,0,4,1
../kbl_data/2024-2025,S45G01N141,부산 KCC,Home,이근휘,6,0,0,0.0,2,3,66.7,2,3,66.7,0,0,0.0,0,0,0,0,0,0,0,0,0,1
../kbl_data/2024-2025,S45G01N141,부산 KCC,Home,김동현,5,1,3,33.3,1,3,33.3,2,6,33.3,0,0,0.0,1,4,5,0,0,1,0,0,2,3
../kbl_data/2024-2025,S45G01N141,부산 KCC,Home,송동훈,0,0,0,0.0,0,0,0.0,0,0,0.0,0,0,0.0,0,0,0,0,0,0,0,0,0,0
../kbl_data/2024-2025,S45G01N141,부산 KCC,Home,여준형,2,0,0,0.0,0,0,0.0,0,0,0.0,2,4,50.0,1,1,2,0,0,0,0,0,2,1
../kbl_data/2024-2025,S45G01N141,부산 KCC,Home,이주영,6,3,5,60.0,0,2,0.0,3,7,42.9,0,0,0.0,1,0,1,3,2,0,0,0,1,1
../kbl_data/2024-2025,S45G01N141,서울 삼성,Away,이정현,11,1,3,33.3,3,4,75.0,4,7,57.1,0,0,0.0,1,3,4,5,2,0,0,0,4,2
../kbl_data/2024-2025,S45G01N141,서울 삼성,Away,최현민,3,0,0,0.0,1,2,50.0,1,2,50.0,0,0,0.0,0,0,0,1,1,0,1,0,0,0
../kbl_data/2024-2025,S45G01N141,서울 삼성,Away,최성모,6,0,0,0.0,2,5,40.0,2,5,40.0,0,0,0.0,1,2,3,4,0,0,0,0,3,3
../kbl_data/2024-2025,S45G01N141,서울 삼성,Away,최승욱,9,3,4,75.0,1,3,33.3,4,7,57.1,0,0,0.0,0,0,0,1,0,0,1,0,0,2
../kbl_data/2024-2025,S45G01N141,서울 삼성,Away,윤성원,0,0,0,0.0,0,0,0.0,0,0,0.0,0,0,0.0,1,0,1,1,1,0,0,0,1,3
../kbl_data/2024-2025,S45G01N141,서울 삼성,Away,마커스 데릭슨,3,0,2,0.0,1,4,25.0,1,6,16.7,0,0,0.0,0,2,2,1,0,0,0,0,0,1
../kbl_data/2024-2025,S45G01N141,서울 삼성,Away,이원석,12,6,7,85.7,0,0,0.0,6,7,85.7,0,0,0.0,0,2,2,0,2,1,0,1,2,2
../kbl_data/2024-2025,S45G01N141,서울 삼성,Away,저스틴 구탕,12,4,4,100.0,1,4,25.0,5,8,62.5,1,2,50.0,0,6,6,3,0,0,0,0,1,3
../kbl_data/2024-2025,S45G01N141,서울 삼성,Away,박승재,5,1,4,25.0,1,2,50.0,2,6,33.3,0,0,0.0,1,2,3,6,1,0,0,0,1,2
../kbl_data/2024-2025,S45G01N141,서울 삼성,Away,코피 코번,20,9,13,69.2,0,0,0.0,9,13,69.2,2,2,100.0,1,7,8,0,0,0,0,2,1,2
../kbl_data/2024-2025,S45G01N141,서울 삼성,Away,임동언,0,0,0,0.0,0,1,0.0,0,1,0.0,0,0,0.0,0,1,1,0,0,0,0,0,0,0
../kbl_data/2024-2025,S45G01N141,서울 삼성,Away,황영찬,0,0,1,0.0,0,0,0.0,0,1,0.0,0,0,0.0,0,0,0,0,0,0,0,0,0,1
../kbl_data/2024-2025,S45G01N142,수원 KT,Home,한희원,9,2,5,40.0,1,2,50.0,3,7,42.9,2,2,100.0,3,3,6,1,1,0,0,0,2,1
../kbl_data/2024-2025,S45G01N142,수원 KT,Home,문성곤,0,0,0,0.0,0,0,0.0,0,0,0.0,0,0,0.0,0,0,0,0,0,0,0,0,0,0
../kbl_data/2024-2025,S45G01N142,수원 KT,Home,이현석,0,0,0,0.0,0,0,0.0,0,0,0.0,0,2,0.0,0,0,0,0,1,0,0,0,0,0
../kbl_data/2024-2025,S45G01N142,수원 KT,Home,허훈,11,2,4,50.0,2,6,33.3,4,10,40.0,1,2,50.0,0,1,1,7,0,1,0,0,2,4
../kbl_data/2024-2025,S45G01N142,수원 KT,Home,박준영,0,0,0,0.0,0,3,0.0,0,3,0.0,0,0,0.0,2,2,4,4,1,0,0,0,1,1
../kbl_data/2024-2025,S45G01N142,수원 KT,Home,박지원,0,0,1,0.0,0,1,0.0,0,2,0.0,0,0,0.0,0,1,1,1,0,0,0,0,1,1
../kbl_data/2024-2025,S45G01N142,수원 KT,Home,하윤기,14,6,13,46.2,0,0,0.0,6,13,46.2,2,3,66.7,1,3,4,1,0,0,0,0,0,0
../kbl_data/2024-2025,S45G01N142,수원 KT,Home,이두원,0,0,0,0.0,0,0,0.0,0,0,0.0,0,0,0.0,0,0,0,0,0,0,0,0,0,0
../kbl_data/2024-2025,S45G01N142,수원 KT,Home,문정현,9,0,4,0.0,3,7,42.9,3,11,27.3,0,0,0.0,3,4,7,2,0,0,0,0,0,2
../kbl_data/2024-2025,S45G01N142,수원 KT,Home,박성재,0,0,0,0.0,0,0,0.0,0,0,0.0,0,0,0.0,0,0,0,0,0,0,0,0,0,1
../kbl_data/2024-2025,S45G01N142,수원 KT,Home,이스마엘 로메로,18,8,8,100.0,0,1,0.0,8,9,88.9,2,2,100.0,2,7,9,2,1,0,0,2,1,2
../kbl_data/2024-2025,S45G01N142,수원 KT,Home,조엘 카굴랑안,9,4,7,57.1,0,1,0.0,4,8,50.0,1,3,33.3,1,0,1,3,0,0,0,0,1,2
../kbl_data/2024-2025,S45G01N142,창원 LG,Away,허일영,12,0,0,0.0,4,5,80.0,4,5,80.0,0,0,0.0,1,1,2,0,0,1,0,0,0,3
../kbl_data/2024-2025,S45G01N142,창원 LG,Away,장민국,0,0,0,0.0,0,0,0.0,0,0,0.0,0,0,0.0,0,1,1,0,0,0,0,0,0,1
../kbl_data/2024-2025,S45G01N142,창원 LG,Away,한상혁,0,0,1,0.0,0,0,0.0,0,1,0.0,0,0,0.0,0,0,0,1,0,0,0,0,1,2
../kbl_data/2024-2025,S45G01N142,창원 LG,Away,전성현,6,0,0,0.0,2,5,40.0,2,5,40.0,0,0,0.0,0,0,0,0,0,0,0,0,1,0
../kbl_data/2024-2025,S45G01N142,창원 LG,Away,정인덕,2,1,1,100.0,0,1,0.0,1,2,50.0,0,0,0.0,1,1,2,1,0,0,0,0,0,4
../kbl_data/2024-2025,S45G01N142,창원 LG,Away,대릴 먼로,18,9,16,56.2,0,2,0.0,9,18,50.0,0,0,0.0,4,12,16,5,1,0,0,0,0,1
../kbl_data/2024-2025,S45G01N142,창원 LG,Away,박정현,0,0,0,0.0,0,0,0.0,0,0,0.0,0,0,0.0,0,0,0,0,0,0,0,0,0,0
../kbl_data/2024-2025,S45G01N142,창원 LG,Away,양준석,16,2,7,28.6,4,6,66.7,6,13,46.2,0,0,0.0,1,1,2,6,1,0,0,0,0,4
../kbl_data/2024-2025,S45G01N142,창원 LG,Away,유기상,10,2,2,100.0,2,7,28.6,4,9,44.4,0,0,0.0,0,2,2,4,2,0,0,0,2,1
../kbl_data/2024-2025,S45G01N142,창원 LG,Away,칼 타마요,8,4,13,30.8,0,2,0.0,4,15,26.7,0,0,0.0,1,4,5,2,1,0,0,0,1,2
../kbl_data/2024-2025,S45G01N142,창원 LG,Away,최형찬,0,0,0,0.0,0,0,0.0,0,0,0.0,0,0,0.0,0,0,0,0,0,0,0,0,0,0
../kbl_data/2024-2025,S45G01N142,창원 LG,Away,브라이언 그리핀,6,1,4,25.0,0,0,0.0,1,4,25.0,4,4,100.0,2,2,4,2,0,1,0,0,0,0
../kbl_data/2024-2025,S45G01N143,원주 DB,Home,이관희,7,1,2,50.0,1,3,33.3,2,5,40.0,2,2,100.0,0,6,6,0,1,0,0,0,1,0
../kbl_data/2024-2025,S45G01N143,원주 DB,Home,김시래,0,0,0,0.0,0,0,0.0,0,0,0.0,0,0,0.0,0,0,0,0,0,0,0,0,0,0
../kbl_data/2024-2025,S45G01N143,원주 DB,Home,서민수,11,1,3,33.3,3,7,42.9,4,10,40.0,0,0,0.0,1,4,5,1,1,0,0,0,0,3
../kbl_data/2024-2025,S45G01N143,원주 DB,Home,김영현,5,1,1,100.0,1,5,20.0,2,6,33.3,0,0,0.0,0,0,0,1,0,0,0,0,0,4
../kbl_data/2024-2025,S45G01N143,원주 DB,Home,치나누 오누아쿠,12,2,6,33.3,2,5,40.0,4,11,36.4,2,4,50.0,1,6,7,3,0,3,0,0,3,3
../kbl_data/2024-2025,S45G01N143,원주 DB,Home,김훈,0,0,1,0.0,0,0,0.0,0,1,0.0,0,0,0.0,0,1,1,1,1,1,0,0,1,1
../kbl_data/2024-2025,S45G01N143,원주 DB,Home,이윤수,0,0,0,0.0,0,0,0.0,0,0,0.0,0,0,0.0,0,0,0,0,0,0,0,0,0,0
../kbl_data/2024-2025,S45G01N143,원주 DB,Home,이용우,0,0,0,0.0,0,0,0.0,0,0,0.0,0,0,0.0,0,0,0,0,0,0,0,0,0,0
../kbl_data/2024-2025,S45G01N143,원주 DB,Home,이선 알바노,17,5,8,62.5,1,5,20.0,6,13,46.2,4,5,80.0,0,5,5,7,2,1,0,0,2,3
../kbl_data/2024-2025,S45G01N143,원주 DB,Home,박인웅,17,7,9,77.8,1,2,50.0,8,11,72.7,0,0,0.0,4,3,7,3,2,0,0,0,0,2
../kbl_data/2024-2025,S45G01N143,원주 DB,Home,로버트 카터,11,2,4,50.0,2,3,66.7,4,7,57.1,1,2,50.0,1,2,3,2,1,1,0,0,1,0
../kbl_data/2024-2025,S45G01N143,원주 DB,Home,김보배,0,0,0,0.0,0,0,0.0,0,0,0.0,0,0,0.0,0,0,0,0,0,0,0,0,0,0
../kbl_data/2024-2025,S45G01N143,대구 한국가스공사,Away,박지훈,0,0,0,0.0,0,1,0.0,0,1,0.0,0,0,0.0,1,0,1,0,0,0,0,0,0,0
../kbl_data/2024-2025,S45G01N143,대구 한국가스공사,Away,이대헌,2,1,7,14.3,0,0,0.0,1,7,14.3,0,0,0.0,0,3,3,1,1,0,0,0,0,2
../kbl_data/2024-2025,S45G01N143,대구 한국가스공사,Away,정성우,2,1,2,50.0,0,1,0.0,1,3,33.3,0,0,0.0,0,1,1,3,1,0,1,0,4,3
../kbl_data/2024-2025,S45G01N143,대구 한국가스공사,Away,김낙현,15,2,5,40.0,3,6,50.0,5,11,45.5,2,2,100.0,0,1,1,4,0,0,0,0,2,2
../kbl_data/2024-2025,S45G01N143,대구 한국가스공사,Away,전현우,13,2,3,66.7,3,9,33.3,5,12,41.7,0,0,0.0,1,1,2,0,0,1,0,0,0,3
../kbl_data/2024-2025,S45G01N143,대구 한국가스공사,Away,양재혁,0,0,0,0.0,0,0,0.0,0,0,0.0,0,0,0.0,1,2,3,2,0,0,1,0,0,2
../kbl_data/2024-2025,S45G01N143,대구 한국가스공사,Away,곽정훈,2,1,3,33.3,0,3,0.0,1,6,16.7,0,0,0.0,4,1,5,1,0,0,0,0,1,2
../kbl_data/2024-2025,S45G01N143,대구 한국가스공사,Away,앤드류 니콜슨,20,5,11,45.5,3,7,42.9,8,18,44.4,1,2,50.0,4,10,14,0,1,0,0,2,1,2
../kbl_data/2024-2025,S45G01N143,대구 한국가스공사,Away,신승민,0,0,2,0.0,0,0,0.0,0,2,0.0,0,0,0.0,0,0,0,0,0,0,0,0,1,0
../kbl_data/2024-2025,S45G01N143,대구 한국가스공사,Away,샘조세프 벨란겔,7,3,5,60.0,0,4,0.0,3,9,33.3,1,2,50.0,1,0,1,2,0,0,0,0,0,2
../kbl_data/2024-2025,S45G01N143,대구 한국가스공사,Away,유슈 은도예,3,0,3,0.0,1,1,100.0,1,4,25.0,0,0,0.0,4,5,9,1,0,0,0,0,2,3
../kbl_data/2024-2025,S45G01N143,대구 한국가스공사,Away,신주영,4,2,2,100.0,0,1,0.0,2,3,66.7,0,0,0.0,2,3,5,1,0,0,0,0,2,0
../kbl_data/2024-2025,S45G01N144,서울 SK,Home,김선형,11,4,5,80.0,1,3,33.3,5,8,62.5,0,0,0.0,1,4,5,4,2,0,0,0,3,0
../kbl_data/2024-2025,S45G01N144,서울 SK,Home,오세근,16,2,3,66.7,4,6,66.7,6,9,66.7,0,0,0.0,2,3,5,1,1,0,0,0,0,1
../kbl_data/2024-2025,S45G01N144,서울 SK,Home,최부경,4,2,2,100.0,0,0,0.0,2,2,100.0,0,0,0.0,1,2,3,1,0,0,0,1,0,2
../kbl_data/2024-2025,S45G01N144,서울 SK,Home,최원혁,3,0,0,0.0,1,3,33.3,1,3,33.3,0,0,0.0,1,2,3,1,1,0,0,0,1,2
../kbl_data/2024-2025,S45G01N144,서울 SK,Home,김지후,0,0,0,0.0,0,1,0.0,0,1,0.0,0,0,0.0,0,0,0,0,0,0,0,0,0,0
../kbl_data/2024-2025,S45G01N144,서울 SK,Home,자밀 워니,29,9,17,52.9,3,8,37.5,12,25,48.0,2,2,100.0,6,10,16,10,2,0,0,1,2,2
../kbl_data/2024-2025,S45G01N144,서울 SK,Home,아이재아 힉스,5,1,2,50.0,1,1,100.0,2,3,66.7,0,0,0.0,0,0,0,1,0,0,0,0,1,2
../kbl_data/2024-2025,S45G01N144,서울 SK,Home,박민우,0,0,0,0.0,0,0,0.0,0,0,0.0,0,0,0.0,0,1,1,0,0,0,0,0,0,0
../kbl_data/2024-2025,S45G01N144,서울 SK,Home,오재현,16,3,7,42.9,2,6,33.3,5,13,38.5,4,4,100.0,0,3,3,4,0,0,0,0,1,3
../kbl_data/2024-2025,S45G01N144,서울 SK,Home,문가온,0,0,0,0.0,0,0,0.0,0,0,0.0,0,0,0.0,0,0,0,0,0,0,0,0,0,0
../kbl_data/2024-2025,S45G01N144,서울 SK,Home,고메즈 델 리아노,0,0,2,0.0,0,1,0.0,0,3,0.0,0,0,0.0,1,0,1,1,0,0,0,0,0,2
../kbl_data/2024-2025,S45G01N144,서울 SK,Home,김태훈,0,0,0,0.0,0,3,0.0,0,3,0.0,0,0,0.0,1,2,3,0,0,0,0,0,1,2
../kbl_data/2024-2025,S45G01N144,안양 정관장,Away,정준원,0,0,0,0.0,0,0,0.0,0,0,0.0,0,0,0.0,0,0,0,2,0,0,0,0,0,0
../kbl_data/2024-2025,S45G01N144,안양 정관장,Away,배병준,13,5,7,71.4,1,2,50.0,6,9,66.7,0,0,0.0,0,1,1,2,1,1,0,0,1,2
../kbl_data/2024-2025,S45G01N144,안양 정관장,Away,정효근,8,1,3,33.3,2,5,40.0,3,8,37.5,0,0,0.0,1,4,5,1,0,1,0,0,1,4
../kbl_data/2024-2025,S45G01N144,안양 정관장,Away,박지훈,16,2,4,50.0,4,9,44.4,6,13,46.2,0,0,0.0,2,7,9,5,0,0,0,0,3,3
../kbl_data/2024-2025,S45G01N144,안양 정관장,Away,디온테 버튼,15,6,13,46.2,0,6,0.0,6,19,31.6,3,4,75.0,3,3,6,2,2,1,1,0,3,1
../kbl_data/2024-2025,S45G01N144,안양 정관장,Away,이우정,0,0,0,0.0,0,0,0.0,0,0,0.0,0,0,0.0,0,0,0,0,0,0,0,0,0,0
../kbl_data/2024-2025,S45G01N144,안양 정관장,Away,김경원,0,0,0,0.0,0,0,0.0,0,0,0.0,0,0,0.0,0,2,2,1,0,0,0,0,0,2
../kbl_data/2024-2025,S45G01N144,안양 정관장,Away,한승희,0,0,0,0.0,0,0,0.0,0,0,0.0,0,0,0.0,0,0,0,0,0,0,0,0,0,0
../kbl_data/2024-2025,S45G01N144,안양 정관장,Away,클리프 알렉산더,4,2,6,33.3,0,1,0.0,2,7,28.6,0,0,0.0,2,1,3,0,0,0,0,2,0,0
../kbl_data/2024-2025,S45G01N144,안양 정관장,Away,하비 고메즈,10,2,4,50.0,2,8,25.0,4,12,33.3,0,0,0.0,2,4,6,1,2,0,0,0,1,1
../kbl_data/2024-2025,S45G01N144,안양 정관장,Away,박정웅,0,0,0,0.0,0,0,0.0,0,0,0.0,0,0,0.0,1,0,1,1,0,0,0,0,1,0
../kbl_data/2024-2025,S45G01N144,안양 정관장,Away,소준혁,3,0,1,0.0,1,2,50.0,1,3,33.3,0,2,0.0,0,0,0,0,0,0,0,0,0,1
../kbl_data/2024-2025,S45G01N145,창원 LG,Home,허일영,2,1,2,50.0,0,4,0.0,1,6,16.7,0,0,0.0,0,3,3,0,1,0,0,0,0,3
../kbl_data/2024-2025,S45G01N145,창원 LG,Home,최진수,0,0,0,0.0,0,0,0.0,0,0,0.0,0,0,0.0,0,0,0,0,0,0,0,0,0,0
../kbl_data/2024-2025,S45G01N145,창원 LG,Home,장민국,0,0,0,0.0,0,1,0.0,0,1,0.0,0,0,0.0,0,0,0,2,0,0,0,0,0,0
../kbl_data/2024-2025,S45G01N145,창원 LG,Home,한상혁,0,0,1,0.0,0,0,0.0,0,1,0.0,0,0,0.0,0,1,1,1,0,0,1,0,0,2
../kbl_data/2024-2025,S45G01N145,창원 LG,Home,전성현,0,0,1,0.0,0,0,0.0,0,1,0.0,0,0,0.0,1,1,2,0,0,0,0,0,0,1
../kbl_data/2024-2025,S45G01N145,창원 LG,Home,정인덕,10,0,3,0.0,2,5,40.0,2,8,25.0,4,5,80.0,0,2,2,3,0,0,0,0,1,3
../kbl_data/2024-2025,S45G01N145,창원 LG,Home,대릴 먼로,10,4,9,44.4,0,0,0.0,4,9,44.4,2,2,100.0,4,8,12,2,1,1,0,0,0,1
../kbl_data/2024-2025,S45G01N145,창원 LG,Home,박정현,0,0,0,0.0,0,0,0.0,0,0,0.0,0,0,0.0,0,0,0,0,0,0,0,0,0,0
../kbl_data/2024-2025,S45G01N145,창원 LG,Home,양준석,16,5,6,83.3,2,4,50.0,7,10,70.0,0,0,0.0,2,1,3,12,1,1,0,0,3,4
../kbl_data/2024-2025,S45G01N145,창원 LG,Home,유기상,14,2,5,40.0,2,6,33.3,4,11,36.4,4,4,100.0,1,4,5,1,0,0,0,0,1,3
../kbl_data/2024-2025,S45G01N145,창원 LG,Home,칼 타마요,24,5,12,41.7,3,5,60.0,8,17,47.1,5,5,100.0,2,5,7,0,2,2,0,0,2,3
../kbl_data/2024-2025,S45G01N145,창원 LG,Home,브라이언 그리핀,8,4,5,80.0,0,1,0.0,4,6,66.7,0,0,0.0,0,1,1,0,0,1,0,1,0,1
../kbl_data/2024-2025,S45G01N145,서울 삼성,Away,이정현,8,1,6,16.7,2,9,22.2,3,15,20.0,0,0,0.0,0,2,2,12,0,0,0,0,1,3
../kbl_data/2024-2025,S45G01N145,서울 삼성,Away,최현민,3,0,0,0.0,1,3,33.3,1,3,33.3,0,0,0.0,0,4,4,1,0,0,0,0,1,2
../kbl_data/2024-2025,S45G01N145,서울 삼성,Away,이원대,0,0,0,0.0,0,3,0.0,0,3,0.0,0,0,0.0,0,0,0,0,0,0,0,0,0,2
../kbl_data/2024-2025,S45G01N145,서울 삼성,Away,최성모,24,3,5,60.0,6,10,60.0,9,15,60.0,0,1,0.0,0,1,1,2,0,0,1,0,2,3
../kbl_data/2024-2025,S45G01N145,서울 삼성,Away,최승욱,0,0,1,0.0,0,0,0.0,0,1,0.0,0,0,0.0,0,1,1,0,0,1,0,0,1,3
../kbl_data/2024-2025,S45G01N145,서울 삼성,Away,윤성원,0,0,0,0.0,0,0,0.0,0,0,0.0,0,0,0.0,0,0,0,0,0,0,0,0,0,0
../kbl_data/2024-2025,S45G01N145,서울 삼성,Away,마커스 데릭슨,8,2,2,100.0,1,4,25.0,3,6,50.0,1,2,50.0,2,5,7,1,0,0,0,0,1,1
../kbl_data/2024-2025,S45G01N145,서울 삼성,Away,차민석,0,0,0,0.0,0,0,0.0,0,0,0.0,0,0,0.0,0,0,0,0,0,0,0,0,0,1
../kbl_data/2024-2025,S45G01N145,서울 삼성,Away,이원석,11,3,5,60.0,1,2,50.0,4,7,57.1,2,4,50.0,1,2,3,0,2,1,0,0,0,2
../kbl_data/2024-2025,S45G01N145,서울 삼성,Away,저스틴 구탕,14,0,2,0.0,4,6,66.7,4,8,50.0,2,2,100.0,1,6,7,1,1,2,0,0,1,5
../kbl_data/2024-2025,S45G01N145,서울 삼성,Away,박승재,2,1,1,100.0,0,0,0.0,1,1,100.0,0,0,0.0,0,0,0,0,0,0,0,0,0,0
../kbl_data/2024-2025,S45G01N145,서울 삼성,Away,코피 코번,9,4,10,40.0,0,0,0.0,4,10,40.0,1,3,33.3,3,7,10,2,0,0,0,0,1,0
../kbl_data/2024-2025,S45G01N146,고양 소노,Home,임동섭,16,1,4,25.0,4,6,66.7,5,10,50.0,2,2,100.0,2,5,7,0,1,0,0,0,4,3
../kbl_data/2024-2025,S45G01N146,고양 소노,Home,이재도,18,5,7,71.4,1,5,20.0,6,12,50.0,5,6,83.3,1,5,6,5,4,0,0,0,2,1
../kbl_data/2024-2025,S45G01N146,고양 소노,Home,최승욱,0,0,3,0.0,0,0,0.0,0,3,0.0,0,0,0.0,0,1,1,3,0,0,1,0,0,1
../kbl_data/2024-2025,S45G01N146,고양 소노,Home,김진유,18,8,9,88.9,0,4,0.0,8,13,61.5,2,2,100.0,2,5,7,1,3,0,0,0,1,3
../kbl_data/2024-2025,S45G01N146,고양 소노,Home,박진철,1,0,2,0.0,0,0,0.0,0,2,0.0,1,6,16.7,1,3,4,0,1,3,0,0,0,0
../kbl_data/2024-2025,S45G01N146,고양 소노,Home,박종하,0,0,0,0.0,0,0,0.0,0,0,0.0,0,0,0.0,0,0,0,0,0,0,0,0,0,1
../kbl_data/2024-2025,S45G01N146,고양 소노,Home,민기남,0,0,1,0.0,0,1,0.0,0,2,0.0,0,0,0.0,0,1,1,1,0,0,0,0,2,2
../kbl_data/2024-2025,S45G01N146,고양 소노,Home,디제이 번즈 Jr,13,6,12,50.0,0,0,0.0,6,12,50.0,1,2,50.0,1,1,2,4,3,0,0,0,2,3
../kbl_data/2024-2025,S45G01N146,고양 소노,Home,서동원,0,0,1,0.0,0,1,0.0,0,2,0.0,0,0,0.0,0,0,0,0,0,0,0,0,0,1
../kbl_data/2024-2025,S45G01N146,고양 소노,Home,정성조,16,5,6,83.3,2,3,66.7,7,9,77.8,0,0,0.0,1,0,1,1,1,0,1,0,1,5
../kbl_data/2024-2025,S45G01N146,고양 소노,Home,김도은,0,0,0,0.0,0,0,0.0,0,0,0.0,0,0,0.0,0,0,0,0,0,0,0,0,0,0
../kbl_data/2024-2025,S45G01N146,고양 소노,Home,알파 카바,2,1,2,50.0,0,0,0.0,1,2,50.0,0,0,0.0,1,1,2,0,0,0,0,0,2,2
../kbl_data/2024-2025,S45G01N146,울산 현대모비스,Away,장재석,2,1,3,33.3,0,0,0.0,1,3,33.3,0,0,0.0,1,1,2,1,0,0,0,0,0,1
../kbl_data/2024-2025,S45G01N146,울산 현대모비스,Away,김지완,0,0,0,0.0,0,0,0.0,0,0,0.0,0,0,0.0,0,0,0,0,0,0,0,0,0,0
../kbl_data/2024-2025,S45G01N146,울산 현대모비스,Away,한호빈,9,2,2,100.0,1,1,100.0,3,3,100.0,2,2,100.0,0,0,0,5,1,0,0,0,3,4
../kbl_data/2024-2025,S45G01N146,울산 현대모비스,Away,김준일,0,0,1,0.0,0,0,0.0,0,1,0.0,0,0,0.0,1,0,1,2,0,0,0,0,1,0
../kbl_data/2024-2025,S45G01N146,울산 현대모비스,Away,김국찬,0,0,0,0.0,0,0,0.0,0,0,0.0,0,0,0.0,0,0,0,0,0,0,0,0,0,2
../kbl_data/2024-2025,S45G01N146,울산 현대모비스,Away,숀 롱,19,7,11,63.6,0,0,0.0,7,11,63.6,5,6,83.3,1,4,5,0,2,0,0,2,4,3
../kbl_data/2024-2025,S45G01N146,울산 현대모비스,Away,이우석,5,2,4,50.0,0,5,0.0,2,9,22.2,1,2,50.0,0,5,5,0,0,0,0,0,4,2
../kbl_data/2024-2025,S45G01N146,울산 현대모비스,Away,이승우,0,0,0,0.0,0,0,0.0,0,0,0.0,0,0,0.0,0,0,0,0,0,0,0,0,0,0
../kbl_data/2024-2025,S45G01N146,울산 현대모비스,Away,신민석,5,1,2,50.0,1,3,33.3,2,5,40.0,0,0,0.0,1,3,4,2,2,0,0,0,1,3
../kbl_data/2024-2025,S45G01N146,울산 현대모비스,Away,게이지 프림,12,5,11,45.5,0,1,0.0,5,12,41.7,2,3,66.7,0,3,3,3,3,0,0,0,2,5
../kbl_data/2024-2025,S45G01N146,울산 현대모비스,Away,박무빈,10,2,3,66.7,2,3,66.7,4,6,66.7,0,0,0.0,2,4,6,0,2,0,0,0,0,1
../kbl_data/2024-2025,S45G01N146,울산 현대모비스,Away,미구엘 안드레 옥존,19,6,7,85.7,1,6,16.7,7,13,53.8,4,5,80.0,1,2,3,3,2,2,0,0,2,1
../kbl_data/2024-2025,S45G01N147,서울 SK,Home,김선형,11,4,9,44.4,1,4,25.0,5,13,38.5,0,0,0.0,0,3,3,6,3,1,0,0,2,3
../kbl_data/2024-2025,S45G01N147,서울 SK,Home,오세근,7,1,2,50.0,1,5,20.0,2,7,28.6,2,2,100.0,0,3,3,1,0,0,0,0,0,3
../kbl_data/2024-2025,S45G01N147,서울 SK,Home,최부경,4,2,2,100.0,0,1,0.0,2,3,66.7,0,0,0.0,2,4,6,0,0,1,0,0,1,0
../kbl_data/2024-2025,S45G01N147,서울 SK,Home,최원혁,0,0,0,0.0,0,1,0.0,0,1,0.0,0,0,0.0,0,1,1,2,0,0,0,0,0,2
../kbl_data/2024-2025,S45G01N147,서울 SK,Home,김지후,0,0,0,0.0,0,0,0.0,0,0,0.0,0,0,0.0,0,0,0,0,0,0,0,0,0,0
../kbl_data/2024-2025,S45G01N147,서울 SK,Home,안영준,11,2,6,33.3,2,4,50.0,4,10,40.0,1,2,50.0,3,5,8,1,1,2,0,0,1,3
../kbl_data/2024-2025,S45G01N147,서울 SK,Home,자밀 워니,25,8,13,61.5,3,8,37.5,11,21,52.4,0,1,0.0,3,8,11,5,0,1,0,1,1,0
../kbl_data/2024-2025,S45G01N147,서울 SK,Home,아이재아 힉스,3,1,1,100.0,0,1,0.0,1,2,50.0,1,1,100.0,0,1,1,0,0,0,0,0,2,1
../kbl_data/2024-2025,S45G01N147,서울 SK,Home,박민우,0,0,0,0.0,0,0,0.0,0,0,0.0,0,0,0.0,0,0,0,0,0,0,0,0,0,0
../kbl_data/2024-2025,S45G01N147,서울 SK,Home,오재현,11,4,7,57.1,1,3,33.3,5,10,50.0,0,0,0.0,2,3,5,3,1,0,0,0,1,3
../kbl_data/2024-2025,S45G01N147,서울 SK,Home,고메즈 델 리아노,0,0,0,0.0,0,0,0.0,0,0,0.0,0,0,0.0,0,0,0,0,0,0,0,0,0,0
../kbl_data/2024-2025,S45G01N147,서울 SK,Home,김태훈,2,1,1,100.0,0,1,0.0,1,2,50.0,0,0,0.0,0,2,2,0,0,0,0,0,0,2
../kbl_data/2024-2025,S45G01N147,원주 DB,Away,이관희,3,0,0,0.0,1,8,12.5,1,8,12.5,0,0,0.0,1,1,2,0,0,1,0,0,0,0
../kbl_data/2024-2025,S45G01N147,원주 DB,Away,김시래,0,0,2,0.0,0,2,0.0,0,4,0.0,0,0,0.0,1,2,3,1,0,0,1,0,0,1
../kbl_data/2024-2025,S45G01N147,원주 DB,Away,서민수,0,0,0,0.0,0,1,0.0,0,1,0.0,0,0,0.0,0,1,1,1,0,0,0,0,0,0
../kbl_data/2024-2025,S45G01N147,원주 DB,Away,김영현,0,0,0,0.0,0,1,0.0,0,1,0.0,0,0,0.0,0,0,0,0,0,0,0,0,0,1
../kbl_data/2024-2025,S45G01N147,원주 DB,Away,치나누 오누아쿠,7,2,7,28.6,1,4,25.0,3,11,27.3,0,0,0.0,2,9,11,8,0,0,0,1,3,2
../kbl_data/2024-2025,S45G01N147,원주 DB,Away,김훈,5,1,2,50.0,1,3,33.3,2,5,40.0,0,0,0.0,1,6,7,0,0,1,0,0,0,0
../kbl_data/2024-2025,S45G01N147,원주 DB,Away,이윤수,0,0,1,0.0,0,0,0.0,0,1,0.0,0,0,0.0,3,2,5,0,0,0,0,0,1,1
../kbl_data/2024-2025,S45G01N147,원주 DB,Away,이용우,10,2,2,100.0,2,4,50.0,4,6,66.7,0,0,0.0,0,0,0,0,0,0,0,0,0,2
../kbl_data/2024-2025,S45G01N147,원주 DB,Away,이선 알바노,14,5,13,38.5,1,7,14.3,6,20,30.0,1,3,33.3,1,2,3,5,0,0,0,0,1,3
../kbl_data/2024-2025,S45G01N147,원주 DB,Away,박인웅,18,2,2,100.0,4,7,57.1,6,9,66.7,2,2,100.0,4,0,4,0,1,0,0,0,2,1
../kbl_data/2024-2025,S45G01N147,원주 DB,Away,로버트 카터,4,1,7,14.3,0,3,0.0,1,10,10.0,2,2,100.0,1,1,2,0,1,0,0,0,2,3
../kbl_data/2024-2025,S45G01N147,원주 DB,Away,김보배,4,2,3,66.7,0,0,0.0,2,3,66.7,0,0,0.0,3,2,5,1,0,0,0,0,0,1
../kbl_data/2024-2025,S45G01N148,대구 한국가스공사,Home,이대헌,10,4,7,57.1,0,1,0.0,4,8,50.0,2,2,100.0,2,0,2,0,2,0,0,0,2,4
../kbl_data/2024-2025,S45G01N148,대구 한국가스공사,Home,정성우,5,1,2,50.0,1,4,25.0,2,6,33.3,0,0,0.0,1,1,2,11,1,0,0,0,1,4
../kbl_data/2024-2025,S45G01N148,대구 한국가스공사,Home,김낙현,0,0,0,0.0,0,0,0.0,0,0,0.0,0,0,0.0,0,0,0,0,0,0,0,0,1,0
../kbl_data/2024-2025,S45G01N148,대구 한국가스공사,Home,전현우,11,1,2,50.0,3,6,50.0,4,8,50.0,0,0,0.0,0,0,0,2,3,0,0,0,1,3
../kbl_data/2024-2025,S45G01N148,대구 한국가스공사,Home,양재혁,1,0,0,0.0,0,1,0.0,0,1,0.0,1,2,50.0,0,1,1,0,0,0,0,0,0,1
../kbl_data/2024-2025,S45G01N148,대구 한국가스공사,Home,곽정훈,0,0,0,0.0,0,1,0.0,0,1,0.0,0,2,0.0,0,1,1,0,1,0,0,0,0,0
../kbl_data/2024-2025,S45G01N148,대구 한국가스공사,Home,이도헌,0,0,0,0.0,0,0,0.0,0,0,0.0,0,0,0.0,0,0,0,0,0,0,0,0,0,0
../kbl_data/2024-2025,S45G01N148,대구 한국가스공사,Home,앤드류 니콜슨,34,8,13,61.5,4,7,57.1,12,20,60.0,6,6,100.0,4,10,14,2,1,2,0,0,2,0
../kbl_data/2024-2025,S45G01N148,대구 한국가스공사,Home,신승민,0,0,1,0.0,0,2,0.0,0,3,0.0,0,0,0.0,3,2,5,0,0,0,0,0,1,2
../kbl_data/2024-2025,S45G01N148,대구 한국가스공사,Home,샘조세프 벨란겔,15,4,8,50.0,1,7,14.3,5,15,33.3,4,4,100.0,1,3,4,4,0,0,0,0,1,2
../kbl_data/2024-2025,S45G01N148,대구 한국가스공사,Home,유슈 은도예,0,0,1,0.0,0,1,0.0,0,2,0.0,0,0,0.0,0,1,1,0,0,0,0,0,0,2
../kbl_data/2024-2025,S45G01N148,대구 한국가스공사,Home,신주영,0,0,0,0.0,0,0,0.0,0,0,0.0,0,0,0.0,0,0,0,0,0,0,0,0,0,0
../kbl_data/2024-2025,S45G01N148,수원 KT,Away,한희원,7,2,4,50.0,1,5,20.0,3,9,33.3,0,0,0.0,0,3,3,2,0,0,0,0,0,3
../kbl_data/2024-2025,S45G01N148,수원 KT,Away,문성곤,3,0,1,0.0,1,4,25.0,1,5,20.0,0,0,0.0,0,0,0,0,0,0,0,0,0,1
../kbl_data/2024-2025,S45G01N148,수원 KT,Away,이현석,0,0,0,0.0,0,1,0.0,0,1,0.0,0,0,0.0,0,0,0,0,0,0,0,0,0,2
../kbl_data/2024-2025,S45G01N148,수원 KT,Away,허훈,16,4,5,80.0,2,6,33.3,6,11,54.5,2,2,100.0,0,2,2,2,0,0,0,0,4,2
../kbl_data/2024-2025,S45G01N148,수원 KT,Away,박준영,0,0,0,0.0,0,0,0.0,0,0,0.0,0,0,0.0,0,1,1,0,0,0,0,0,0,1
../kbl_data/2024-2025,S45G01N148,수원 KT,Away,박지원,0,0,0,0.0,0,0,0.0,0,0,0.0,0,0,0.0,1,1,2,1,0,0,0,0,1,2
../kbl_data/2024-2025,S45G01N148,수원 KT,Away,하윤기,13,4,10,40.0,0,0,0.0,4,10,40.0,5,6,83.3,3,8,11,2,0,1,0,0,1,1
../kbl_data/2024-2025,S45G01N148,수원 KT,Away,문정현,0,0,1,0.0,0,0,0.0,0,1,0.0,0,0,0.0,2,0,2,1,0,0,0,0,0,2
../kbl_data/2024-2025,S45G01N148,수원 KT,Away,레이션 해먼즈,6,2,4,50.0,0,1,0.0,2,5,40.0,2,2,100.0,1,4,5,3,2,1,0,0,3,2
../kbl_data/2024-2025,S45G01N148,수원 KT,Away,박성재,0,0,0,0.0,0,0,0.0,0,0,0.0,0,0,0.0,0,0,0,0,0,0,0,0,0,0
../kbl_data/2024-2025,S45G01N148,수원 KT,Away,이스마엘 로메로,14,6,8,75.0,0,1,0.0,6,9,66.7,2,3,66.7,2,3,5,2,1,0,0,2,0,2
../kbl_data/2024-2025,S45G01N148,수원 KT,Away,조엘 카굴랑안,15,3,7,42.9,3,5,60.0,6,12,50.0,0,0,0.0,1,3,4,6,3,0,0,0,2,2
../kbl_data/2024-2025,S45G01N149,수원 KT,Home,한희원,6,0,1,0.0,2,5,40.0,2,6,33.3,0,0,0.0,0,3,3,4,0,0,0,0,0,4
../kbl_data/2024-2025,S45G01N149,수원 KT,Home,문성곤,12,0,0,0.0,4,8,50.0,4,8,50.0,0,0,0.0,1,4,5,0,1,0,0,0,0,1
../kbl_data/2024-2025,S45G01N149,수원 KT,Home,이현석,0,0,0,0.0,0,0,0.0,0,0,0.0,0,0,0.0,0,0,0,1,0,0,0,0,0,0
../kbl_data/2024-2025,S45G01N149,수원 KT,Home,허훈,9,3,7,42.9,1,4,25.0,4,11,36.4,0,1,0.0,0,3,3,5,0,0,1,0,3,2
../kbl_data/2024-2025,S45G01N149,수원 KT,Home,박준영,5,1,3,33.3,1,2,50.0,2,5,40.0,0,0,0.0,0,0,0,0,0,0,0,0,0,0
../kbl_data/2024-2025,S45G01N149,수원 KT,Home,박지원,0,0,0,0.0,0,0,0.0,0,0,0.0,0,0,0.0,0,0,0,0,0,0,0,0,0,0
../kbl_data/2024-2025,S45G01N149,수원 KT,Home,하윤기,16,7,11,63.6,0,0,0.0,7,11,63.6,2,2,100.0,3,3,6,4,1,1,0,2,2,2
../kbl_data/2024-2025,S45G01N149,수원 KT,Home,문정현,0,0,1,0.0,0,2,0.0,0,3,0.0,0,0,0.0,0,1,1,2,1,0,0,0,0,2
../kbl_data/2024-2025,S45G01N149,수원 KT,Home,레이션 해먼즈,11,2,3,66.7,2,7,28.6,4,10,40.0,1,2,50.0,0,6,6,1,1,1,0,0,1,2
../kbl_data/2024-2025,S45G01N149,수원 KT,Home,박성재,9,0,2,0.0,3,3,100.0,3,5,60.0,0,0,0.0,0,1,1,0,0,0,1,0,0,1
../kbl_data/2024-2025,S45G01N149,수원 KT,Home,이스마엘 로메로,2,1,1,100.0,0,0,0.0,1,1,100.0,0,2,0.0,0,1,1,1,1,0,0,0,1,2
../kbl_data/2024-2025,S45G01N149,수원 KT,Home,조엘 카굴랑안,4,2,3,66.7,0,1,0.0,2,4,50.0,0,0,0.0,1,2,3,4,0,0,0,0,5,0
../kbl_data/2024-2025,S45G01N149,서울 삼성,Away,이정현,5,2,5,40.0,0,6,0.0,2,11,18.2,1,3,33.3,3,5,8,4,3,1,0,0,3,2
../kbl_data/2024-2025,S45G01N149,서울 삼성,Away,최현민,12,0,0,0.0,4,5,80.0,4,5,80.0,0,0,0.0,0,0,0,0,0,0,0,0,0,0
../kbl_data/2024-2025,S45G01N149,서울 삼성,Away,이원대,5,1,2,50.0,1,2,50.0,2,4,50.0,0,0,0.0,0,0,0,0,0,0,1,0,1,0
../kbl_data/2024-2025,S45G01N149,서울 삼성,Away,최성모,12,2,7,28.6,1,7,14.3,3,14,21.4,5,7,71.4,1,1,2,7,1,0,0,0,1,5
../kbl_data/2024-2025,S45G01N149,서울 삼성,Away,최승욱,0,0,0,0.0,0,0,0.0,0,0,0.0,0,0,0.0,0,1,1,0,0,0,0,0,1,2
../kbl_data/2024-2025,S45G01N149,서울 삼성,Away,윤성원,0,0,0,0.0,0,0,0.0,0,0,0.0,0,0,0.0,0,0,0,0,0,0,0,0,0,0
../kbl_data/2024-2025,S45G01N149,서울 삼성,Away,마커스 데릭슨,10,4,5,80.0,0,3,0.0,4,8,50.0,2,2,100.0,2,5,7,1,0,0,0,0,1,2
../kbl_data/2024-2025,S45G01N149,서울 삼성,Away,차민석,0,0,0,0.0,0,0,0.0,0,0,0.0,0,0,0.0,0,0,0,0,0,0,0,0,0,0
../kbl_data/2024-2025,S45G01N149,서울 삼성,Away,이원석,13,6,12,50.0,0,1,0.0,6,13,46.2,1,1,100.0,4,5,9,0,1,1,1,0,0,1
../kbl_data/2024-2025,S45G01N149,서울 삼성,Away,저스틴 구탕,8,4,6,66.7,0,2,0.0,4,8,50.0,0,0,0.0,1,2,3,2,3,0,0,0,1,4
../kbl_data/2024-2025,S45G01N149,서울 삼성,Away,박승재,0,0,0,0.0,0,1,0.0,0,1,0.0,0,0,0.0,0,0,0,0,0,0,0,0,0,0
../kbl_data/2024-2025,S45G01N149,서울 삼성,Away,코피 코번,0,0,3,0.0,0,0,0.0,0,3,0.0,0,0,0.0,0,5,5,0,1,0,0,0,5,2
../kbl_data/2024-2025,S45G01N150,안양 정관장,Home,송창용,0,0,0,0.0,0,0,0.0,0,0,0.0,0,0,0.0,0,0,0,0,0,0,0,0,0,0
../kbl_data/2024-2025,S45G01N150,안양 정관장,Home,배병준,8,2,4,50.0,1,7,14.3,3,11,27.3,1,2,50.0,2,2,4,3,1,1,1,0,3,3
../kbl_data/2024-2025,S45G01N150,안양 정관장,Home,정효근,10,2,5,40.0,1,5,20.0,3,10,30.0,3,6,50.0,1,7,8,4,0,1,0,0,1,3
../kbl_data/2024-2025,S45G01N150,안양 정관장,Home,박지훈,10,1,5,20.0,2,8,25.0,3,13,23.1,2,3,66.7,5,4,9,4,4,1,0,0,1,4
../kbl_data/2024-2025,S45G01N150,안양 정관장,Home,디온테 버튼,4,1,5,20.0,0,4,0.0,1,9,11.1,2,2,100.0,4,0,4,3,1,1,0,0,2,2
../kbl_data/2024-2025,S45G01N150,안양 정관장,Home,최성원,0,0,1,0.0,0,0,0.0,0,1,0.0,0,0,0.0,0,0,0,0,0,0,0,0,0,1
../kbl_data/2024-2025,S45G01N150,안양 정관장,Home,김경원,0,0,0,0.0,0,0,0.0,0,0,0.0,0,0,0.0,0,0,0,0,0,0,0,0,0,0
../kbl_data/2024-2025,S45G01N150,안양 정관장,Home,한승희,4,2,2,100.0,0,0,0.0,2,2,100.0,0,0,0.0,3,0,3,0,0,0,0,0,0,1
../kbl_data/2024-2025,S45G01N150,안양 정관장,Home,조니 오브라이언트,21,7,14,50.0,2,5,40.0,9,19,47.4,1,2,50.0,4,5,9,3,1,0,0,1,2,3
../kbl_data/2024-2025,S45G01N150,안양 정관장,Home,하비 고메즈,18,3,4,75.0,4,6,66.7,7,10,70.0,0,0,0.0,2,2,4,2,3,0,0,0,3,4
../kbl_data/2024-2025,S45G01N150,안양 정관장,Home,박정웅,0,0,1,0.0,0,0,0.0,0,1,0.0,0,0,0.0,0,1,1,0,0,0,0,0,0,0
../kbl_data/2024-2025,S45G01N150,안양 정관장,Home,소준혁,0,0,0,0.0,0,0,0.0,0,0,0.0,0,0,0.0,0,0,0,0,0,0,0,0,0,0
../kbl_data/2024-2025,S45G01N150,원주 DB,Away,이관희,24,5,9,55.6,4,8,50.0,9,17,52.9,2,2,100.0,0,2,2,4,0,0,0,0,0,3
../kbl_data/2024-2025,S45G01N150,원주 DB,Away,김시래,0,0,3,0.0,0,1,0.0,0,4,0.0,0,0,0.0,2,1,3,2,1,0,0,0,1,0
../kbl_data/2024-2025,S45G01N150,원주 DB,Away,서민수,0,0,2,0.0,0,2,0.0,0,4,0.0,0,0,0.0,4,5,9,3,3,1,0,0,3,3
../kbl_data/2024-2025,S45G01N150,원주 DB,Away,김영현,0,0,2,0.0,0,0,0.0,0,2,0.0,0,0,0.0,1,1,2,0,1,0,0,0,0,1
../kbl_data/2024-2025,S45G01N150,원주 DB,Away,치나누 오누아쿠,10,3,7,42.9,1,2,50.0,4,9,44.4,1,2,50.0,1,2,3,1,1,0,0,0,0,1
../kbl_data/2024-2025,S45G01N150,원주 DB,Away,김훈,0,0,0,0.0,0,0,0.0,0,0,0.0,0,0,0.0,0,0,0,0,0,0,0,0,0,0
../kbl_data/2024-2025,S45G01N150,원주 DB,Away,이용우,0,0,0,0.0,0,0,0.0,0,0,0.0,0,0,0.0,0,0,0,0,0,0,0,0,0,0
../kbl_data/2024-2025,S45G01N150,원주 DB,Away,정호영,0,0,0,0.0,0,0,0.0,0,0,0.0,0,0,0.0,0,0,0,0,0,0,0,0,0,0
../kbl_data/2024-2025,S45G01N150,원주 DB,Away,이선 알바노,11,4,8,50.0,1,6,16.7,5,14,35.7,0,0,0.0,3,7,10,12,0,1,0,0,5,3
../kbl_data/2024-2025,S45G01N150,원주 DB,Away,박인웅,6,1,2,50.0,1,2,50.0,2,4,50.0,1,1,100.0,3,1,4,1,1,1,0,0,2,1
../kbl_data/2024-2025,S45G01N150,원주 DB,Away,로버트 카터,28,6,10,60.0,4,9,44.4,10,19,52.6,4,4,100.0,7,7,14,1,1,1,1,0,4,4
../kbl_data/2024-2025,S45G01N150,원주 DB,Away,김보배,3,1,1,100.0,0,0,0.0,1,1,100.0,1,4,25.0,1,1,2,0,0,0,0,1,1,1
../kbl_data/2024-2025,S45G01N151,울산 현대모비스,Home,장재석,0,0,1,0.0,0,0,0.0,0,1,0.0,0,0,0.0,1,1,2,0,0,0,0,0,0,1
../kbl_data/2024-2025,S45G01N151,울산 현대모비스,Home,한호빈,6,0,0,0.0,2,4,50.0,2,4,50.0,0,0,0.0,0,2,2,1,0,0,0,0,0,4
../kbl_data/2024-2025,S45G01N151,울산 현대모비스,Home,김준일,4,2,3,66.7,0,0,0.0,2,3,66.7,0,0,0.0,0,1,1,2,0,0,0,0,1,3
../kbl_data/2024-2025,S45G01N151,울산 현대모비스,Home,김국찬,0,0,0,0.0,0,0,0.0,0,0,0.0,0,0,0.0,0,0,0,0,0,0,0,0,0,0
../kbl_data/2024-2025,S45G01N151,울산 현대모비스,Home,서명진,0,0,1,0.0,0,0,0.0,0,1,0.0,0,0,0.0,0,1,1,1,0,0,0,0,0,0
../kbl_data/2024-2025,S45G01N151,울산 현대모비스,Home,숀 롱,24,8,13,61.5,1,1,100.0,9,14,64.3,5,7,71.4,6,4,10,2,1,1,0,1,4,2
../kbl_data/2024-2025,S45G01N151,울산 현대모비스,Home,이우석,7,2,6,33.3,1,8,12.5,3,14,21.4,0,0,0.0,3,5,8,5,0,0,0,0,2,2
../kbl_data/2024-2025,S45G01N151,울산 현대모비스,Home,이승우,0,0,0,0.0,0,0,0.0,0,0,0.0,0,0,0.0,0,0,0,0,0,0,0,0,0,0
../kbl_data/2024-2025,S45G01N151,울산 현대모비스,Home,신민석,6,0,1,0.0,2,6,33.3,2,7,28.6,0,0,0.0,1,4,5,0,0,0,0,0,4,3
../kbl_data/2024-2025,S45G01N151,울산 현대모비스,Home,게이지 프림,15,6,12,50.0,1,2,50.0,7,14,50.0,0,0,0.0,3,1,4,0,0,0,0,1,3,2
../kbl_data/2024-2025,S45G01N151,울산 현대모비스,Home,박무빈,0,0,2,0.0,0,0,0.0,0,2,0.0,0,0,0.0,1,5,6,4,0,0,0,0,2,1
../kbl_data/2024-2025,S45G01N151,울산 현대모비스,Home,미구엘 안드레 옥존,9,3,6,50.0,1,5,20.0,4,11,36.4,0,0,0.0,3,4,7,6,0,0,0,0,1,1
../kbl_data/2024-2025,S45G01N151,서울 SK,Away,김선형,16,8,10,80.0,0,1,0.0,8,11,72.7,0,0,0.0,0,2,2,4,4,0,0,0,0,2
../kbl_data/2024-2025,S45G01N151,서울 SK,Away,오세근,6,3,4,75.0,0,1,0.0,3,5,60.0,0,0,0.0,1,1,2,0,0,0,0,0,0,4
../kbl_data/2024-2025,S45G01N151,서울 SK,Away,최부경,8,4,6,66.7,0,1,0.0,4,7,57.1,0,0,0.0,3,2,5,2,0,0,0,0,1,2
../kbl_data/2024-2025,S45G01N151,서울 SK,Away,최원혁,0,0,0,0.0,0,0,0.0,0,0,0.0,0,0,0.0,0,1,1,3,0,0,0,0,1,2
../kbl_data/2024-2025,S45G01N151,서울 SK,Away,김지후,0,0,0,0.0,0,0,0.0,0,0,0.0,0,0,0.0,0,0,0,0,0,0,0,0,0,0
../kbl_data/2024-2025,S45G01N151,서울 SK,Away,안영준,14,1,3,33.3,3,5,60.0,4,8,50.0,3,5,60.0,2,4,6,3,1,1,0,0,0,2
../kbl_data/2024-2025,S45G01N151,서울 SK,Away,자밀 워니,30,6,20,30.0,5,10,50.0,11,30,36.7,3,5,60.0,3,8,11,3,3,3,0,0,0,2
../kbl_data/2024-2025,S45G01N151,서울 SK,Away,아이재아 힉스,1,0,1,0.0,0,0,0.0,0,1,0.0,1,2,50.0,0,0,0,0,0,0,0,0,0,1
../kbl_data/2024-2025,S45G01N151,서울 SK,Away,박민우,0,0,0,0.0,0,0,0.0,0,0,0.0,0,0,0.0,0,0,0,0,0,0,0,0,0,0
../kbl_data/2024-2025,S45G01N151,서울 SK,Away,오재현,6,3,7,42.9,0,2,0.0,3,9,33.3,0,0,0.0,1,1,2,4,3,0,1,0,1,2
../kbl_data/2024-2025,S45G01N151,서울 SK,Away,고메즈 델 리아노,0,0,0,0.0,0,0,0.0,0,0,0.0,0,0,0.0,0,0,0,0,0,0,0,0,0,0
../kbl_data/2024-2025,S45G01N151,서울 SK,Away,김태훈,2,1,1,100.0,0,0,0.0,1,1,100.0,0,0,0.0,0,1,1,0,0,0,0,0,0,0
../kbl_data/2024-2025,S45G01N152,창원 LG,Home,허일영,0,0,1,0.0,0,0,0.0,0,1,0.0,0,0,0.0,0,2,2,0,0,0,0,0,0,2
../kbl_data/2024-2025,S45G01N152,창원 LG,Home,장민국,2,1,2,50.0,0,1,0.0,1,3,33.3,0,0,0.0,1,0,1,0,0,0,0,0,0,0
../kbl_data/2024-2025,S45G01N152,창원 LG,Home,한상혁,0,0,3,0.0,0,1,0.0,0,4,0.0,0,0,0.0,0,0,0,2,1,0,0,0,0,1
../kbl_data/2024-2025,S45G01N152,창원 LG,Home,전성현,14,1,1,100.0,4,8,50.0,5,9,55.6,0,0,0.0,0,0,0,1,1,0,0,0,1,1
../kbl_data/2024-2025,S45G01N152,창원 LG,Home,정인덕,0,0,4,0.0,0,4,0.0,0,8,0.0,0,0,0.0,1,1,2,2,0,0,0,0,1,3
../kbl_data/2024-2025,S45G01N152,창원 LG,Home,대릴 먼로,18,6,8,75.0,1,1,100.0,7,9,77.8,3,3,100.0,3,11,14,5,2,2,0,2,4,2
../kbl_data/2024-2025,S45G01N152,창원 LG,Home,박정현,13,3,5,60.0,1,1,100.0,4,6,66.7,4,4,100.0,0,3,3,0,0,0,0,0,0,1
../kbl_data/2024-2025,S45G01N152,창원 LG,Home,양준석,10,5,9,55.6,0,1,0.0,5,10,50.0,0,0,0.0,1,3,4,4,0,0,0,0,1,4
../kbl_data/2024-2025,S45G01N152,창원 LG,Home,이경도,0,0,0,0.0,0,0,0.0,0,0,0.0,0,0,0.0,0,0,0,0,0,0,0,0,0,0
../kbl_data/2024-2025,S45G01N152,창원 LG,Home,칼 타마요,7,3,10,30.0,0,4,0.0,3,14,21.4,1,2,50.0,1,4,5,1,1,0,0,0,4,1
../kbl_data/2024-2025,S45G01N152,창원 LG,Home,최형찬,3,0,0,0.0,1,2,50.0,1,2,50.0,0,0,0.0,0,2,2,0,0,0,0,0,0,1
../kbl_data/2024-2025,S45G01N152,창원 LG,Home,브라이언 그리핀,0,0,1,0.0,0,0,0.0,0,1,0.0,0,0,0.0,1,2,3,1,0,0,0,0,2,1
../kbl_data/2024-2025,S45G01N152,고양 소노,Away,홍경기,0,0,0,0.0,0,0,0.0,0,0,0.0,0,0,0.0,0,0,0,0,0,0,0,0,0,0
../kbl_data/2024-2025,S45G01N152,고양 소노,Away,임동섭,0,0,1,0.0,0,6,0.0,0,7,0.0,0,0,0.0,1,5,6,0,0,0,0,0,0,3
../kbl_data/2024-2025,S45G01N152,고양 소노,Away,이재도,9,2,8,25.0,1,3,33.3,3,11,27.3,2,4,50.0,0,4,4,4,1,0,0,0,2,2
../kbl_data/2024-2025,S45G01N152,고양 소노,Away,최승욱,2,1,3,33.3,0,0,0.0,1,3,33.3,0,0,0.0,1,0,1,1,1,0,0,0,2,0
../kbl_data/2024-2025,S45G01N152,고양 소노,Away,박진철,11,5,9,55.6,0,0,0.0,5,9,55.6,1,2,50.0,2,3,5,2,2,2,0,0,2,2
../kbl_data/2024-2025,S45G01N152,고양 소노,Away,문시윤,5,2,3,66.7,0,1,0.0,2,4,50.0,1,1,100.0,0,0,0,0,0,0,0,0,0,1
../kbl_data/2024-2025,S45G01N152,고양 소노,Away,박종하,5,1,3,33.3,1,4,25.0,2,7,28.6,0,0,0.0,0,1,1,0,1,0,0,0,0,0
../kbl_data/2024-2025,S45G01N152,고양 소노,Away,민기남,6,0,0,0.0,2,3,66.7,2,3,66.7,0,0,0.0,0,0,0,1,0,0,1,0,0,1
../kbl_data/2024-2025,S45G01N152,고양 소노,Away,디제이 번즈 Jr,12,6,14,42.9,0,0,0.0,6,14,42.9,0,0,0.0,5,10,15,5,2,0,0,0,4,5
../kbl_data/2024-2025,S45G01N152,고양 소노,Away,서동원,0,0,0,0.0,0,0,0.0,0,0,0.0,0,0,0.0,0,1,1,0,0,0,0,0,0,0
../kbl_data/2024-2025,S45G01N152,고양 소노,Away,정성조,10,5,6,83.3,0,1,0.0,5,7,71.4,0,3,0.0,1,3,4,2,1,1,0,0,1,2
../kbl_data/2024-2025,S45G01N152,고양 소노,Away,알파 카바,2,1,4,25.0,0,0,0.0,1,4,25.0,0,0,0.0,1,0,1,0,0,0,0,0,0,0
../kbl_data/2024-2025,S45G01N153,수원 KT,Home,한희원,3,0,0,0.0,1,5,20.0,1,5,20.0,0,0,0.0,0,3,3,2,0,0,0,0,1,1
../kbl_data/2024-2025,S45G01N153,수원 KT,Home,문성곤,0,0,0,0.0,0,2,0.0,0,2,0.0,0,0,0.0,4,1,5,1,1,0,0,0,3,2
../kbl_data/2024-2025,S45G01N153,수원 KT,Home,이현석,0,0,0,0.0,0,2,0.0,0,2,0.0,0,0,0.0,0,0,0,1,0,0,0,0,0,0
../kbl_data/2024-2025,S45G01N153,수원 KT,Home,허훈,10,1,3,33.3,2,8,25.0,3,11,27.3,2,2,100.0,1,1,2,2,1,0,0,0,5,2
../kbl_data/2024-2025,S45G01N153,수원 KT,Home,박준영,5,1,3,33.3,1,4,25.0,2,7,28.6,0,0,0.0,0,3,3,3,0,0,0,0,3,0
../kbl_data/2024-2025,S45G01N153,수원 KT,Home,박지원,0,0,0,0.0,0,0,0.0,0,0,0.0,0,0,0.0,1,0,1,0,0,0,0,0,0,0
../kbl_data/2024-2025,S45G01N153,수원 KT,Home,하윤기,7,3,7,42.9,0,0,0.0,3,7,42.9,1,2,50.0,0,1,1,0,0,0,0,0,1,1
../kbl_data/2024-2025,S45G01N153,수원 KT,Home,문정현,7,3,6,50.0,0,1,0.0,3,7,42.9,1,2,50.0,1,0,1,1,2,0,0,0,0,1
../kbl_data/2024-2025,S45G01N153,수원 KT,Home,레이션 해먼즈,9,3,4,75.0,1,2,50.0,4,6,66.7,0,2,0.0,3,4,7,2,1,0,0,0,0,2
../kbl_data/2024-2025,S45G01N153,수원 KT,Home,박성재,5,1,1,100.0,1,2,50.0,2,3,66.7,0,0,0.0,0,3,3,0,0,0,0,0,0,2
../kbl_data/2024-2025,S45G01N153,수원 KT,Home,이스마엘 로메로,13,6,7,85.7,0,1,0.0,6,8,75.0,1,2,50.0,1,5,6,1,0,0,0,1,1,1
../kbl_data/2024-2025,S45G01N153,수원 KT,Home,조엘 카굴랑안,13,4,10,40.0,1,3,33.3,5,13,38.5,2,2,100.0,1,1,2,5,3,0,0,0,2,4
../kbl_data/2024-2025,S45G01N153,안양 정관장,Away,송창용,0,0,0,0.0,0,0,0.0,0,0,0.0,0,0,0.0,0,1,1,0,1,0,0,0,0,2
../kbl_data/2024-2025,S45G01N153,안양 정관장,Away,정준원,6,3,5,60.0,0,2,0.0,3,7,42.9,0,0,0.0,1,0,1,1,1,0,0,0,1,3
../kbl_data/2024-2025,S45G01N153,안양 정관장,Away,배병준,9,3,5,60.0,1,4,25.0,4,9,44.4,0,2,0.0,1,1,2,2,1,0,0,0,3,1
../kbl_data/2024-2025,S45G01N153,안양 정관장,Away,박지훈,11,4,4,100.0,1,1,100.0,5,5,100.0,0,0,0.0,2,4,6,6,2,0,0,0,4,2
../kbl_data/2024-2025,S45G01N153,안양 정관장,Away,디온테 버튼,27,6,14,42.9,4,4,100.0,10,18,55.6,3,4,75.0,3,4,7,1,3,0,0,1,1,0
../kbl_data/2024-2025,S45G01N153,안양 정관장,Away,최성원,5,1,2,50.0,1,1,100.0,2,3,66.7,0,0,0.0,0,0,0,0,0,0,0,0,2,1
../kbl_data/2024-2025,S45G01N153,안양 정관장,Away,김경원,8,4,7,57.1,0,1,0.0,4,8,50.0,0,0,0.0,1,6,7,1,2,1,0,0,0,3
../kbl_data/2024-2025,S45G01N153,안양 정관장,Away,한승희,4,2,2,100.0,0,0,0.0,2,2,100.0,0,0,0.0,1,0,1,0,0,0,1,0,0,3
../kbl_data/2024-2025,S45G01N153,안양 정관장,Away,조니 오브라이언트,21,5,9,55.6,3,4,75.0,8,13,61.5,2,2,100.0,1,10,11,2,0,0,0,0,2,0
../kbl_data/2024-2025,S45G01N153,안양 정관장,Away,하비 고메즈,0,0,1,0.0,0,1,0.0,0,2,0.0,0,0,0.0,2,1,3,1,1,0,0,0,2,1
../kbl_data/2024-2025,S45G01N153,안양 정관장,Away,박정웅,0,0,1,0.0,0,0,0.0,0,1,0.0,0,0,0.0,0,0,0,0,0,0,0,0,0,0
../kbl_data/2024-2025,S45G01N153,안양 정관장,Away,소준혁,2,1,1,100.0,0,3,0.0,1,4,25.0,0,2,0.0,1,1,2,1,0,1,0,0,1,1
../kbl_data/2024-2025,S45G01N154,원주 DB,Home,이관희,25,5,7,71.4,4,7,57.1,9,14,64.3,3,4,75.0,0,5,5,2,1,0,0,0,1,2
../kbl_data/2024-2025,S45G01N154,원주 DB,Home,김시래,0,0,0,0.0,0,0,0.0,0,0,0.0,0,0,0.0,0,0,0,0,0,0,0,0,0,0
../kbl_data/2024-2025,S45G01N154,원주 DB,Home,서민수,2,1,1,100.0,0,0,0.0,1,1,100.0,0,0,0.0,0,1,1,0,1,0,0,0,0,1
../kbl_data/2024-2025,S45G01N154,원주 DB,Home,김영현,1,0,1,0.0,0,0,0.0,0,1,0.0,1,2,50.0,1,0,1,0,1,0,0,0,0,1
../kbl_data/2024-2025,S45G01N154,원주 DB,Home,정효근,15,6,9,66.7,1,4,25.0,7,13,53.8,0,0,0.0,4,5,9,2,0,0,0,1,2,3
../kbl_data/2024-2025,S45G01N154,원주 DB,Home,치나누 오누아쿠,4,2,7,28.6,0,1,0.0,2,8,25.0,0,0,0.0,1,0,1,3,0,0,0,0,0,1
../kbl_data/2024-2025,S45G01N154,원주 DB,Home,김훈,0,0,0,0.0,0,0,0.0,0,0,0.0,0,0,0.0,0,0,0,1,0,0,0,0,0,1
../kbl_data/2024-2025,S45G01N154,원주 DB,Home,정호영,0,0,0,0.0,0,0,0.0,0,0,0.0,0,0,0.0,0,0,0,0,0,0,0,0,0,0
../kbl_data/2024-2025,S45G01N154,원주 DB,Home,이선 알바노,32,6,10,60.0,6,9,66.7,12,19,63.2,2,2,100.0,2,5,7,9,4,0,0,0,1,3
../kbl_data/2024-2025,S45G01N154,원주 DB,Home,박인웅,6,2,3,66.7,0,4,0.0,2,7,28.6,2,2,100.0,3,2,5,2,1,0,0,0,0,2
../kbl_data/2024-2025,S45G01N154,원주 DB,Home,로버트 카터,14,2,3,66.7,2,6,33.3,4,9,44.4,4,5,80.0,0,5,5,4,0,1,0,1,1,3
../kbl_data/2024-2025,S45G01N154,원주 DB,Home,김보배,0,0,0,0.0,0,0,0.0,0,0,0.0,0,0,0.0,0,0,0,0,0,0,0,0,0,0
../kbl_data/2024-2025,S45G01N154,서울 삼성,Away,이정현,12,1,1,100.0,2,7,28.6,3,8,37.5,4,4,100.0,1,2,3,7,2,0,0,0,2,1
../kbl_data/2024-2025,S45G01N154,서울 삼성,Away,최현민,6,0,0,0.0,1,1,100.0,1,1,100.0,3,4,75.0,1,1,2,2,0,0,0,0,0,3
../kbl_data/2024-2025,S45G01N154,서울 삼성,Away,이원대,0,0,1,0.0,0,1,0.0,0,2,0.0,0,0,0.0,0,0,0,2,0,0,0,0,2,1
../kbl_data/2024-2025,S45G01N154,서울 삼성,Away,최성모,15,1,1,100.0,4,10,40.0,5,11,45.5,1,1,100.0,0,3,3,2,0,0,0,0,2,5
../kbl_data/2024-2025,S45G01N154,서울 삼성,Away,최승욱,3,0,0,0.0,1,3,33.3,1,3,33.3,0,0,0.0,0,1,1,0,0,0,0,0,0,1
../kbl_data/2024-2025,S45G01N154,서울 삼성,Away,윤성원,3,0,1,0.0,1,2,50.0,1,3,33.3,0,0,0.0,1,1,2,0,0,0,0,0,0,0
../kbl_data/2024-2025,S45G01N154,서울 삼성,Away,마커스 데릭슨,4,2,2,100.0,0,0,0.0,2,2,100.0,0,0,0.0,1,3,4,2,0,1,0,0,1,1
../kbl_data/2024-2025,S45G01N154,서울 삼성,Away,차민석,0,0,0,0.0,0,0,0.0,0,0,0.0,0,0,0.0,0,0,0,0,0,0,0,0,0,0
../kbl_data/2024-2025,S45G01N154,서울 삼성,Away,이원석,13,4,6,66.7,1,3,33.3,5,9,55.6,2,2,100.0,2,2,4,1,0,0,0,0,1,3
../kbl_data/2024-2025,S45G01N154,서울 삼성,Away,저스틴 구탕,15,3,5,60.0,3,8,37.5,6,13,46.2,0,0,0.0,2,2,4,9,1,0,0,1,1,2
../kbl_data/2024-2025,S45G01N154,서울 삼성,Away,박승재,0,0,1,0.0,0,1,0.0,0,2,0.0,0,0,0.0,0,0,0,1,0,0,0,0,0,0
../kbl_data/2024-2025,S45G01N154,서울 삼성,Away,코피 코번,21,9,12,75.0,0,0,0.0,9,12,75.0,3,5,60.0,0,7,7,1,0,0,0,0,0,2
../kbl_data/2024-2025,S45G01N155,부산 KCC,Home,정창영,8,1,2,50.0,2,5,40.0,3,7,42.9,0,0,0.0,1,3,4,10,3,0,1,0,1,2
../kbl_data/2024-2025,S45G01N155,부산 KCC,Home,전준범,0,0,0,0.0,0,0,0.0,0,0,0.0,0,0,0.0,0,0,0,0,0,0,0,0,0,0
../kbl_data/2024-2025,S45G01N155,부산 KCC,Home,허웅,21,3,5,60.0,5,7,71.4,8,12,66.7,0,0,0.0,1,2,3,4,0,0,0,0,4,1
../kbl_data/2024-2025,S45G01N155,부산 KCC,Home,이승현,8,4,9,44.4,0,1,0.0,4,10,40.0,0,0,0.0,0,7,7,0,2,0,0,0,0,3
../kbl_data/2024-2025,S45G01N155,부산 KCC,Home,이호현,14,7,14,50.0,0,0,0.0,7,14,50.0,0,0,0.0,0,4,4,2,3,0,0,0,0,4
../kbl_data/2024-2025,S45G01N155,부산 KCC,Home,캐디 라렌,28,9,13,69.2,3,3,100.0,12,16,75.0,1,2,50.0,0,6,6,6,0,4,0,5,5,0
../kbl_data/2024-2025,S45G01N155,부산 KCC,Home,이근휘,3,0,0,0.0,1,2,50.0,1,2,50.0,0,0,0.0,0,2,2,0,1,0,0,0,0,1
../kbl_data/2024-2025,S45G01N155,부산 KCC,Home,김동현,0,0,0,0.0,0,0,0.0,0,0,0.0,0,0,0.0,0,0,0,2,0,0,0,0,1,2
../kbl_data/2024-2025,S45G01N155,부산 KCC,Home,여준형,2,1,1,100.0,0,0,0.0,1,1,100.0,0,0,0.0,0,1,1,1,1,0,0,0,0,0
../kbl_data/2024-2025,S45G01N155,부산 KCC,Home,캘빈 제프리 에피스톨라,3,0,0,0.0,1,1,100.0,1,1,100.0,0,0,0.0,0,2,2,3,0,0,0,0,1,1
../kbl_data/2024-2025,S45G01N155,부산 KCC,Home,이주영,2,1,1,100.0,0,0,0.0,1,1,100.0,0,0,0.0,0,0,0,0,1,0,0,0,0,1
../kbl_data/2024-2025,S45G01N155,부산 KCC,Home,이찬영,0,0,0,0.0,0,1,0.0,0,1,0.0,0,0,0.0,0,0,0,1,1,0,0,0,0,0
../kbl_data/2024-2025,S45G01N155,서울 SK,Away,김선형,22,6,10,60.0,3,8,37.5,9,18,50.0,1,1,100.0,3,2,5,6,1,0,0,0,1,5
../kbl_data/2024-2025,S45G01N155,서울 SK,Away,오세근,3,1,3,33.3,0,2,0.0,1,5,20.0,1,2,50.0,1,0,1,1,0,0,0,0,0,0
../kbl_data/2024-2025,S45G01N155,서울 SK,Away,최부경,6,0,1,0.0,2,2,100.0,2,3,66.7,0,0,0.0,1,1,2,2,0,0,0,0,1,0
../kbl_data/2024-2025,S45G01N155,서울 SK,Away,최원혁,3,0,1,0.0,1,4,25.0,1,5,20.0,0,0,0.0,8,3,11,2,2,0,0,0,2,2
../kbl_data/2024-2025,S45G01N155,서울 SK,Away,김지후,0,0,0,0.0,0,0,0.0,0,0,0.0,0,0,0.0,0,0,0,0,0,0,0,0,0,0
../kbl_data/2024-2025,S45G01N155,서울 SK,Away,안영준,10,2,4,50.0,2,9,22.2,4,13,30.8,0,0,0.0,2,6,8,2,2,1,0,0,4,3
../kbl_data/2024-2025,S45G01N155,서울 SK,Away,자밀 워니,12,6,11,54.5,0,8,0.0,6,19,31.6,0,0,0.0,4,8,12,6,4,1,0,1,3,2
../kbl_data/2024-2025,S45G01N155,서울 SK,Away,아이재아 힉스,2,1,2,50.0,0,0,0.0,1,2,50.0,0,0,0.0,0,0,0,0,0,0,0,1,1,0
../kbl_data/2024-2025,S45G01N155,서울 SK,Away,박민우,3,0,0,0.0,1,1,100.0,1,1,100.0,0,0,0.0,0,0,0,0,0,0,0,0,0,0
../kbl_data/2024-2025,S45G01N155,서울 SK,Away,오재현,8,4,7,57.1,0,4,0.0,4,11,36.4,0,4,0.0,1,0,1,2,1,0,0,0,3,1
../kbl_data/2024-2025,S45G01N155,서울 SK,Away,고메즈 델 리아노,1,0,1,0.0,0,0,0.0,0,1,0.0,1,2,50.0,0,1,1,1,1,0,0,0,0,0
../kbl_data/2024-2025,S45G01N155,서울 SK,Away,김태훈,2,1,1,100.0,0,1,0.0,1,2,50.0,0,0,0.0,1,0,1,1,0,0,0,0,0,1
../kbl_data/2024-2025,S45G01N156,창원 LG,Home,허일영,7,1,1,100.0,1,1,100.0,2,2,100.0,2,2,100.0,0,0,0,1,0,0,0,0,2,1
../kbl_data/2024-2025,S45G01N156,창원 LG,Home,장민국,0,0,0,0.0,0,0,0.0,0,0,0.0,0,0,0.0,0,0,0,0,0,0,0,0,0,0
../kbl_data/2024-2025,S45G01N156,창원 LG,Home,한상혁,0,0,0,0.0,0,0,0.0,0,0,0.0,0,0,0.0,0,0,0,0,0,0,0,0,0,0
../kbl_data/2024-2025,S45G01N156,창원 LG,Home,전성현,12,0,0,0.0,4,6,66.7,4,6,66.7,0,0,0.0,0,1,1,2,0,0,0,0,3,1
../kbl_data/2024-2025,S45G01N156,창원 LG,Home,정인덕,0,0,1,0.0,0,2,0.0,0,3,0.0,0,0,0.0,0,1,1,1,2,0,0,0,1,3
../kbl_data/2024-2025,S45G01N156,창원 LG,Home,대릴 먼로,8,1,9,11.1,2,2,100.0,3,11,27.3,0,2,0.0,5,7,12,3,1,2,1,0,5,3
../kbl_data/2024-2025,S45G01N156,창원 LG,Home,박정현,6,3,3,100.0,0,0,0.0,3,3,100.0,0,0,0.0,2,1,3,0,1,0,0,0,3,3
../kbl_data/2024-2025,S45G01N156,창원 LG,Home,양준석,8,4,8,50.0,0,1,0.0,4,9,44.4,0,0,0.0,1,2,3,7,0,0,0,0,1,2
../kbl_data/2024-2025,S45G01N156,창원 LG,Home,이경도,5,1,2,50.0,1,2,50.0,2,4,50.0,0,0,0.0,0,1,1,5,0,0,0,0,1,0
../kbl_data/2024-2025,S45G01N156,창원 LG,Home,칼 타마요,12,6,14,42.9,0,0,0.0,6,14,42.9,0,2,0.0,5,5,10,1,1,0,1,0,0,4
../kbl_data/2024-2025,S45G01N156,창원 LG,Home,최형찬,2,1,1,100.0,0,0,0.0,1,1,100.0,0,0,0.0,0,1,1,1,2,0,0,0,0,3
../kbl_data/2024-2025,S45G01N156,창원 LG,Home,브라이언 그리핀,11,5,9,55.6,0,2,0.0,5,11,45.5,1,2,50.0,2,0,2,0,2,0,0,4,1,2
../kbl_data/2024-2025,S45G01N156,울산 현대모비스,Away,장재석,11,5,6,83.3,0,0,0.0,5,6,83.3,1,2,50.0,0,3,3,1,1,0,0,1,0,2
../kbl_data/2024-2025,S45G01N156,울산 현대모비스,Away,한호빈,9,0,0,0.0,3,5,60.0,3,5,60.0,0,0,0.0,0,1,1,2,0,0,1,0,0,0
../kbl_data/2024-2025,S45G01N156,울산 현대모비스,Away,김준일,4,1,2,50.0,0,1,0.0,1,3,33.3,2,2,100.0,2,3,5,1,1,1,1,0,0,1
../kbl_data/2024-2025,S45G01N156,울산 현대모비스,Away,김국찬,2,1,2,50.0,0,1,0.0,1,3,33.3,0,0,0.0,1,0,1,0,0,0,1,0,0,1
../kbl_data/2024-2025,S45G01N156,울산 현대모비스,Away,서명진,2,1,2,50.0,0,3,0.0,1,5,20.0,0,0,0.0,0,0,0,2,1,0,1,0,1,0
../kbl_data/2024-2025,S45G01N156,울산 현대모비스,Away,숀 롱,6,0,6,0.0,0,0,0.0,0,6,0.0,6,10,60.0,7,4,11,3,1,0,0,0,4,3
../kbl_data/2024-2025,S45G01N156,울산 현대모비스,Away,이우석,7,2,5,40.0,1,7,14.3,3,12,25.0,0,0,0.0,2,2,4,4,1,0,0,0,3,2
../kbl_data/2024-2025,S45G01N156,울산 현대모비스,Away,이승우,0,0,0,0.0,0,1,0.0,0,1,0.0,0,0,0.0,0,0,0,0,0,0,0,0,0,0
../kbl_data/2024-2025,S45G01N156,울산 현대모비스,Away,신민석,0,0,0,0.0,0,1,0.0,0,1,0.0,0,0,0.0,0,0,0,0,0,0,0,0,0,1
../kbl_data/2024-2025,S45G01N156,울산 현대모비스,Away,게이지 프림,25,12,14,85.7,0,1,0.0,12,15,80.0,1,2,50.0,2,4,6,2,2,1,0,0,4,2
../kbl_data/2024-2025,S45G01N156,울산 현대모비스,Away,박무빈,0,0,1,0.0,0,1,0.0,0,2,0.0,0,0,0.0,0,1,1,4,0,0,0,0,1,2
../kbl_data/2024-2025,S45G01N156,울산 현대모비스,Away,미구엘 안드레 옥존,2,1,2,50.0,0,3,0.0,1,5,20.0,0,0,0.0,0,1,1,2,0,0,0,0,0,2
../kbl_data/2024-2025,S45G01N157,고양 소노,Home,홍경기,7,1,3,33.3,1,4,25.0,2,7,28.6,2,2,100.0,0,3,3,0,1,0,0,0,1,4
../kbl_data/2024-2025,S45G01N157,고양 소노,Home,임동섭,9,2,3,66.7,1,5,20.0,3,8,37.5,2,2,100.0,0,7,7,1,0,0,0,0,1,1
../kbl_data/2024-2025,S45G01N157,고양 소노,Home,이재도,9,1,5,20.0,1,3,33.3,2,8,25.0,4,4,100.0,1,1,2,4,1,0,0,0,3,1
../kbl_data/2024-2025,S45G01N157,고양 소노,Home,최승욱,7,2,3,66.7,1,2,50.0,3,5,60.0,0,0,0.0,0,3,3,0,0,0,0,0,1,1
../kbl_data/2024-2025,S45G01N157,고양 소노,Home,박진철,0,0,2,0.0,0,0,0.0,0,2,0.0,0,0,0.0,0,1,1,0,0,0,0,0,0,3
../kbl_data/2024-2025,S45G01N157,고양 소노,Home,문시윤,2,1,1,100.0,0,1,0.0,1,2,50.0,0,0,0.0,1,4,5,1,0,0,0,0,1,0
../kbl_data/2024-2025,S45G01N157,고양 소노,Home,박종하,4,2,4,50.0,0,2,0.0,2,6,33.3,0,0,0.0,2,0,2,2,2,0,0,0,0,2
../kbl_data/2024-2025,S45G01N157,고양 소노,Home,민기남,2,0,1,0.0,0,2,0.0,0,3,0.0,2,3,66.7,0,0,0,1,0,0,1,0,1,2
../kbl_data/2024-2025,S45G01N157,고양 소노,Home,디제이 번즈 Jr,0,0,4,0.0,0,0,0.0,0,4,0.0,0,0,0.0,1,1,2,1,0,0,0,0,1,1
../kbl_data/2024-2025,S45G01N157,고양 소노,Home,서동원,0,0,0,0.0,0,0,0.0,0,0,0.0,0,0,0.0,0,0,0,1,0,0,0,0,0,2
../kbl_data/2024-2025,S45G01N157,고양 소노,Home,정성조,7,1,2,50.0,1,4,25.0,2,6,33.3,2,2,100.0,0,4,4,2,1,1,0,0,5,4
../kbl_data/2024-2025,S45G01N157,고양 소노,Home,알파 카바,9,4,10,40.0,0,0,0.0,4,10,40.0,1,4,25.0,6,9,15,1,1,0,0,3,5,2
../kbl_data/2024-2025,S45G01N157,대구 한국가스공사,Away,차바위,0,0,0,0.0,0,1,0.0,0,1,0.0,0,0,0.0,0,1,1,2,0,0,0,0,0,4
../kbl_data/2024-2025,S45G01N157,대구 한국가스공사,Away,이대헌,26,12,15,80.0,0,1,0.0,12,16,75.0,2,3,66.7,3,5,8,1,3,1,0,0,1,2
../kbl_data/2024-2025,S45G01N157,대구 한국가스공사,Away,정성우,5,1,3,33.3,1,4,25.0,2,7,28.6,0,0,0.0,2,3,5,5,1,0,0,0,0,4
../kbl_data/2024-2025,S45G01N157,대구 한국가스공사,Away,전현우,10,0,0,0.0,3,7,42.9,3,7,42.9,1,1,100.0,0,2,2,2,0,1,0,0,1,2
../kbl_data/2024-2025,S45G01N157,대구 한국가스공사,Away,양재혁,0,0,0,0.0,0,2,0.0,0,2,0.0,0,0,0.0,0,1,1,0,0,0,0,0,1,1
../kbl_data/2024-2025,S45G01N157,대구 한국가스공사,Away,곽정훈,2,0,0,0.0,0,1,0.0,0,1,0.0,2,2,100.0,0,0,0,1,0,0,0,0,0,0
../kbl_data/2024-2025,S45G01N157,대구 한국가스공사,Away,앤드류 니콜슨,11,2,3,66.7,1,7,14.3,3,10,30.0,4,4,100.0,0,6,6,0,1,1,0,0,2,2
../kbl_data/2024-2025,S45G01N157,대구 한국가스공사,Away,신승민,6,1,5,20.0,0,2,0.0,1,7,14.3,4,5,80.0,0,3,3,1,1,0,0,0,1,0
../kbl_data/2024-2025,S45G01N157,대구 한국가스공사,Away,샘조세프 벨란겔,6,2,3,66.7,0,1,0.0,2,4,50.0,2,4,50.0,0,3,3,6,5,0,0,0,0,3
../kbl_data/2024-2025,S45G01N157,대구 한국가스공사,Away,유슈 은도예,5,1,5,20.0,0,1,0.0,1,6,16.7,3,4,75.0,0,5,5,1,3,4,0,0,2,1
../kbl_data/2024-2025,S45G01N157,대구 한국가스공사,Away,안세영,3,1,1,100.0,0,0,0.0,1,1,100.0,1,2,50.0,0,1,1,0,1,0,0,0,1,2
../kbl_data/2024-2025,S45G01N157,대구 한국가스공사,Away,신주영,2,1,1,100.0,0,1,0.0,1,2,50.0,0,0,0.0,2,1,3,0,0,1,0,0,1,2
../kbl_data/2024-2025,S45G01N158,울산 현대모비스,Home,장재석,5,1,1,100.0,0,0,0.0,1,1,100.0,3,4,75.0,2,0,2,1,1,2,0,0,4,3
../kbl_data/2024-2025,S45G01N158,울산 현대모비스,Home,한호빈,3,0,1,0.0,1,5,20.0,1,6,16.7,0,0,0.0,0,0,0,1,0,0,1,0,0,5
../kbl_data/2024-2025,S45G01N158,울산 현대모비스,Home,김준일,7,3,4,75.0,0,1,0.0,3,5,60.0,1,2,50.0,0,5,5,0,1,2,0,0,2,3
../kbl_data/2024-2025,S45G01N158,울산 현대모비스,Home,김국찬,0,0,1,0.0,0,1,0.0,0,2,0.0,0,0,0.0,1,0,1,1,1,0,0,0,2,3
../kbl_data/2024-2025,S45G01N158,울산 현대모비스,Home,서명진,11,1,1,100.0,2,3,66.7,3,4,75.0,3,4,75.0,0,0,0,0,0,1,0,0,0,1
../kbl_data/2024-2025,S45G01N158,울산 현대모비스,Home,숀 롱,4,2,4,50.0,0,0,0.0,2,4,50.0,0,0,0.0,1,9,10,4,0,0,0,0,1,1
../kbl_data/2024-2025,S45G01N158,울산 현대모비스,Home,이우석,22,4,5,80.0,4,5,80.0,8,10,80.0,2,4,50.0,0,3,3,2,0,1,1,0,0,1
../kbl_data/2024-2025,S45G01N158,울산 현대모비스,Home,이승우,0,0,0,0.0,0,0,0.0,0,0,0.0,0,0,0.0,0,0,0,0,0,0,0,0,0,0
../kbl_data/2024-2025,S45G01N158,울산 현대모비스,Home,신민석,2,1,1,100.0,0,1,0.0,1,2,50.0,0,0,0.0,0,0,0,0,1,0,0,0,1,0
../kbl_data/2024-2025,S45G01N158,울산 현대모비스,Home,게이지 프림,18,8,16,50.0,0,1,0.0,8,17,47.1,2,2,100.0,3,9,12,1,2,2,0,0,3,4
../kbl_data/2024-2025,S45G01N158,울산 현대모비스,Home,박무빈,0,0,5,0.0,0,1,0.0,0,6,0.0,0,0,0.0,2,1,3,4,0,0,0,0,2,1
../kbl_data/2024-2025,S45G01N158,울산 현대모비스,Home,미구엘 안드레 옥존,0,0,1,0.0,0,2,0.0,0,3,0.0,0,0,0.0,0,2,2,4,0,0,0,0,3,1
../kbl_data/2024-2025,S45G01N158,수원 KT,Away,한희원,1,0,1,0.0,0,1,0.0,0,2,0.0,1,2,50.0,1,2,3,1,3,0,0,0,2,2
../kbl_data/2024-2025,S45G01N158,수원 KT,Away,문성곤,0,0,1,0.0,0,1,0.0,0,2,0.0,0,0,0.0,2,0,2,1,1,0,1,0,0,2
../kbl_data/2024-2025,S45G01N158,수원 KT,Away,이현석,0,0,0,0.0,0,0,0.0,0,0,0.0,0,0,0.0,0,0,0,0,0,0,0,0,0,0
../kbl_data/2024-2025,S45G01N158,수원 KT,Away,허훈,18,6,11,54.5,1,9,11.1,7,20,35.0,3,3,100.0,1,2,3,3,2,0,0,0,1,2
../kbl_data/2024-2025,S45G01N158,수원 KT,Away,박준영,10,2,4,50.0,1,2,50.0,3,6,50.0,3,5,60.0,2,3,5,2,0,0,0,0,2,2
../kbl_data/2024-2025,S45G01N158,수원 KT,Away,박지원,0,0,2,0.0,0,0,0.0,0,2,0.0,0,0,0.0,1,1,2,1,1,0,0,0,0,1
../kbl_data/2024-2025,S45G01N158,수원 KT,Away,하윤기,9,4,6,66.7,0,0,0.0,4,6,66.7,1,2,50.0,2,3,5,2,2,0,0,1,2,2
../kbl_data/2024-2025,S45G01N158,수원 KT,Away,문정현,0,0,2,0.0,0,0,0.0,0,2,0.0,0,0,0.0,0,0,0,1,0,0,0,0,0,1
../kbl_data/2024-2025,S45G01N158,수원 KT,Away,레이션 해먼즈,13,5,13,38.5,1,2,50.0,6,15,40.0,0,0,0.0,4,3,7,1,1,0,0,0,3,2
../kbl_data/2024-2025,S45G01N158,수원 KT,Away,박성재,7,2,2,100.0,1,3,33.3,3,5,60.0,0,1,0.0,1,2,3,2,1,0,0,0,1,1
../kbl_data/2024-2025,S45G01N158,수원 KT,Away,이스마엘 로메로,20,7,10,70.0,1,1,100.0,8,11,72.7,3,5,60.0,1,6,7,1,1,1,0,1,2,3
../kbl_data/2024-2025,S45G01N158,수원 KT,Away,조엘 카굴랑안,0,0,5,0.0,0,0,0.0,0,5,0.0,0,0,0.0,0,0,0,1,3,0,1,0,0,0
../kbl_data/2024-2025,S45G01N159,서울 삼성,Home,이정현,14,4,9,44.4,2,7,28.6,6,16,37.5,0,0,0.0,0,4,4,6,1,0,0,0,3,3
../kbl_data/2024-2025,S45G01N159,서울 삼성,Home,최현민,12,0,0,0.0,3,5,60.0,3,5,60.0,3,5,60.0,0,4,4,1,0,0,0,0,2,4
../kbl_data/2024-2025,S45G01N159,서울 삼성,Home,최성모,9,0,1,0.0,3,4,75.0,3,5,60.0,0,0,0.0,0,3,3,2,1,0,0,0,1,2
../kbl_data/2024-2025,S45G01N159,서울 삼성,Home,최승욱,0,0,2,0.0,0,1,0.0,0,3,0.0,0,0,0.0,0,2,2,1,0,0,0,0,0,0
../kbl_data/2024-2025,S45G01N159,서울 삼성,Home,윤성원,3,0,0,0.0,1,1,100.0,1,1,100.0,0,0,0.0,0,0,0,1,0,0,0,0,0,2
../kbl_data/2024-2025,S45G01N159,서울 삼성,Home,마커스 데릭슨,2,0,0,0.0,0,2,0.0,0,2,0.0,2,2,100.0,2,1,3,0,1,0,0,0,4,5
../kbl_data/2024-2025,S45G01N159,서울 삼성,Home,차민석,0,0,0,0.0,0,0,0.0,0,0,0.0,0,0,0.0,0,0,0,0,0,0,0,0,0,0
../kbl_data/2024-2025,S45G01N159,서울 삼성,Home,이원석,7,2,3,66.7,1,3,33.3,3,6,50.0,0,0,0.0,1,1,2,1,1,0,0,0,0,3
../kbl_data/2024-2025,S45G01N159,서울 삼성,Home,저스틴 구탕,6,1,7,14.3,1,4,25.0,2,11,18.2,1,2,50.0,2,6,8,4,2,0,0,0,5,0
../kbl_data/2024-2025,S45G01N159,서울 삼성,Home,박승재,3,0,1,0.0,1,2,50.0,1,3,33.3,0,0,0.0,0,0,0,1,0,0,0,0,1,1
../kbl_data/2024-2025,S45G01N159,서울 삼성,Home,코피 코번,18,7,11,63.6,0,0,0.0,7,11,63.6,4,5,80.0,3,9,12,0,0,0,0,1,1,4
../kbl_data/2024-2025,S45G01N159,서울 삼성,Home,황영찬,0,0,0,0.0,0,0,0.0,0,0,0.0,0,0,0.0,0,0,0,0,0,0,0,0,0,0
../kbl_data/2024-2025,S45G01N159,안양 정관장,Away,송창용,3,0,0,0.0,1,1,100.0,1,1,100.0,0,0,0.0,1,1,2,0,1,0,1,0,1,3
../kbl_data/2024-2025,S45G01N159,안양 정관장,Away,정준원,12,4,5,80.0,1,2,50.0,5,7,71.4,1,1,100.0,0,1,1,0,0,0,0,0,0,3
../kbl_data/2024-2025,S45G01N159,안양 정관장,Away,배병준,3,0,2,0.0,1,6,16.7,1,8,12.5,0,0,0.0,1,6,7,1,1,0,0,0,1,0
../kbl_data/2024-2025,S45G01N159,안양 정관장,Away,박지훈,4,2,4,50.0,0,0,0.0,2,4,50.0,0,0,0.0,1,0,1,3,1,1,1,0,1,2
../kbl_data/2024-2025,S45G01N159,안양 정관장,Away,디온테 버튼,21,7,14,50.0,1,7,14.3,8,21,38.1,4,7,57.1,1,4,5,4,4,0,0,1,4,2
../kbl_data/2024-2025,S45G01N159,안양 정관장,Away,최성원,1,0,0,0.0,0,1,0.0,0,1,0.0,1,2,50.0,0,3,3,4,0,0,0,0,0,3
../kbl_data/2024-2025,S45G01N159,안양 정관장,Away,김경원,16,5,7,71.4,1,2,50.0,6,9,66.7,3,3,100.0,3,2,5,2,3,1,0,0,0,2
../kbl_data/2024-2025,S45G01N159,안양 정관장,Away,한승희,3,1,2,50.0,0,2,0.0,1,4,25.0,1,2,50.0,2,1,3,0,1,0,0,0,0,2
../kbl_data/2024-2025,S45G01N159,안양 정관장,Away,조니 오브라이언트,20,5,9,55.6,3,8,37.5,8,17,47.1,1,6,16.7,3,7,10,1,1,0,0,0,1,2
../kbl_data/2024-2025,S45G01N159,안양 정관장,Away,하비 고메즈,2,1,1,100.0,0,1,0.0,1,2,50.0,0,0,0.0,1,0,1,0,1,0,0,0,1,0
../kbl_data/2024-2025,S45G01N159,안양 정관장,Away,박정웅,0,0,0,0.0,0,0,0.0,0,0,0.0,0,0,0.0,0,0,0,0,0,0,0,0,0,0
../kbl_data/2024-2025,S45G01N159,안양 정관장,Away,소준혁,0,0,0,0.0,0,0,0.0,0,0,0.0,0,0,0.0,0,0,0,0,0,0,0,0,0,0
../kbl_data/2024-2025,S45G01N160,부산 KCC,Home,정창영,0,0,0,0.0,0,0,0.0,0,0,0.0,0,0,0.0,0,1,1,1,1,0,0,0,1,1
../kbl_data/2024-2025,S45G01N160,부산 KCC,Home,전준범,0,0,0,0.0,0,0,0.0,0,0,0.0,0,0,0.0,0,0,0,0,0,0,0,0,0,0
../kbl_data/2024-2025,S45G01N160,부산 KCC,Home,허웅,14,1,6,16.7,4,8,50.0,5,14,35.7,0,0,0.0,0,2,2,6,2,0,0,0,1,4
../kbl_data/2024-2025,S45G01N160,부산 KCC,Home,이승현,16,8,11,72.7,0,1,0.0,8,12,66.7,0,0,0.0,1,7,8,5,2,0,0,0,2,3
../kbl_data/2024-2025,S45G01N160,부산 KCC,Home,이호현,13,2,4,50.0,3,4,75.0,5,8,62.5,0,0,0.0,0,3,3,8,0,0,0,0,3,1
../kbl_data/2024-2025,S45G01N160,부산 KCC,Home,캐디 라렌,25,8,12,66.7,2,5,40.0,10,17,58.8,3,3,100.0,4,3,7,3,2,1,0,1,1,2
../kbl_data/2024-2025,S45G01N160,부산 KCC,Home,이근휘,15,0,0,0.0,5,8,62.5,5,8,62.5,0,0,0.0,0,2,2,1,0,0,0,0,1,0
../kbl_data/2024-2025,S45G01N160,부산 KCC,Home,김동현,8,1,1,100.0,2,5,40.0,3,6,50.0,0,0,0.0,0,1,1,1,1,0,0,0,0,5
../kbl_data/2024-2025,S45G01N160,부산 KCC,Home,여준형,0,0,0,0.0,0,0,0.0,0,0,0.0,0,0,0.0,0,0,0,0,0,0,0,0,0,0
../kbl_data/2024-2025,S45G01N160,부산 KCC,Home,캘빈 제프리 에피스톨라,5,1,1,100.0,1,1,100.0,2,2,100.0,0,0,0.0,0,1,1,4,0,0,0,0,2,2
../kbl_data/2024-2025,S45G01N160,부산 KCC,Home,이주영,0,0,0,0.0,0,0,0.0,0,0,0.0,0,0,0.0,0,0,0,0,0,0,0,0,0,0
../kbl_data/2024-2025,S45G01N160,부산 KCC,Home,이찬영,0,0,0,0.0,0,0,0.0,0,0,0.0,0,0,0.0,0,0,0,0,0,0,0,0,0,0
../kbl_data/2024-2025,S45G01N160,원주 DB,Away,이관희,13,5,7,71.4,1,2,50.0,6,9,66.7,0,0,0.0,0,1,1,5,3,0,0,0,1,1
../kbl_data/2024-2025,S45G01N160,원주 DB,Away,김시래,1,0,0,0.0,0,1,0.0,0,1,0.0,1,2,50.0,0,0,0,1,0,0,0,0,0,0
../kbl_data/2024-2025,S45G01N160,원주 DB,Away,서민수,8,4,4,100.0,0,2,0.0,4,6,66.7,0,0,0.0,2,1,3,1,1,0,0,0,0,2
../kbl_data/2024-2025,S45G01N160,원주 DB,Away,김영현,0,0,0,0.0,0,0,0.0,0,0,0.0,0,0,0.0,0,0,0,0,0,0,0,0,0,0
../kbl_data/2024-2025,S45G01N160,원주 DB,Away,정효근,11,1,2,50.0,3,6,50.0,4,8,50.0,0,0,0.0,1,3,4,3,1,1,0,0,2,2
../kbl_data/2024-2025,S45G01N160,원주 DB,Away,치나누 오누아쿠,14,4,8,50.0,1,4,25.0,5,12,41.7,3,3,100.0,5,7,12,1,0,1,0,1,4,2
../kbl_data/2024-2025,S45G01N160,원주 DB,Away,김훈,0,0,0,0.0,0,0,0.0,0,0,0.0,0,0,0.0,0,0,0,0,0,0,0,0,0,0
../kbl_data/2024-2025,S45G01N160,원주 DB,Away,이용우,0,0,0,0.0,0,0,0.0,0,0,0.0,0,0,0.0,0,0,0,0,0,0,0,0,0,0
../kbl_data/2024-2025,S45G01N160,원주 DB,Away,정호영,12,4,5,80.0,1,4,25.0,5,9,55.6,1,1,100.0,0,0,0,0,0,0,0,0,1,2
../kbl_data/2024-2025,S45G01N160,원주 DB,Away,이선 알바노,15,2,4,50.0,3,5,60.0,5,9,55.6,2,2,100.0,0,4,4,4,1,0,0,0,2,3
../kbl_data/2024-2025,S45G01N160,원주 DB,Away,박인웅,7,2,4,50.0,1,3,33.3,3,7,42.9,0,0,0.0,3,0,3,1,2,0,0,0,2,3
../kbl_data/2024-2025,S45G01N160,원주 DB,Away,로버트 카터,6,0,1,0.0,2,3,66.7,2,4,50.0,0,0,0.0,0,2,2,1,2,0,0,0,1,0
../kbl_data/2024-2025,S45G01N161,대구 한국가스공사,Home,차바위,0,0,1,0.0,0,1,0.0,0,2,0.0,0,0,0.0,0,0,0,0,0,0,0,0,0,0
../kbl_data/2024-2025,S45G01N161,대구 한국가스공사,Home,정성우,13,3,3,100.0,2,5,40.0,5,8,62.5,1,2,50.0,1,4,5,5,2,0,0,0,2,3
../kbl_data/2024-2025,S45G01N161,대구 한국가스공사,Home,김철욱,0,0,0,0.0,0,1,0.0,0,1,0.0,0,0,0.0,0,0,0,0,0,0,0,0,0,0
../kbl_data/2024-2025,S45G01N161,대구 한국가스공사,Home,전현우,13,0,0,0.0,4,6,66.7,4,6,66.7,1,3,33.3,1,2,3,0,0,1,0,0,2,2
../kbl_data/2024-2025,S45G01N161,대구 한국가스공사,Home,양재혁,0,0,0,0.0,0,2,0.0,0,2,0.0,0,0,0.0,1,0,1,2,1,0,0,0,0,1
../kbl_data/2024-2025,S45G01N161,대구 한국가스공사,Home,곽정훈,5,1,3,33.3,1,2,50.0,2,5,40.0,0,0,0.0,3,2,5,1,1,0,0,0,0,5
../kbl_data/2024-2025,S45G01N161,대구 한국가스공사,Home,앤드류 니콜슨,25,8,13,61.5,3,9,33.3,11,22,50.0,0,0,0.0,3,4,7,0,1,1,0,3,2,1
../kbl_data/2024-2025,S45G01N161,대구 한국가스공사,Home,신승민,0,0,1,0.0,0,2,0.0,0,3,0.0,0,0,0.0,1,2,3,3,2,0,0,0,1,2
../kbl_data/2024-2025,S45G01N161,대구 한국가스공사,Home,샘조세프 벨란겔,21,5,10,50.0,2,10,20.0,7,20,35.0,5,6,83.3,0,2,2,4,2,0,1,0,3,2
../kbl_data/2024-2025,S45G01N161,대구 한국가스공사,Home,유슈 은도예,4,2,2,100.0,0,0,0.0,2,2,100.0,0,0,0.0,2,1,3,0,0,0,0,2,1,2
../kbl_data/2024-2025,S45G01N161,대구 한국가스공사,Home,안세영,0,0,0,0.0,0,0,0.0,0,0,0.0,0,0,0.0,0,0,0,0,0,0,0,0,0,0
../kbl_data/2024-2025,S45G01N161,대구 한국가스공사,Home,신주영,0,0,0,0.0,0,1,0.0,0,1,0.0,0,0,0.0,2,0,2,1,0,0,0,0,1,2
../kbl_data/2024-2025,S45G01N161,부산 KCC,Away,정창영,0,0,0,0.0,0,0,0.0,0,0,0.0,0,0,0.0,0,1,1,1,0,0,0,0,0,0
../kbl_data/2024-2025,S45G01N161,부산 KCC,Away,전준범,0,0,0,0.0,0,0,0.0,0,0,0.0,0,0,0.0,0,0,0,0,0,0,0,0,0,0
../kbl_data/2024-2025,S45G01N161,부산 KCC,Away,허웅,18,3,4,75.0,3,8,37.5,6,12,50.0,3,4,75.0,0,1,1,6,0,0,0,0,4,4
../kbl_data/2024-2025,S45G01N161,부산 KCC,Away,이승현,12,6,12,50.0,0,1,0.0,6,13,46.2,0,0,0.0,4,2,6,6,2,1,0,0,1,1
../kbl_data/2024-2025,S45G01N161,부산 KCC,Away,이호현,15,1,3,33.3,3,4,75.0,4,7,57.1,4,4,100.0,0,6,6,5,0,0,0,0,4,3
../kbl_data/2024-2025,S45G01N161,부산 KCC,Away,캐디 라렌,19,8,11,72.7,1,2,50.0,9,13,69.2,0,2,0.0,2,8,10,1,0,0,0,1,2,3
../kbl_data/2024-2025,S45G01N161,부산 KCC,Away,이근휘,3,0,0,0.0,1,2,50.0,1,2,50.0,0,0,0.0,0,1,1,1,0,0,0,0,1,0
../kbl_data/2024-2025,S45G01N161,부산 KCC,Away,김동현,11,3,5,60.0,1,2,50.0,4,7,57.1,2,2,100.0,1,2,3,0,3,0,0,0,1,4
../kbl_data/2024-2025,S45G01N161,부산 KCC,Away,여준형,0,0,0,0.0,0,0,0.0,0,0,0.0,0,0,0.0,0,0,0,0,0,0,0,0,0,0
../kbl_data/2024-2025,S45G01N161,부산 KCC,Away,캘빈 제프리 에피스톨라,9,3,4,75.0,1,2,50.0,4,6,66.7,0,0,0.0,0,0,0,1,3,0,0,0,1,0
../kbl_data/2024-2025,S45G01N161,부산 KCC,Away,이주영,0,0,0,0.0,0,0,0.0,0,0,0.0,0,0,0.0,0,0,0,0,0,0,0,0,0,0
../kbl_data/2024-2025,S45G01N161,부산 KCC,Away,이찬영,0,0,0,0.0,0,0,0.0,0,0,0.0,0,0,0.0,0,0,0,0,0,0,0,0,0,0
../kbl_data/2024-2025,S45G01N162,고양 소노,Home,홍경기,0,0,1,0.0,0,4,0.0,0,5,0.0,0,0,0.0,0,0,0,1,0,0,0,0,0,0
../kbl_data/2024-2025,S45G01N162,고양 소노,Home,임동섭,11,0,3,0.0,3,7,42.9,3,10,30.0,2,2,100.0,1,7,8,1,0,0,0,0,0,4
../kbl_data/2024-2025,S45G01N162,고양 소노,Home,이재도,14,2,6,33.3,3,4,75.0,5,10,50.0,1,2,50.0,1,1,2,4,1,0,0,0,4,2
../kbl_data/2024-2025,S45G01N162,고양 소노,Home,최승욱,2,1,3,33.3,0,0,0.0,1,3,33.3,0,0,0.0,1,1,2,0,1,0,0,0,2,4
../kbl_data/2024-2025,S45G01N162,고양 소노,Home,박진철,0,0,0,0.0,0,0,0.0,0,0,0.0,0,0,0.0,2,1,3,0,0,0,0,0,1,0
../kbl_data/2024-2025,S45G01N162,고양 소노,Home,조은후,2,1,1,100.0,0,1,0.0,1,2,50.0,0,0,0.0,1,1,2,0,0,0,0,0,1,2
../kbl_data/2024-2025,S45G01N162,고양 소노,Home,박종하,3,1,2,50.0,0,1,0.0,1,3,33.3,1,2,50.0,0,1,1,0,0,0,0,0,0,3
../kbl_data/2024-2025,S45G01N162,고양 소노,Home,디제이 번즈 Jr,2,1,5,20.0,0,0,0.0,1,5,20.0,0,0,0.0,1,1,2,2,0,0,0,0,0,1
../kbl_data/2024-2025,S45G01N162,고양 소노,Home,서동원,2,1,1,100.0,0,1,0.0,1,2,50.0,0,0,0.0,1,0,1,0,0,0,0,0,0,0
../kbl_data/2024-2025,S45G01N162,고양 소노,Home,정성조,3,0,1,0.0,1,4,25.0,1,5,20.0,0,0,0.0,0,2,2,3,0,0,0,0,2,1
../kbl_data/2024-2025,S45G01N162,고양 소노,Home,알파 카바,16,8,11,72.7,0,0,0.0,8,11,72.7,0,1,0.0,3,3,6,3,0,2,0,4,1,1
../kbl_data/2024-2025,S45G01N162,고양 소노,Home,케빈 켐바오,14,3,8,37.5,2,7,28.6,5,15,33.3,2,2,100.0,2,2,4,5,0,0,0,0,5,4
../kbl_data/2024-2025,S45G01N162,안양 정관장,Away,송창용,1,0,0,0.0,0,1,0.0,0,1,0.0,1,2,50.0,0,3,3,2,2,0,1,0,3,3
../kbl_data/2024-2025,S45G01N162,안양 정관장,Away,정준원,14,4,6,66.7,2,3,66.7,6,9,66.7,0,0,0.0,1,1,2,2,1,0,0,0,0,1
../kbl_data/2024-2025,S45G01N162,안양 정관장,Away,배병준,13,1,2,50.0,3,6,50.0,4,8,50.0,2,2,100.0,1,4,5,2,0,0,0,0,2,1
../kbl_data/2024-2025,S45G01N162,안양 정관장,Away,박지훈,16,5,6,83.3,1,3,33.3,6,9,66.7,3,4,75.0,0,4,4,8,2,0,0,0,0,1
../kbl_data/2024-2025,S45G01N162,안양 정관장,Away,디온테 버튼,24,10,12,83.3,0,4,0.0,10,16,62.5,4,4,100.0,1,5,6,2,2,0,0,1,3,1
../kbl_data/2024-2025,S45G01N162,안양 정관장,Away,최성원,0,0,0,0.0,0,4,0.0,0,4,0.0,0,0,0.0,0,1,1,2,1,0,0,0,0,3
../kbl_data/2024-2025,S45G01N162,안양 정관장,Away,김경원,0,0,1,0.0,0,0,0.0,0,1,0.0,0,0,0.0,1,0,1,0,0,0,1,0,0,0
../kbl_data/2024-2025,S45G01N162,안양 정관장,Away,한승희,3,1,2,50.0,0,0,0.0,1,2,50.0,1,2,50.0,1,4,5,1,0,0,1,0,0,3
../kbl_data/2024-2025,S45G01N162,안양 정관장,Away,조니 오브라이언트,17,4,9,44.4,2,3,66.7,6,12,50.0,3,5,60.0,0,7,7,0,1,0,0,0,1,1
../kbl_data/2024-2025,S45G01N162,안양 정관장,Away,하비 고메즈,0,0,0,0.0,0,0,0.0,0,0,0.0,0,0,0.0,0,1,1,0,0,0,0,0,1,0
../kbl_data/2024-2025,S45G01N162,안양 정관장,Away,박정웅,0,0,0,0.0,0,0,0.0,0,0,0.0,0,0,0.0,0,0,0,1,0,0,0,0,0,0
../kbl_data/2024-2025,S45G01N162,안양 정관장,Away,소준혁,6,0,0,0.0,2,2,100.0,2,2,100.0,0,0,0.0,0,0,0,0,0,0,0,0,1,2
../kbl_data/2024-2025,S45G01N163,서울 삼성,Home,이정현,25,6,12,50.0,2,6,33.3,8,18,44.4,7,7,100.0,2,3,5,5,1,1,0,0,3,1
../kbl_data/2024-2025,S45G01N163,서울 삼성,Home,최현민,0,0,1,0.0,0,2,0.0,0,3,0.0,0,0,0.0,0,0,0,3,2,0,0,0,2,2
../kbl_data/2024-2025,S45G01N163,서울 삼성,Home,최성모,8,1,3,33.3,2,5,40.0,3,8,37.5,0,0,0.0,0,2,2,6,1,0,0,0,3,4
../kbl_data/2024-2025,S45G01N163,서울 삼성,Home,최승욱,2,1,1,100.0,0,1,0.0,1,2,50.0,0,1,0.0,0,1,1,0,1,0,0,0,1,4
../kbl_data/2024-2025,S45G01N163,서울 삼성,Home,윤성원,0,0,0,0.0,0,0,0.0,0,0,0.0,0,0,0.0,0,0,0,0,0,0,0,0,0,0
../kbl_data/2024-2025,S45G01N163,서울 삼성,Home,마커스 데릭슨,16,2,4,50.0,4,8,50.0,6,12,50.0,0,0,0.0,0,3,3,0,0,0,1,0,0,2
../kbl_data/2024-2025,S45G01N163,서울 삼성,Home,차민석,0,0,0,0.0,0,0,0.0,0,0,0.0,0,0,0.0,0,0,0,0,0,0,0,0,0,0
../kbl_data/2024-2025,S45G01N163,서울 삼성,Home,이원석,7,3,8,37.5,0,0,0.0,3,8,37.5,1,2,50.0,7,5,12,1,0,1,0,0,0,3
../kbl_data/2024-2025,S45G01N163,서울 삼성,Home,저스틴 구탕,10,2,5,40.0,2,4,50.0,4,9,44.4,0,0,0.0,1,6,7,5,1,0,0,0,2,4
../kbl_data/2024-2025,S45G01N163,서울 삼성,Home,박승재,2,1,1,100.0,0,1,0.0,1,2,50.0,0,0,0.0,0,0,0,0,0,0,0,0,0,0
../kbl_data/2024-2025,S45G01N163,서울 삼성,Home,코피 코번,5,2,3,66.7,0,0,0.0,2,3,66.7,1,2,50.0,0,4,4,1,0,0,0,0,2,0
../kbl_data/2024-2025,S45G01N163,서울 삼성,Home,황영찬,0,0,0,0.0,0,0,0.0,0,0,0.0,0,0,0.0,0,0,0,0,0,0,0,0,0,0
../kbl_data/2024-2025,S45G01N163,서울 SK,Away,김선형,15,6,9,66.7,0,0,0.0,6,9,66.7,3,4,75.0,1,0,1,7,5,0,0,0,3,3
../kbl_data/2024-2025,S45G01N163,서울 SK,Away,오세근,3,0,1,0.0,1,4,25.0,1,5,20.0,0,0,0.0,2,3,5,1,1,1,0,0,0,2
../kbl_data/2024-2025,S45G01N163,서울 SK,Away,최부경,2,1,2,50.0,0,0,0.0,1,2,50.0,0,2,0.0,2,1,3,1,0,0,0,0,0,0
../kbl_data/2024-2025,S45G01N163,서울 SK,Away,최원혁,0,0,0,0.0,0,0,0.0,0,0,0.0,0,0,0.0,3,0,3,1,0,0,0,0,1,0
../kbl_data/2024-2025,S45G01N163,서울 SK,Away,김지후,0,0,0,0.0,0,0,0.0,0,0,0.0,0,0,0.0,0,0,0,0,0,0,0,0,0,0
../kbl_data/2024-2025,S45G01N163,서울 SK,Away,안영준,18,2,6,33.3,2,7,28.6,4,13,30.8,8,11,72.7,1,4,5,3,2,0,0,0,2,3
../kbl_data/2024-2025,S45G01N163,서울 SK,Away,자밀 워니,25,12,20,60.0,0,4,0.0,12,24,50.0,1,1,100.0,2,9,11,6,3,0,0,0,1,2
../kbl_data/2024-2025,S45G01N163,서울 SK,Away,아이재아 힉스,7,2,6,33.3,1,3,33.3,3,9,33.3,0,0,0.0,1,0,1,0,0,0,0,0,1,1
../kbl_data/2024-2025,S45G01N163,서울 SK,Away,박민우,0,0,0,0.0,0,0,0.0,0,0,0.0,0,0,0.0,0,0,0,0,0,0,0,0,0,0
../kbl_data/2024-2025,S45G01N163,서울 SK,Away,오재현,9,2,4,50.0,1,4,25.0,3,8,37.5,2,2,100.0,3,3,6,3,0,0,0,0,1,5
../kbl_data/2024-2025,S45G01N163,서울 SK,Away,고메즈 델 리아노,0,0,0,0.0,0,0,0.0,0,0,0.0,0,0,0.0,0,1,1,0,1,0,0,0,0,1
../kbl_data/2024-2025,S45G01N163,서울 SK,Away,김태훈,0,0,0,0.0,0,0,0.0,0,0,0.0,0,0,0.0,0,0,0,0,0,0,0,0,0,1
../kbl_data/2024-2025,S45G01N164,원주 DB,Home,이관희,14,3,4,75.0,2,4,50.0,5,8,62.5,2,3,66.7,0,2,2,2,1,0,0,0,1,0
../kbl_data/2024-2025,S45G01N164,원주 DB,Home,김시래,2,1,1,100.0,0,0,0.0,1,1,100.0,0,0,0.0,0,0,0,0,0,0,0,0,0,0
../kbl_data/2024-2025,S45G01N164,원주 DB,Home,서민수,0,0,0,0.0,0,1,0.0,0,1,0.0,0,0,0.0,1,1,2,0,1,0,0,0,0,0
../kbl_data/2024-2025,S45G01N164,원주 DB,Home,김영현,0,0,0,0.0,0,0,0.0,0,0,0.0,0,0,0.0,0,0,0,0,0,0,0,0,0,0
../kbl_data/2024-2025,S45G01N164,원주 DB,Home,정효근,2,1,1,100.0,0,2,0.0,1,3,33.3,0,0,0.0,1,1,2,0,0,2,0,0,0,4
../kbl_data/2024-2025,S45G01N164,원주 DB,Home,강상재,15,6,9,66.7,1,2,50.0,7,11,63.6,0,2,0.0,4,5,9,3,0,0,0,0,1,3
../kbl_data/2024-2025,S45G01N164,원주 DB,Home,치나누 오누아쿠,11,2,4,50.0,2,2,100.0,4,6,66.7,1,1,100.0,0,3,3,1,0,0,0,0,3,2
../kbl_data/2024-2025,S45G01N164,원주 DB,Home,김훈,0,0,0,0.0,0,0,0.0,0,0,0.0,0,0,0.0,0,0,0,0,0,0,0,0,0,0
../kbl_data/2024-2025,S45G01N164,원주 DB,Home,정호영,0,0,0,0.0,0,0,0.0,0,0,0.0,0,0,0.0,0,0,0,0,0,0,0,0,0,0
../kbl_data/2024-2025,S45G01N164,원주 DB,Home,이선 알바노,3,0,3,0.0,1,9,11.1,1,12,8.3,0,2,0.0,0,5,5,7,3,1,0,0,2,3
../kbl_data/2024-2025,S45G01N164,원주 DB,Home,박인웅,12,1,2,50.0,2,8,25.0,3,10,30.0,4,4,100.0,3,1,4,1,0,0,0,0,3,3
../kbl_data/2024-2025,S45G01N164,원주 DB,Home,로버트 카터,10,3,8,37.5,1,4,25.0,4,12,33.3,1,2,50.0,1,6,7,3,2,1,0,0,1,3
../kbl_data/2024-2025,S45G01N164,수원 KT,Away,한희원,7,2,4,50.0,1,2,50.0,3,6,50.0,0,0,0.0,0,0,0,0,1,1,0,0,1,4
../kbl_data/2024-2025,S45G01N164,수원 KT,Away,문성곤,0,0,0,0.0,0,0,0.0,0,0,0.0,0,0,0.0,0,0,0,0,0,0,0,0,0,2
../kbl_data/2024-2025,S45G01N164,수원 KT,Away,이현석,0,0,0,0.0,0,0,0.0,0,0,0.0,0,0,0.0,0,0,0,0,0,0,0,0,0,0
../kbl_data/2024-2025,S45G01N164,수원 KT,Away,허훈,21,2,8,25.0,5,8,62.5,7,16,43.8,2,2,100.0,0,4,4,5,2,0,0,0,4,2
../kbl_data/2024-2025,S45G01N164,수원 KT,Away,박준영,0,0,0,0.0,0,0,0.0,0,0,0.0,0,0,0.0,0,0,0,0,0,0,0,0,0,0
../kbl_data/2024-2025,S45G01N164,수원 KT,Away,박지원,0,0,0,0.0,0,0,0.0,0,0,0.0,0,0,0.0,0,0,0,0,0,0,0,0,0,0
../kbl_data/2024-2025,S45G01N164,수원 KT,Away,하윤기,16,7,12,58.3,0,0,0.0,7,12,58.3,2,2,100.0,2,4,6,3,2,0,0,1,2,1
../kbl_data/2024-2025,S45G01N164,수원 KT,Away,문정현,5,1,4,25.0,1,4,25.0,2,8,25.0,0,2,0.0,3,2,5,2,0,0,1,0,0,1
../kbl_data/2024-2025,S45G01N164,수원 KT,Away,레이션 해먼즈,8,4,6,66.7,0,2,0.0,4,8,50.0,0,0,0.0,3,8,11,2,0,1,0,0,1,4
../kbl_data/2024-2025,S45G01N164,수원 KT,Away,박성재,0,0,0,0.0,0,0,0.0,0,0,0.0,0,0,0.0,1,1,2,0,0,0,0,0,0,1
../kbl_data/2024-2025,S45G01N164,수원 KT,Away,이스마엘 로메로,8,4,6,66.7,0,0,0.0,4,6,66.7,0,2,0.0,1,4,5,2,1,0,0,0,2,2
../kbl_data/2024-2025,S45G01N164,수원 KT,Away,조엘 카굴랑안,6,3,7,42.9,0,2,0.0,3,9,33.3,0,0,0.0,1,0,1,3,0,0,0,0,0,0
../kbl_data/2024-2025,S45G01N165,창원 LG,Home,허일영,4,0,2,0.0,1,2,50.0,1,4,25.0,1,1,100.0,2,2,4,0,2,0,0,0,2,1
../kbl_data/2024-2025,S45G01N165,창원 LG,Home,장민국,0,0,0,0.0,0,0,0.0,0,0,0.0,0,0,0.0,0,0,0,0,0,0,0,0,0,0
../kbl_data/2024-2025,S45G01N165,창원 LG,Home,한상혁,0,0,0,0.0,0,0,0.0,0,0,0.0,0,0,0.0,0,0,0,0,0,0,0,0,0,0
../kbl_data/2024-2025,S45G01N165,창원 LG,Home,전성현,6,0,2,0.0,2,5,40.0,2,7,28.6,0,0,0.0,0,0,0,1,0,0,0,0,1,2
../kbl_data/2024-2025,S45G01N165,창원 LG,Home,정인덕,6,3,4,75.0,0,1,0.0,3,5,60.0,0,0,0.0,1,5,6,0,1,0,0,0,0,2
../kbl_data/2024-2025,S45G01N165,창원 LG,Home,대릴 먼로,4,2,2,100.0,0,0,0.0,2,2,100.0,0,0,0.0,0,7,7,5,1,0,0,0,2,2
../kbl_data/2024-2025,S45G01N165,창원 LG,Home,박정현,0,0,0,0.0,0,0,0.0,0,0,0.0,0,0,0.0,0,0,0,0,0,0,0,0,0,0
../kbl_data/2024-2025,S45G01N165,창원 LG,Home,아셈 마레이,14,5,9,55.6,0,0,0.0,5,9,55.6,4,9,44.4,4,7,11,1,0,3,0,0,1,3
../kbl_data/2024-2025,S45G01N165,창원 LG,Home,양준석,14,3,5,60.0,2,10,20.0,5,15,33.3,2,2,100.0,1,1,2,5,1,0,1,0,2,2
../kbl_data/2024-2025,S45G01N165,창원 LG,Home,이경도,5,1,2,50.0,1,1,100.0,2,3,66.7,0,0,0.0,0,0,0,0,0,0,0,0,0,1
../kbl_data/2024-2025,S45G01N165,창원 LG,Home,칼 타마요,14,7,14,50.0,0,2,0.0,7,16,43.8,0,1,0.0,0,3,3,3,1,0,0,0,1,3
../kbl_data/2024-2025,S45G01N165,창원 LG,Home,최형찬,2,1,1,100.0,0,0,0.0,1,1,100.0,0,0,0.0,0,2,2,0,0,0,0,0,0,3
../kbl_data/2024-2025,S45G01N165,대구 한국가스공사,Away,김동량,0,0,0,0.0,0,0,0.0,0,0,0.0,0,0,0.0,0,0,0,0,0,0,0,0,0,0
../kbl_data/2024-2025,S45G01N165,대구 한국가스공사,Away,차바위,0,0,0,0.0,0,0,0.0,0,0,0.0,0,0,0.0,0,0,0,0,0,0,0,0,0,0
../kbl_data/2024-2025,S45G01N165,대구 한국가스공사,Away,박지훈,5,1,2,50.0,1,3,33.3,2,5,40.0,0,0,0.0,2,1,3,1,0,0,0,0,1,2
../kbl_data/2024-2025,S45G01N165,대구 한국가스공사,Away,정성우,4,2,3,66.7,0,3,0.0,2,6,33.3,0,0,0.0,1,1,2,1,0,0,1,0,2,3
../kbl_data/2024-2025,S45G01N165,대구 한국가스공사,Away,우동현,0,0,0,0.0,0,0,0.0,0,0,0.0,0,0,0.0,0,0,0,0,0,0,0,0,0,0
../kbl_data/2024-2025,S45G01N165,대구 한국가스공사,Away,전현우,0,0,1,0.0,0,4,0.0,0,5,0.0,0,0,0.0,1,2,3,0,1,0,0,0,0,4
../kbl_data/2024-2025,S45G01N165,대구 한국가스공사,Away,곽정훈,4,0,0,0.0,1,3,33.3,1,3,33.3,1,2,50.0,2,4,6,0,1,0,0,0,0,1
../kbl_data/2024-2025,S45G01N165,대구 한국가스공사,Away,앤드류 니콜슨,23,5,11,45.5,4,10,40.0,9,21,42.9,1,2,50.0,4,8,12,1,2,0,0,0,1,2
../kbl_data/2024-2025,S45G01N165,대구 한국가스공사,Away,신승민,3,0,3,0.0,1,4,25.0,1,7,14.3,0,0,0.0,1,5,6,2,0,2,0,0,2,4
../kbl_data/2024-2025,S45G01N165,대구 한국가스공사,Away,샘조세프 벨란겔,23,6,11,54.5,3,6,50.0,9,17,52.9,2,2,100.0,2,0,2,7,0,0,0,0,2,2
../kbl_data/2024-2025,S45G01N165,대구 한국가스공사,Away,유슈 은도예,5,1,2,50.0,0,1,0.0,1,3,33.3,3,4,75.0,2,4,6,0,0,1,0,1,0,1
../kbl_data/2024-2025,S45G01N165,대구 한국가스공사,Away,신주영,0,0,1,0.0,0,2,0.0,0,3,0.0,0,0,0.0,0,0,0,0,1,0,0,0,0,2
../kbl_data/2024-2025,S45G01N166,울산 현대모비스,Home,장재석,3,1,1,100.0,0,0,0.0,1,1,100.0,1,2,50.0,0,4,4,6,0,0,0,0,3,2
../kbl_data/2024-2025,S45G01N166,울산 현대모비스,Home,한호빈,5,1,1,100.0,1,5,20.0,2,6,33.3,0,0,0.0,0,1,1,4,0,0,0,0,1,2
../kbl_data/2024-2025,S45G01N166,울산 현대모비스,Home,김준일,0,0,0,0.0,0,0,0.0,0,0,0.0,0,0,0.0,0,1,1,0,0,0,0,0,1,1
../kbl_data/2024-2025,S45G01N166,울산 현대모비스,Home,김국찬,11,1,1,100.0,3,3,100.0,4,4,100.0,0,0,0.0,2,2,4,0,0,2,0,0,1,2
../kbl_data/2024-2025,S45G01N166,울산 현대모비스,Home,서명진,5,1,2,50.0,1,2,50.0,2,4,50.0,0,0,0.0,0,3,3,2,2,0,0,0,0,3
../kbl_data/2024-2025,S45G01N166,울산 현대모비스,Home,숀 롱,25,9,14,64.3,1,1,100.0,10,15,66.7,4,6,66.7,2,3,5,3,3,0,0,3,3,2
../kbl_data/2024-2025,S45G01N166,울산 현대모비스,Home,이우석,18,6,10,60.0,2,7,28.6,8,17,47.1,0,0,0.0,0,5,5,3,0,1,0,0,0,1
../kbl_data/2024-2025,S45G01N166,울산 현대모비스,Home,이승우,6,3,3,100.0,0,0,0.0,3,3,100.0,0,0,0.0,0,0,0,0,1,0,0,0,0,0
../kbl_data/2024-2025,S45G01N166,울산 현대모비스,Home,신민석,2,1,1,100.0,0,1,0.0,1,2,50.0,0,0,0.0,0,4,4,0,0,0,0,0,0,0
../kbl_data/2024-2025,S45G01N166,울산 현대모비스,Home,게이지 프림,18,8,13,61.5,0,0,0.0,8,13,61.5,2,3,66.7,4,3,7,4,0,1,0,0,0,0
../kbl_data/2024-2025,S45G01N166,울산 현대모비스,Home,박무빈,4,2,3,66.7,0,4,0.0,2,7,28.6,0,0,0.0,0,1,1,3,0,0,0,0,0,2
../kbl_data/2024-2025,S45G01N166,울산 현대모비스,Home,미구엘 안드레 옥존,0,0,0,0.0,0,0,0.0,0,0,0.0,0,0,0.0,0,0,0,0,0,0,0,0,0,0
../kbl_data/2024-2025,S45G01N166,부산 KCC,Away,정창영,2,1,2,50.0,0,0,0.0,1,2,50.0,0,0,0.0,0,0,0,3,0,0,0,0,1,0
../kbl_data/2024-2025,S45G01N166,부산 KCC,Away,전준범,2,1,2,50.0,0,1,0.0,1,3,33.3,0,0,0.0,0,2,2,2,0,0,0,0,0,3
../kbl_data/2024-2025,S45G01N166,부산 KCC,Away,허웅,15,2,4,50.0,3,7,42.9,5,11,45.5,2,3,66.7,0,2,2,5,0,0,0,0,3,0
../kbl_data/2024-2025,S45G01N166,부산 KCC,Away,이승현,2,1,2,50.0,0,0,0.0,1,2,50.0,0,0,0.0,0,3,3,0,0,0,0,0,0,0
../kbl_data/2024-2025,S45G01N166,부산 KCC,Away,이호현,2,1,5,20.0,0,1,0.0,1,6,16.7,0,0,0.0,0,0,0,1,1,0,0,0,0,0
../kbl_data/2024-2025,S45G01N166,부산 KCC,Away,캐디 라렌,33,13,21,61.9,1,4,25.0,14,25,56.0,4,5,80.0,5,3,8,3,0,2,0,3,4,4
../kbl_data/2024-2025,S45G01N166,부산 KCC,Away,이근휘,12,0,0,0.0,4,9,44.4,4,9,44.4,0,0,0.0,0,0,0,1,3,0,0,0,2,2
../kbl_data/2024-2025,S45G01N166,부산 KCC,Away,김동현,0,0,0,0.0,0,0,0.0,0,0,0.0,0,0,0.0,0,0,0,0,0,0,0,0,0,0
../kbl_data/2024-2025,S45G01N166,부산 KCC,Away,여준형,2,1,1,100.0,0,1,0.0,1,2,50.0,0,0,0.0,0,1,1,1,1,0,0,0,0,4
../kbl_data/2024-2025,S45G01N166,부산 KCC,Away,캘빈 제프리 에피스톨라,10,2,3,66.7,2,4,50.0,4,7,57.1,0,0,0.0,0,6,6,0,1,0,0,0,1,2
../kbl_data/2024-2025,S45G01N166,부산 KCC,Away,이주영,0,0,0,0.0,0,0,0.0,0,0,0.0,0,0,0.0,0,0,0,1,0,0,0,0,0,0
../kbl_data/2024-2025,S45G01N166,부산 KCC,Away,이찬영,0,0,0,0.0,0,0,0.0,0,0,0.0,0,0,0.0,0,0,0,0,0,0,0,0,0,0
../kbl_data/2024-2025,S45G01N167,수원 KT,Home,한희원,0,0,1,0.0,0,2,0.0,0,3,0.0,0,0,0.0,3,3,6,2,1,0,0,0,3,3
../kbl_data/2024-2025,S45G01N167,수원 KT,Home,문성곤,3,0,0,0.0,1,5,20.0,1,5,20.0,0,0,0.0,1,1,2,2,0,0,0,0,0,2
../kbl_data/2024-2025,S45G01N167,수원 KT,Home,이현석,0,0,0,0.0,0,0,0.0,0,0,0.0,0,0,0.0,0,0,0,0,0,0,0,0,0,0
../kbl_data/2024-2025,S45G01N167,수원 KT,Home,허훈,16,2,4,50.0,4,14,28.6,6,18,33.3,0,1,0.0,0,0,0,6,0,0,0,0,2,1
../kbl_data/2024-2025,S45G01N167,수원 KT,Home,박준영,10,4,7,57.1,0,1,0.0,4,8,50.0,2,3,66.7,6,3,9,4,1,0,0,0,3,1
../kbl_data/2024-2025,S45G01N167,수원 KT,Home,박지원,0,0,0,0.0,0,0,0.0,0,0,0.0,0,0,0.0,0,0,0,0,0,0,0,0,0,0
../kbl_data/2024-2025,S45G01N167,수원 KT,Home,하윤기,2,1,2,50.0,0,0,0.0,1,2,50.0,0,0,0.0,1,1,2,2,0,0,0,0,2,2
../kbl_data/2024-2025,S45G01N167,수원 KT,Home,문정현,9,2,3,66.7,1,4,25.0,3,7,42.9,2,2,100.0,0,3,3,0,0,0,0,0,1,3
../kbl_data/2024-2025,S45G01N167,수원 KT,Home,레이션 해먼즈,23,5,11,45.5,3,5,60.0,8,16,50.0,4,4,100.0,5,4,9,0,2,1,0,0,0,4
../kbl_data/2024-2025,S45G01N167,수원 KT,Home,박성재,0,0,0,0.0,0,0,0.0,0,0,0.0,0,0,0.0,0,0,0,0,0,0,0,0,0,0
../kbl_data/2024-2025,S45G01N167,수원 KT,Home,이스마엘 로메로,11,3,5,60.0,1,2,50.0,4,7,57.1,2,4,50.0,2,8,10,1,0,0,0,1,2,4
../kbl_data/2024-2025,S45G01N167,수원 KT,Home,조엘 카굴랑안,4,0,0,0.0,0,2,0.0,0,2,0.0,4,4,100.0,0,1,1,4,1,0,0,0,0,1
../kbl_data/2024-2025,S45G01N167,고양 소노,Away,함준후,0,0,1,0.0,0,1,0.0,0,2,0.0,0,0,0.0,0,1,1,0,0,0,2,0,0,3
../kbl_data/2024-2025,S45G01N167,고양 소노,Away,임동섭,10,0,1,0.0,2,3,66.7,2,4,50.0,4,4,100.0,1,4,5,2,3,1,1,0,3,4
../kbl_data/2024-2025,S45G01N167,고양 소노,Away,이재도,21,5,7,71.4,3,3,100.0,8,10,80.0,2,2,100.0,1,2,3,3,1,0,1,0,3,1
../kbl_data/2024-2025,S45G01N167,고양 소노,Away,김영훈,0,0,0,0.0,0,0,0.0,0,0,0.0,0,0,0.0,0,0,0,0,0,0,0,0,0,1
../kbl_data/2024-2025,S45G01N167,고양 소노,Away,박진철,0,0,0,0.0,0,0,0.0,0,0,0.0,0,0,0.0,0,0,0,0,0,0,0,0,0,1
../kbl_data/2024-2025,S45G01N167,고양 소노,Away,문시윤,0,0,0,0.0,0,0,0.0,0,0,0.0,0,0,0.0,0,0,0,0,0,0,0,0,0,0
../kbl_data/2024-2025,S45G01N167,고양 소노,Away,조은후,1,0,1,0.0,0,1,0.0,0,2,0.0,1,2,50.0,0,0,0,2,1,0,0,0,0,1
../kbl_data/2024-2025,S45G01N167,고양 소노,Away,박종하,4,0,4,0.0,1,2,50.0,1,6,16.7,1,2,50.0,0,0,0,2,2,0,0,0,1,3
../kbl_data/2024-2025,S45G01N167,고양 소노,Away,민기남,0,0,1,0.0,0,0,0.0,0,1,0.0,0,0,0.0,0,0,0,1,0,0,0,0,0,0
../kbl_data/2024-2025,S45G01N167,고양 소노,Away,디제이 번즈 Jr,19,8,15,53.3,0,1,0.0,8,16,50.0,3,5,60.0,3,6,9,5,1,0,0,0,2,3
../kbl_data/2024-2025,S45G01N167,고양 소노,Away,정성조,0,0,0,0.0,0,1,0.0,0,1,0.0,0,0,0.0,0,1,1,0,0,0,0,0,1,2
../kbl_data/2024-2025,S45G01N167,고양 소노,Away,케빈 켐바오,18,5,11,45.5,2,7,28.6,7,18,38.9,2,2,100.0,0,8,8,2,1,1,0,0,2,0
../kbl_data/2024-2025,S45G01N168,원주 DB,Home,이관희,11,3,5,60.0,1,6,16.7,4,11,36.4,2,2,100.0,0,5,5,2,1,0,0,0,2,2
../kbl_data/2024-2025,S45G01N168,원주 DB,Home,김시래,7,2,4,50.0,1,2,50.0,3,6,50.0,0,0,0.0,0,1,1,1,0,0,0,0,2,4
../kbl_data/2024-2025,S45G01N168,원주 DB,Home,서민수,0,0,1,0.0,0,2,0.0,0,3,0.0,0,0,0.0,4,1,5,2,0,0,0,0,0,1
../kbl_data/2024-2025,S45G01N168,원주 DB,Home,김영현,0,0,0,0.0,0,0,0.0,0,0,0.0,0,0,0.0,0,0,0,0,0,0,0,0,0,0
../kbl_data/2024-2025,S45G01N168,원주 DB,Home,정효근,10,3,8,37.5,1,1,100.0,4,9,44.4,1,2,50.0,0,4,4,0,0,0,0,0,0,3
../kbl_data/2024-2025,S45G01N168,원주 DB,Home,강상재,0,0,4,0.0,0,1,0.0,0,5,0.0,0,0,0.0,2,3,5,1,2,0,0,0,2,3
../kbl_data/2024-2025,S45G01N168,원주 DB,Home,치나누 오누아쿠,19,8,12,66.7,0,4,0.0,8,16,50.0,3,3,100.0,6,4,10,4,1,0,0,2,2,3
../kbl_data/2024-2025,S45G01N168,원주 DB,Home,김훈,0,0,0,0.0,0,0,0.0,0,0,0.0,0,0,0.0,0,0,0,1,0,0,0,0,0,2
../kbl_data/2024-2025,S45G01N168,원주 DB,Home,이용우,3,0,0,0.0,1,1,100.0,1,1,100.0,0,0,0.0,0,1,1,0,0,0,0,0,0,0
../kbl_data/2024-2025,S45G01N168,원주 DB,Home,이선 알바노,4,2,7,28.6,0,2,0.0,2,9,22.2,0,0,0.0,0,2,2,6,3,0,0,0,3,0
../kbl_data/2024-2025,S45G01N168,원주 DB,Home,박인웅,0,0,0,0.0,0,0,0.0,0,0,0.0,0,0,0.0,0,0,0,0,0,0,0,0,0,1
../kbl_data/2024-2025,S45G01N168,원주 DB,Home,로버트 카터,7,2,4,50.0,1,4,25.0,3,8,37.5,0,0,0.0,0,3,3,0,0,1,0,0,1,0
../kbl_data/2024-2025,S45G01N168,창원 LG,Away,허일영,9,0,2,0.0,2,7,28.6,2,9,22.2,3,4,75.0,3,2,5,1,2,1,0,0,0,1
../kbl_data/2024-2025,S45G01N168,창원 LG,Away,장민국,6,0,0,0.0,2,4,50.0,2,4,50.0,0,0,0.0,0,0,0,0,0,0,0,0,0,1
../kbl_data/2024-2025,S45G01N168,창원 LG,Away,한상혁,0,0,0,0.0,0,0,0.0,0,0,0.0,0,0,0.0,0,0,0,0,0,0,0,0,0,0
../kbl_data/2024-2025,S45G01N168,창원 LG,Away,전성현,0,0,0,0.0,0,2,0.0,0,2,0.0,0,0,0.0,0,1,1,0,0,0,0,0,0,0
../kbl_data/2024-2025,S45G01N168,창원 LG,Away,정인덕,6,2,3,66.7,0,3,0.0,2,6,33.3,2,2,100.0,0,0,0,2,2,1,0,0,0,2
../kbl_data/2024-2025,S45G01N168,창원 LG,Away,대릴 먼로,11,4,4,100.0,1,1,100.0,5,5,100.0,0,0,0.0,0,7,7,1,0,1,1,0,3,0
../kbl_data/2024-2025,S45G01N168,창원 LG,Away,박정현,0,0,0,0.0,0,0,0.0,0,0,0.0,0,0,0.0,0,0,0,0,0,0,0,0,0,0
../kbl_data/2024-2025,S45G01N168,창원 LG,Away,아셈 마레이,15,7,10,70.0,0,0,0.0,7,10,70.0,1,3,33.3,2,11,13,3,1,1,0,0,2,2
../kbl_data/2024-2025,S45G01N168,창원 LG,Away,양준석,8,4,7,57.1,0,3,0.0,4,10,40.0,0,0,0.0,1,1,2,5,0,0,0,0,3,3
../kbl_data/2024-2025,S45G01N168,창원 LG,Away,이경도,8,4,5,80.0,0,0,0.0,4,5,80.0,0,0,0.0,1,0,1,4,1,0,0,0,0,1
../kbl_data/2024-2025,S45G01N168,창원 LG,Away,칼 타마요,11,4,10,40.0,1,2,50.0,5,12,41.7,0,0,0.0,0,3,3,1,1,0,0,0,0,4
../kbl_data/2024-2025,S45G01N168,창원 LG,Away,최형찬,2,1,2,50.0,0,2,0.0,1,4,25.0,0,0,0.0,1,3,4,1,1,0,0,0,0,4
../kbl_data/2024-2025,S45G01N169,대구 한국가스공사,Home,김동량,1,0,2,0.0,0,0,0.0,0,2,0.0,1,2,50.0,0,2,2,1,0,0,0,0,0,2
../kbl_data/2024-2025,S45G01N169,대구 한국가스공사,Home,차바위,0,0,0,0.0,0,0,0.0,0,0,0.0,0,0,0.0,0,0,0,0,0,0,0,0,0,0
../kbl_data/2024-2025,S45G01N169,대구 한국가스공사,Home,박지훈,2,1,2,50.0,0,2,0.0,1,4,25.0,0,0,0.0,0,1,1,1,0,0,0,0,0,3
../kbl_data/2024-2025,S45G01N169,대구 한국가스공사,Home,정성우,0,0,0,0.0,0,0,0.0,0,0,0.0,0,0,0.0,0,1,1,5,2,0,0,0,1,1
../kbl_data/2024-2025,S45G01N169,대구 한국가스공사,Home,우동현,0,0,0,0.0,0,0,0.0,0,0,0.0,0,0,0.0,0,0,0,0,0,0,0,0,0,0
../kbl_data/2024-2025,S45G01N169,대구 한국가스공사,Home,전현우,7,2,2,100.0,1,6,16.7,3,8,37.5,0,0,0.0,1,2,3,2,1,0,0,0,1,0
../kbl_data/2024-2025,S45G01N169,대구 한국가스공사,Home,양재혁,9,0,0,0.0,3,5,60.0,3,5,60.0,0,0,0.0,0,3,3,2,1,0,0,0,1,5
../kbl_data/2024-2025,S45G01N169,대구 한국가스공사,Home,곽정훈,0,0,0,0.0,0,0,0.0,0,0,0.0,0,0,0.0,0,0,0,0,0,0,0,0,0,0
../kbl_data/2024-2025,S45G01N169,대구 한국가스공사,Home,앤드류 니콜슨,23,6,13,46.2,2,6,33.3,8,19,42.1,5,5,100.0,3,6,9,1,1,0,0,0,0,1
../kbl_data/2024-2025,S45G01N169,대구 한국가스공사,Home,신승민,10,2,2,100.0,2,5,40.0,4,7,57.1,0,1,0.0,2,3,5,1,0,0,0,0,1,4
../kbl_data/2024-2025,S45G01N169,대구 한국가스공사,Home,샘조세프 벨란겔,13,4,6,66.7,1,6,16.7,5,12,41.7,2,2,100.0,0,4,4,8,0,0,0,0,2,1
../kbl_data/2024-2025,S45G01N169,대구 한국가스공사,Home,유슈 은도예,10,4,6,66.7,0,0,0.0,4,6,66.7,2,2,100.0,1,0,1,1,0,1,0,1,1,2
../kbl_data/2024-2025,S45G01N169,서울 SK,Away,김선형,16,5,8,62.5,2,4,50.0,7,12,58.3,0,0,0.0,0,2,2,5,1,1,0,0,1,2
../kbl_data/2024-2025,S45G01N169,서울 SK,Away,오세근,0,0,2,0.0,0,2,0.0,0,4,0.0,0,0,0.0,0,7,7,2,0,0,0,0,0,0
../kbl_data/2024-2025,S45G01N169,서울 SK,Away,최부경,6,2,4,50.0,0,1,0.0,2,5,40.0,2,2,100.0,2,4,6,0,0,0,1,0,2,2
../kbl_data/2024-2025,S45G01N169,서울 SK,Away,최원혁,0,0,0,0.0,0,1,0.0,0,1,0.0,0,0,0.0,1,0,1,1,0,0,0,0,1,1
../kbl_data/2024-2025,S45G01N169,서울 SK,Away,김지후,0,0,0,0.0,0,0,0.0,0,0,0.0,0,0,0.0,0,0,0,0,0,0,0,0,0,0
../kbl_data/2024-2025,S45G01N169,서울 SK,Away,안영준,10,4,5,80.0,0,3,0.0,4,8,50.0,2,2,100.0,3,8,11,4,0,0,0,0,1,3
../kbl_data/2024-2025,S45G01N169,서울 SK,Away,자밀 워니,29,7,8,87.5,4,11,36.4,11,19,57.9,3,5,60.0,1,6,7,4,1,0,0,0,1,3
../kbl_data/2024-2025,S45G01N169,서울 SK,Away,전성환,0,0,0,0.0,0,0,0.0,0,0,0.0,0,0,0.0,0,0,0,0,0,0,0,0,0,0
../kbl_data/2024-2025,S45G01N169,서울 SK,Away,아이재아 힉스,5,1,1,100.0,1,3,33.3,2,4,50.0,0,0,0.0,0,0,0,0,0,0,0,0,0,2
../kbl_data/2024-2025,S45G01N169,서울 SK,Away,오재현,12,4,9,44.4,1,1,100.0,5,10,50.0,1,1,100.0,1,0,1,2,0,0,0,0,0,2
../kbl_data/2024-2025,S45G01N169,서울 SK,Away,고메즈 델 리아노,2,1,2,50.0,0,0,0.0,1,2,50.0,0,0,0.0,0,0,0,0,0,0,0,0,1,1
../kbl_data/2024-2025,S45G01N169,서울 SK,Away,김태훈,0,0,0,0.0,0,1,0.0,0,1,0.0,0,0,0.0,0,1,1,0,0,0,0,0,1,0
../kbl_data/2024-2025,S45G01N170,안양 정관장,Home,송창용,0,0,0,0.0,0,0,0.0,0,0,0.0,0,0,0.0,0,1,1,0,0,0,0,0,0,0
../kbl_data/2024-2025,S45G01N170,안양 정관장,Home,정준원,3,0,1,0.0,1,4,25.0,1,5,20.0,0,0,0.0,1,1,2,1,0,0,0,0,2,2
../kbl_data/2024-2025,S45G01N170,안양 정관장,Home,배병준,7,2,4,50.0,1,5,20.0,3,9,33.3,0,0,0.0,0,4,4,1,0,0,0,0,1,2
../kbl_data/2024-2025,S45G01N170,안양 정관장,Home,박지훈,14,4,10,40.0,2,4,50.0,6,14,42.9,0,0,0.0,4,4,8,7,2,0,0,0,1,2
../kbl_data/2024-2025,S45G01N170,안양 정관장,Home,디온테 버튼,16,3,12,25.0,1,5,20.0,4,17,23.5,7,9,77.8,3,4,7,6,2,0,0,0,3,1
../kbl_data/2024-2025,S45G01N170,안양 정관장,Home,최성원,0,0,0,0.0,0,0,0.0,0,0,0.0,0,0,0.0,0,0,0,0,0,0,0,0,0,2
../kbl_data/2024-2025,S45G01N170,안양 정관장,Home,김경원,8,4,7,57.1,0,2,0.0,4,9,44.4,0,0,0.0,4,0,4,1,1,0,2,0,1,3
../kbl_data/2024-2025,S45G01N170,안양 정관장,Home,한승희,12,6,7,85.7,0,0,0.0,6,7,85.7,0,0,0.0,4,4,8,0,0,0,0,0,0,4
../kbl_data/2024-2025,S45G01N170,안양 정관장,Home,조니 오브라이언트,10,1,4,25.0,1,3,33.3,2,7,28.6,5,5,100.0,0,1,1,1,0,2,0,0,0,4
../kbl_data/2024-2025,S45G01N170,안양 정관장,Home,하비 고메즈,15,3,3,100.0,3,6,50.0,6,9,66.7,0,0,0.0,2,2,4,0,1,0,1,0,0,0
../kbl_data/2024-2025,S45G01N170,안양 정관장,Home,박정웅,0,0,0,0.0,0,0,0.0,0,0,0.0,0,0,0.0,0,0,0,0,0,0,0,0,0,0
../kbl_data/2024-2025,S45G01N170,안양 정관장,Home,소준혁,0,0,0,0.0,0,0,0.0,0,0,0.0,0,0,0.0,0,0,0,0,0,0,0,0,0,0
../kbl_data/2024-2025,S45G01N170,울산 현대모비스,Away,장재석,3,1,2,50.0,0,0,0.0,1,2,50.0,1,4,25.0,3,2,5,1,0,0,0,0,0,1
../kbl_data/2024-2025,S45G01N170,울산 현대모비스,Away,한호빈,11,1,2,50.0,2,5,40.0,3,7,42.9,3,4,75.0,0,1,1,2,0,0,0,0,3,1
../kbl_data/2024-2025,S45G01N170,울산 현대모비스,Away,김준일,0,0,0,0.0,0,0,0.0,0,0,0.0,0,0,0.0,0,0,0,0,0,0,0,0,0,0
../kbl_data/2024-2025,S45G01N170,울산 현대모비스,Away,김국찬,2,1,2,50.0,0,3,0.0,1,5,20.0,0,0,0.0,1,6,7,1,0,0,0,0,1,3
../kbl_data/2024-2025,S45G01N170,울산 현대모비스,Away,서명진,4,2,3,66.7,0,3,0.0,2,6,33.3,0,0,0.0,1,0,1,2,1,0,0,0,0,0
../kbl_data/2024-2025,S45G01N170,울산 현대모비스,Away,숀 롱,19,6,11,54.5,1,1,100.0,7,12,58.3,4,4,100.0,6,3,9,1,0,1,0,2,2,4
../kbl_data/2024-2025,S45G01N170,울산 현대모비스,Away,이우석,12,4,7,57.1,1,6,16.7,5,13,38.5,1,1,100.0,1,6,7,6,2,0,0,0,2,4
../kbl_data/2024-2025,S45G01N170,울산 현대모비스,Away,이승우,0,0,0,0.0,0,0,0.0,0,0,0.0,0,0,0.0,0,0,0,0,0,0,0,0,0,1
../kbl_data/2024-2025,S45G01N170,울산 현대모비스,Away,신민석,9,0,1,0.0,3,7,42.9,3,8,37.5,0,0,0.0,2,5,7,1,0,0,0,0,0,3
../kbl_data/2024-2025,S45G01N170,울산 현대모비스,Away,게이지 프림,18,7,13,53.8,0,0,0.0,7,13,53.8,4,4,100.0,1,2,3,1,0,2,0,0,5,3
../kbl_data/2024-2025,S45G01N170,울산 현대모비스,Away,박무빈,0,0,1,0.0,0,0,0.0,0,1,0.0,0,0,0.0,0,0,0,3,0,0,0,0,0,1
../kbl_data/2024-2025,S45G01N170,울산 현대모비스,Away,미구엘 안드레 옥존,0,0,0,0.0,0,0,0.0,0,0,0.0,0,2,0.0,0,0,0,0,0,0,0,0,0,0
../kbl_data/2024-2025,S45G01N171,부산 KCC,Home,정창영,2,1,1,100.0,0,0,0.0,1,1,100.0,0,0,0.0,0,1,1,1,0,0,0,0,1,2
../kbl_data/2024-2025,S45G01N171,부산 KCC,Home,전준범,0,0,0,0.0,0,0,0.0,0,0,0.0,0,0,0.0,0,0,0,0,0,0,0,0,0,0
../kbl_data/2024-2025,S45G01N171,부산 KCC,Home,허웅,15,3,3,100.0,2,7,28.6,5,10,50.0,3,4,75.0,0,3,3,2,0,0,0,0,3,2
../kbl_data/2024-2025,S45G01N171,부산 KCC,Home,이승현,8,3,5,60.0,0,0,0.0,3,5,60.0,2,2,100.0,1,5,6,2,0,0,0,0,1,3
../kbl_data/2024-2025,S45G01N171,부산 KCC,Home,이호현,6,2,3,66.7,0,1,0.0,2,4,50.0,2,2,100.0,0,3,3,6,0,0,0,0,3,4
../kbl_data/2024-2025,S45G01N171,부산 KCC,Home,송교창,4,0,0,0.0,1,1,100.0,1,1,100.0,1,2,50.0,1,1,2,1,2,0,0,0,1,2
../kbl_data/2024-2025,S45G01N171,부산 KCC,Home,최준용,16,3,5,60.0,2,6,33.3,5,11,45.5,4,6,66.7,3,7,10,6,2,3,0,0,2,1
../kbl_data/2024-2025,S45G01N171,부산 KCC,Home,캐디 라렌,17,6,12,50.0,1,3,33.3,7,15,46.7,2,3,66.7,6,4,10,4,0,0,0,1,2,1
../kbl_data/2024-2025,S45G01N171,부산 KCC,Home,이근휘,6,0,0,0.0,2,5,40.0,2,5,40.0,0,0,0.0,0,1,1,0,0,0,0,0,0,0
../kbl_data/2024-2025,S45G01N171,부산 KCC,Home,여준형,0,0,0,0.0,0,0,0.0,0,0,0.0,0,0,0.0,0,0,0,0,0,0,0,0,0,0
../kbl_data/2024-2025,S45G01N171,부산 KCC,Home,캘빈 제프리 에피스톨라,6,0,0,0.0,2,3,66.7,2,3,66.7,0,0,0.0,0,0,0,0,1,0,0,0,0,3
../kbl_data/2024-2025,S45G01N171,부산 KCC,Home,도노반 스미스,4,1,2,50.0,0,2,0.0,1,4,25.0,2,3,66.7,0,1,1,0,0,1,0,0,1,2
../kbl_data/2024-2025,S45G01N171,수원 KT,Away,한희원,11,2,4,50.0,2,3,66.7,4,7,57.1,1,1,100.0,2,2,4,3,3,0,0,0,1,4
../kbl_data/2024-2025,S45G01N171,수원 KT,Away,문성곤,9,0,0,0.0,3,3,100.0,3,3,100.0,0,0,0.0,2,2,4,2,1,0,0,0,0,3
../kbl_data/2024-2025,S45G01N171,수원 KT,Away,이현석,0,0,0,0.0,0,0,0.0,0,0,0.0,0,0,0.0,0,0,0,0,0,0,0,0,0,0
../kbl_data/2024-2025,S45G01N171,수원 KT,Away,허훈,22,2,7,28.6,6,12,50.0,8,19,42.1,0,0,0.0,1,4,5,5,1,0,1,0,0,1
../kbl_data/2024-2025,S45G01N171,수원 KT,Away,박준영,3,0,2,0.0,1,2,50.0,1,4,25.0,0,0,0.0,1,0,1,3,2,1,0,0,2,0
../kbl_data/2024-2025,S45G01N171,수원 KT,Away,박지원,0,0,0,0.0,0,0,0.0,0,0,0.0,0,0,0.0,0,0,0,0,0,0,0,0,0,0
../kbl_data/2024-2025,S45G01N171,수원 KT,Away,하윤기,13,5,7,71.4,0,0,0.0,5,7,71.4,3,3,100.0,1,4,5,0,1,0,0,0,1,2
../kbl_data/2024-2025,S45G01N171,수원 KT,Away,문정현,5,2,2,100.0,0,1,0.0,2,3,66.7,1,1,100.0,0,1,1,3,2,0,0,0,0,5
../kbl_data/2024-2025,S45G01N171,수원 KT,Away,레이션 해먼즈,21,6,11,54.5,2,8,25.0,8,19,42.1,3,3,100.0,1,5,6,3,0,1,0,0,0,4
../kbl_data/2024-2025,S45G01N171,수원 KT,Away,박성재,0,0,0,0.0,0,0,0.0,0,0,0.0,0,0,0.0,0,1,1,0,0,0,0,0,1,1
../kbl_data/2024-2025,S45G01N171,수원 KT,Away,이스마엘 로메로,5,2,3,66.7,0,1,0.0,2,4,50.0,1,1,100.0,1,1,2,2,1,0,0,0,1,2
../kbl_data/2024-2025,S45G01N171,수원 KT,Away,조엘 카굴랑안,6,0,1,0.0,2,5,40.0,2,6,33.3,0,0,0.0,0,0,0,0,0,0,0,0,2,1
../kbl_data/2024-2025,S45G01N172,대구 한국가스공사,Home,김동량,0,0,0,0.0,0,0,0.0,0,0,0.0,0,0,0.0,0,0,0,0,0,0,0,0,0,0
../kbl_data/2024-2025,S45G01N172,대구 한국가스공사,Home,차바위,0,0,0,0.0,0,0,0.0,0,0,0.0,0,0,0.0,0,0,0,1,0,0,0,0,0,2
../kbl_data/2024-2025,S45G01N172,대구 한국가스공사,Home,박지훈,0,0,0,0.0,0,0,0.0,0,0,0.0,0,0,0.0,0,0,0,0,0,0,0,0,0,1
../kbl_data/2024-2025,S45G01N172,대구 한국가스공사,Home,정성우,14,5,6,83.3,0,2,0.0,5,8,62.5,4,6,66.7,0,2,2,4,3,0,1,0,0,3
../kbl_data/2024-2025,S45G01N172,대구 한국가스공사,Home,우동현,0,0,0,0.0,0,0,0.0,0,0,0.0,0,0,0.0,0,0,0,0,0,0,0,0,0,0
../kbl_data/2024-2025,S45G01N172,대구 한국가스공사,Home,전현우,7,2,2,100.0,1,4,25.0,3,6,50.0,0,0,0.0,1,3,4,2,0,0,0,0,0,4
../kbl_data/2024-2025,S45G01N172,대구 한국가스공사,Home,양재혁,2,1,1,100.0,0,3,0.0,1,4,25.0,0,0,0.0,1,0,1,1,0,0,1,0,1,2
../kbl_data/2024-2025,S45G01N172,대구 한국가스공사,Home,곽정훈,3,0,0,0.0,1,1,100.0,1,1,100.0,0,0,0.0,1,1,2,0,0,0,0,0,2,2
../kbl_data/2024-2025,S45G01N172,대구 한국가스공사,Home,앤드류 니콜슨,12,4,10,40.0,1,5,20.0,5,15,33.3,1,1,100.0,1,6,7,1,1,0,0,0,0,1
../kbl_data/2024-2025,S45G01N172,대구 한국가스공사,Home,신승민,10,4,5,80.0,0,2,0.0,4,7,57.1,2,2,100.0,2,4,6,3,0,0,0,0,2,0
../kbl_data/2024-2025,S45G01N172,대구 한국가스공사,Home,샘조세프 벨란겔,17,5,10,50.0,1,3,33.3,6,13,46.2,4,6,66.7,1,9,10,4,2,0,0,0,5,2
../kbl_data/2024-2025,S45G01N172,대구 한국가스공사,Home,유슈 은도예,7,2,5,40.0,0,0,0.0,2,5,40.0,3,5,60.0,0,5,5,1,0,3,0,0,2,3
../kbl_data/2024-2025,S45G01N172,서울 삼성,Away,이정현,9,2,4,50.0,1,5,20.0,3,9,33.3,2,4,50.0,0,3,3,2,2,0,0,0,0,2
../kbl_data/2024-2025,S45G01N172,서울 삼성,Away,최현민,4,0,0,0.0,1,2,50.0,1,2,50.0,1,2,50.0,2,2,4,3,1,0,0,0,0,2
../kbl_data/2024-2025,S45G01N172,서울 삼성,Away,최성모,3,0,2,0.0,1,7,14.3,1,9,11.1,0,0,0.0,0,3,3,2,1,0,0,0,2,4
../kbl_data/2024-2025,S45G01N172,서울 삼성,Away,최승욱,5,1,2,50.0,1,3,33.3,2,5,40.0,0,2,0.0,2,2,4,1,1,0,0,0,0,0
../kbl_data/2024-2025,S45G01N172,서울 삼성,Away,윤성원,0,0,0,0.0,0,0,0.0,0,0,0.0,0,0,0.0,0,0,0,0,0,0,0,0,0,0
../kbl_data/2024-2025,S45G01N172,서울 삼성,Away,마커스 데릭슨,7,2,5,40.0,0,3,0.0,2,8,25.0,3,4,75.0,0,2,2,1,0,0,0,0,2,2
../kbl_data/2024-2025,S45G01N172,서울 삼성,Away,차민석,0,0,0,0.0,0,0,0.0,0,0,0.0,0,0,0.0,0,0,0,0,0,0,0,0,0,0
../kbl_data/2024-2025,S45G01N172,서울 삼성,Away,이원석,2,1,3,33.3,0,2,0.0,1,5,20.0,0,0,0.0,1,1,2,1,0,1,0,0,0,0
../kbl_data/2024-2025,S45G01N172,서울 삼성,Away,저스틴 구탕,11,1,2,50.0,3,7,42.9,4,9,44.4,0,0,0.0,1,5,6,8,2,0,0,0,3,4
../kbl_data/2024-2025,S45G01N172,서울 삼성,Away,박승재,6,0,1,0.0,2,3,66.7,2,4,50.0,0,0,0.0,0,2,2,1,0,0,0,0,2,4
../kbl_data/2024-2025,S45G01N172,서울 삼성,Away,코피 코번,22,8,16,50.0,0,0,0.0,8,16,50.0,6,6,100.0,5,4,9,0,0,0,0,1,1,2
../kbl_data/2024-2025,S45G01N172,서울 삼성,Away,황영찬,0,0,0,0.0,0,0,0.0,0,0,0.0,0,0,0.0,0,0,0,0,0,0,0,0,0,0
../kbl_data/2024-2025,S45G01N173,고양 소노,Home,함준후,0,0,0,0.0,0,0,0.0,0,0,0.0,0,0,0.0,0,0,0,0,0,0,0,0,0,2
../kbl_data/2024-2025,S45G01N173,고양 소노,Home,정희재,0,0,0,0.0,0,1,0.0,0,1,0.0,0,0,0.0,1,2,3,3,1,1,0,0,3,2
../kbl_data/2024-2025,S45G01N173,고양 소노,Home,임동섭,6,0,0,0.0,2,5,40.0,2,5,40.0,0,0,0.0,0,2,2,0,1,0,0,0,0,4
../kbl_data/2024-2025,S45G01N173,고양 소노,Home,이재도,17,2,3,66.7,3,7,42.9,5,10,50.0,4,6,66.7,1,4,5,1,4,0,0,0,4,3
../kbl_data/2024-2025,S45G01N173,고양 소노,Home,박진철,0,0,0,0.0,0,0,0.0,0,0,0.0,0,0,0.0,0,0,0,0,0,0,0,0,0,0
../kbl_data/2024-2025,S45G01N173,고양 소노,Home,조은후,2,1,1,100.0,0,0,0.0,1,1,100.0,0,0,0.0,1,1,2,1,0,0,0,0,1,0
../kbl_data/2024-2025,S45G01N173,고양 소노,Home,박종하,6,0,0,0.0,2,5,40.0,2,5,40.0,0,0,0.0,0,3,3,4,1,0,0,0,1,4
../kbl_data/2024-2025,S45G01N173,고양 소노,Home,민기남,5,1,1,100.0,1,2,50.0,2,3,66.7,0,0,0.0,1,0,1,1,1,0,0,0,0,1
../kbl_data/2024-2025,S45G01N173,고양 소노,Home,디제이 번즈 Jr,12,6,12,50.0,0,1,0.0,6,13,46.2,0,1,0.0,0,5,5,7,0,0,0,0,0,1
../kbl_data/2024-2025,S45G01N173,고양 소노,Home,정성조,0,0,0,0.0,0,0,0.0,0,0,0.0,0,0,0.0,0,0,0,1,0,0,0,0,0,1
../kbl_data/2024-2025,S45G01N173,고양 소노,Home,알파 카바,2,1,2,50.0,0,0,0.0,1,2,50.0,0,2,0.0,0,2,2,0,0,0,0,0,0,1
../kbl_data/2024-2025,S45G01N173,고양 소노,Home,케빈 켐바오,36,6,12,50.0,6,14,42.9,12,26,46.2,6,6,100.0,3,9,12,3,2,0,0,1,4,1
../kbl_data/2024-2025,S45G01N173,원주 DB,Away,이관희,29,3,6,50.0,7,10,70.0,10,16,62.5,2,2,100.0,1,2,3,1,2,0,1,0,4,3
../kbl_data/2024-2025,S45G01N173,원주 DB,Away,김시래,0,0,0,0.0,0,2,0.0,0,2,0.0,0,0,0.0,0,1,1,1,0,0,0,0,0,2
../kbl_data/2024-2025,S45G01N173,원주 DB,Away,서민수,0,0,1,0.0,0,2,0.0,0,3,0.0,0,0,0.0,1,0,1,1,0,0,0,0,1,1
../kbl_data/2024-2025,S45G01N173,원주 DB,Away,김영현,0,0,0,0.0,0,0,0.0,0,0,0.0,0,0,0.0,0,0,0,0,0,0,0,0,0,0
../kbl_data/2024-2025,S45G01N173,원주 DB,Away,정효근,6,3,4,75.0,0,2,0.0,3,6,50.0,0,0,0.0,2,2,4,0,0,1,0,0,2,0
../kbl_data/2024-2025,S45G01N173,원주 DB,Away,박봉진,0,0,0,0.0,0,0,0.0,0,0,0.0,0,0,0.0,0,0,0,0,0,0,0,0,0,0
../kbl_data/2024-2025,S45G01N173,원주 DB,Away,강상재,9,3,5,60.0,0,2,0.0,3,7,42.9,3,4,75.0,2,10,12,5,0,0,0,0,1,1
../kbl_data/2024-2025,S45G01N173,원주 DB,Away,치나누 오누아쿠,9,3,8,37.5,1,2,50.0,4,10,40.0,0,2,0.0,2,10,12,2,0,0,0,0,1,3
../kbl_data/2024-2025,S45G01N173,원주 DB,Away,이용우,11,2,2,100.0,2,7,28.6,4,9,44.4,1,2,50.0,1,0,1,2,1,0,0,0,0,3
../kbl_data/2024-2025,S45G01N173,원주 DB,Away,정호영,0,0,0,0.0,0,0,0.0,0,0,0.0,0,0,0.0,0,0,0,0,0,0,0,0,0,0
../kbl_data/2024-2025,S45G01N173,원주 DB,Away,이선 알바노,18,6,14,42.9,2,3,66.7,8,17,47.1,0,0,0.0,1,4,5,8,2,0,0,0,3,3
../kbl_data/2024-2025,S45G01N173,원주 DB,Away,로버트 카터,0,0,2,0.0,0,2,0.0,0,4,0.0,0,0,0.0,0,1,1,0,0,0,0,0,0,1
../kbl_data/2024-2025,S45G01N174,서울 SK,Home,김선형,15,5,8,62.5,1,4,25.0,6,12,50.0,2,3,66.7,3,1,4,7,3,0,0,0,1,3
../kbl_data/2024-2025,S45G01N174,서울 SK,Home,오세근,8,1,2,50.0,2,4,50.0,3,6,50.0,0,0,0.0,2,4,6,2,0,0,0,0,1,3
../kbl_data/2024-2025,S45G01N174,서울 SK,Home,최부경,1,0,2,0.0,0,0,0.0,0,2,0.0,1,1,100.0,0,0,0,0,0,0,0,0,1,3
../kbl_data/2024-2025,S45G01N174,서울 SK,Home,최원혁,3,0,0,0.0,1,3,33.3,1,3,33.3,0,0,0.0,0,2,2,0,1,0,0,0,2,2
../kbl_data/2024-2025,S45G01N174,서울 SK,Home,김지후,0,0,0,0.0,0,0,0.0,0,0,0.0,0,0,0.0,0,0,0,0,0,0,0,0,0,0
../kbl_data/2024-2025,S45G01N174,서울 SK,Home,안영준,18,6,12,50.0,2,4,50.0,8,16,50.0,0,2,0.0,3,3,6,0,1,1,0,0,2,2
../kbl_data/2024-2025,S45G01N174,서울 SK,Home,자밀 워니,25,10,19,52.6,1,4,25.0,11,23,47.8,2,3,66.7,4,13,17,6,1,1,0,3,2,1
../kbl_data/2024-2025,S45G01N174,서울 SK,Home,아이재아 힉스,2,1,2,50.0,0,0,0.0,1,2,50.0,0,0,0.0,0,2,2,0,0,0,0,0,0,1
../kbl_data/2024-2025,S45G01N174,서울 SK,Home,박민우,0,0,0,0.0,0,0,0.0,0,0,0.0,0,0,0.0,0,0,0,0,0,0,0,0,0,0
../kbl_data/2024-2025,S45G01N174,서울 SK,Home,오재현,6,1,4,25.0,1,3,33.3,2,7,28.6,1,2,50.0,0,0,0,2,2,0,1,0,1,2
../kbl_data/2024-2025,S45G01N174,서울 SK,Home,고메즈 델 리아노,0,0,0,0.0,0,0,0.0,0,0,0.0,0,0,0.0,0,0,0,0,0,0,0,0,0,0
../kbl_data/2024-2025,S45G01N174,서울 SK,Home,김태훈,0,0,0,0.0,0,0,0.0,0,0,0.0,0,0,0.0,0,1,1,0,0,0,0,0,0,0
../kbl_data/2024-2025,S45G01N174,창원 LG,Away,허일영,3,0,1,0.0,1,2,50.0,1,3,33.3,0,0,0.0,0,0,0,0,0,0,0,0,0,2
../kbl_data/2024-2025,S45G01N174,창원 LG,Away,장민국,0,0,0,0.0,0,0,0.0,0,0,0.0,0,0,0.0,0,1,1,0,0,0,0,0,0,0
../kbl_data/2024-2025,S45G01N174,창원 LG,Away,한상혁,0,0,0,0.0,0,0,0.0,0,0,0.0,0,0,0.0,0,0,0,0,0,0,0,0,0,0
../kbl_data/2024-2025,S45G01N174,창원 LG,Away,전성현,19,0,2,0.0,6,10,60.0,6,12,50.0,1,1,100.0,0,1,1,1,1,0,0,0,1,1
../kbl_data/2024-2025,S45G01N174,창원 LG,Away,정인덕,5,0,0,0.0,1,4,25.0,1,4,25.0,2,2,100.0,0,3,3,2,3,0,0,0,2,4
../kbl_data/2024-2025,S45G01N174,창원 LG,Away,대릴 먼로,0,0,0,0.0,0,0,0.0,0,0,0.0,0,0,0.0,1,3,4,1,0,0,0,0,2,1
../kbl_data/2024-2025,S45G01N174,창원 LG,Away,박정현,6,2,5,40.0,0,1,0.0,2,6,33.3,2,2,100.0,3,3,6,0,0,0,0,0,0,0
../kbl_data/2024-2025,S45G01N174,창원 LG,Away,아셈 마레이,19,9,18,50.0,0,0,0.0,9,18,50.0,1,4,25.0,9,8,17,7,4,0,0,1,4,3
../kbl_data/2024-2025,S45G01N174,창원 LG,Away,양준석,11,4,7,57.1,1,4,25.0,5,11,45.5,0,0,0.0,0,3,3,6,0,0,0,0,2,3
../kbl_data/2024-2025,S45G01N174,창원 LG,Away,이경도,0,0,0,0.0,0,1,0.0,0,1,0.0,0,0,0.0,1,0,1,0,0,0,0,0,1,0
../kbl_data/2024-2025,S45G01N174,창원 LG,Away,칼 타마요,7,2,7,28.6,1,4,25.0,3,11,27.3,0,0,0.0,1,3,4,1,1,1,0,0,1,3
../kbl_data/2024-2025,S45G01N174,창원 LG,Away,최형찬,0,0,0,0.0,0,1,0.0,0,1,0.0,0,0,0.0,0,0,0,0,0,0,0,0,0,1
../kbl_data/2024-2025,S45G01N175,부산 KCC,Home,정창영,0,0,1,0.0,0,1,0.0,0,2,0.0,0,0,0.0,0,0,0,0,0,0,0,0,0,1
../kbl_data/2024-2025,S45G01N175,부산 KCC,Home,전준범,0,0,0,0.0,0,0,0.0,0,0,0.0,0,0,0.0,1,0,1,0,0,0,0,0,0,0
../kbl_data/2024-2025,S45G01N175,부산 KCC,Home,허웅,15,4,7,57.1,2,7,28.6,6,14,42.9,1,1,100.0,0,4,4,6,1,0,0,0,3,2
../kbl_data/2024-2025,S45G01N175,부산 KCC,Home,이승현,4,2,6,33.3,0,0,0.0,2,6,33.3,0,0,0.0,3,1,4,2,0,0,0,0,0,0
../kbl_data/2024-2025,S45G01N175,부산 KCC,Home,이호현,19,4,7,57.1,3,4,75.0,7,11,63.6,2,2,100.0,1,4,5,3,3,0,0,0,1,4
../kbl_data/2024-2025,S45G01N175,부산 KCC,Home,송교창,8,2,4,50.0,1,1,100.0,3,5,60.0,1,2,50.0,2,3,5,1,2,0,0,0,3,2
../kbl_data/2024-2025,S45G01N175,부산 KCC,Home,최준용,16,5,12,41.7,0,3,0.0,5,15,33.3,6,8,75.0,1,4,5,4,1,0,0,0,4,2
../kbl_data/2024-2025,S45G01N175,부산 KCC,Home,캐디 라렌,22,5,10,50.0,1,3,33.3,6,13,46.2,9,9,100.0,5,8,13,0,0,2,0,0,2,2
../kbl_data/2024-2025,S45G01N175,부산 KCC,Home,이근휘,0,0,1,0.0,0,2,0.0,0,3,0.0,0,0,0.0,0,0,0,0,1,0,0,0,0,0
../kbl_data/2024-2025,S45G01N175,부산 KCC,Home,캘빈 제프리 에피스톨라,0,0,1,0.0,0,0,0.0,0,1,0.0,0,0,0.0,1,0,1,1,0,0,0,0,0,1
../kbl_data/2024-2025,S45G01N175,부산 KCC,Home,이주영,0,0,0,0.0,0,0,0.0,0,0,0.0,0,0,0.0,0,0,0,0,0,0,0,0,0,0
../kbl_data/2024-2025,S45G01N175,부산 KCC,Home,도노반 스미스,2,1,3,33.3,0,1,0.0,1,4,25.0,0,0,0.0,0,1,1,0,1,0,0,0,1,2
../kbl_data/2024-2025,S45G01N175,안양 정관장,Away,송창용,0,0,0,0.0,0,1,0.0,0,1,0.0,0,0,0.0,0,0,0,0,0,0,0,0,0,0
../kbl_data/2024-2025,S45G01N175,안양 정관장,Away,정준원,15,2,4,50.0,3,5,60.0,5,9,55.6,2,2,100.0,0,1,1,3,1,1,1,0,0,3
../kbl_data/2024-2025,S45G01N175,안양 정관장,Away,배병준,2,1,5,20.0,0,1,0.0,1,6,16.7,0,0,0.0,0,3,3,4,1,0,0,0,0,1
../kbl_data/2024-2025,S45G01N175,안양 정관장,Away,박지훈,21,6,8,75.0,3,4,75.0,9,12,75.0,0,0,0.0,1,3,4,8,2,1,0,0,2,3
../kbl_data/2024-2025,S45G01N175,안양 정관장,Away,디온테 버튼,9,4,7,57.1,0,1,0.0,4,8,50.0,1,2,50.0,0,5,5,5,1,1,0,1,1,2
../kbl_data/2024-2025,S45G01N175,안양 정관장,Away,최성원,0,0,0,0.0,0,0,0.0,0,0,0.0,0,0,0.0,0,2,2,0,0,0,0,0,1,1
../kbl_data/2024-2025,S45G01N175,안양 정관장,Away,김경원,2,1,4,25.0,0,0,0.0,1,4,25.0,0,0,0.0,0,2,2,0,0,0,0,0,0,4
../kbl_data/2024-2025,S45G01N175,안양 정관장,Away,한승희,22,8,11,72.7,2,3,66.7,10,14,71.4,0,2,0.0,0,3,3,3,2,0,1,0,1,3
../kbl_data/2024-2025,S45G01N175,안양 정관장,Away,조니 오브라이언트,14,6,8,75.0,0,3,0.0,6,11,54.5,2,2,100.0,1,5,6,2,0,0,0,0,5,2
../kbl_data/2024-2025,S45G01N175,안양 정관장,Away,하비 고메즈,2,0,0,0.0,0,1,0.0,0,1,0.0,2,2,100.0,1,1,2,0,0,0,0,0,0,1
../kbl_data/2024-2025,S45G01N175,안양 정관장,Away,박정웅,0,0,0,0.0,0,0,0.0,0,0,0.0,0,0,0.0,0,0,0,0,0,0,0,0,0,0
../kbl_data/2024-2025,S45G01N175,안양 정관장,Away,소준혁,4,0,0,0.0,1,2,50.0,1,2,50.0,1,4,25.0,1,1,2,0,0,0,0,0,0,1
../kbl_data/2024-2025,S45G01N176,서울 삼성,Home,이정현,11,3,5,60.0,1,4,25.0,4,9,44.4,2,2,100.0,0,2,2,8,3,0,0,0,4,3
../kbl_data/2024-2025,S45G01N176,서울 삼성,Home,최현민,9,0,1,0.0,3,4,75.0,3,5,60.0,0,0,0.0,0,2,2,1,0,0,0,0,2,2
../kbl_data/2024-2025,S45G01N176,서울 삼성,Home,최성모,7,2,2,100.0,1,3,33.3,3,5,60.0,0,0,0.0,1,0,1,4,0,0,0,0,2,2
../kbl_data/2024-2025,S45G01N176,서울 삼성,Home,최승욱,2,1,2,50.0,0,0,0.0,1,2,50.0,0,0,0.0,0,5,5,0,0,0,0,0,0,0
../kbl_data/2024-2025,S45G01N176,서울 삼성,Home,윤성원,0,0,0,0.0,0,0,0.0,0,0,0.0,0,0,0.0,0,0,0,0,0,0,0,0,0,0
../kbl_data/2024-2025,S45G01N176,서울 삼성,Home,마커스 데릭슨,3,0,2,0.0,1,2,50.0,1,4,25.0,0,0,0.0,0,4,4,0,2,1,1,0,2,2
../kbl_data/2024-2025,S45G01N176,서울 삼성,Home,이원석,20,6,12,50.0,1,1,100.0,7,13,53.8,5,6,83.3,3,3,6,0,0,0,0,0,3,1
../kbl_data/2024-2025,S45G01N176,서울 삼성,Home,저스틴 구탕,4,2,3,66.7,0,4,0.0,2,7,28.6,0,0,0.0,1,4,5,4,4,1,0,0,4,2
../kbl_data/2024-2025,S45G01N176,서울 삼성,Home,박승재,4,0,1,0.0,1,1,100.0,1,2,50.0,1,2,50.0,1,1,2,2,0,0,0,0,1,1
../kbl_data/2024-2025,S45G01N176,서울 삼성,Home,코피 코번,8,4,5,80.0,0,0,0.0,4,5,80.0,0,0,0.0,1,3,4,0,1,1,0,0,5,2
../kbl_data/2024-2025,S45G01N176,서울 삼성,Home,임동언,0,0,0,0.0,0,0,0.0,0,0,0.0,0,0,0.0,0,0,0,0,0,0,0,0,0,0
../kbl_data/2024-2025,S45G01N176,서울 삼성,Home,황영찬,0,0,0,0.0,0,0,0.0,0,0,0.0,0,0,0.0,0,0,0,0,0,0,1,0,1,1
../kbl_data/2024-2025,S45G01N176,울산 현대모비스,Away,장재석,13,6,8,75.0,0,0,0.0,6,8,75.0,1,2,50.0,3,4,7,0,1,0,0,2,2,3
../kbl_data/2024-2025,S45G01N176,울산 현대모비스,Away,한호빈,1,0,1,0.0,0,2,0.0,0,3,0.0,1,2,50.0,1,2,3,2,1,0,0,0,1,3
../kbl_data/2024-2025,S45G01N176,울산 현대모비스,Away,김국찬,8,2,3,66.7,1,5,20.0,3,8,37.5,1,1,100.0,2,0,2,2,4,0,0,0,0,1
../kbl_data/2024-2025,S45G01N176,울산 현대모비스,Away,서명진,4,0,2,0.0,1,1,100.0,1,3,33.3,1,1,100.0,0,2,2,1,0,0,0,0,0,1
../kbl_data/2024-2025,S45G01N176,울산 현대모비스,Away,숀 롱,16,7,15,46.7,0,1,0.0,7,16,43.8,2,2,100.0,5,4,9,5,1,0,0,0,3,3
../kbl_data/2024-2025,S45G01N176,울산 현대모비스,Away,이우석,11,4,5,80.0,1,4,25.0,5,9,55.6,0,0,0.0,0,5,5,5,2,0,1,0,2,2
../kbl_data/2024-2025,S45G01N176,울산 현대모비스,Away,이승우,0,0,0,0.0,0,0,0.0,0,0,0.0,0,0,0.0,0,0,0,0,0,0,0,0,0,0
../kbl_data/2024-2025,S45G01N176,울산 현대모비스,Away,신민석,14,1,1,100.0,4,7,57.1,5,8,62.5,0,0,0.0,0,1,1,1,3,0,0,0,2,0
../kbl_data/2024-2025,S45G01N176,울산 현대모비스,Away,게이지 프림,8,4,9,44.4,0,0,0.0,4,9,44.4,0,0,0.0,2,1,3,1,0,0,0,0,0,0
../kbl_data/2024-2025,S45G01N176,울산 현대모비스,Away,박무빈,2,1,3,33.3,0,2,0.0,1,5,20.0,0,0,0.0,0,0,0,3,1,0,1,0,2,3
../kbl_data/2024-2025,S45G01N176,울산 현대모비스,Away,미구엘 안드레 옥존,0,0,1,0.0,0,1,0.0,0,2,0.0,0,0,0.0,0,0,0,0,0,0,0,0,0,2
../kbl_data/2024-2025,S45G01N176,울산 현대모비스,Away,이대균,0,0,1,0.0,0,0,0.0,0,1,0.0,0,0,0.0,0,1,1,0,0,0,0,0,0,0
../kbl_data/2024-2025,S45G01N177,창원 LG,Home,허일영,0,0,0,0.0,0,1,0.0,0,1,0.0,0,0,0.0,0,0,0,0,0,0,0,0,0,2
../kbl_data/2024-2025,S45G01N177,창원 LG,Home,최진수,0,0,0,0.0,0,0,0.0,0,0,0.0,0,0,0.0,0,0,0,0,0,0,0,0,0,0
../kbl_data/2024-2025,S45G01N177,창원 LG,Home,장민국,0,0,0,0.0,0,1,0.0,0,1,0.0,0,0,0.0,0,1,1,0,0,0,0,0,0,3
../kbl_data/2024-2025,S45G01N177,창원 LG,Home,전성현,12,0,1,0.0,4,6,66.7,4,7,57.1,0,0,0.0,1,1,2,4,1,0,0,0,2,1
../kbl_data/2024-2025,S45G01N177,창원 LG,Home,정인덕,13,2,2,100.0,3,5,60.0,5,7,71.4,0,0,0.0,0,2,2,2,3,0,0,0,1,3
../kbl_data/2024-2025,S45G01N177,창원 LG,Home,대릴 먼로,7,3,6,50.0,0,0,0.0,3,6,50.0,1,2,50.0,3,1,4,0,0,0,0,0,0,3
../kbl_data/2024-2025,S45G01N177,창원 LG,Home,박정현,2,1,2,50.0,0,0,0.0,1,2,50.0,0,0,0.0,1,0,1,0,0,0,0,0,0,1
../kbl_data/2024-2025,S45G01N177,창원 LG,Home,아셈 마레이,18,7,11,63.6,0,0,0.0,7,11,63.6,4,5,80.0,6,6,12,7,3,0,0,1,3,4
../kbl_data/2024-2025,S45G01N177,창원 LG,Home,양준석,17,3,9,33.3,3,6,50.0,6,15,40.0,2,2,100.0,2,2,4,6,1,0,0,0,3,3
../kbl_data/2024-2025,S45G01N177,창원 LG,Home,이경도,0,0,1,0.0,0,1,0.0,0,2,0.0,0,0,0.0,0,0,0,1,1,0,1,0,1,1
../kbl_data/2024-2025,S45G01N177,창원 LG,Home,칼 타마요,21,7,13,53.8,2,3,66.7,9,16,56.2,1,1,100.0,1,5,6,6,1,0,0,0,4,1
../kbl_data/2024-2025,S45G01N177,창원 LG,Home,최형찬,0,0,1,0.0,0,0,0.0,0,1,0.0,0,0,0.0,0,1,1,0,0,0,0,0,1,1
../kbl_data/2024-2025,S45G01N177,부산 KCC,Away,정창영,4,0,1,0.0,1,1,100.0,1,2,50.0,1,4,25.0,1,0,1,4,4,0,0,0,1,1
../kbl_data/2024-2025,S45G01N177,부산 KCC,Away,전준범,0,0,0,0.0,0,0,0.0,0,0,0.0,0,0,0.0,0,0,0,0,0,0,0,0,0,0
../kbl_data/2024-2025,S45G01N177,부산 KCC,Away,허웅,24,8,14,57.1,1,6,16.7,9,20,45.0,5,6,83.3,0,1,1,4,1,0,0,0,2,3
../kbl_data/2024-2025,S45G01N177,부산 KCC,Away,이승현,2,1,2,50.0,0,1,0.0,1,3,33.3,0,0,0.0,0,0,0,1,0,0,0,0,1,1
../kbl_data/2024-2025,S45G01N177,부산 KCC,Away,이호현,3,0,0,0.0,1,2,50.0,1,2,50.0,0,0,0.0,0,2,2,1,0,0,0,0,1,1
../kbl_data/2024-2025,S45G01N177,부산 KCC,Away,송교창,5,1,1,100.0,1,2,50.0,2,3,66.7,0,0,0.0,0,0,0,4,1,0,0,0,3,2
../kbl_data/2024-2025,S45G01N177,부산 KCC,Away,최준용,17,4,7,57.1,2,6,33.3,6,13,46.2,3,3,100.0,3,1,4,1,1,1,0,0,3,1
../kbl_data/2024-2025,S45G01N177,부산 KCC,Away,캐디 라렌,21,9,11,81.8,0,1,0.0,9,12,75.0,3,4,75.0,4,6,10,0,0,0,0,2,3,1
../kbl_data/2024-2025,S45G01N177,부산 KCC,Away,이근휘,0,0,0,0.0,0,0,0.0,0,0,0.0,0,0,0.0,0,1,1,0,0,0,0,0,0,0
../kbl_data/2024-2025,S45G01N177,부산 KCC,Away,캘빈 제프리 에피스톨라,2,1,2,50.0,0,1,0.0,1,3,33.3,0,0,0.0,0,1,1,2,1,0,1,0,1,4
../kbl_data/2024-2025,S45G01N177,부산 KCC,Away,이주영,0,0,0,0.0,0,0,0.0,0,0,0.0,0,0,0.0,0,0,0,0,0,0,0,0,0,0
../kbl_data/2024-2025,S45G01N177,부산 KCC,Away,도노반 스미스,2,0,1,0.0,0,0,0.0,0,1,0.0,2,4,50.0,0,1,1,0,1,2,0,0,2,3
../kbl_data/2024-2025,S45G01N178,서울 SK,Home,김선형,11,0,4,0.0,3,7,42.9,3,11,27.3,2,2,100.0,2,5,7,3,4,2,0,0,2,3
../kbl_data/2024-2025,S45G01N178,서울 SK,Home,오세근,6,0,1,0.0,2,4,50.0,2,5,40.0,0,0,0.0,0,0,0,0,0,0,0,0,1,0
../kbl_data/2024-2025,S45G01N178,서울 SK,Home,최부경,4,0,0,0.0,1,2,50.0,1,2,50.0,1,2,50.0,0,2,2,0,1,2,0,0,0,3
../kbl_data/2024-2025,S45G01N178,서울 SK,Home,최원혁,2,0,0,0.0,0,1,0.0,0,1,0.0,2,2,100.0,1,2,3,0,1,0,0,0,0,4
../kbl_data/2024-2025,S45G01N178,서울 SK,Home,김지후,0,0,0,0.0,0,0,0.0,0,0,0.0,0,0,0.0,0,0,0,0,0,0,0,0,0,0
../kbl_data/2024-2025,S45G01N178,서울 SK,Home,장문호,0,0,0,0.0,0,0,0.0,0,0,0.0,0,0,0.0,0,0,0,0,0,0,0,0,0,0
../kbl_data/2024-2025,S45G01N178,서울 SK,Home,안영준,16,5,8,62.5,2,5,40.0,7,13,53.8,0,0,0.0,3,5,8,4,2,0,0,0,4,2
../kbl_data/2024-2025,S45G01N178,서울 SK,Home,자밀 워니,27,11,22,50.0,1,5,20.0,12,27,44.4,2,3,66.7,1,9,10,4,0,3,0,0,0,1
../kbl_data/2024-2025,S45G01N178,서울 SK,Home,아이재아 힉스,4,2,3,66.7,0,0,0.0,2,3,66.7,0,0,0.0,0,1,1,0,0,1,0,0,1,0
../kbl_data/2024-2025,S45G01N178,서울 SK,Home,오재현,10,2,3,66.7,2,5,40.0,4,8,50.0,0,0,0.0,0,5,5,3,0,1,0,0,1,3
../kbl_data/2024-2025,S45G01N178,서울 SK,Home,고메즈 델 리아노,0,0,0,0.0,0,0,0.0,0,0,0.0,0,0,0.0,0,0,0,0,0,0,0,0,0,0
../kbl_data/2024-2025,S45G01N178,서울 SK,Home,김태훈,0,0,0,0.0,0,0,0.0,0,0,0.0,0,0,0.0,1,0,1,0,0,0,0,0,0,0
../kbl_data/2024-2025,S45G01N178,수원 KT,Away,한희원,4,2,4,50.0,0,2,0.0,2,6,33.3,0,0,0.0,1,3,4,0,0,0,0,0,2,2
../kbl_data/2024-2025,S45G01N178,수원 KT,Away,문성곤,0,0,0,0.0,0,0,0.0,0,0,0.0,0,0,0.0,1,0,1,0,0,0,0,0,0,1
../kbl_data/2024-2025,S45G01N178,수원 KT,Away,이현석,0,0,0,0.0,0,0,0.0,0,0,0.0,0,0,0.0,1,0,1,0,1,0,0,0,0,0
../kbl_data/2024-2025,S45G01N178,수원 KT,Away,허훈,11,1,8,12.5,3,13,23.1,4,21,19.0,0,0,0.0,2,4,6,10,1,0,0,0,0,2
../kbl_data/2024-2025,S45G01N178,수원 KT,Away,박준영,12,2,2,100.0,2,5,40.0,4,7,57.1,2,2,100.0,0,4,4,3,0,0,0,0,0,2
../kbl_data/2024-2025,S45G01N178,수원 KT,Away,박지원,0,0,0,0.0,0,0,0.0,0,0,0.0,0,0,0.0,0,0,0,0,0,0,0,0,0,1
../kbl_data/2024-2025,S45G01N178,수원 KT,Away,하윤기,12,5,7,71.4,0,0,0.0,5,7,71.4,2,2,100.0,1,1,2,2,0,0,0,0,2,1
../kbl_data/2024-2025,S45G01N178,수원 KT,Away,문정현,0,0,3,0.0,0,2,0.0,0,5,0.0,0,0,0.0,4,3,7,0,0,0,0,0,2,1
../kbl_data/2024-2025,S45G01N178,수원 KT,Away,레이션 해먼즈,23,6,6,100.0,3,6,50.0,9,12,75.0,2,5,40.0,1,10,11,0,1,0,0,0,1,3
../kbl_data/2024-2025,S45G01N178,수원 KT,Away,박성재,0,0,0,0.0,0,0,0.0,0,0,0.0,0,0,0.0,0,0,0,0,0,0,0,0,0,0
../kbl_data/2024-2025,S45G01N178,수원 KT,Away,이스마엘 로메로,2,1,2,50.0,0,0,0.0,1,2,50.0,0,0,0.0,0,2,2,0,0,0,0,1,0,2
../kbl_data/2024-2025,S45G01N178,수원 KT,Away,조엘 카굴랑안,11,1,7,14.3,3,6,50.0,4,13,30.8,0,0,0.0,1,2,3,5,3,0,1,0,3,1
../kbl_data/2024-2025,S45G01N179,울산 현대모비스,Home,장재석,12,6,10,60.0,0,0,0.0,6,10,60.0,0,0,0.0,2,2,4,1,0,0,0,1,1,4
../kbl_data/2024-2025,S45G01N179,울산 현대모비스,Home,이대헌,4,2,7,28.6,0,0,0.0,2,7,28.6,0,3,0.0,1,2,3,0,2,0,0,0,0,4
../kbl_data/2024-2025,S45G01N179,울산 현대모비스,Home,한호빈,8,1,2,50.0,2,3,66.7,3,5,60.0,0,0,0.0,0,0,0,1,3,0,0,0,1,2
../kbl_data/2024-2025,S45G01N179,울산 현대모비스,Home,김국찬,0,0,1,0.0,0,2,0.0,0,3,0.0,0,0,0.0,0,2,2,1,0,0,2,0,0,0
../kbl_data/2024-2025,S45G01N179,울산 현대모비스,Home,서명진,9,3,5,60.0,1,2,50.0,4,7,57.1,0,0,0.0,0,0,0,2,0,0,0,0,1,2
../kbl_data/2024-2025,S45G01N179,울산 현대모비스,Home,숀 롱,25,8,10,80.0,0,1,0.0,8,11,72.7,9,17,52.9,4,8,12,1,0,0,0,0,1,0
../kbl_data/2024-2025,S45G01N179,울산 현대모비스,Home,이우석,8,4,6,66.7,0,3,0.0,4,9,44.4,0,0,0.0,1,3,4,3,0,0,0,0,3,3
../kbl_data/2024-2025,S45G01N179,울산 현대모비스,Home,이승우,0,0,0,0.0,0,0,0.0,0,0,0.0,0,0,0.0,0,0,0,0,0,0,0,0,0,0
../kbl_data/2024-2025,S45G01N179,울산 현대모비스,Home,신민석,3,0,0,0.0,1,1,100.0,1,1,100.0,0,0,0.0,0,0,0,0,0,0,0,0,0,1
../kbl_data/2024-2025,S45G01N179,울산 현대모비스,Home,게이지 프림,8,3,9,33.3,0,1,0.0,3,10,30.0,2,3,66.7,2,4,6,7,2,0,0,0,1,4
../kbl_data/2024-2025,S45G01N179,울산 현대모비스,Home,박무빈,6,3,4,75.0,0,0,0.0,3,4,75.0,0,0,0.0,0,1,1,1,0,0,0,0,1,3
../kbl_data/2024-2025,S45G01N179,울산 현대모비스,Home,미구엘 안드레 옥존,2,1,1,100.0,0,2,0.0,1,3,33.3,0,0,0.0,0,0,0,2,1,0,0,0,0,1
../kbl_data/2024-2025,S45G01N179,대구 한국가스공사,Away,김동량,2,1,1,100.0,0,1,0.0,1,2,50.0,0,0,0.0,0,1,1,2,0,0,0,0,0,0
../kbl_data/2024-2025,S45G01N179,대구 한국가스공사,Away,차바위,0,0,0,0.0,0,0,0.0,0,0,0.0,0,0,0.0,0,0,0,0,0,0,0,0,0,0
../kbl_data/2024-2025,S45G01N179,대구 한국가스공사,Away,김준일,14,7,8,87.5,0,0,0.0,7,8,87.5,0,0,0.0,1,7,8,6,1,0,0,0,2,5
../kbl_data/2024-2025,S45G01N179,대구 한국가스공사,Away,정성우,16,5,5,100.0,1,3,33.3,6,8,75.0,3,3,100.0,0,2,2,4,0,0,1,0,1,1
../kbl_data/2024-2025,S45G01N179,대구 한국가스공사,Away,우동현,0,0,0,0.0,0,1,0.0,0,1,0.0,0,0,0.0,0,1,1,0,0,0,0,0,1,0
../kbl_data/2024-2025,S45G01N179,대구 한국가스공사,Away,전현우,19,2,2,100.0,5,6,83.3,7,8,87.5,0,0,0.0,0,0,0,2,1,0,0,0,2,4
../kbl_data/2024-2025,S45G01N179,대구 한국가스공사,Away,양재혁,0,0,0,0.0,0,1,0.0,0,1,0.0,0,0,0.0,1,1,2,0,1,0,0,0,0,3
../kbl_data/2024-2025,S45G01N179,대구 한국가스공사,Away,곽정훈,5,1,1,100.0,1,2,50.0,2,3,66.7,0,0,0.0,0,1,1,0,0,0,0,0,0,2
../kbl_data/2024-2025,S45G01N179,대구 한국가스공사,Away,앤드류 니콜슨,22,6,11,54.5,1,5,20.0,7,16,43.8,7,9,77.8,1,7,8,0,0,0,0,0,3,4
../kbl_data/2024-2025,S45G01N179,대구 한국가스공사,Away,신승민,2,0,1,0.0,0,3,0.0,0,4,0.0,2,2,100.0,0,5,5,1,1,0,0,0,0,1
../kbl_data/2024-2025,S45G01N179,대구 한국가스공사,Away,샘조세프 벨란겔,10,2,6,33.3,1,5,20.0,3,11,27.3,3,3,100.0,2,2,4,9,3,0,0,0,1,1
../kbl_data/2024-2025,S45G01N179,대구 한국가스공사,Away,유슈 은도예,4,1,2,50.0,0,1,0.0,1,3,33.3,2,2,100.0,0,2,2,0,0,0,0,1,1,4
../kbl_data/2024-2025,S45G01N180,서울 삼성,Home,이정현,10,0,1,0.0,2,6,33.3,2,7,28.6,4,4,100.0,0,6,6,7,0,1,1,0,4,2
../kbl_data/2024-2025,S45G01N180,서울 삼성,Home,최현민,7,0,1,0.0,2,4,50.0,2,5,40.0,1,2,50.0,0,1,1,2,1,0,0,0,1,4
../kbl_data/2024-2025,S45G01N180,서울 삼성,Home,이원대,3,0,1,0.0,1,3,33.3,1,4,25.0,0,0,0.0,0,0,0,2,1,0,0,0,0,4
../kbl_data/2024-2025,S45G01N180,서울 삼성,Home,최승욱,8,4,12,33.3,0,6,0.0,4,18,22.2,0,0,0.0,2,10,12,4,8,0,2,0,2,4
../kbl_data/2024-2025,S45G01N180,서울 삼성,Home,윤성원,8,1,2,50.0,1,2,50.0,2,4,50.0,3,4,75.0,1,1,2,0,0,0,0,0,1,2
../kbl_data/2024-2025,S45G01N180,서울 삼성,Home,마커스 데릭슨,13,1,4,25.0,2,5,40.0,3,9,33.3,5,6,83.3,3,3,6,2,0,0,0,0,1,2
../kbl_data/2024-2025,S45G01N180,서울 삼성,Home,이원석,9,1,2,50.0,1,1,100.0,2,3,66.7,4,6,66.7,1,2,3,0,1,0,0,0,0,2
../kbl_data/2024-2025,S45G01N180,서울 삼성,Home,저스틴 구탕,11,5,10,50.0,0,2,0.0,5,12,41.7,1,2,50.0,1,8,9,1,0,1,0,3,3,3
../kbl_data/2024-2025,S45G01N180,서울 삼성,Home,김근현,0,0,0,0.0,0,1,0.0,0,1,0.0,0,0,0.0,0,0,0,0,0,0,0,0,0,1
../kbl_data/2024-2025,S45G01N180,서울 삼성,Home,박승재,0,0,0,0.0,0,3,0.0,0,3,0.0,0,0,0.0,0,1,1,1,0,0,0,0,0,0
../kbl_data/2024-2025,S45G01N180,서울 삼성,Home,코피 코번,14,6,12,50.0,0,0,0.0,6,12,50.0,2,6,33.3,4,14,18,3,1,0,0,0,2,1
../kbl_data/2024-2025,S45G01N180,서울 삼성,Home,황영찬,0,0,0,0.0,0,0,0.0,0,0,0.0,0,0,0.0,0,0,0,0,0,0,0,0,1,1
../kbl_data/2024-2025,S45G01N180,고양 소노,Away,함준후,0,0,0,0.0,0,3,0.0,0,3,0.0,0,0,0.0,0,1,1,1,1,0,0,0,0,3
../kbl_data/2024-2025,S45G01N180,고양 소노,Away,정희재,1,0,0,0.0,0,2,0.0,0,2,0.0,1,2,50.0,0,3,3,0,0,0,0,0,0,1
../kbl_data/2024-2025,S45G01N180,고양 소노,Away,임동섭,8,1,2,50.0,2,8,25.0,3,10,30.0,0,0,0.0,4,7,11,0,1,0,0,0,1,3
../kbl_data/2024-2025,S45G01N180,고양 소노,Away,이재도,10,4,8,50.0,0,4,0.0,4,12,33.3,2,2,100.0,0,2,2,4,2,0,0,0,3,4
../kbl_data/2024-2025,S45G01N180,고양 소노,Away,최승욱,8,4,12,33.3,0,6,0.0,4,18,22.2,0,0,0.0,2,10,12,4,8,0,2,0,2,4
../kbl_data/2024-2025,S45G01N180,고양 소노,Away,조은후,2,0,0,0.0,0,0,0.0,0,0,0.0,2,4,50.0,0,0,0,0,0,0,0,0,0,1
../kbl_data/2024-2025,S45G01N180,고양 소노,Away,박종하,4,2,2,100.0,0,2,0.0,2,4,50.0,0,0,0.0,0,1,1,1,0,0,0,0,1,2
../kbl_data/2024-2025,S45G01N180,고양 소노,Away,민기남,3,0,0,0.0,1,2,50.0,1,2,50.0,0,0,0.0,1,0,1,1,0,0,0,0,0,1
../kbl_data/2024-2025,S45G01N180,고양 소노,Away,디제이 번즈 Jr,6,3,8,37.5,0,1,0.0,3,9,33.3,0,0,0.0,1,1,2,1,0,1,0,0,2,5
../kbl_data/2024-2025,S45G01N180,고양 소노,Away,정성조,0,0,0,0.0,0,0,0.0,0,0,0.0,0,0,0.0,1,0,1,0,0,0,0,0,0,0
../kbl_data/2024-2025,S45G01N180,고양 소노,Away,알파 카바,1,0,1,0.0,0,0,0.0,0,1,0.0,1,2,50.0,4,2,6,1,1,1,0,0,1,5
../kbl_data/2024-2025,S45G01N180,고양 소노,Away,케빈 켐바오,26,2,8,25.0,6,16,37.5,8,24,33.3,4,7,57.1,2,7,9,3,1,0,0,0,2,0
../kbl_data/2024-2025,S45G01N181,부산 KCC,Home,정창영,2,1,1,100.0,0,0,0.0,1,1,100.0,0,0,0.0,1,0,1,2,1,0,0,0,0,1
../kbl_data/2024-2025,S45G01N181,부산 KCC,Home,전준범,0,0,0,0.0,0,0,0.0,0,0,0.0,0,0,0.0,0,0,0,0,0,0,0,0,0,0
../kbl_data/2024-2025,S45G01N181,부산 KCC,Home,허웅,8,2,5,40.0,1,4,25.0,3,9,33.3,1,1,100.0,0,1,1,6,1,0,0,0,2,4
../kbl_data/2024-2025,S45G01N181,부산 KCC,Home,이승현,5,1,3,33.3,1,1,100.0,2,4,50.0,0,0,0.0,2,2,4,1,0,0,0,0,0,2
../kbl_data/2024-2025,S45G01N181,부산 KCC,Home,이호현,12,3,5,60.0,2,2,100.0,5,7,71.4,0,0,0.0,0,1,1,0,0,0,0,0,1,3
../kbl_data/2024-2025,S45G01N181,부산 KCC,Home,송교창,3,0,5,0.0,1,1,100.0,1,6,16.7,0,0,0.0,0,1,1,2,0,1,0,0,1,3
../kbl_data/2024-2025,S45G01N181,부산 KCC,Home,최준용,3,0,6,0.0,0,1,0.0,0,7,0.0,3,4,75.0,1,7,8,3,0,0,0,0,4,2
../kbl_data/2024-2025,S45G01N181,부산 KCC,Home,캐디 라렌,28,8,13,61.5,3,3,100.0,11,16,68.8,3,4,75.0,1,7,8,2,1,1,0,2,1,2
../kbl_data/2024-2025,S45G01N181,부산 KCC,Home,이근휘,11,0,0,0.0,3,5,60.0,3,5,60.0,2,2,100.0,1,0,1,1,0,0,0,0,0,0
../kbl_data/2024-2025,S45G01N181,부산 KCC,Home,캘빈 제프리 에피스톨라,0,0,1,0.0,0,0,0.0,0,1,0.0,0,0,0.0,0,0,0,0,0,0,0,0,0,1
../kbl_data/2024-2025,S45G01N181,부산 KCC,Home,이주영,4,1,1,100.0,0,0,0.0,1,1,100.0,2,2,100.0,0,0,0,1,0,0,0,0,0,1
../kbl_data/2024-2025,S45G01N181,부산 KCC,Home,도노반 스미스,2,1,2,50.0,0,2,0.0,1,4,25.0,0,0,0.0,0,2,2,3,0,1,0,1,0,0
../kbl_data/2024-2025,S45G01N181,창원 LG,Away,허일영,9,0,1,0.0,3,5,60.0,3,6,50.0,0,0,0.0,0,2,2,0,0,0,0,0,0,4
../kbl_data/2024-2025,S45G01N181,창원 LG,Away,최진수,7,2,6,33.3,1,3,33.3,3,9,33.3,0,0,0.0,3,3,6,3,1,0,0,0,0,1
../kbl_data/2024-2025,S45G01N181,창원 LG,Away,장민국,0,0,0,0.0,0,0,0.0,0,0,0.0,0,0,0.0,0,0,0,0,0,0,0,0,0,0
../kbl_data/2024-2025,S45G01N181,창원 LG,Away,전성현,12,2,2,100.0,2,5,40.0,4,7,57.1,2,2,100.0,0,2,2,1,0,0,0,0,0,2
../kbl_data/2024-2025,S45G01N181,창원 LG,Away,정인덕,9,0,2,0.0,3,6,50.0,3,8,37.5,0,0,0.0,0,2,2,0,1,0,0,0,0,3
../kbl_data/2024-2025,S45G01N181,창원 LG,Away,대릴 먼로,4,2,2,100.0,0,1,0.0,2,3,66.7,0,0,0.0,0,2,2,2,0,0,0,0,0,2
../kbl_data/2024-2025,S45G01N181,창원 LG,Away,박정현,0,0,0,0.0,0,0,0.0,0,0,0.0,0,0,0.0,0,0,0,0,0,0,0,0,0,0
../kbl_data/2024-2025,S45G01N181,창원 LG,Away,아셈 마레이,17,8,12,66.7,0,0,0.0,8,12,66.7,1,2,50.0,9,5,14,8,3,0,1,1,1,1
../kbl_data/2024-2025,S45G01N181,창원 LG,Away,양준석,9,3,10,30.0,1,2,50.0,4,12,33.3,0,0,0.0,0,3,3,6,0,0,0,0,2,1
../kbl_data/2024-2025,S45G01N181,창원 LG,Away,이경도,2,1,1,100.0,0,0,0.0,1,1,100.0,0,2,0.0,0,0,0,2,1,0,0,0,0,0
../kbl_data/2024-2025,S45G01N181,창원 LG,Away,칼 타마요,12,3,8,37.5,2,3,66.7,5,11,45.5,0,0,0.0,0,4,4,1,1,0,0,0,0,4
../kbl_data/2024-2025,S45G01N181,창원 LG,Away,최형찬,2,0,0,0.0,0,1,0.0,0,1,0.0,2,2,100.0,0,1,1,0,0,0,0,0,1,3
../kbl_data/2024-2025,S45G01N182,서울 SK,Home,김선형,15,3,7,42.9,2,6,33.3,5,13,38.5,3,3,100.0,2,2,4,7,2,0,0,0,3,3
../kbl_data/2024-2025,S45G01N182,서울 SK,Home,오세근,5,2,3,66.7,0,2,0.0,2,5,40.0,1,2,50.0,0,1,1,0,0,1,0,0,1,0
../kbl_data/2024-2025,S45G01N182,서울 SK,Home,최부경,3,0,1,0.0,1,1,100.0,1,2,50.0,0,0,0.0,1,3,4,1,1,1,0,0,1,1
../kbl_data/2024-2025,S45G01N182,서울 SK,Home,최원혁,3,0,0,0.0,1,2,50.0,1,2,50.0,0,0,0.0,1,0,1,1,2,0,0,0,1,4
../kbl_data/2024-2025,S45G01N182,서울 SK,Home,김지후,0,0,0,0.0,0,0,0.0,0,0,0.0,0,0,0.0,0,0,0,0,0,0,0,0,0,0
../kbl_data/2024-2025,S45G01N182,서울 SK,Home,장문호,0,0,0,0.0,0,0,0.0,0,0,0.0,0,0,0.0,0,0,0,0,0,0,0,0,0,1
../kbl_data/2024-2025,S45G01N182,서울 SK,Home,안영준,17,1,2,50.0,5,11,45.5,6,13,46.2,0,0,0.0,2,5,7,2,1,1,0,0,4,4
../kbl_data/2024-2025,S45G01N182,서울 SK,Home,자밀 워니,24,9,20,45.0,0,3,0.0,9,23,39.1,6,8,75.0,4,17,21,3,1,3,0,0,3,2
../kbl_data/2024-2025,S45G01N182,서울 SK,Home,아이재아 힉스,4,2,3,66.7,0,0,0.0,2,3,66.7,0,0,0.0,0,0,0,0,1,1,0,0,1,1
../kbl_data/2024-2025,S45G01N182,서울 SK,Home,오재현,11,2,5,40.0,1,4,25.0,3,9,33.3,4,4,100.0,1,1,2,6,2,0,0,0,0,1
../kbl_data/2024-2025,S45G01N182,서울 SK,Home,고메즈 델 리아노,0,0,0,0.0,0,0,0.0,0,0,0.0,0,0,0.0,0,0,0,0,0,0,0,0,0,0
../kbl_data/2024-2025,S45G01N182,서울 SK,Home,김태훈,3,0,0,0.0,1,1,100.0,1,1,100.0,0,0,0.0,0,0,0,0,0,0,0,0,0,0
../kbl_data/2024-2025,S45G01N182,안양 정관장,Away,송창용,5,1,2,50.0,1,3,33.3,2,5,40.0,0,0,0.0,0,0,0,0,0,0,0,0,0,3
../kbl_data/2024-2025,S45G01N182,안양 정관장,Away,정준원,0,0,0,0.0,0,2,0.0,0,2,0.0,0,0,0.0,0,0,0,0,1,1,0,0,2,2
../kbl_data/2024-2025,S45G01N182,안양 정관장,Away,배병준,2,1,3,33.3,0,2,0.0,1,5,20.0,0,0,0.0,0,2,2,1,0,0,0,0,1,1
../kbl_data/2024-2025,S45G01N182,안양 정관장,Away,김영현,10,1,1,100.0,2,5,40.0,3,6,50.0,2,2,100.0,2,3,5,2,1,0,1,0,2,2
../kbl_data/2024-2025,S45G01N182,안양 정관장,Away,이종현,0,0,0,0.0,0,0,0.0,0,0,0.0,0,0,0.0,0,0,0,0,0,0,0,0,0,0
../kbl_data/2024-2025,S45G01N182,안양 정관장,Away,박지훈,11,1,6,16.7,2,6,33.3,3,12,25.0,3,6,50.0,2,5,7,7,2,0,0,0,4,4
../kbl_data/2024-2025,S45G01N182,안양 정관장,Away,디온테 버튼,24,4,12,33.3,5,10,50.0,9,22,40.9,1,2,50.0,3,5,8,5,2,3,0,0,0,2
../kbl_data/2024-2025,S45G01N182,안양 정관장,Away,김경원,0,0,1,0.0,0,0,0.0,0,1,0.0,0,0,0.0,1,0,1,0,0,0,0,0,0,1
../kbl_data/2024-2025,S45G01N182,안양 정관장,Away,한승희,6,1,3,33.3,1,2,50.0,2,5,40.0,1,2,50.0,4,5,9,0,0,0,0,0,2,4
../kbl_data/2024-2025,S45G01N182,안양 정관장,Away,조니 오브라이언트,18,8,14,57.1,0,3,0.0,8,17,47.1,2,2,100.0,3,4,7,0,1,0,0,0,2,1
../kbl_data/2024-2025,S45G01N182,안양 정관장,Away,하비 고메즈,0,0,0,0.0,0,0,0.0,0,0,0.0,0,0,0.0,0,1,1,0,0,0,0,0,0,1
../kbl_data/2024-2025,S45G01N182,안양 정관장,Away,소준혁,5,1,1,100.0,1,2,50.0,2,3,66.7,0,0,0.0,1,1,2,1,0,0,0,0,1,0
../kbl_data/2024-2025,S45G01N183,수원 KT,Home,한희원,12,1,2,50.0,3,4,75.0,4,6,66.7,1,2,50.0,1,1,2,5,1,0,0,0,1,2
../kbl_data/2024-2025,S45G01N183,수원 KT,Home,문성곤,0,0,0,0.0,0,1,0.0,0,1,0.0,0,0,0.0,0,2,2,0,0,0,0,0,0,1
../kbl_data/2024-2025,S45G01N183,수원 KT,Home,이현석,0,0,0,0.0,0,0,0.0,0,0,0.0,0,0,0.0,0,0,0,0,0,0,0,0,0,0
../kbl_data/2024-2025,S45G01N183,수원 KT,Home,허훈,6,0,2,0.0,2,6,33.3,2,8,25.0,0,0,0.0,0,1,1,1,1,0,0,0,0,3
../kbl_data/2024-2025,S45G01N183,수원 KT,Home,박준영,3,0,2,0.0,1,3,33.3,1,5,20.0,0,0,0.0,1,0,1,0,0,0,0,0,0,0
../kbl_data/2024-2025,S45G01N183,수원 KT,Home,박지원,4,0,0,0.0,1,1,100.0,1,1,100.0,1,2,50.0,2,1,3,2,0,0,0,0,2,3
../kbl_data/2024-2025,S45G01N183,수원 KT,Home,하윤기,20,9,17,52.9,0,0,0.0,9,17,52.9,2,2,100.0,2,4,6,2,0,0,0,1,0,0
../kbl_data/2024-2025,S45G01N183,수원 KT,Home,문정현,8,1,5,20.0,2,2,100.0,3,7,42.9,0,0,0.0,1,5,6,4,3,0,0,0,1,2
../kbl_data/2024-2025,S45G01N183,수원 KT,Home,레이션 해먼즈,17,6,13,46.2,1,4,25.0,7,17,41.2,2,2,100.0,5,10,15,5,1,0,0,1,2,2
../kbl_data/2024-2025,S45G01N183,수원 KT,Home,박성재,3,0,0,0.0,1,2,50.0,1,2,50.0,0,0,0.0,0,0,0,1,0,0,0,0,0,0
../kbl_data/2024-2025,S45G01N183,수원 KT,Home,이스마엘 로메로,0,0,1,0.0,0,0,0.0,0,1,0.0,0,0,0.0,0,0,0,0,0,0,0,0,0,1
../kbl_data/2024-2025,S45G01N183,수원 KT,Home,조엘 카굴랑안,10,3,8,37.5,1,3,33.3,4,11,36.4,1,1,100.0,1,0,1,4,3,0,0,0,1,2
../kbl_data/2024-2025,S45G01N183,원주 DB,Away,이관희,9,0,2,0.0,3,6,50.0,3,8,37.5,0,0,0.0,0,1,1,2,0,0,0,0,1,1
../kbl_data/2024-2025,S45G01N183,원주 DB,Away,김시래,0,0,0,0.0,0,0,0.0,0,0,0.0,0,0,0.0,0,0,0,0,0,0,0,0,0,0
../kbl_data/2024-2025,S45G01N183,원주 DB,Away,서민수,0,0,0,0.0,0,0,0.0,0,0,0.0,0,0,0.0,3,0,3,0,0,2,0,0,0,0
../kbl_data/2024-2025,S45G01N183,원주 DB,Away,정효근,15,6,8,75.0,1,5,20.0,7,13,53.8,0,2,0.0,3,5,8,2,0,1,0,0,0,4
../kbl_data/2024-2025,S45G01N183,원주 DB,Away,박봉진,0,0,0,0.0,0,0,0.0,0,0,0.0,0,0,0.0,0,0,0,0,0,0,0,0,0,0
../kbl_data/2024-2025,S45G01N183,원주 DB,Away,강상재,16,5,7,71.4,2,3,66.7,7,10,70.0,0,0,0.0,1,7,8,3,1,2,0,0,2,2
../kbl_data/2024-2025,S45G01N183,원주 DB,Away,최성원,3,0,0,0.0,1,4,25.0,1,4,25.0,0,0,0.0,1,2,3,2,2,0,0,0,3,2
../kbl_data/2024-2025,S45G01N183,원주 DB,Away,치나누 오누아쿠,14,4,8,50.0,1,2,50.0,5,10,50.0,3,5,60.0,2,9,11,2,1,0,0,0,4,0
../kbl_data/2024-2025,S45G01N183,원주 DB,Away,김훈,0,0,0,0.0,0,0,0.0,0,0,0.0,0,0,0.0,0,0,0,0,0,0,0,0,0,0
../kbl_data/2024-2025,S45G01N183,원주 DB,Away,이용우,0,0,0,0.0,0,0,0.0,0,0,0.0,0,0,0.0,0,0,0,0,0,0,0,0,0,0
../kbl_data/2024-2025,S45G01N183,원주 DB,Away,이선 알바노,12,3,9,33.3,1,7,14.3,4,16,25.0,3,4,75.0,3,2,5,10,0,0,0,0,1,3
../kbl_data/2024-2025,S45G01N183,원주 DB,Away,로버트 카터,7,3,5,60.0,0,2,0.0,3,7,42.9,1,2,50.0,2,2,4,1,0,0,0,0,2,2
../kbl_data/2024-2025,S45G01N184,대구 한국가스공사,Home,김동량,4,1,1,100.0,0,0,0.0,1,1,100.0,2,2,100.0,1,3,4,0,0,0,0,0,0,1
../kbl_data/2024-2025,S45G01N184,대구 한국가스공사,Home,차바위,0,0,0,0.0,0,1,0.0,0,1,0.0,0,0,0.0,1,0,1,0,0,0,0,0,0,1
../kbl_data/2024-2025,S45G01N184,대구 한국가스공사,Home,박지훈,0,0,0,0.0,0,0,0.0,0,0,0.0,0,0,0.0,0,0,0,0,0,0,0,0,0,0
../kbl_data/2024-2025,S45G01N184,대구 한국가스공사,Home,김준일,13,6,11,54.5,0,1,0.0,6,12,50.0,1,2,50.0,1,3,4,3,3,0,0,0,5,1
../kbl_data/2024-2025,S45G01N184,대구 한국가스공사,Home,정성우,6,2,5,40.0,0,4,0.0,2,9,22.2,2,2,100.0,0,1,1,7,3,0,0,0,1,3
../kbl_data/2024-2025,S45G01N184,대구 한국가스공사,Home,우동현,4,0,0,0.0,1,2,50.0,1,2,50.0,1,2,50.0,0,0,0,1,2,0,0,0,0,0
../kbl_data/2024-2025,S45G01N184,대구 한국가스공사,Home,양재혁,0,0,0,0.0,0,0,0.0,0,0,0.0,0,0,0.0,0,0,0,0,0,0,0,0,0,0
../kbl_data/2024-2025,S45G01N184,대구 한국가스공사,Home,곽정훈,0,0,1,0.0,0,2,0.0,0,3,0.0,0,0,0.0,1,1,2,2,1,0,1,0,0,5
../kbl_data/2024-2025,S45G01N184,대구 한국가스공사,Home,앤드류 니콜슨,16,3,6,50.0,1,3,33.3,4,9,44.4,7,10,70.0,2,4,6,0,1,0,0,0,2,3
../kbl_data/2024-2025,S45G01N184,대구 한국가스공사,Home,신승민,0,0,3,0.0,0,2,0.0,0,5,0.0,0,0,0.0,0,2,2,1,1,0,0,0,0,2
../kbl_data/2024-2025,S45G01N184,대구 한국가스공사,Home,샘조세프 벨란겔,10,3,9,33.3,1,8,12.5,4,17,23.5,1,2,50.0,1,1,2,2,0,0,0,0,1,2
../kbl_data/2024-2025,S45G01N184,대구 한국가스공사,Home,유슈 은도예,13,5,6,83.3,0,0,0.0,5,6,83.3,3,6,50.0,2,4,6,0,1,1,0,2,0,3
../kbl_data/2024-2025,S45G01N184,울산 현대모비스,Away,장재석,1,0,3,0.0,0,0,0.0,0,3,0.0,1,2,50.0,3,1,4,1,1,2,0,0,0,1
../kbl_data/2024-2025,S45G01N184,울산 현대모비스,Away,이대헌,11,4,5,80.0,1,2,50.0,5,7,71.4,0,0,0.0,0,3,3,0,1,0,0,0,6,3
../kbl_data/2024-2025,S45G01N184,울산 현대모비스,Away,한호빈,0,0,0,0.0,0,3,0.0,0,3,0.0,0,0,0.0,1,0,1,2,0,0,1,0,3,4
../kbl_data/2024-2025,S45G01N184,울산 현대모비스,Away,김국찬,0,0,0,0.0,0,0,0.0,0,0,0.0,0,0,0.0,0,0,0,0,0,0,0,0,0,0
../kbl_data/2024-2025,S45G01N184,울산 현대모비스,Away,서명진,9,0,1,0.0,3,5,60.0,3,6,50.0,0,0,0.0,0,1,1,7,1,0,0,0,0,3
../kbl_data/2024-2025,S45G01N184,울산 현대모비스,Away,숀 롱,9,3,5,60.0,0,0,0.0,3,5,60.0,3,6,50.0,2,3,5,0,0,1,0,1,3,2
../kbl_data/2024-2025,S45G01N184,울산 현대모비스,Away,이우석,10,2,3,66.7,2,7,28.6,4,10,40.0,0,0,0.0,0,9,9,3,0,0,0,0,1,3
../kbl_data/2024-2025,S45G01N184,울산 현대모비스,Away,이승우,0,0,0,0.0,0,0,0.0,0,0,0.0,0,0,0.0,0,0,0,0,0,0,0,0,0,0
../kbl_data/2024-2025,S45G01N184,울산 현대모비스,Away,신민석,0,0,0,0.0,0,1,0.0,0,1,0.0,0,0,0.0,0,1,1,0,0,0,0,0,1,0
../kbl_data/2024-2025,S45G01N184,울산 현대모비스,Away,게이지 프림,23,7,13,53.8,1,1,100.0,8,14,57.1,6,8,75.0,1,8,9,3,1,0,0,0,3,4
../kbl_data/2024-2025,S45G01N184,울산 현대모비스,Away,박무빈,3,1,2,50.0,0,1,0.0,1,3,33.3,1,2,50.0,0,1,1,1,1,0,0,0,3,4
../kbl_data/2024-2025,S45G01N184,울산 현대모비스,Away,미구엘 안드레 옥존,3,0,1,0.0,1,3,33.3,1,4,25.0,0,0,0.0,0,0,0,0,0,0,0,0,0,1
../kbl_data/2024-2025,S45G01N185,서울 삼성,Home,이정현,14,4,7,57.1,2,9,22.2,6,16,37.5,0,0,0.0,1,8,9,5,1,0,0,0,5,4
../kbl_data/2024-2025,S45G01N185,서울 삼성,Home,최현민,10,2,5,40.0,2,7,28.6,4,12,33.3,0,0,0.0,2,1,3,1,1,0,0,0,0,2
../kbl_data/2024-2025,S45G01N185,서울 삼성,Home,이원대,3,0,0,0.0,1,4,25.0,1,4,25.0,0,0,0.0,0,1,1,2,0,0,0,0,1,2
../kbl_data/2024-2025,S45G01N185,서울 삼성,Home,최성모,7,1,3,33.3,1,7,14.3,2,10,20.0,2,2,100.0,0,1,1,2,1,1,0,0,1,3
../kbl_data/2024-2025,S45G01N185,서울 삼성,Home,최승욱,8,0,4,0.0,0,8,0.0,0,12,0.0,8,16,50.0,4,6,10,0,4,0,0,0,2,8
../kbl_data/2024-2025,S45G01N185,서울 삼성,Home,윤성원,0,0,0,0.0,0,2,0.0,0,2,0.0,0,0,0.0,1,0,1,1,0,0,0,0,2,3
../kbl_data/2024-2025,S45G01N185,서울 삼성,Home,마커스 데릭슨,3,0,0,0.0,1,3,33.3,1,3,33.3,0,0,0.0,0,2,2,0,0,0,0,0,0,1
../kbl_data/2024-2025,S45G01N185,서울 삼성,Home,이원석,2,1,5,20.0,0,0,0.0,1,5,20.0,0,0,0.0,5,2,7,0,0,0,0,0,0,1
../kbl_data/2024-2025,S45G01N185,서울 삼성,Home,저스틴 구탕,6,2,4,50.0,0,0,0.0,2,4,50.0,2,2,100.0,3,0,3,2,2,1,0,1,2,5
../kbl_data/2024-2025,S45G01N185,서울 삼성,Home,박승재,0,0,0,0.0,0,0,0.0,0,0,0.0,0,0,0.0,0,0,0,0,0,0,0,0,0,0
../kbl_data/2024-2025,S45G01N185,서울 삼성,Home,코피 코번,18,8,12,66.7,0,0,0.0,8,12,66.7,2,2,100.0,4,5,9,1,2,1,0,0,2,0
../kbl_data/2024-2025,S45G01N185,서울 삼성,Home,황영찬,0,0,0,0.0,0,0,0.0,0,0,0.0,0,2,0.0,1,0,1,0,0,0,0,0,0,2
../kbl_data/2024-2025,S45G01N185,고양 소노,Away,함준후,4,1,1,100.0,0,1,0.0,1,2,50.0,2,3,66.7,0,0,0,1,0,0,1,0,1,2
../kbl_data/2024-2025,S45G01N185,고양 소노,Away,정희재,0,0,0,0.0,0,0,0.0,0,0,0.0,0,0,0.0,0,2,2,1,1,0,0,0,0,1
../kbl_data/2024-2025,S45G01N185,고양 소노,Away,임동섭,8,1,2,50.0,2,4,50.0,3,6,50.0,0,0,0.0,1,8,9,1,2,0,0,0,0,4
../kbl_data/2024-2025,S45G01N185,고양 소노,Away,이재도,14,3,6,50.0,1,5,20.0,4,11,36.4,5,8,62.5,2,2,4,3,1,0,0,0,3,2
../kbl_data/2024-2025,S45G01N185,고양 소노,Away,최승욱,8,0,4,0.0,0,8,0.0,0,12,0.0,8,16,50.0,4,6,10,0,4,0,0,0,2,8
../kbl_data/2024-2025,S45G01N185,고양 소노,Away,박진철,0,0,0,0.0,0,0,0.0,0,0,0.0,0,0,0.0,0,0,0,0,0,0,0,0,0,0
../kbl_data/2024-2025,S45G01N185,고양 소노,Away,박종하,6,1,2,50.0,0,0,0.0,1,2,50.0,4,4,100.0,0,0,0,1,1,0,0,0,0,2
../kbl_data/2024-2025,S45G01N185,고양 소노,Away,민기남,9,0,0,0.0,3,5,60.0,3,5,60.0,0,0,0.0,0,0,0,0,0,0,1,0,1,2
../kbl_data/2024-2025,S45G01N185,고양 소노,Away,디제이 번즈 Jr,10,5,10,50.0,0,0,0.0,5,10,50.0,0,0,0.0,0,4,4,5,1,0,0,0,3,2
../kbl_data/2024-2025,S45G01N185,고양 소노,Away,정성조,0,0,0,0.0,0,0,0.0,0,0,0.0,0,0,0.0,0,0,0,0,0,0,0,0,0,0
../kbl_data/2024-2025,S45G01N185,고양 소노,Away,알파 카바,4,2,2,100.0,0,0,0.0,2,2,100.0,0,0,0.0,1,0,1,0,0,0,0,0,0,0
../kbl_data/2024-2025,S45G01N185,고양 소노,Away,케빈 켐바오,17,4,9,44.4,2,11,18.2,6,20,30.0,3,3,100.0,0,5,5,6,0,0,0,0,1,1
../kbl_data/2024-2025,S45G01N186,수원 KT,Home,한희원,6,0,0,0.0,2,4,50.0,2,4,50.0,0,0,0.0,0,2,2,0,1,0,1,0,0,3
../kbl_data/2024-2025,S45G01N186,수원 KT,Home,문성곤,3,0,0,0.0,1,2,50.0,1,2,50.0,0,0,0.0,1,2,3,0,0,0,0,0,1,0
../kbl_data/2024-2025,S45G01N186,수원 KT,Home,이현석,0,0,0,0.0,0,0,0.0,0,0,0.0,0,0,0.0,0,0,0,0,0,0,0,0,0,0
../kbl_data/2024-2025,S45G01N186,수원 KT,Home,허훈,12,3,7,42.9,2,8,25.0,5,15,33.3,0,0,0.0,0,2,2,9,0,0,0,0,3,1
../kbl_data/2024-2025,S45G01N186,수원 KT,Home,박준영,2,1,3,33.3,0,0,0.0,1,3,33.3,0,2,0.0,2,1,3,1,0,0,0,0,1,0
../kbl_data/2024-2025,S45G01N186,수원 KT,Home,박지원,0,0,0,0.0,0,0,0.0,0,0,0.0,0,0,0.0,0,0,0,0,0,0,0,0,0,0
../kbl_data/2024-2025,S45G01N186,수원 KT,Home,하윤기,10,4,9,44.4,0,0,0.0,4,9,44.4,2,4,50.0,1,4,5,0,1,1,0,0,1,2
../kbl_data/2024-2025,S45G01N186,수원 KT,Home,문정현,6,0,0,0.0,2,4,50.0,2,4,50.0,0,0,0.0,5,4,9,6,0,0,0,0,0,2
../kbl_data/2024-2025,S45G01N186,수원 KT,Home,레이션 해먼즈,26,6,11,54.5,3,11,27.3,9,22,40.9,5,6,83.3,1,8,9,1,0,0,0,1,0,2
../kbl_data/2024-2025,S45G01N186,수원 KT,Home,박성재,0,0,0,0.0,0,0,0.0,0,0,0.0,0,0,0.0,0,0,0,0,0,0,0,0,0,0
../kbl_data/2024-2025,S45G01N186,수원 KT,Home,이스마엘 로메로,4,2,2,100.0,0,1,0.0,2,3,66.7,0,0,0.0,0,1,1,0,0,0,0,0,1,1
../kbl_data/2024-2025,S45G01N186,수원 KT,Home,조엘 카굴랑안,5,1,4,25.0,1,1,100.0,2,5,40.0,0,0,0.0,1,0,1,3,1,0,1,0,2,3
../kbl_data/2024-2025,S45G01N186,서울 SK,Away,김선형,15,6,9,66.7,1,5,20.0,7,14,50.0,0,0,0.0,1,3,4,3,2,0,0,0,0,3
../kbl_data/2024-2025,S45G01N186,서울 SK,Away,오세근,16,2,4,50.0,4,6,66.7,6,10,60.0,0,0,0.0,0,5,5,1,1,0,0,0,1,0
../kbl_data/2024-2025,S45G01N186,서울 SK,Away,최부경,8,2,2,100.0,1,1,100.0,3,3,100.0,1,1,100.0,3,4,7,1,0,0,0,0,0,3
../kbl_data/2024-2025,S45G01N186,서울 SK,Away,최원혁,0,0,0,0.0,0,1,0.0,0,1,0.0,0,0,0.0,1,0,1,1,1,0,0,0,0,0
../kbl_data/2024-2025,S45G01N186,서울 SK,Away,김지후,0,0,0,0.0,0,0,0.0,0,0,0.0,0,0,0.0,0,0,0,0,0,0,0,0,0,0
../kbl_data/2024-2025,S45G01N186,서울 SK,Away,장문호,0,0,0,0.0,0,0,0.0,0,0,0.0,0,0,0.0,0,0,0,0,0,0,0,0,0,0
../kbl_data/2024-2025,S45G01N186,서울 SK,Away,안영준,17,3,4,75.0,3,8,37.5,6,12,50.0,2,2,100.0,1,3,4,0,1,0,1,0,3,3
../kbl_data/2024-2025,S45G01N186,서울 SK,Away,자밀 워니,21,7,16,43.8,1,3,33.3,8,19,42.1,4,5,80.0,2,12,14,5,1,1,0,0,3,2
../kbl_data/2024-2025,S45G01N186,서울 SK,Away,아이재아 힉스,7,2,5,40.0,1,1,100.0,3,6,50.0,0,0,0.0,0,0,0,1,0,2,0,1,0,2
../kbl_data/2024-2025,S45G01N186,서울 SK,Away,오재현,0,0,0,0.0,0,2,0.0,0,2,0.0,0,0,0.0,0,1,1,3,0,1,0,0,1,4
../kbl_data/2024-2025,S45G01N186,서울 SK,Away,고메즈 델 리아노,0,0,0,0.0,0,0,0.0,0,0,0.0,0,0,0.0,0,0,0,0,0,0,0,0,0,0
../kbl_data/2024-2025,S45G01N186,서울 SK,Away,김태훈,1,0,0,0.0,0,0,0.0,0,0,0.0,1,3,33.3,0,0,0,0,0,1,0,0,0,0
../kbl_data/2024-2025,S45G01N187,안양 정관장,Home,정준원,0,0,1,0.0,0,0,0.0,0,1,0.0,0,0,0.0,0,0,0,1,0,1,0,0,0,0
../kbl_data/2024-2025,S45G01N187,안양 정관장,Home,김영현,5,1,1,100.0,1,1,100.0,2,2,100.0,0,0,0.0,3,2,5,2,2,0,0,0,0,1
../kbl_data/2024-2025,S45G01N187,안양 정관장,Home,이종현,2,1,3,33.3,0,1,0.0,1,4,25.0,0,0,0.0,4,2,6,0,0,0,0,0,0,5
../kbl_data/2024-2025,S45G01N187,안양 정관장,Home,박지훈,14,4,8,50.0,2,5,40.0,6,13,46.2,0,0,0.0,1,4,5,7,1,1,0,0,4,2
../kbl_data/2024-2025,S45G01N187,안양 정관장,Home,디온테 버튼,27,7,17,41.2,3,12,25.0,10,29,34.5,4,4,100.0,0,12,12,4,2,0,0,1,1,2
../kbl_data/2024-2025,S45G01N187,안양 정관장,Home,이우정,4,0,0,0.0,1,1,100.0,1,1,100.0,1,2,50.0,1,0,1,0,1,0,0,0,0,2
../kbl_data/2024-2025,S45G01N187,안양 정관장,Home,김준형,0,0,0,0.0,0,0,0.0,0,0,0.0,0,0,0.0,0,0,0,0,0,0,0,0,0,0
../kbl_data/2024-2025,S45G01N187,안양 정관장,Home,김경원,0,0,1,0.0,0,0,0.0,0,1,0.0,0,0,0.0,0,0,0,0,1,0,0,0,0,0
../kbl_data/2024-2025,S45G01N187,안양 정관장,Home,한승희,2,1,1,100.0,0,1,0.0,1,2,50.0,0,0,0.0,1,0,1,1,0,0,0,0,0,5
../kbl_data/2024-2025,S45G01N187,안양 정관장,Home,조니 오브라이언트,8,1,8,12.5,2,6,33.3,3,14,21.4,0,0,0.0,1,3,4,0,1,0,0,0,4,2
../kbl_data/2024-2025,S45G01N187,안양 정관장,Home,하비 고메즈,11,1,2,50.0,3,6,50.0,4,8,50.0,0,0,0.0,2,1,3,0,1,0,0,0,0,1
../kbl_data/2024-2025,S45G01N187,안양 정관장,Home,소준혁,3,0,0,0.0,1,2,50.0,1,2,50.0,0,0,0.0,1,0,1,1,1,0,0,0,0,1
../kbl_data/2024-2025,S45G01N187,부산 KCC,Away,정창영,6,3,3,100.0,0,1,0.0,3,4,75.0,0,0,0.0,0,2,2,3,2,0,0,0,0,1
../kbl_data/2024-2025,S45G01N187,부산 KCC,Away,전준범,0,0,0,0.0,0,0,0.0,0,0,0.0,0,0,0.0,0,0,0,0,0,0,0,0,0,0
../kbl_data/2024-2025,S45G01N187,부산 KCC,Away,허웅,4,2,4,50.0,0,1,0.0,2,5,40.0,0,0,0.0,0,3,3,3,0,0,0,0,2,0
../kbl_data/2024-2025,S45G01N187,부산 KCC,Away,이승현,3,1,3,33.3,0,0,0.0,1,3,33.3,1,2,50.0,1,1,2,0,1,0,0,0,1,0
../kbl_data/2024-2025,S45G01N187,부산 KCC,Away,이호현,8,4,6,66.7,0,1,0.0,4,7,57.1,0,0,0.0,1,2,3,3,0,0,0,0,1,3
../kbl_data/2024-2025,S45G01N187,부산 KCC,Away,송교창,4,2,3,66.7,0,1,0.0,2,4,50.0,0,0,0.0,2,1,3,2,0,0,0,0,0,2
../kbl_data/2024-2025,S45G01N187,부산 KCC,Away,최준용,11,4,5,80.0,0,7,0.0,4,12,33.3,3,4,75.0,0,4,4,1,0,1,0,0,2,3
../kbl_data/2024-2025,S45G01N187,부산 KCC,Away,캐디 라렌,24,9,16,56.2,0,2,0.0,9,18,50.0,6,13,46.2,4,16,20,3,0,2,0,1,4,1
../kbl_data/2024-2025,S45G01N187,부산 KCC,Away,이근휘,1,0,0,0.0,0,1,0.0,0,1,0.0,1,1,100.0,0,0,0,0,0,0,0,0,0,1
../kbl_data/2024-2025,S45G01N187,부산 KCC,Away,캘빈 제프리 에피스톨라,0,0,0,0.0,0,0,0.0,0,0,0.0,0,0,0.0,0,0,0,0,0,0,0,0,0,0
../kbl_data/2024-2025,S45G01N187,부산 KCC,Away,이주영,0,0,0,0.0,0,1,0.0,0,1,0.0,0,0,0.0,1,0,1,0,0,0,0,0,1,3
../kbl_data/2024-2025,S45G01N187,부산 KCC,Away,도노반 스미스,6,3,7,42.9,0,0,0.0,3,7,42.9,0,0,0.0,2,2,4,0,2,0,0,0,1,0
../kbl_data/2024-2025,S45G01N188,고양 소노,Home,함준후,0,0,0,0.0,0,1,0.0,0,1,0.0,0,0,0.0,0,1,1,1,0,0,0,0,0,3
../kbl_data/2024-2025,S45G01N188,고양 소노,Home,정희재,0,0,0,0.0,0,0,0.0,0,0,0.0,0,0,0.0,0,1,1,1,1,0,0,0,0,0
../kbl_data/2024-2025,S45G01N188,고양 소노,Home,임동섭,13,4,4,100.0,1,4,25.0,5,8,62.5,2,4,50.0,2,1,3,0,1,1,0,0,1,3
../kbl_data/2024-2025,S45G01N188,고양 소노,Home,이재도,7,3,5,60.0,0,3,0.0,3,8,37.5,1,1,100.0,1,3,4,8,0,0,0,0,2,0
../kbl_data/2024-2025,S45G01N188,고양 소노,Home,최승욱,3,0,2,0.0,1,2,50.0,1,4,25.0,0,0,0.0,0,0,0,0,0,0,0,0,1,3
../kbl_data/2024-2025,S45G01N188,고양 소노,Home,조은후,5,1,1,100.0,1,1,100.0,2,2,100.0,0,0,0.0,1,0,1,0,1,0,0,0,0,0
../kbl_data/2024-2025,S45G01N188,고양 소노,Home,박종하,6,0,3,0.0,2,3,66.7,2,6,33.3,0,1,0.0,0,2,2,0,1,0,0,0,1,0
../kbl_data/2024-2025,S45G01N188,고양 소노,Home,민기남,0,0,0,0.0,0,1,0.0,0,1,0.0,0,0,0.0,0,0,0,3,0,0,0,0,0,1
../kbl_data/2024-2025,S45G01N188,고양 소노,Home,디제이 번즈 Jr,20,10,13,76.9,0,0,0.0,10,13,76.9,0,0,0.0,1,1,2,3,0,0,0,0,2,4
../kbl_data/2024-2025,S45G01N188,고양 소노,Home,정성조,4,1,2,50.0,0,1,0.0,1,3,33.3,2,2,100.0,0,1,1,2,0,0,0,0,0,1
../kbl_data/2024-2025,S45G01N188,고양 소노,Home,알파 카바,12,6,8,75.0,0,0,0.0,6,8,75.0,0,0,0.0,1,2,3,0,2,2,0,0,2,3
../kbl_data/2024-2025,S45G01N188,고양 소노,Home,케빈 켐바오,10,2,6,33.3,1,6,16.7,3,12,25.0,3,4,75.0,2,4,6,6,1,0,0,0,1,0
../kbl_data/2024-2025,S45G01N188,울산 현대모비스,Away,장재석,4,2,3,66.7,0,0,0.0,2,3,66.7,0,0,0.0,2,0,2,4,0,1,0,1,0,1
../kbl_data/2024-2025,S45G01N188,울산 현대모비스,Away,이대헌,8,4,4,100.0,0,0,0.0,4,4,100.0,0,0,0.0,2,2,4,0,0,0,0,0,0,3
../kbl_data/2024-2025,S45G01N188,울산 현대모비스,Away,한호빈,3,0,0,0.0,1,5,20.0,1,5,20.0,0,0,0.0,0,2,2,4,1,0,1,0,0,2
../kbl_data/2024-2025,S45G01N188,울산 현대모비스,Away,김국찬,11,3,6,50.0,1,4,25.0,4,10,40.0,2,2,100.0,4,3,7,2,2,0,0,0,0,0
../kbl_data/2024-2025,S45G01N188,울산 현대모비스,Away,서명진,3,0,2,0.0,1,1,100.0,1,3,33.3,0,0,0.0,1,2,3,4,0,0,0,0,2,3
../kbl_data/2024-2025,S45G01N188,울산 현대모비스,Away,숀 롱,26,8,12,66.7,0,0,0.0,8,12,66.7,10,13,76.9,3,5,8,3,1,2,0,4,2,1
../kbl_data/2024-2025,S45G01N188,울산 현대모비스,Away,이우석,22,4,4,100.0,4,13,30.8,8,17,47.1,2,2,100.0,1,4,5,4,1,1,0,0,0,2
../kbl_data/2024-2025,S45G01N188,울산 현대모비스,Away,이승우,2,1,1,100.0,0,0,0.0,1,1,100.0,0,0,0.0,0,1,1,0,0,0,0,0,1,1
../kbl_data/2024-2025,S45G01N188,울산 현대모비스,Away,신민석,0,0,0,0.0,0,2,0.0,0,2,0.0,0,0,0.0,0,2,2,0,1,0,0,0,1,1
../kbl_data/2024-2025,S45G01N188,울산 현대모비스,Away,게이지 프림,14,6,10,60.0,0,2,0.0,6,12,50.0,2,2,100.0,4,2,6,1,0,0,0,0,1,0
../kbl_data/2024-2025,S45G01N188,울산 현대모비스,Away,박무빈,5,1,1,100.0,0,0,0.0,1,1,100.0,3,3,100.0,0,1,1,0,0,0,0,0,1,2
../kbl_data/2024-2025,S45G01N188,울산 현대모비스,Away,미구엘 안드레 옥존,3,0,0,0.0,1,2,50.0,1,2,50.0,0,0,0.0,0,0,0,2,0,0,0,0,2,0
../kbl_data/2024-2025,S45G01N189,서울 SK,Home,김선형,12,4,6,66.7,1,3,33.3,5,9,55.6,1,2,50.0,0,4,4,2,1,0,0,0,1,1
../kbl_data/2024-2025,S45G01N189,서울 SK,Home,오세근,5,2,2,100.0,0,6,0.0,2,8,25.0,1,1,100.0,0,4,4,1,0,0,0,0,1,4
../kbl_data/2024-2025,S45G01N189,서울 SK,Home,최부경,3,1,5,20.0,0,1,0.0,1,6,16.7,1,2,50.0,2,1,3,0,1,0,0,0,1,3
../kbl_data/2024-2025,S45G01N189,서울 SK,Home,최원혁,3,0,0,0.0,1,2,50.0,1,2,50.0,0,0,0.0,1,3,4,1,0,0,0,0,1,1
../kbl_data/2024-2025,S45G01N189,서울 SK,Home,김지후,0,0,0,0.0,0,0,0.0,0,0,0.0,0,0,0.0,0,0,0,0,0,0,0,0,0,0
../kbl_data/2024-2025,S45G01N189,서울 SK,Home,장문호,0,0,0,0.0,0,0,0.0,0,0,0.0,0,0,0.0,0,0,0,0,0,0,0,0,0,0
../kbl_data/2024-2025,S45G01N189,서울 SK,Home,안영준,17,4,6,66.7,2,7,28.6,6,13,46.2,3,3,100.0,2,0,2,2,2,2,0,0,0,3
../kbl_data/2024-2025,S45G01N189,서울 SK,Home,자밀 워니,16,4,9,44.4,2,5,40.0,6,14,42.9,2,4,50.0,0,9,9,8,0,1,0,1,4,0
../kbl_data/2024-2025,S45G01N189,서울 SK,Home,아이재아 힉스,4,2,4,50.0,0,1,0.0,2,5,40.0,0,0,0.0,0,1,1,0,0,0,0,0,0,0
../kbl_data/2024-2025,S45G01N189,서울 SK,Home,오재현,8,4,5,80.0,0,3,0.0,4,8,50.0,0,0,0.0,1,1,2,1,1,1,0,0,0,2
../kbl_data/2024-2025,S45G01N189,서울 SK,Home,고메즈 델 리아노,0,0,0,0.0,0,0,0.0,0,0,0.0,0,0,0.0,0,0,0,0,0,0,0,0,0,0
../kbl_data/2024-2025,S45G01N189,서울 SK,Home,김태훈,0,0,1,0.0,0,1,0.0,0,2,0.0,0,0,0.0,0,1,1,0,0,0,0,0,0,0
../kbl_data/2024-2025,S45G01N189,창원 LG,Away,허일영,8,2,2,100.0,0,5,0.0,2,7,28.6,4,4,100.0,1,3,4,0,0,0,0,0,2,4
../kbl_data/2024-2025,S45G01N189,창원 LG,Away,최진수,4,1,2,50.0,0,4,0.0,1,6,16.7,2,2,100.0,1,3,4,1,1,1,0,0,1,3
../kbl_data/2024-2025,S45G01N189,창원 LG,Away,장민국,0,0,0,0.0,0,0,0.0,0,0,0.0,0,0,0.0,0,0,0,0,0,0,0,0,0,0
../kbl_data/2024-2025,S45G01N189,창원 LG,Away,전성현,16,2,4,50.0,4,9,44.4,6,13,46.2,0,0,0.0,0,1,1,1,0,0,0,0,0,0
../kbl_data/2024-2025,S45G01N189,창원 LG,Away,정인덕,8,1,4,25.0,2,3,66.7,3,7,42.9,0,0,0.0,2,3,5,0,0,0,0,0,0,1
../kbl_data/2024-2025,S45G01N189,창원 LG,Away,대릴 먼로,5,1,1,100.0,1,1,100.0,2,2,100.0,0,0,0.0,0,2,2,0,1,0,0,0,0,0
../kbl_data/2024-2025,S45G01N189,창원 LG,Away,박정현,0,0,0,0.0,0,0,0.0,0,0,0.0,0,0,0.0,0,0,0,0,0,0,0,0,1,1
../kbl_data/2024-2025,S45G01N189,창원 LG,Away,아셈 마레이,19,9,13,69.2,0,0,0.0,9,13,69.2,1,3,33.3,7,14,21,3,3,0,0,0,2,3
../kbl_data/2024-2025,S45G01N189,창원 LG,Away,양준석,5,1,4,25.0,1,4,25.0,2,8,25.0,0,0,0.0,0,1,1,6,1,0,0,0,3,3
../kbl_data/2024-2025,S45G01N189,창원 LG,Away,이경도,2,1,1,100.0,0,1,0.0,1,2,50.0,0,0,0.0,0,0,0,1,0,0,0,0,1,1
../kbl_data/2024-2025,S45G01N189,창원 LG,Away,칼 타마요,10,4,10,40.0,0,2,0.0,4,12,33.3,2,2,100.0,1,4,5,4,1,0,0,0,0,2
../kbl_data/2024-2025,S45G01N189,창원 LG,Away,최형찬,0,0,0,0.0,0,0,0.0,0,0,0.0,0,0,0.0,0,0,0,0,0,0,0,0,0,0
../kbl_data/2024-2025,S45G01N190,원주 DB,Home,이관희,12,1,3,33.3,2,4,50.0,3,7,42.9,4,4,100.0,0,2,2,1,0,0,0,0,2,1
../kbl_data/2024-2025,S45G01N190,원주 DB,Home,김시래,11,4,6,66.7,0,1,0.0,4,7,57.1,3,4,75.0,1,2,3,1,1,0,0,0,0,3
../kbl_data/2024-2025,S45G01N190,원주 DB,Home,서민수,2,1,1,100.0,0,0,0.0,1,1,100.0,0,0,0.0,0,2,2,1,0,0,0,0,0,1
../kbl_data/2024-2025,S45G01N190,원주 DB,Home,정효근,0,0,0,0.0,0,0,0.0,0,0,0.0,0,0,0.0,1,2,3,2,0,1,0,0,2,2
../kbl_data/2024-2025,S45G01N190,원주 DB,Home,박봉진,0,0,0,0.0,0,0,0.0,0,0,0.0,0,0,0.0,0,0,0,0,0,0,0,0,0,0
../kbl_data/2024-2025,S45G01N190,원주 DB,Home,강상재,17,4,4,100.0,3,3,100.0,7,7,100.0,0,0,0.0,0,3,3,2,0,0,1,0,2,2
../kbl_data/2024-2025,S45G01N190,원주 DB,Home,최성원,2,1,4,25.0,0,2,0.0,1,6,16.7,0,0,0.0,0,3,3,3,1,0,0,0,0,2
../kbl_data/2024-2025,S45G01N190,원주 DB,Home,치나누 오누아쿠,5,2,4,50.0,0,0,0.0,2,4,50.0,1,2,50.0,0,7,7,1,1,1,0,0,1,2
../kbl_data/2024-2025,S45G01N190,원주 DB,Home,김훈,0,0,0,0.0,0,0,0.0,0,0,0.0,0,0,0.0,0,0,0,0,0,0,0,0,0,0
../kbl_data/2024-2025,S45G01N190,원주 DB,Home,오마리 스펠맨,18,1,6,16.7,5,9,55.6,6,15,40.0,1,1,100.0,0,2,2,0,0,1,0,0,0,1
../kbl_data/2024-2025,S45G01N190,원주 DB,Home,정호영,0,0,0,0.0,0,0,0.0,0,0,0.0,0,0,0.0,0,0,0,0,0,0,0,0,0,0
../kbl_data/2024-2025,S45G01N190,원주 DB,Home,이선 알바노,21,6,9,66.7,2,6,33.3,8,15,53.3,3,3,100.0,3,2,5,3,0,0,0,0,2,4
../kbl_data/2024-2025,S45G01N190,부산 KCC,Away,정창영,7,2,3,66.7,1,3,33.3,3,6,50.0,0,0,0.0,2,2,4,5,2,0,0,0,2,4
../kbl_data/2024-2025,S45G01N190,부산 KCC,Away,전준범,0,0,0,0.0,0,0,0.0,0,0,0.0,0,0,0.0,0,0,0,0,0,0,0,0,0,0
../kbl_data/2024-2025,S45G01N190,부산 KCC,Away,허웅,11,3,5,60.0,1,7,14.3,4,12,33.3,2,2,100.0,0,0,0,5,2,0,0,0,1,2
../kbl_data/2024-2025,S45G01N190,부산 KCC,Away,이승현,8,4,9,44.4,0,3,0.0,4,12,33.3,0,0,0.0,1,2,3,0,0,0,0,0,0,1
../kbl_data/2024-2025,S45G01N190,부산 KCC,Away,이호현,18,4,7,57.1,2,2,100.0,6,9,66.7,4,6,66.7,0,3,3,1,0,0,0,0,2,2
../kbl_data/2024-2025,S45G01N190,부산 KCC,Away,송교창,7,2,5,40.0,1,2,50.0,3,7,42.9,0,0,0.0,2,2,4,5,0,0,0,0,0,4
../kbl_data/2024-2025,S45G01N190,부산 KCC,Away,캐디 라렌,21,7,10,70.0,1,3,33.3,8,13,61.5,4,4,100.0,2,10,12,2,0,2,0,2,2,3
../kbl_data/2024-2025,S45G01N190,부산 KCC,Away,이근휘,0,0,0,0.0,0,4,0.0,0,4,0.0,0,0,0.0,0,0,0,0,0,0,0,0,0,0
../kbl_data/2024-2025,S45G01N190,부산 KCC,Away,여준형,0,0,0,0.0,0,0,0.0,0,0,0.0,0,0,0.0,0,0,0,0,0,0,0,0,0,0
../kbl_data/2024-2025,S45G01N190,부산 KCC,Away,캘빈 제프리 에피스톨라,0,0,0,0.0,0,0,0.0,0,0,0.0,0,0,0.0,1,2,3,1,0,0,0,0,0,1
../kbl_data/2024-2025,S45G01N190,부산 KCC,Away,이주영,3,0,1,0.0,1,2,50.0,1,3,33.3,0,0,0.0,0,1,1,0,0,0,0,0,0,1
../kbl_data/2024-2025,S45G01N190,부산 KCC,Away,도노반 스미스,0,0,4,0.0,0,0,0.0,0,4,0.0,0,0,0.0,0,0,0,2,0,0,0,0,0,2
../kbl_data/2024-2025,S45G01N191,부산 KCC,Home,정창영,8,3,4,75.0,0,3,0.0,3,7,42.9,2,2,100.0,1,1,2,2,0,0,0,0,2,2
../kbl_data/2024-2025,S45G01N191,부산 KCC,Home,전준범,12,1,3,33.3,3,4,75.0,4,7,57.1,1,2,50.0,0,0,0,1,0,0,0,0,0,4
../kbl_data/2024-2025,S45G01N191,부산 KCC,Home,허웅,16,2,5,40.0,4,10,40.0,6,15,40.0,0,0,0.0,0,3,3,9,1,0,1,0,4,1
../kbl_data/2024-2025,S45G01N191,부산 KCC,Home,이승현,15,6,10,60.0,1,2,50.0,7,12,58.3,0,0,0.0,8,1,9,3,2,0,0,0,0,0
../kbl_data/2024-2025,S45G01N191,부산 KCC,Home,이호현,0,0,1,0.0,0,0,0.0,0,1,0.0,0,0,0.0,0,1,1,2,1,0,0,0,1,0
../kbl_data/2024-2025,S45G01N191,부산 KCC,Home,전태영,0,0,0,0.0,0,0,0.0,0,0,0.0,0,0,0.0,0,0,0,0,0,0,0,0,0,0
../kbl_data/2024-2025,S45G01N191,부산 KCC,Home,캐디 라렌,26,8,12,66.7,1,4,25.0,9,16,56.2,7,10,70.0,1,5,6,2,2,3,0,4,2,4
../kbl_data/2024-2025,S45G01N191,부산 KCC,Home,이근휘,3,0,0,0.0,1,1,100.0,1,1,100.0,0,0,0.0,1,0,1,0,1,0,0,0,2,1
../kbl_data/2024-2025,S45G01N191,부산 KCC,Home,캘빈 제프리 에피스톨라,0,0,1,0.0,0,2,0.0,0,3,0.0,0,0,0.0,1,4,5,1,0,0,1,0,1,2
../kbl_data/2024-2025,S45G01N191,부산 KCC,Home,이주영,2,1,2,50.0,0,1,0.0,1,3,33.3,0,0,0.0,0,1,1,0,2,0,1,0,1,2
../kbl_data/2024-2025,S45G01N191,부산 KCC,Home,이찬영,0,0,0,0.0,0,0,0.0,0,0,0.0,0,0,0.0,0,0,0,0,0,0,0,0,0,0
../kbl_data/2024-2025,S45G01N191,부산 KCC,Home,도노반 스미스,3,0,4,0.0,1,3,33.3,1,7,14.3,0,0,0.0,1,2,3,1,0,1,0,0,1,2
../kbl_data/2024-2025,S45G01N191,고양 소노,Away,정희재,1,0,0,0.0,0,0,0.0,0,0,0.0,1,2,50.0,0,0,0,0,0,0,0,0,2,2
../kbl_data/2024-2025,S45G01N191,고양 소노,Away,임동섭,6,0,0,0.0,2,2,100.0,2,2,100.0,0,0,0.0,0,0,0,0,0,0,0,0,0,4
../kbl_data/2024-2025,S45G01N191,고양 소노,Away,이재도,19,4,7,57.1,2,3,66.7,6,10,60.0,5,6,83.3,2,8,10,2,2,1,0,0,3,2
../kbl_data/2024-2025,S45G01N191,고양 소노,Away,최승욱,10,2,2,100.0,2,5,40.0,4,7,57.1,0,0,0.0,0,0,0,1,1,0,0,0,0,3
../kbl_data/2024-2025,S45G01N191,고양 소노,Away,조은후,0,0,0,0.0,0,0,0.0,0,0,0.0,0,0,0.0,0,0,0,0,0,0,0,0,0,0
../kbl_data/2024-2025,S45G01N191,고양 소노,Away,박종하,19,5,8,62.5,3,6,50.0,8,14,57.1,0,0,0.0,1,0,1,0,0,0,0,0,1,1
../kbl_data/2024-2025,S45G01N191,고양 소노,Away,민기남,0,0,0,0.0,0,0,0.0,0,0,0.0,0,0,0.0,0,1,1,0,0,0,0,0,0,0
../kbl_data/2024-2025,S45G01N191,고양 소노,Away,앨런 윌리엄스,17,6,18,33.3,0,0,0.0,6,18,33.3,5,6,83.3,3,5,8,6,3,0,0,0,4,5
../kbl_data/2024-2025,S45G01N191,고양 소노,Away,디제이 번즈 Jr,8,4,5,80.0,0,0,0.0,4,5,80.0,0,0,0.0,1,2,3,1,1,0,0,0,0,0
../kbl_data/2024-2025,S45G01N191,고양 소노,Away,이근준,3,0,0,0.0,1,4,25.0,1,4,25.0,0,0,0.0,2,6,8,0,1,1,0,0,1,3
../kbl_data/2024-2025,S45G01N191,고양 소노,Away,정성조,0,0,0,0.0,0,0,0.0,0,0,0.0,0,0,0.0,0,0,0,0,0,0,0,0,0,0
../kbl_data/2024-2025,S45G01N191,고양 소노,Away,케빈 켐바오,12,2,2,100.0,2,11,18.2,4,13,30.8,2,2,100.0,3,5,8,18,3,0,0,1,5,0
../kbl_data/2024-2025,S45G01N192,안양 정관장,Home,정준원,4,2,4,50.0,0,3,0.0,2,7,28.6,0,0,0.0,3,1,4,0,0,0,0,0,0,1
../kbl_data/2024-2025,S45G01N192,안양 정관장,Home,배병준,11,2,5,40.0,2,3,66.7,4,8,50.0,1,1,100.0,1,1,2,0,1,0,0,0,0,0
../kbl_data/2024-2025,S45G01N192,안양 정관장,Home,김영현,0,0,1,0.0,0,3,0.0,0,4,0.0,0,0,0.0,2,0,2,0,0,0,0,0,0,2
../kbl_data/2024-2025,S45G01N192,안양 정관장,Home,이종현,0,0,0,0.0,0,1,0.0,0,1,0.0,0,0,0.0,1,2,3,0,0,2,0,0,0,0
../kbl_data/2024-2025,S45G01N192,안양 정관장,Home,박지훈,10,5,11,45.5,0,4,0.0,5,15,33.3,0,0,0.0,0,2,2,0,3,0,1,0,1,3
../kbl_data/2024-2025,S45G01N192,안양 정관장,Home,디온테 버튼,7,2,10,20.0,1,5,20.0,3,15,20.0,0,0,0.0,3,7,10,2,0,0,0,1,2,3
../kbl_data/2024-2025,S45G01N192,안양 정관장,Home,변준형,7,2,3,66.7,0,6,0.0,2,9,22.2,3,4,75.0,1,2,3,4,2,0,0,0,1,3
../kbl_data/2024-2025,S45G01N192,안양 정관장,Home,김경원,2,1,2,50.0,0,1,0.0,1,3,33.3,0,0,0.0,3,2,5,0,0,2,0,0,1,0
../kbl_data/2024-2025,S45G01N192,안양 정관장,Home,한승희,2,0,4,0.0,0,1,0.0,0,5,0.0,2,2,100.0,3,1,4,2,0,2,0,0,0,4
../kbl_data/2024-2025,S45G01N192,안양 정관장,Home,조니 오브라이언트,11,3,7,42.9,0,2,0.0,3,9,33.3,5,6,83.3,4,9,13,1,0,0,0,0,2,1
../kbl_data/2024-2025,S45G01N192,안양 정관장,Home,하비 고메즈,2,1,3,33.3,0,3,0.0,1,6,16.7,0,0,0.0,0,0,0,0,0,0,0,0,0,0
../kbl_data/2024-2025,S45G01N192,안양 정관장,Home,소준혁,0,0,0,0.0,0,0,0.0,0,0,0.0,0,0,0.0,0,0,0,0,0,0,0,0,0,0
../kbl_data/2024-2025,S45G01N192,수원 KT,Away,문성곤,6,0,1,0.0,2,5,40.0,2,6,33.3,0,0,0.0,4,4,8,1,2,2,0,0,0,4
../kbl_data/2024-2025,S45G01N192,수원 KT,Away,이현석,0,0,0,0.0,0,0,0.0,0,0,0.0,0,0,0.0,0,0,0,0,0,0,0,0,0,0
../kbl_data/2024-2025,S45G01N192,수원 KT,Away,허훈,8,2,6,33.3,1,8,12.5,3,14,21.4,1,2,50.0,2,4,6,4,0,0,0,0,2,2
../kbl_data/2024-2025,S45G01N192,수원 KT,Away,박준영,6,3,5,60.0,0,1,0.0,3,6,50.0,0,1,0.0,3,4,7,2,0,0,0,0,1,1
../kbl_data/2024-2025,S45G01N192,수원 KT,Away,최진광,0,0,0,0.0,0,0,0.0,0,0,0.0,0,0,0.0,0,0,0,0,0,0,0,0,0,0
../kbl_data/2024-2025,S45G01N192,수원 KT,Away,이윤기,0,0,0,0.0,0,0,0.0,0,0,0.0,0,0,0.0,0,0,0,0,0,0,0,0,0,0
../kbl_data/2024-2025,S45G01N192,수원 KT,Away,하윤기,5,1,5,20.0,0,0,0.0,1,5,20.0,3,4,75.0,5,2,7,0,0,1,0,0,2,4
../kbl_data/2024-2025,S45G01N192,수원 KT,Away,문정현,7,2,5,40.0,1,4,25.0,3,9,33.3,0,2,0.0,1,5,6,1,0,2,0,0,2,1
../kbl_data/2024-2025,S45G01N192,수원 KT,Away,레이션 해먼즈,19,4,12,33.3,3,6,50.0,7,18,38.9,2,4,50.0,5,12,17,1,1,2,0,0,3,4
../kbl_data/2024-2025,S45G01N192,수원 KT,Away,박성재,0,0,2,0.0,0,4,0.0,0,6,0.0,0,0,0.0,0,0,0,3,0,0,0,0,0,1
../kbl_data/2024-2025,S45G01N192,수원 KT,Away,이스마엘 로메로,8,3,3,100.0,0,0,0.0,3,3,100.0,2,2,100.0,1,2,3,0,0,0,0,0,1,2
../kbl_data/2024-2025,S45G01N192,수원 KT,Away,조엘 카굴랑안,4,1,4,25.0,0,1,0.0,1,5,20.0,2,2,100.0,1,1,2,5,1,0,0,0,1,1
../kbl_data/2024-2025,S45G01N193,원주 DB,Home,이관희,12,2,4,50.0,2,6,33.3,4,10,40.0,2,2,100.0,0,2,2,3,2,1,0,0,0,3
../kbl_data/2024-2025,S45G01N193,원주 DB,Home,김시래,0,0,0,0.0,0,1,0.0,0,1,0.0,0,0,0.0,0,0,0,0,0,0,0,0,0,1
../kbl_data/2024-2025,S45G01N193,원주 DB,Home,서민수,5,1,1,100.0,1,1,100.0,2,2,100.0,0,0,0.0,1,1,2,0,0,0,0,0,0,2
../kbl_data/2024-2025,S45G01N193,원주 DB,Home,정효근,13,5,7,71.4,1,4,25.0,6,11,54.5,0,1,0.0,3,4,7,1,1,1,0,0,2,1
../kbl_data/2024-2025,S45G01N193,원주 DB,Home,박봉진,0,0,0,0.0,0,1,0.0,0,1,0.0,0,0,0.0,0,0,0,0,0,0,0,0,0,1
../kbl_data/2024-2025,S45G01N193,원주 DB,Home,강상재,9,3,3,100.0,1,2,50.0,4,5,80.0,0,0,0.0,0,4,4,3,2,0,0,0,0,2
../kbl_data/2024-2025,S45G01N193,원주 DB,Home,최성원,6,0,0,0.0,2,5,40.0,2,5,40.0,0,0,0.0,1,2,3,2,0,0,1,0,2,4
../kbl_data/2024-2025,S45G01N193,원주 DB,Home,김훈,0,0,0,0.0,0,1,0.0,0,1,0.0,0,0,0.0,0,0,0,0,0,0,0,0,0,0
../kbl_data/2024-2025,S45G01N193,원주 DB,Home,이용우,0,0,0,0.0,0,0,0.0,0,0,0.0,0,0,0.0,0,0,0,0,0,0,0,0,0,0
../kbl_data/2024-2025,S45G01N193,원주 DB,Home,오마리 스펠맨,24,6,7,85.7,3,9,33.3,9,16,56.2,3,3,100.0,0,9,9,4,1,1,0,2,4,1
../kbl_data/2024-2025,S45G01N193,원주 DB,Home,이선 알바노,20,6,7,85.7,2,6,33.3,8,13,61.5,2,3,66.7,1,1,2,7,2,0,0,0,2,2
../kbl_data/2024-2025,S45G01N193,원주 DB,Home,로버트 카터,0,0,1,0.0,0,1,0.0,0,2,0.0,0,0,0.0,0,2,2,1,1,0,0,0,1,1
../kbl_data/2024-2025,S45G01N193,대구 한국가스공사,Away,차바위,0,0,0,0.0,0,0,0.0,0,0,0.0,0,0,0.0,0,1,1,0,0,0,0,0,0,2
../kbl_data/2024-2025,S45G01N193,대구 한국가스공사,Away,박지훈,0,0,0,0.0,0,0,0.0,0,0,0.0,0,0,0.0,0,1,1,0,0,0,0,0,0,2
../kbl_data/2024-2025,S45G01N193,대구 한국가스공사,Away,김준일,11,5,11,45.5,0,0,0.0,5,11,45.5,1,1,100.0,6,3,9,6,1,0,0,0,3,2
../kbl_data/2024-2025,S45G01N193,대구 한국가스공사,Away,정성우,10,2,2,100.0,2,5,40.0,4,7,57.1,0,0,0.0,0,1,1,5,0,0,0,0,1,2
../kbl_data/2024-2025,S45G01N193,대구 한국가스공사,Away,김낙현,8,0,1,0.0,2,4,50.0,2,5,40.0,2,3,66.7,2,0,2,3,1,0,0,0,2,1
../kbl_data/2024-2025,S45G01N193,대구 한국가스공사,Away,전현우,5,1,1,100.0,1,8,12.5,2,9,22.2,0,0,0.0,1,2,3,1,0,1,0,0,1,2
../kbl_data/2024-2025,S45G01N193,대구 한국가스공사,Away,양재혁,0,0,0,0.0,0,1,0.0,0,1,0.0,0,0,0.0,0,0,0,1,0,0,0,0,0,0
../kbl_data/2024-2025,S45G01N193,대구 한국가스공사,Away,앤드류 니콜슨,23,5,13,38.5,4,6,66.7,9,19,47.4,1,2,50.0,3,5,8,2,0,0,0,0,1,1
../kbl_data/2024-2025,S45G01N193,대구 한국가스공사,Away,신승민,0,0,0,0.0,0,2,0.0,0,2,0.0,0,0,0.0,0,7,7,0,1,0,0,0,2,2
../kbl_data/2024-2025,S45G01N193,대구 한국가스공사,Away,샘조세프 벨란겔,14,2,4,50.0,3,4,75.0,5,8,62.5,1,3,33.3,0,1,1,5,3,0,0,0,3,1
../kbl_data/2024-2025,S45G01N193,대구 한국가스공사,Away,유슈 은도예,9,3,5,60.0,0,0,0.0,3,5,60.0,3,4,75.0,0,5,5,1,0,0,0,1,2,2
../kbl_data/2024-2025,S45G01N193,대구 한국가스공사,Away,신주영,0,0,0,0.0,0,1,0.0,0,1,0.0,0,0,0.0,0,0,0,1,0,0,0,0,0,0
../kbl_data/2024-2025,S45G01N194,창원 LG,Home,허일영,12,3,4,75.0,2,6,33.3,5,10,50.0,0,0,0.0,3,5,8,1,0,0,0,0,2,2
../kbl_data/2024-2025,S45G01N194,창원 LG,Home,최진수,2,1,4,25.0,0,1,0.0,1,5,20.0,0,0,0.0,0,3,3,1,1,0,0,0,0,2
../kbl_data/2024-2025,S45G01N194,창원 LG,Home,전성현,9,3,4,75.0,1,5,20.0,4,9,44.4,0,0,0.0,0,3,3,1,1,0,0,0,0,1
../kbl_data/2024-2025,S45G01N194,창원 LG,Home,정인덕,11,4,5,80.0,1,1,100.0,5,6,83.3,0,0,0.0,0,2,2,0,0,1,0,0,1,3
../kbl_data/2024-2025,S45G01N194,창원 LG,Home,대릴 먼로,2,1,2,50.0,0,2,0.0,1,4,25.0,0,0,0.0,3,2,5,1,0,0,0,0,1,1
../kbl_data/2024-2025,S45G01N194,창원 LG,Home,박정현,6,3,6,50.0,0,1,0.0,3,7,42.9,0,0,0.0,0,1,1,1,1,0,0,0,1,2
../kbl_data/2024-2025,S45G01N194,창원 LG,Home,아셈 마레이,14,7,12,58.3,0,0,0.0,7,12,58.3,0,4,0.0,4,5,9,5,3,0,0,0,2,1
../kbl_data/2024-2025,S45G01N194,창원 LG,Home,김종호,0,0,0,0.0,0,0,0.0,0,0,0.0,0,0,0.0,0,0,0,0,0,0,0,0,1,1
../kbl_data/2024-2025,S45G01N194,창원 LG,Home,양준석,7,3,8,37.5,0,1,0.0,3,9,33.3,1,2,50.0,0,2,2,9,1,0,0,0,0,2
../kbl_data/2024-2025,S45G01N194,창원 LG,Home,이경도,4,1,2,50.0,0,0,0.0,1,2,50.0,2,2,100.0,0,3,3,1,0,1,0,0,1,1
../kbl_data/2024-2025,S45G01N194,창원 LG,Home,칼 타마요,4,2,4,50.0,0,0,0.0,2,4,50.0,0,0,0.0,0,4,4,2,0,0,0,0,1,0
../kbl_data/2024-2025,S45G01N194,창원 LG,Home,최형찬,3,0,2,0.0,1,1,100.0,1,3,33.3,0,0,0.0,0,0,0,0,0,0,0,0,0,2
../kbl_data/2024-2025,S45G01N194,서울 삼성,Away,이정현,4,0,2,0.0,1,4,25.0,1,6,16.7,1,2,50.0,0,0,0,3,0,0,0,0,3,3
../kbl_data/2024-2025,S45G01N194,서울 삼성,Away,최현민,4,2,2,100.0,0,3,0.0,2,5,40.0,0,0,0.0,0,2,2,1,1,0,0,0,0,0
../kbl_data/2024-2025,S45G01N194,서울 삼성,Away,이원대,2,1,2,50.0,0,2,0.0,1,4,25.0,0,0,0.0,0,1,1,2,1,0,0,0,0,3
../kbl_data/2024-2025,S45G01N194,서울 삼성,Away,최성모,6,0,6,0.0,2,3,66.7,2,9,22.2,0,0,0.0,0,2,2,4,0,0,1,0,1,0
../kbl_data/2024-2025,S45G01N194,서울 삼성,Away,최승욱,2,0,0,0.0,0,0,0.0,0,0,0.0,2,2,100.0,0,2,2,0,1,0,0,0,0,1
../kbl_data/2024-2025,S45G01N194,서울 삼성,Away,윤성원,0,0,0,0.0,0,0,0.0,0,0,0.0,0,0,0.0,0,0,0,0,0,0,0,0,0,0
../kbl_data/2024-2025,S45G01N194,서울 삼성,Away,차민석,0,0,0,0.0,0,0,0.0,0,0,0.0,0,0,0.0,0,0,0,0,0,0,0,0,0,1
../kbl_data/2024-2025,S45G01N194,서울 삼성,Away,이원석,16,7,12,58.3,0,2,0.0,7,14,50.0,2,2,100.0,1,2,3,2,1,1,0,0,0,3
../kbl_data/2024-2025,S45G01N194,서울 삼성,Away,저스틴 구탕,8,4,6,66.7,0,2,0.0,4,8,50.0,0,0,0.0,0,2,2,2,1,0,0,2,0,3
../kbl_data/2024-2025,S45G01N194,서울 삼성,Away,박승재,0,0,0,0.0,0,0,0.0,0,0,0.0,0,0,0.0,0,1,1,1,0,0,0,0,1,2
../kbl_data/2024-2025,S45G01N194,서울 삼성,Away,코피 코번,8,3,7,42.9,0,0,0.0,3,7,42.9,2,2,100.0,4,4,8,1,0,0,0,0,4,0
../kbl_data/2024-2025,S45G01N194,서울 삼성,Away,글렌 로빈슨 3세,12,2,4,50.0,1,3,33.3,3,7,42.9,5,5,100.0,1,4,5,0,0,1,1,0,1,1
../kbl_data/2024-2025,S45G01N195,부산 KCC,Home,정창영,6,0,1,0.0,2,3,66.7,2,4,50.0,0,0,0.0,0,4,4,1,1,0,0,0,1,1
../kbl_data/2024-2025,S45G01N195,부산 KCC,Home,전준범,5,1,1,100.0,1,4,25.0,2,5,40.0,0,0,0.0,0,0,0,0,0,0,0,0,0,3
../kbl_data/2024-2025,S45G01N195,부산 KCC,Home,허웅,7,2,6,33.3,1,5,20.0,3,11,27.3,0,0,0.0,0,1,1,2,0,0,0,0,2,2
../kbl_data/2024-2025,S45G01N195,부산 KCC,Home,이승현,11,4,10,40.0,1,2,50.0,5,12,41.7,0,0,0.0,1,3,4,2,1,0,0,0,4,4
../kbl_data/2024-2025,S45G01N195,부산 KCC,Home,이호현,18,4,6,66.7,2,4,50.0,6,10,60.0,4,4,100.0,1,2,3,5,1,0,0,0,4,2
../kbl_data/2024-2025,S45G01N195,부산 KCC,Home,전태영,0,0,0,0.0,0,0,0.0,0,0,0.0,0,0,0.0,0,0,0,0,0,0,0,0,0,0
../kbl_data/2024-2025,S45G01N195,부산 KCC,Home,캐디 라렌,18,8,13,61.5,0,2,0.0,8,15,53.3,2,2,100.0,4,12,16,2,1,2,0,3,1,0
../kbl_data/2024-2025,S45G01N195,부산 KCC,Home,이근휘,0,0,0,0.0,0,3,0.0,0,3,0.0,0,0,0.0,0,1,1,1,0,0,0,0,0,0
../kbl_data/2024-2025,S45G01N195,부산 KCC,Home,캘빈 제프리 에피스톨라,0,0,0,0.0,0,0,0.0,0,0,0.0,0,0,0.0,0,1,1,0,0,0,0,0,0,2
../kbl_data/2024-2025,S45G01N195,부산 KCC,Home,이주영,0,0,0,0.0,0,0,0.0,0,0,0.0,0,0,0.0,0,0,0,0,0,0,0,0,0,0
../kbl_data/2024-2025,S45G01N195,부산 KCC,Home,이찬영,0,0,0,0.0,0,0,0.0,0,0,0.0,0,0,0.0,0,0,0,0,0,0,0,0,0,0
../kbl_data/2024-2025,S45G01N195,부산 KCC,Home,도노반 스미스,2,1,2,50.0,0,0,0.0,1,2,50.0,0,0,0.0,0,1,1,0,0,0,0,0,0,0
../kbl_data/2024-2025,S45G01N195,수원 KT,Away,문성곤,4,2,2,100.0,0,3,0.0,2,5,40.0,0,0,0.0,4,2,6,0,1,0,0,0,1,0
../kbl_data/2024-2025,S45G01N195,수원 KT,Away,이현석,3,0,0,0.0,1,2,50.0,1,2,50.0,0,0,0.0,0,0,0,1,0,0,0,0,0,0
../kbl_data/2024-2025,S45G01N195,수원 KT,Away,허훈,10,2,4,50.0,2,3,66.7,4,7,57.1,0,0,0.0,1,2,3,6,0,0,0,0,2,1
../kbl_data/2024-2025,S45G01N195,수원 KT,Away,박준영,0,0,0,0.0,0,0,0.0,0,0,0.0,0,0,0.0,0,0,0,0,0,0,0,0,0,0
../kbl_data/2024-2025,S45G01N195,수원 KT,Away,최진광,0,0,0,0.0,0,0,0.0,0,0,0.0,0,0,0.0,0,0,0,0,0,0,0,0,0,0
../kbl_data/2024-2025,S45G01N195,수원 KT,Away,이윤기,0,0,0,0.0,0,1,0.0,0,1,0.0,0,0,0.0,0,1,1,0,0,0,0,0,0,1
../kbl_data/2024-2025,S45G01N195,수원 KT,Away,하윤기,6,3,13,23.1,0,0,0.0,3,13,23.1,0,0,0.0,1,2,3,2,2,1,0,0,0,0
../kbl_data/2024-2025,S45G01N195,수원 KT,Away,문정현,6,3,7,42.9,0,5,0.0,3,12,25.0,0,1,0.0,1,3,4,2,1,0,0,0,0,2
../kbl_data/2024-2025,S45G01N195,수원 KT,Away,레이션 해먼즈,21,6,11,54.5,3,7,42.9,9,18,50.0,0,0,0.0,5,6,11,2,1,2,0,1,0,3
../kbl_data/2024-2025,S45G01N195,수원 KT,Away,박성재,8,1,1,100.0,2,7,28.6,3,8,37.5,0,0,0.0,5,1,6,3,1,1,1,0,0,3
../kbl_data/2024-2025,S45G01N195,수원 KT,Away,이스마엘 로메로,14,7,10,70.0,0,0,0.0,7,10,70.0,0,0,0.0,3,5,8,1,0,0,0,0,0,5
../kbl_data/2024-2025,S45G01N195,수원 KT,Away,조엘 카굴랑안,8,1,4,25.0,2,7,28.6,3,11,27.3,0,0,0.0,3,3,6,6,3,0,0,0,2,1
../kbl_data/2024-2025,S45G01N196,울산 현대모비스,Home,함지훈,4,1,1,100.0,0,0,0.0,1,1,100.0,2,2,100.0,2,3,5,2,1,0,0,0,1,1
../kbl_data/2024-2025,S45G01N196,울산 현대모비스,Home,장재석,0,0,0,0.0,0,0,0.0,0,0,0.0,0,0,0.0,0,0,0,0,0,0,0,0,0,0
../kbl_data/2024-2025,S45G01N196,울산 현대모비스,Home,이대헌,0,0,1,0.0,0,1,0.0,0,2,0.0,0,0,0.0,0,1,1,0,0,0,0,0,1,1
../kbl_data/2024-2025,S45G01N196,울산 현대모비스,Home,한호빈,3,0,0,0.0,1,2,50.0,1,2,50.0,0,0,0.0,0,2,2,2,0,0,0,0,0,2
../kbl_data/2024-2025,S45G01N196,울산 현대모비스,Home,김국찬,0,0,0,0.0,0,0,0.0,0,0,0.0,0,0,0.0,0,0,0,0,0,0,0,0,0,0
../kbl_data/2024-2025,S45G01N196,울산 현대모비스,Home,서명진,12,3,7,42.9,2,7,28.6,5,14,35.7,0,0,0.0,2,4,6,6,1,0,0,0,3,2
../kbl_data/2024-2025,S45G01N196,울산 현대모비스,Home,숀 롱,16,6,8,75.0,1,1,100.0,7,9,77.8,1,2,50.0,3,2,5,2,0,1,0,1,3,1
../kbl_data/2024-2025,S45G01N196,울산 현대모비스,Home,이우석,15,3,8,37.5,3,7,42.9,6,15,40.0,0,2,0.0,2,4,6,3,1,1,0,0,5,1
../kbl_data/2024-2025,S45G01N196,울산 현대모비스,Home,신민석,0,0,0,0.0,0,2,0.0,0,2,0.0,0,0,0.0,2,3,5,1,1,0,0,0,0,1
../kbl_data/2024-2025,S45G01N196,울산 현대모비스,Home,게이지 프림,22,9,19,47.4,0,1,0.0,9,20,45.0,4,4,100.0,4,1,5,0,1,0,0,0,0,3
../kbl_data/2024-2025,S45G01N196,울산 현대모비스,Home,박무빈,0,0,0,0.0,0,1,0.0,0,1,0.0,0,0,0.0,0,0,0,3,0,0,0,0,0,1
../kbl_data/2024-2025,S45G01N196,울산 현대모비스,Home,미구엘 안드레 옥존,5,0,0,0.0,1,4,25.0,1,4,25.0,2,3,66.7,0,2,2,1,2,1,0,0,0,3
../kbl_data/2024-2025,S45G01N196,서울 SK,Away,김선형,8,2,6,33.3,1,2,50.0,3,8,37.5,1,2,50.0,0,2,2,5,3,0,0,0,2,3
../kbl_data/2024-2025,S45G01N196,서울 SK,Away,오세근,15,3,3,100.0,3,4,75.0,6,7,85.7,0,0,0.0,1,2,3,0,1,0,0,0,0,3
../kbl_data/2024-2025,S45G01N196,서울 SK,Away,최부경,0,0,1,0.0,0,0,0.0,0,1,0.0,0,0,0.0,2,0,2,0,1,0,0,0,2,1
../kbl_data/2024-2025,S45G01N196,서울 SK,Away,최원혁,0,0,0,0.0,0,0,0.0,0,0,0.0,0,0,0.0,1,0,1,1,0,0,0,0,1,2
../kbl_data/2024-2025,S45G01N196,서울 SK,Away,김지후,0,0,0,0.0,0,0,0.0,0,0,0.0,0,0,0.0,0,0,0,0,0,0,0,0,0,0
../kbl_data/2024-2025,S45G01N196,서울 SK,Away,안영준,16,5,9,55.6,1,3,33.3,6,12,50.0,3,3,100.0,0,3,3,1,0,1,0,0,2,2
../kbl_data/2024-2025,S45G01N196,서울 SK,Away,자밀 워니,18,9,17,52.9,0,4,0.0,9,21,42.9,0,0,0.0,2,8,10,5,2,3,1,0,2,2
../kbl_data/2024-2025,S45G01N196,서울 SK,Away,김형빈,0,0,0,0.0,0,0,0.0,0,0,0.0,0,0,0.0,0,0,0,0,0,0,0,0,0,1
../kbl_data/2024-2025,S45G01N196,서울 SK,Away,아이재아 힉스,7,2,2,100.0,1,1,100.0,3,3,100.0,0,0,0.0,2,4,6,2,0,1,0,2,3,0
../kbl_data/2024-2025,S45G01N196,서울 SK,Away,오재현,14,6,11,54.5,0,2,0.0,6,13,46.2,2,2,100.0,1,0,1,1,1,0,0,0,0,2
../kbl_data/2024-2025,S45G01N196,서울 SK,Away,고메즈 델 리아노,0,0,0,0.0,0,0,0.0,0,0,0.0,0,0,0.0,0,0,0,0,0,0,0,0,0,0
../kbl_data/2024-2025,S45G01N196,서울 SK,Away,김태훈,2,1,1,100.0,0,1,0.0,1,2,50.0,0,0,0.0,0,0,0,0,0,0,0,0,0,3
../kbl_data/2024-2025,S45G01N197,원주 DB,Home,이관희,15,0,2,0.0,5,12,41.7,5,14,35.7,0,0,0.0,0,4,4,0,0,0,0,0,2,3
../kbl_data/2024-2025,S45G01N197,원주 DB,Home,김시래,0,0,0,0.0,0,1,0.0,0,1,0.0,0,0,0.0,1,1,2,0,0,0,0,0,0,0
../kbl_data/2024-2025,S45G01N197,원주 DB,Home,서민수,0,0,0,0.0,0,0,0.0,0,0,0.0,0,0,0.0,0,0,0,0,0,0,0,0,0,0
../kbl_data/2024-2025,S45G01N197,원주 DB,Home,정효근,2,1,2,50.0,0,2,0.0,1,4,25.0,0,0,0.0,0,0,0,0,0,1,0,0,2,2
../kbl_data/2024-2025,S45G01N197,원주 DB,Home,박봉진,0,0,1,0.0,0,3,0.0,0,4,0.0,0,0,0.0,2,1,3,2,0,0,0,0,0,4
../kbl_data/2024-2025,S45G01N197,원주 DB,Home,강상재,12,2,5,40.0,1,7,14.3,3,12,25.0,5,8,62.5,1,7,8,2,2,0,0,0,1,3
../kbl_data/2024-2025,S45G01N197,원주 DB,Home,최성원,7,1,2,50.0,1,5,20.0,2,7,28.6,2,2,100.0,1,2,3,2,1,0,0,0,1,3
../kbl_data/2024-2025,S45G01N197,원주 DB,Home,김훈,0,0,0,0.0,0,0,0.0,0,0,0.0,0,0,0.0,0,0,0,0,0,0,0,0,0,0
../kbl_data/2024-2025,S45G01N197,원주 DB,Home,이용우,0,0,0,0.0,0,0,0.0,0,0,0.0,0,0,0.0,0,0,0,0,0,0,0,0,0,0
../kbl_data/2024-2025,S45G01N197,원주 DB,Home,오마리 스펠맨,21,7,13,53.8,1,6,16.7,8,19,42.1,4,6,66.7,5,10,15,1,2,1,0,1,3,3
../kbl_data/2024-2025,S45G01N197,원주 DB,Home,이선 알바노,25,6,10,60.0,2,8,25.0,8,18,44.4,7,8,87.5,3,4,7,9,1,1,0,0,2,1
../kbl_data/2024-2025,S45G01N197,원주 DB,Home,로버트 카터,0,0,0,0.0,0,1,0.0,0,1,0.0,0,0,0.0,0,2,2,1,0,0,0,0,0,0
../kbl_data/2024-2025,S45G01N197,고양 소노,Away,정희재,2,1,1,100.0,0,2,0.0,1,3,33.3,0,0,0.0,0,1,1,0,0,0,1,0,0,3
../kbl_data/2024-2025,S45G01N197,고양 소노,Away,임동섭,17,2,2,100.0,4,7,57.1,6,9,66.7,1,1,100.0,1,7,8,0,0,0,0,0,0,4
../kbl_data/2024-2025,S45G01N197,고양 소노,Away,이재도,6,0,2,0.0,2,4,50.0,2,6,33.3,0,0,0.0,1,3,4,7,0,0,0,0,1,2
../kbl_data/2024-2025,S45G01N197,고양 소노,Away,최승욱,3,1,1,100.0,0,0,0.0,1,1,100.0,1,1,100.0,1,0,1,2,0,0,0,0,1,0
../kbl_data/2024-2025,S45G01N197,고양 소노,Away,김진유,0,0,0,0.0,0,0,0.0,0,0,0.0,0,0,0.0,0,0,0,0,0,0,0,0,0,0
../kbl_data/2024-2025,S45G01N197,고양 소노,Away,이정현,2,0,2,0.0,0,5,0.0,0,7,0.0,2,2,100.0,0,1,1,1,1,0,0,0,4,3
../kbl_data/2024-2025,S45G01N197,고양 소노,Away,박종하,13,2,3,66.7,2,4,50.0,4,7,57.1,3,3,100.0,0,1,1,0,1,0,0,0,0,5
../kbl_data/2024-2025,S45G01N197,고양 소노,Away,민기남,0,0,0,0.0,0,0,0.0,0,0,0.0,0,0,0.0,0,0,0,0,0,0,0,0,0,0
../kbl_data/2024-2025,S45G01N197,고양 소노,Away,앨런 윌리엄스,4,1,8,12.5,0,0,0.0,1,8,12.5,2,2,100.0,0,7,7,4,2,1,0,0,2,0
../kbl_data/2024-2025,S45G01N197,고양 소노,Away,디제이 번즈 Jr,14,7,12,58.3,0,1,0.0,7,13,53.8,0,0,0.0,2,4,6,3,2,0,0,0,1,2
../kbl_data/2024-2025,S45G01N197,고양 소노,Away,이근준,0,0,0,0.0,0,0,0.0,0,0,0.0,0,0,0.0,0,1,1,0,0,0,0,0,0,1
../kbl_data/2024-2025,S45G01N197,고양 소노,Away,케빈 켐바오,31,9,15,60.0,4,10,40.0,13,25,52.0,1,2,50.0,5,6,11,2,1,0,1,1,2,3
../kbl_data/2024-2025,S45G01N198,서울 삼성,Home,이정현,13,2,4,50.0,2,7,28.6,4,11,36.4,3,3,100.0,0,0,0,6,1,0,0,0,3,3
../kbl_data/2024-2025,S45G01N198,서울 삼성,Home,최현민,6,0,0,0.0,2,3,66.7,2,3,66.7,0,0,0.0,0,2,2,0,0,0,0,0,1,3
../kbl_data/2024-2025,S45G01N198,서울 삼성,Home,이원대,0,0,1,0.0,0,0,0.0,0,1,0.0,0,0,0.0,1,1,2,1,0,0,0,0,1,1
../kbl_data/2024-2025,S45G01N198,서울 삼성,Home,최성모,2,0,1,0.0,0,6,0.0,0,7,0.0,2,2,100.0,1,1,2,4,0,0,0,0,0,3
../kbl_data/2024-2025,S45G01N198,서울 삼성,Home,최승욱,4,2,3,66.7,0,1,0.0,2,4,50.0,0,0,0.0,0,1,1,0,0,1,0,0,0,1
../kbl_data/2024-2025,S45G01N198,서울 삼성,Home,윤성원,0,0,0,0.0,0,0,0.0,0,0,0.0,0,0,0.0,0,0,0,0,0,0,0,0,0,0
../kbl_data/2024-2025,S45G01N198,서울 삼성,Home,차민석,0,0,0,0.0,0,0,0.0,0,0,0.0,0,0,0.0,0,0,0,0,0,0,0,0,0,0
../kbl_data/2024-2025,S45G01N198,서울 삼성,Home,이원석,8,2,3,66.7,1,1,100.0,3,4,75.0,1,2,50.0,3,1,4,0,0,0,1,0,2,2
../kbl_data/2024-2025,S45G01N198,서울 삼성,Home,저스틴 구탕,1,0,4,0.0,0,1,0.0,0,5,0.0,1,4,25.0,1,5,6,0,3,1,0,0,0,2
../kbl_data/2024-2025,S45G01N198,서울 삼성,Home,박승재,5,1,1,100.0,1,1,100.0,2,2,100.0,0,0,0.0,0,3,3,2,1,0,0,0,0,1
../kbl_data/2024-2025,S45G01N198,서울 삼성,Home,코피 코번,20,9,23,39.1,0,0,0.0,9,23,39.1,2,4,50.0,11,5,16,0,2,0,0,2,1,2
../kbl_data/2024-2025,S45G01N198,서울 삼성,Home,글렌 로빈슨 3세,4,1,4,25.0,0,1,0.0,1,5,20.0,2,2,100.0,0,0,0,0,0,1,0,0,2,2
../kbl_data/2024-2025,S45G01N198,대구 한국가스공사,Away,김동량,0,0,0,0.0,0,0,0.0,0,0,0.0,0,0,0.0,0,0,0,0,0,0,0,0,0,0
../kbl_data/2024-2025,S45G01N198,대구 한국가스공사,Away,차바위,3,0,0,0.0,1,2,50.0,1,2,50.0,0,0,0.0,0,2,2,1,0,0,0,0,0,1
../kbl_data/2024-2025,S45G01N198,대구 한국가스공사,Away,박지훈,2,1,2,50.0,0,1,0.0,1,3,33.3,0,0,0.0,1,2,3,2,1,1,0,0,1,5
../kbl_data/2024-2025,S45G01N198,대구 한국가스공사,Away,김준일,7,3,7,42.9,0,1,0.0,3,8,37.5,1,2,50.0,3,4,7,1,1,0,0,0,2,4
../kbl_data/2024-2025,S45G01N198,대구 한국가스공사,Away,정성우,2,1,3,33.3,0,2,0.0,1,5,20.0,0,0,0.0,0,2,2,1,1,0,0,0,2,1
../kbl_data/2024-2025,S45G01N198,대구 한국가스공사,Away,김낙현,0,0,0,0.0,0,4,0.0,0,4,0.0,0,0,0.0,0,3,3,1,0,0,0,0,1,1
../kbl_data/2024-2025,S45G01N198,대구 한국가스공사,Away,전현우,2,1,2,50.0,0,2,0.0,1,4,25.0,0,0,0.0,0,2,2,1,0,0,0,0,1,2
../kbl_data/2024-2025,S45G01N198,대구 한국가스공사,Away,양재혁,0,0,0,0.0,0,0,0.0,0,0,0.0,0,0,0.0,0,0,0,0,0,0,0,0,1,0
../kbl_data/2024-2025,S45G01N198,대구 한국가스공사,Away,앤드류 니콜슨,37,7,9,77.8,6,10,60.0,13,19,68.4,5,6,83.3,2,7,9,1,0,3,0,0,1,2
../kbl_data/2024-2025,S45G01N198,대구 한국가스공사,Away,신승민,3,1,2,50.0,0,1,0.0,1,3,33.3,1,2,50.0,0,0,0,1,0,0,0,0,1,0
../kbl_data/2024-2025,S45G01N198,대구 한국가스공사,Away,샘조세프 벨란겔,8,0,2,0.0,2,3,66.7,2,5,40.0,2,2,100.0,2,2,4,2,2,0,2,0,3,2
../kbl_data/2024-2025,S45G01N198,대구 한국가스공사,Away,유슈 은도예,2,1,2,50.0,0,1,0.0,1,3,33.3,0,0,0.0,2,2,4,0,0,0,0,0,1,2
../kbl_data/2024-2025,S45G01N199,창원 LG,Home,허일영,10,2,3,66.7,1,3,33.3,3,6,50.0,3,5,60.0,4,1,5,0,0,0,0,0,0,3
../kbl_data/2024-2025,S45G01N199,창원 LG,Home,최진수,0,0,1,0.0,0,0,0.0,0,1,0.0,0,0,0.0,0,2,2,0,1,0,0,0,1,0
../kbl_data/2024-2025,S45G01N199,창원 LG,Home,전성현,0,0,2,0.0,0,5,0.0,0,7,0.0,0,0,0.0,2,0,2,0,0,0,0,0,1,1
../kbl_data/2024-2025,S45G01N199,창원 LG,Home,정인덕,5,1,4,25.0,1,4,25.0,2,8,25.0,0,0,0.0,1,2,3,0,1,0,0,0,1,2
../kbl_data/2024-2025,S45G01N199,창원 LG,Home,대릴 먼로,12,6,10,60.0,0,1,0.0,6,11,54.5,0,0,0.0,8,7,15,2,1,1,0,1,2,2
../kbl_data/2024-2025,S45G01N199,창원 LG,Home,박정현,0,0,0,0.0,0,0,0.0,0,0,0.0,0,0,0.0,0,0,0,0,0,0,0,0,0,0
../kbl_data/2024-2025,S45G01N199,창원 LG,Home,아셈 마레이,9,4,6,66.7,0,0,0.0,4,6,66.7,1,3,33.3,2,8,10,2,0,0,0,0,3,2
../kbl_data/2024-2025,S45G01N199,창원 LG,Home,김종호,0,0,1,0.0,0,0,0.0,0,1,0.0,0,0,0.0,0,0,0,0,0,0,0,0,0,0
../kbl_data/2024-2025,S45G01N199,창원 LG,Home,양준석,5,2,4,50.0,0,9,0.0,2,13,15.4,1,2,50.0,3,5,8,5,2,0,0,0,4,1
../kbl_data/2024-2025,S45G01N199,창원 LG,Home,이경도,0,0,0,0.0,0,0,0.0,0,0,0.0,0,0,0.0,0,0,0,0,0,0,0,0,1,0
../kbl_data/2024-2025,S45G01N199,창원 LG,Home,칼 타마요,14,5,15,33.3,1,3,33.3,6,18,33.3,1,2,50.0,3,3,6,2,0,0,0,0,3,4
../kbl_data/2024-2025,S45G01N199,창원 LG,Home,최형찬,0,0,0,0.0,0,3,0.0,0,3,0.0,0,0,0.0,0,0,0,0,0,0,0,0,0,1
../kbl_data/2024-2025,S45G01N199,안양 정관장,Away,정준원,0,0,0,0.0,0,0,0.0,0,0,0.0,0,0,0.0,0,0,0,0,0,0,0,0,0,0
../kbl_data/2024-2025,S45G01N199,안양 정관장,Away,김영현,4,0,1,0.0,1,1,100.0,1,2,50.0,1,2,50.0,0,0,0,0,1,0,0,0,0,0
../kbl_data/2024-2025,S45G01N199,안양 정관장,Away,이종현,0,0,0,0.0,0,0,0.0,0,0,0.0,0,0,0.0,0,0,0,0,0,0,0,0,0,0
../kbl_data/2024-2025,S45G01N199,안양 정관장,Away,박지훈,4,2,5,40.0,0,2,0.0,2,7,28.6,0,0,0.0,1,1,2,5,1,0,0,0,2,3
../kbl_data/2024-2025,S45G01N199,안양 정관장,Away,디온테 버튼,5,2,4,50.0,0,3,0.0,2,7,28.6,1,2,50.0,1,8,9,4,2,1,0,0,1,0
../kbl_data/2024-2025,S45G01N199,안양 정관장,Away,김준형,0,0,0,0.0,0,0,0.0,0,0,0.0,0,0,0.0,0,0,0,0,0,0,0,0,0,0
../kbl_data/2024-2025,S45G01N199,안양 정관장,Away,변준형,7,2,3,66.7,1,3,33.3,3,6,50.0,0,0,0.0,0,3,3,4,0,0,0,0,1,3
../kbl_data/2024-2025,S45G01N199,안양 정관장,Away,김경원,7,2,4,50.0,1,1,100.0,3,5,60.0,0,1,0.0,0,3,3,1,0,3,0,0,1,1
../kbl_data/2024-2025,S45G01N199,안양 정관장,Away,한승희,6,1,7,14.3,0,2,0.0,1,9,11.1,4,4,100.0,3,4,7,1,0,0,1,0,0,3
../kbl_data/2024-2025,S45G01N199,안양 정관장,Away,조니 오브라이언트,10,4,8,50.0,0,3,0.0,4,11,36.4,2,4,50.0,0,3,3,0,2,0,0,0,1,1
../kbl_data/2024-2025,S45G01N199,안양 정관장,Away,하비 고메즈,19,3,6,50.0,4,8,50.0,7,14,50.0,1,2,50.0,4,3,7,2,1,0,0,0,1,2
../kbl_data/2024-2025,S45G01N199,안양 정관장,Away,소준혁,8,1,1,100.0,2,3,66.7,3,4,75.0,0,0,0.0,0,2,2,2,0,1,0,0,1,3
../kbl_data/2024-2025,S45G01N200,서울 SK,Home,김선형,8,1,5,20.0,2,6,33.3,3,11,27.3,0,2,0.0,0,3,3,5,0,1,0,0,4,2
../kbl_data/2024-2025,S45G01N200,서울 SK,Home,오세근,10,3,5,60.0,1,4,25.0,4,9,44.4,1,2,50.0,2,2,4,1,0,1,0,0,0,1
../kbl_data/2024-2025,S45G01N200,서울 SK,Home,최부경,4,2,2,100.0,0,1,0.0,2,3,66.7,0,0,0.0,1,2,3,2,2,0,0,0,1,1
../kbl_data/2024-2025,S45G01N200,서울 SK,Home,최원혁,1,0,0,0.0,0,0,0.0,0,0,0.0,1,2,50.0,0,2,2,0,0,0,0,0,0,0
../kbl_data/2024-2025,S45G01N200,서울 SK,Home,김지후,0,0,0,0.0,0,0,0.0,0,0,0.0,0,0,0.0,0,0,0,0,0,0,0,0,0,0
../kbl_data/2024-2025,S45G01N200,서울 SK,Home,안영준,21,5,7,71.4,3,5,60.0,8,12,66.7,2,4,50.0,5,3,8,3,4,0,0,0,2,4
../kbl_data/2024-2025,S45G01N200,서울 SK,Home,자밀 워니,21,10,19,52.6,0,4,0.0,10,23,43.5,1,6,16.7,4,10,14,3,2,0,0,1,1,4
../kbl_data/2024-2025,S45G01N200,서울 SK,Home,김형빈,0,0,0,0.0,0,0,0.0,0,0,0.0,0,0,0.0,0,0,0,0,0,0,0,0,0,0
../kbl_data/2024-2025,S45G01N200,서울 SK,Home,아이재아 힉스,4,2,2,100.0,0,0,0.0,2,2,100.0,0,0,0.0,1,0,1,1,0,0,0,0,0,2
../kbl_data/2024-2025,S45G01N200,서울 SK,Home,오재현,14,5,8,62.5,0,2,0.0,5,10,50.0,4,4,100.0,1,4,5,0,1,0,0,0,0,2
../kbl_data/2024-2025,S45G01N200,서울 SK,Home,고메즈 델 리아노,0,0,0,0.0,0,0,0.0,0,0,0.0,0,0,0.0,0,0,0,0,0,0,0,0,0,0
../kbl_data/2024-2025,S45G01N200,서울 SK,Home,김태훈,2,1,1,100.0,0,2,0.0,1,3,33.3,0,0,0.0,0,1,1,0,1,0,0,0,0,3
../kbl_data/2024-2025,S45G01N200,부산 KCC,Away,정창영,2,1,1,100.0,0,0,0.0,1,1,100.0,0,0,0.0,0,1,1,1,1,0,0,0,2,5
../kbl_data/2024-2025,S45G01N200,부산 KCC,Away,전준범,3,0,0,0.0,1,3,33.3,1,3,33.3,0,0,0.0,0,2,2,1,0,0,0,0,0,2
../kbl_data/2024-2025,S45G01N200,부산 KCC,Away,허웅,27,6,12,50.0,3,12,25.0,9,24,37.5,6,6,100.0,1,3,4,7,3,0,0,0,6,2
../kbl_data/2024-2025,S45G01N200,부산 KCC,Away,이승현,6,3,7,42.9,0,0,0.0,3,7,42.9,0,0,0.0,0,10,10,2,1,1,0,0,1,3
../kbl_data/2024-2025,S45G01N200,부산 KCC,Away,이호현,4,0,3,0.0,0,0,0.0,0,3,0.0,4,4,100.0,0,1,1,1,0,0,0,0,1,5
../kbl_data/2024-2025,S45G01N200,부산 KCC,Away,전태영,0,0,0,0.0,0,0,0.0,0,0,0.0,0,0,0.0,0,0,0,0,0,0,0,0,0,0
../kbl_data/2024-2025,S45G01N200,부산 KCC,Away,캐디 라렌,24,10,13,76.9,0,3,0.0,10,16,62.5,4,5,80.0,4,7,11,1,0,1,0,1,4,2
../kbl_data/2024-2025,S45G01N200,부산 KCC,Away,이근휘,0,0,1,0.0,0,1,0.0,0,2,0.0,0,0,0.0,2,0,2,0,0,0,0,0,0,0
../kbl_data/2024-2025,S45G01N200,부산 KCC,Away,캘빈 제프리 에피스톨라,0,0,0,0.0,0,0,0.0,0,0,0.0,0,0,0.0,0,0,0,0,0,0,0,0,0,0
../kbl_data/2024-2025,S45G01N200,부산 KCC,Away,이주영,11,4,5,80.0,1,3,33.3,5,8,62.5,0,0,0.0,0,0,0,3,0,0,0,0,2,2
../kbl_data/2024-2025,S45G01N200,부산 KCC,Away,이찬영,0,0,0,0.0,0,0,0.0,0,0,0.0,0,0,0.0,0,0,0,0,0,0,0,0,0,0
../kbl_data/2024-2025,S45G01N200,부산 KCC,Away,도노반 스미스,0,0,1,0.0,0,0,0.0,0,1,0.0,0,0,0.0,0,0,0,1,0,1,0,0,0,1
../kbl_data/2024-2025,S45G01N201,울산 현대모비스,Home,함지훈,6,1,1,100.0,1,2,50.0,2,3,66.7,1,2,50.0,1,2,3,2,0,0,0,0,1,2
../kbl_data/2024-2025,S45G01N201,울산 현대모비스,Home,장재석,0,0,0,0.0,0,0,0.0,0,0,0.0,0,0,0.0,0,0,0,0,0,0,0,0,0,0
../kbl_data/2024-2025,S45G01N201,울산 현대모비스,Home,이대헌,7,2,4,50.0,1,1,100.0,3,5,60.0,0,0,0.0,2,2,4,1,0,0,1,0,2,0
../kbl_data/2024-2025,S45G01N201,울산 현대모비스,Home,한호빈,3,0,1,0.0,1,4,25.0,1,5,20.0,0,0,0.0,0,1,1,0,0,0,0,0,0,2
../kbl_data/2024-2025,S45G01N201,울산 현대모비스,Home,김국찬,2,0,0,0.0,0,1,0.0,0,1,0.0,2,2,100.0,0,0,0,2,1,1,0,0,1,1
../kbl_data/2024-2025,S45G01N201,울산 현대모비스,Home,서명진,2,1,1,100.0,0,4,0.0,1,5,20.0,0,0,0.0,1,5,6,2,0,0,0,0,2,3
../kbl_data/2024-2025,S45G01N201,울산 현대모비스,Home,숀 롱,14,7,11,63.6,0,1,0.0,7,12,58.3,0,1,0.0,2,2,4,3,1,3,0,3,3,2
../kbl_data/2024-2025,S45G01N201,울산 현대모비스,Home,이우석,2,1,4,25.0,0,2,0.0,1,6,16.7,0,0,0.0,0,5,5,4,0,0,0,0,2,0
../kbl_data/2024-2025,S45G01N201,울산 현대모비스,Home,신민석,0,0,0,0.0,0,1,0.0,0,1,0.0,0,0,0.0,0,2,2,1,1,0,0,0,0,1
../kbl_data/2024-2025,S45G01N201,울산 현대모비스,Home,게이지 프림,12,6,14,42.9,0,0,0.0,6,14,42.9,0,0,0.0,1,4,5,0,1,0,0,0,2,0
../kbl_data/2024-2025,S45G01N201,울산 현대모비스,Home,박무빈,8,1,1,100.0,2,3,66.7,3,4,75.0,0,0,0.0,0,1,1,4,1,0,1,0,1,3
../kbl_data/2024-2025,S45G01N201,울산 현대모비스,Home,미구엘 안드레 옥존,0,0,2,0.0,0,2,0.0,0,4,0.0,0,0,0.0,1,0,1,2,0,0,0,0,1,0
../kbl_data/2024-2025,S45G01N201,수원 KT,Away,문성곤,2,1,2,50.0,0,3,0.0,1,5,20.0,0,0,0.0,4,3,7,1,2,1,0,0,0,3
../kbl_data/2024-2025,S45G01N201,수원 KT,Away,이현석,0,0,0,0.0,0,0,0.0,0,0,0.0,0,0,0.0,0,3,3,1,0,0,0,0,0,2
../kbl_data/2024-2025,S45G01N201,수원 KT,Away,허훈,12,3,7,42.9,2,6,33.3,5,13,38.5,0,0,0.0,1,3,4,2,2,0,0,0,4,2
../kbl_data/2024-2025,S45G01N201,수원 KT,Away,최진광,0,0,0,0.0,0,0,0.0,0,0,0.0,0,0,0.0,0,0,0,0,0,0,0,0,0,0
../kbl_data/2024-2025,S45G01N201,수원 KT,Away,이윤기,0,0,0,0.0,0,0,0.0,0,0,0.0,0,0,0.0,0,0,0,0,0,0,0,0,0,0
../kbl_data/2024-2025,S45G01N201,수원 KT,Away,하윤기,9,3,8,37.5,0,0,0.0,3,8,37.5,3,4,75.0,2,2,4,0,0,0,0,0,2,3
../kbl_data/2024-2025,S45G01N201,수원 KT,Away,이두원,3,0,0,0.0,1,2,50.0,1,2,50.0,0,0,0.0,0,2,2,0,0,0,0,0,0,1
../kbl_data/2024-2025,S45G01N201,수원 KT,Away,문정현,2,1,5,20.0,0,3,0.0,1,8,12.5,0,0,0.0,5,2,7,1,2,0,0,0,0,1
../kbl_data/2024-2025,S45G01N201,수원 KT,Away,레이션 해먼즈,8,3,6,50.0,0,3,0.0,3,9,33.3,2,2,100.0,1,1,2,3,4,0,0,1,2,2
../kbl_data/2024-2025,S45G01N201,수원 KT,Away,박성재,11,1,3,33.3,3,3,100.0,4,6,66.7,0,0,0.0,0,1,1,1,0,0,0,0,4,0
../kbl_data/2024-2025,S45G01N201,수원 KT,Away,조던 모건,12,6,14,42.9,0,1,0.0,6,15,40.0,0,0,0.0,4,8,12,0,0,1,0,0,0,0
../kbl_data/2024-2025,S45G01N201,수원 KT,Away,조엘 카굴랑안,3,0,1,0.0,1,3,33.3,1,4,25.0,0,0,0.0,1,2,3,3,2,0,0,0,0,0
../kbl_data/2024-2025,S45G01N202,고양 소노,Home,정희재,2,1,1,100.0,0,1,0.0,1,2,50.0,0,0,0.0,0,1,1,0,0,0,1,0,0,2
../kbl_data/2024-2025,S45G01N202,고양 소노,Home,임동섭,9,0,2,0.0,3,6,50.0,3,8,37.5,0,0,0.0,0,5,5,1,0,0,0,0,1,3
../kbl_data/2024-2025,S45G01N202,고양 소노,Home,이재도,5,2,3,66.7,0,4,0.0,2,7,28.6,1,1,100.0,0,2,2,4,1,0,0,0,2,5
../kbl_data/2024-2025,S45G01N202,고양 소노,Home,최승욱,7,2,2,100.0,0,0,0.0,2,2,100.0,3,4,75.0,1,2,3,1,0,0,0,0,0,0
../kbl_data/2024-2025,S45G01N202,고양 소노,Home,김진유,2,1,1,100.0,0,0,0.0,1,1,100.0,0,0,0.0,0,0,0,0,1,0,0,0,0,0
../kbl_data/2024-2025,S45G01N202,고양 소노,Home,이정현,14,4,8,50.0,2,6,33.3,6,14,42.9,0,0,0.0,0,1,1,4,3,0,1,0,3,1
../kbl_data/2024-2025,S45G01N202,고양 소노,Home,박종하,0,0,0,0.0,0,0,0.0,0,0,0.0,0,0,0.0,0,0,0,1,0,0,0,0,0,1
../kbl_data/2024-2025,S45G01N202,고양 소노,Home,민기남,0,0,0,0.0,0,0,0.0,0,0,0.0,0,0,0.0,0,0,0,0,0,0,0,0,0,0
../kbl_data/2024-2025,S45G01N202,고양 소노,Home,앨런 윌리엄스,17,7,13,53.8,0,0,0.0,7,13,53.8,3,4,75.0,2,4,6,6,2,1,0,0,3,1
../kbl_data/2024-2025,S45G01N202,고양 소노,Home,디제이 번즈 Jr,6,2,3,66.7,0,0,0.0,2,3,66.7,2,2,100.0,0,3,3,0,1,0,0,0,1,3
../kbl_data/2024-2025,S45G01N202,고양 소노,Home,이근준,0,0,0,0.0,0,0,0.0,0,0,0.0,0,0,0.0,0,0,0,0,0,0,0,0,0,0
../kbl_data/2024-2025,S45G01N202,고양 소노,Home,케빈 켐바오,17,4,9,44.4,3,8,37.5,7,17,41.2,0,0,0.0,1,5,6,4,2,0,0,3,3,0
../kbl_data/2024-2025,S45G01N202,대구 한국가스공사,Away,차바위,0,0,0,0.0,0,1,0.0,0,1,0.0,0,0,0.0,0,1,1,0,0,0,0,0,0,1
../kbl_data/2024-2025,S45G01N202,대구 한국가스공사,Away,박지훈,9,3,4,75.0,1,4,25.0,4,8,50.0,0,0,0.0,0,2,2,1,0,0,0,0,0,3
../kbl_data/2024-2025,S45G01N202,대구 한국가스공사,Away,김준일,2,1,3,33.3,0,0,0.0,1,3,33.3,0,0,0.0,1,5,6,8,0,2,0,0,4,0
../kbl_data/2024-2025,S45G01N202,대구 한국가스공사,Away,정성우,0,0,0,0.0,0,1,0.0,0,1,0.0,0,0,0.0,0,0,0,0,0,0,0,0,1,3
../kbl_data/2024-2025,S45G01N202,대구 한국가스공사,Away,김낙현,19,5,8,62.5,2,7,28.6,7,15,46.7,3,3,100.0,2,1,3,3,1,1,0,0,1,1
../kbl_data/2024-2025,S45G01N202,대구 한국가스공사,Away,우동현,0,0,0,0.0,0,0,0.0,0,0,0.0,0,0,0.0,0,0,0,0,0,0,0,0,0,0
../kbl_data/2024-2025,S45G01N202,대구 한국가스공사,Away,양재혁,2,1,1,100.0,0,0,0.0,1,1,100.0,0,0,0.0,0,2,2,0,0,0,0,0,1,1
../kbl_data/2024-2025,S45G01N202,대구 한국가스공사,Away,곽정훈,0,0,0,0.0,0,0,0.0,0,0,0.0,0,0,0.0,0,0,0,0,0,0,0,0,0,0
../kbl_data/2024-2025,S45G01N202,대구 한국가스공사,Away,앤드류 니콜슨,20,3,7,42.9,4,8,50.0,7,15,46.7,2,2,100.0,0,9,9,2,1,0,0,0,5,3
../kbl_data/2024-2025,S45G01N202,대구 한국가스공사,Away,신승민,17,5,5,100.0,2,4,50.0,7,9,77.8,1,1,100.0,1,5,6,2,0,0,0,0,1,3
../kbl_data/2024-2025,S45G01N202,대구 한국가스공사,Away,샘조세프 벨란겔,19,6,7,85.7,2,5,40.0,8,12,66.7,1,1,100.0,0,2,2,8,2,0,1,0,3,3
../kbl_data/2024-2025,S45G01N202,대구 한국가스공사,Away,유슈 은도예,0,0,0,0.0,0,0,0.0,0,0,0.0,0,0,0.0,0,3,3,1,0,0,0,0,0,1
../kbl_data/2024-2025,S45G01N203,원주 DB,Home,이관희,7,1,2,50.0,1,4,25.0,2,6,33.3,2,2,100.0,0,2,2,1,0,0,0,0,1,1
../kbl_data/2024-2025,S45G01N203,원주 DB,Home,김시래,0,0,1,0.0,0,1,0.0,0,2,0.0,0,0,0.0,0,2,2,0,0,0,0,0,1,1
../kbl_data/2024-2025,S45G01N203,원주 DB,Home,서민수,0,0,0,0.0,0,0,0.0,0,0,0.0,0,0,0.0,0,1,1,0,0,1,0,0,0,1
../kbl_data/2024-2025,S45G01N203,원주 DB,Home,정효근,18,6,7,85.7,2,7,28.6,8,14,57.1,0,4,0.0,2,7,9,0,1,1,0,0,2,4
../kbl_data/2024-2025,S45G01N203,원주 DB,Home,박봉진,0,0,0,0.0,0,0,0.0,0,0,0.0,0,0,0.0,0,0,0,0,0,0,0,0,0,0
../kbl_data/2024-2025,S45G01N203,원주 DB,Home,강상재,7,2,4,50.0,1,2,50.0,3,6,50.0,0,0,0.0,1,4,5,1,0,0,1,0,0,3
../kbl_data/2024-2025,S45G01N203,원주 DB,Home,최성원,0,0,1,0.0,0,0,0.0,0,1,0.0,0,0,0.0,0,1,1,1,0,0,0,0,0,0
../kbl_data/2024-2025,S45G01N203,원주 DB,Home,김훈,0,0,0,0.0,0,0,0.0,0,0,0.0,0,0,0.0,0,0,0,0,0,0,0,0,0,0
../kbl_data/2024-2025,S45G01N203,원주 DB,Home,이용우,0,0,0,0.0,0,1,0.0,0,1,0.0,0,0,0.0,2,1,3,1,0,1,0,0,0,1
../kbl_data/2024-2025,S45G01N203,원주 DB,Home,오마리 스펠맨,12,3,9,33.3,1,6,16.7,4,15,26.7,3,6,50.0,1,9,10,4,2,2,0,0,3,2
../kbl_data/2024-2025,S45G01N203,원주 DB,Home,이선 알바노,23,7,10,70.0,2,3,66.7,9,13,69.2,3,5,60.0,0,4,4,4,1,0,0,0,4,2
../kbl_data/2024-2025,S45G01N203,원주 DB,Home,로버트 카터,0,0,1,0.0,0,2,0.0,0,3,0.0,0,0,0.0,1,2,3,1,0,1,0,0,1,0
../kbl_data/2024-2025,S45G01N203,창원 LG,Away,허일영,0,0,1,0.0,0,4,0.0,0,5,0.0,0,0,0.0,0,2,2,1,1,0,1,0,0,3
../kbl_data/2024-2025,S45G01N203,창원 LG,Away,최진수,0,0,0,0.0,0,1,0.0,0,1,0.0,0,0,0.0,0,0,0,1,0,0,0,0,0,2
../kbl_data/2024-2025,S45G01N203,창원 LG,Away,전성현,8,1,3,33.3,2,9,22.2,3,12,25.0,0,0,0.0,1,1,2,4,0,0,0,0,1,1
../kbl_data/2024-2025,S45G01N203,창원 LG,Away,정인덕,8,1,4,25.0,2,5,40.0,3,9,33.3,0,0,0.0,3,4,7,3,0,0,1,0,1,0
../kbl_data/2024-2025,S45G01N203,창원 LG,Away,대릴 먼로,4,1,6,16.7,0,0,0.0,1,6,16.7,2,3,66.7,4,6,10,1,1,0,0,0,3,2
../kbl_data/2024-2025,S45G01N203,창원 LG,Away,박정현,0,0,0,0.0,0,0,0.0,0,0,0.0,0,0,0.0,0,0,0,0,0,0,0,0,0,0
../kbl_data/2024-2025,S45G01N203,창원 LG,Away,아셈 마레이,9,3,9,33.3,0,0,0.0,3,9,33.3,3,4,75.0,3,9,12,1,0,0,0,1,2,5
../kbl_data/2024-2025,S45G01N203,창원 LG,Away,김종호,0,0,0,0.0,0,0,0.0,0,0,0.0,0,0,0.0,0,0,0,0,0,0,0,0,0,0
../kbl_data/2024-2025,S45G01N203,창원 LG,Away,양준석,0,0,4,0.0,0,1,0.0,0,5,0.0,0,0,0.0,3,1,4,6,0,0,0,0,1,2
../kbl_data/2024-2025,S45G01N203,창원 LG,Away,이경도,0,0,2,0.0,0,1,0.0,0,3,0.0,0,0,0.0,0,0,0,0,0,1,0,0,0,2
../kbl_data/2024-2025,S45G01N203,창원 LG,Away,칼 타마요,34,9,15,60.0,4,11,36.4,13,26,50.0,4,4,100.0,3,5,8,2,3,0,0,1,2,1
../kbl_data/2024-2025,S45G01N203,창원 LG,Away,최형찬,0,0,0,0.0,0,0,0.0,0,0,0.0,0,0,0.0,0,0,0,0,0,0,0,0,0,1
../kbl_data/2024-2025,S45G01N204,서울 삼성,Home,이정현,5,1,5,20.0,1,6,16.7,2,11,18.2,0,0,0.0,1,1,2,7,0,0,0,0,1,2
../kbl_data/2024-2025,S45G01N204,서울 삼성,Home,최현민,1,0,0,0.0,0,0,0.0,0,0,0.0,1,2,50.0,1,2,3,1,0,0,0,0,1,1
../kbl_data/2024-2025,S45G01N204,서울 삼성,Home,이원대,0,0,0,0.0,0,0,0.0,0,0,0.0,0,0,0.0,0,1,1,1,0,0,0,0,0,0
../kbl_data/2024-2025,S45G01N204,서울 삼성,Home,최성모,14,1,2,50.0,4,7,57.1,5,9,55.6,0,0,0.0,2,1,3,2,1,0,0,0,4,2
../kbl_data/2024-2025,S45G01N204,서울 삼성,Home,최승욱,5,1,2,50.0,1,1,100.0,2,3,66.7,0,0,0.0,1,1,2,2,1,0,0,0,0,1
../kbl_data/2024-2025,S45G01N204,서울 삼성,Home,윤성원,0,0,0,0.0,0,0,0.0,0,0,0.0,0,0,0.0,0,0,0,0,0,0,0,0,0,0
../kbl_data/2024-2025,S45G01N204,서울 삼성,Home,차민석,0,0,0,0.0,0,0,0.0,0,0,0.0,0,0,0.0,0,0,0,0,0,0,0,0,0,0
../kbl_data/2024-2025,S45G01N204,서울 삼성,Home,이원석,14,3,9,33.3,2,3,66.7,5,12,41.7,2,3,66.7,4,5,9,2,1,0,0,0,1,1
../kbl_data/2024-2025,S45G01N204,서울 삼성,Home,저스틴 구탕,8,2,2,100.0,1,3,33.3,3,5,60.0,1,1,100.0,1,4,5,1,0,0,0,0,2,2
../kbl_data/2024-2025,S45G01N204,서울 삼성,Home,박승재,0,0,0,0.0,0,0,0.0,0,0,0.0,0,0,0.0,0,0,0,0,0,0,0,0,0,1
../kbl_data/2024-2025,S45G01N204,서울 삼성,Home,코피 코번,21,9,15,60.0,0,0,0.0,9,15,60.0,3,5,60.0,1,4,5,1,1,0,0,0,5,3
../kbl_data/2024-2025,S45G01N204,서울 삼성,Home,글렌 로빈슨 3세,8,3,5,60.0,0,5,0.0,3,10,30.0,2,2,100.0,0,1,1,1,1,1,0,0,2,2
../kbl_data/2024-2025,S45G01N204,안양 정관장,Away,정준원,6,3,3,100.0,0,2,0.0,3,5,60.0,0,0,0.0,1,0,1,0,0,1,0,0,1,0
../kbl_data/2024-2025,S45G01N204,안양 정관장,Away,김영현,0,0,0,0.0,0,0,0.0,0,0,0.0,0,0,0.0,0,0,0,0,0,0,0,0,0,1
../kbl_data/2024-2025,S45G01N204,안양 정관장,Away,이종현,5,1,1,100.0,1,1,100.0,2,2,100.0,0,0,0.0,0,0,0,0,0,2,0,0,1,1
../kbl_data/2024-2025,S45G01N204,안양 정관장,Away,박지훈,15,7,12,58.3,0,0,0.0,7,12,58.3,1,2,50.0,1,3,4,8,3,1,0,0,1,3
../kbl_data/2024-2025,S45G01N204,안양 정관장,Away,디온테 버튼,0,0,2,0.0,0,2,0.0,0,4,0.0,0,2,0.0,0,1,1,1,0,0,0,0,1,3
../kbl_data/2024-2025,S45G01N204,안양 정관장,Away,김준형,0,0,0,0.0,0,0,0.0,0,0,0.0,0,0,0.0,0,0,0,0,0,0,0,0,0,0
../kbl_data/2024-2025,S45G01N204,안양 정관장,Away,변준형,7,3,6,50.0,0,2,0.0,3,8,37.5,1,2,50.0,0,1,1,8,2,0,2,0,0,2
../kbl_data/2024-2025,S45G01N204,안양 정관장,Away,김경원,0,0,0,0.0,0,0,0.0,0,0,0.0,0,0,0.0,0,0,0,0,0,0,0,0,0,0
../kbl_data/2024-2025,S45G01N204,안양 정관장,Away,한승희,6,3,4,75.0,0,1,0.0,3,5,60.0,0,0,0.0,1,3,4,3,0,1,1,0,1,2
../kbl_data/2024-2025,S45G01N204,안양 정관장,Away,조니 오브라이언트,28,7,9,77.8,4,6,66.7,11,15,73.3,2,2,100.0,1,10,11,3,2,0,0,0,4,4
../kbl_data/2024-2025,S45G01N204,안양 정관장,Away,하비 고메즈,22,2,2,100.0,6,12,50.0,8,14,57.1,0,0,0.0,2,2,4,1,2,0,0,0,0,2
../kbl_data/2024-2025,S45G01N204,안양 정관장,Away,소준혁,0,0,0,0.0,0,0,0.0,0,0,0.0,0,0,0.0,0,1,1,0,0,0,0,0,0,1
../kbl_data/2024-2025,S45G01N205,수원 KT,Home,문성곤,15,2,3,66.7,3,11,27.3,5,14,35.7,2,2,100.0,2,5,7,2,2,0,1,0,1,2
../kbl_data/2024-2025,S45G01N205,수원 KT,Home,이현석,0,0,0,0.0,0,0,0.0,0,0,0.0,0,0,0.0,0,0,0,0,0,0,0,0,0,0
../kbl_data/2024-2025,S45G01N205,수원 KT,Home,허훈,9,3,7,42.9,1,6,16.7,4,13,30.8,0,0,0.0,1,3,4,4,0,0,1,0,4,2
../kbl_data/2024-2025,S45G01N205,수원 KT,Home,이윤기,0,0,0,0.0,0,0,0.0,0,0,0.0,0,0,0.0,0,0,0,0,0,0,0,0,0,1
../kbl_data/2024-2025,S45G01N205,수원 KT,Home,박지원,0,0,0,0.0,0,0,0.0,0,0,0.0,0,0,0.0,0,0,0,0,0,0,0,0,0,0
../kbl_data/2024-2025,S45G01N205,수원 KT,Home,하윤기,7,3,4,75.0,0,0,0.0,3,4,75.0,1,1,100.0,5,1,6,2,1,0,0,2,0,1
../kbl_data/2024-2025,S45G01N205,수원 KT,Home,이두원,0,0,0,0.0,0,0,0.0,0,0,0.0,0,0,0.0,0,0,0,0,0,0,0,0,0,0
../kbl_data/2024-2025,S45G01N205,수원 KT,Home,문정현,14,5,6,83.3,1,3,33.3,6,9,66.7,1,3,33.3,2,4,6,4,0,1,0,0,2,3
../kbl_data/2024-2025,S45G01N205,수원 KT,Home,레이션 해먼즈,14,4,6,66.7,1,8,12.5,5,14,35.7,3,3,100.0,2,7,9,6,3,1,0,0,1,2
../kbl_data/2024-2025,S45G01N205,수원 KT,Home,박성재,2,0,0,0.0,0,0,0.0,0,0,0.0,2,2,100.0,1,1,2,1,0,0,0,0,0,0
../kbl_data/2024-2025,S45G01N205,수원 KT,Home,조던 모건,2,1,4,25.0,0,0,0.0,1,4,25.0,0,0,0.0,0,0,0,0,1,0,0,0,2,3
../kbl_data/2024-2025,S45G01N205,수원 KT,Home,조엘 카굴랑안,12,4,7,57.1,1,4,25.0,5,11,45.5,1,2,50.0,0,1,1,1,2,0,0,0,0,3
../kbl_data/2024-2025,S45G01N205,대구 한국가스공사,Away,김동량,0,0,1,0.0,0,0,0.0,0,1,0.0,0,0,0.0,0,0,0,0,0,0,0,0,0,0
../kbl_data/2024-2025,S45G01N205,대구 한국가스공사,Away,차바위,6,0,0,0.0,2,3,66.7,2,3,66.7,0,0,0.0,1,0,1,0,0,0,0,0,2,3
../kbl_data/2024-2025,S45G01N205,대구 한국가스공사,Away,박지훈,0,0,0,0.0,0,0,0.0,0,0,0.0,0,0,0.0,1,0,1,0,0,0,0,0,0,2
../kbl_data/2024-2025,S45G01N205,대구 한국가스공사,Away,김준일,8,4,8,50.0,0,0,0.0,4,8,50.0,0,0,0.0,5,3,8,2,0,1,0,0,2,2
../kbl_data/2024-2025,S45G01N205,대구 한국가스공사,Away,정성우,12,3,5,60.0,2,6,33.3,5,11,45.5,0,0,0.0,0,2,2,5,2,0,0,0,1,3
../kbl_data/2024-2025,S45G01N205,대구 한국가스공사,Away,김낙현,13,2,5,40.0,3,6,50.0,5,11,45.5,0,0,0.0,0,2,2,2,3,0,0,0,2,3
../kbl_data/2024-2025,S45G01N205,대구 한국가스공사,Away,전현우,0,0,1,0.0,0,0,0.0,0,1,0.0,0,0,0.0,1,0,1,1,0,0,0,0,0,0
../kbl_data/2024-2025,S45G01N205,대구 한국가스공사,Away,양재혁,0,0,0,0.0,0,0,0.0,0,0,0.0,0,0,0.0,0,0,0,0,0,0,0,0,1,0
../kbl_data/2024-2025,S45G01N205,대구 한국가스공사,Away,앤드류 니콜슨,17,2,7,28.6,4,5,80.0,6,12,50.0,1,1,100.0,0,8,8,0,0,1,0,0,3,1
../kbl_data/2024-2025,S45G01N205,대구 한국가스공사,Away,신승민,4,0,1,0.0,0,2,0.0,0,3,0.0,4,4,100.0,1,3,4,2,0,0,0,0,0,2
../kbl_data/2024-2025,S45G01N205,대구 한국가스공사,Away,샘조세프 벨란겔,10,2,5,40.0,2,4,50.0,4,9,44.4,0,2,0.0,1,4,5,3,2,0,0,0,2,2
../kbl_data/2024-2025,S45G01N205,대구 한국가스공사,Away,유슈 은도예,4,1,2,50.0,0,0,0.0,1,2,50.0,2,2,100.0,1,1,2,1,0,0,0,0,1,1
../kbl_data/2024-2025,S45G01N206,서울 삼성,Home,이정현,4,0,0,0.0,0,4,0.0,0,4,0.0,4,4,100.0,1,6,7,3,0,0,0,0,3,2
../kbl_data/2024-2025,S45G01N206,서울 삼성,Home,최현민,2,1,3,33.3,0,5,0.0,1,8,12.5,0,0,0.0,2,2,4,1,0,0,0,0,0,1
../kbl_data/2024-2025,S45G01N206,서울 삼성,Home,이원대,0,0,1,0.0,0,1,0.0,0,2,0.0,0,0,0.0,0,0,0,0,1,0,0,0,1,2
../kbl_data/2024-2025,S45G01N206,서울 삼성,Home,최성모,11,2,3,66.7,2,6,33.3,4,9,44.4,1,1,100.0,0,6,6,5,1,0,0,0,2,4
../kbl_data/2024-2025,S45G01N206,서울 삼성,Home,최승욱,0,0,0,0.0,0,0,0.0,0,0,0.0,0,0,0.0,0,0,0,0,0,0,0,0,0,0
../kbl_data/2024-2025,S45G01N206,서울 삼성,Home,윤성원,0,0,0,0.0,0,0,0.0,0,0,0.0,0,0,0.0,0,0,0,0,0,0,0,0,0,0
../kbl_data/2024-2025,S45G01N206,서울 삼성,Home,차민석,2,1,1,100.0,0,0,0.0,1,1,100.0,0,0,0.0,0,0,0,0,0,0,0,0,0,0
../kbl_data/2024-2025,S45G01N206,서울 삼성,Home,이원석,11,1,5,20.0,2,5,40.0,3,10,30.0,3,4,75.0,1,6,7,0,1,0,0,0,3,2
../kbl_data/2024-2025,S45G01N206,서울 삼성,Home,저스틴 구탕,8,4,7,57.1,0,4,0.0,4,11,36.4,0,0,0.0,1,3,4,3,0,0,0,1,2,3
../kbl_data/2024-2025,S45G01N206,서울 삼성,Home,박승재,0,0,0,0.0,0,0,0.0,0,0,0.0,0,0,0.0,0,0,0,0,0,0,0,0,0,0
../kbl_data/2024-2025,S45G01N206,서울 삼성,Home,코피 코번,18,8,15,53.3,0,0,0.0,8,15,53.3,2,3,66.7,6,5,11,1,0,0,0,1,3,1
../kbl_data/2024-2025,S45G01N206,서울 삼성,Home,글렌 로빈슨 3세,10,5,8,62.5,0,3,0.0,5,11,45.5,0,0,0.0,0,3,3,1,4,0,0,0,1,1
../kbl_data/2024-2025,S45G01N206,서울 SK,Away,김선형,10,4,8,50.0,0,2,0.0,4,10,40.0,2,2,100.0,0,2,2,6,3,0,0,0,1,1
../kbl_data/2024-2025,S45G01N206,서울 SK,Away,오세근,2,1,3,33.3,0,1,0.0,1,4,25.0,0,0,0.0,1,2,3,0,0,0,0,0,0,0
../kbl_data/2024-2025,S45G01N206,서울 SK,Away,최부경,1,0,0,0.0,0,2,0.0,0,2,0.0,1,2,50.0,1,2,3,0,1,0,0,0,0,4
../kbl_data/2024-2025,S45G01N206,서울 SK,Away,최원혁,0,0,0,0.0,0,0,0.0,0,0,0.0,0,0,0.0,0,0,0,2,0,0,0,0,0,3
../kbl_data/2024-2025,S45G01N206,서울 SK,Away,김지후,0,0,0,0.0,0,1,0.0,0,1,0.0,0,0,0.0,0,0,0,0,0,0,0,0,0,0
../kbl_data/2024-2025,S45G01N206,서울 SK,Away,안영준,9,2,7,28.6,1,8,12.5,3,15,20.0,2,2,100.0,1,4,5,5,0,1,0,0,2,2
../kbl_data/2024-2025,S45G01N206,서울 SK,Away,자밀 워니,26,7,13,53.8,3,7,42.9,10,20,50.0,3,4,75.0,1,7,8,4,3,1,0,1,2,1
../kbl_data/2024-2025,S45G01N206,서울 SK,Away,김형빈,0,0,0,0.0,0,0,0.0,0,0,0.0,0,0,0.0,0,1,1,0,1,0,0,0,0,0
../kbl_data/2024-2025,S45G01N206,서울 SK,Away,아이재아 힉스,4,1,3,33.3,0,1,0.0,1,4,25.0,2,2,100.0,1,1,2,1,1,0,0,1,1,0
../kbl_data/2024-2025,S45G01N206,서울 SK,Away,오재현,20,6,7,85.7,2,4,50.0,8,11,72.7,2,2,100.0,2,7,9,1,1,1,0,0,1,3
../kbl_data/2024-2025,S45G01N206,서울 SK,Away,고메즈 델 리아노,0,0,0,0.0,0,0,0.0,0,0,0.0,0,0,0.0,0,0,0,0,0,0,0,0,0,0
../kbl_data/2024-2025,S45G01N206,서울 SK,Away,김태훈,3,0,0,0.0,1,2,50.0,1,2,50.0,0,0,0.0,0,1,1,0,0,0,0,0,1,1
../kbl_data/2024-2025,S45G01N207,울산 현대모비스,Home,함지훈,0,0,0,0.0,0,0,0.0,0,0,0.0,0,0,0.0,0,0,0,0,0,0,0,0,0,0
../kbl_data/2024-2025,S45G01N207,울산 현대모비스,Home,장재석,4,2,4,50.0,0,0,0.0,2,4,50.0,0,0,0.0,0,1,1,1,1,2,0,0,0,0
../kbl_data/2024-2025,S45G01N207,울산 현대모비스,Home,이대헌,14,7,11,63.6,0,3,0.0,7,14,50.0,0,0,0.0,2,4,6,2,0,0,1,0,0,4
../kbl_data/2024-2025,S45G01N207,울산 현대모비스,Home,한호빈,2,1,2,50.0,0,3,0.0,1,5,20.0,0,0,0.0,1,0,1,4,1,0,0,0,1,4
../kbl_data/2024-2025,S45G01N207,울산 현대모비스,Home,김국찬,8,1,1,100.0,2,2,100.0,3,3,100.0,0,0,0.0,0,1,1,1,0,1,0,0,1,4
../kbl_data/2024-2025,S45G01N207,울산 현대모비스,Home,서명진,3,0,1,0.0,1,5,20.0,1,6,16.7,0,0,0.0,0,2,2,2,1,0,0,0,0,0
../kbl_data/2024-2025,S45G01N207,울산 현대모비스,Home,숀 롱,13,5,10,50.0,0,1,0.0,5,11,45.5,3,4,75.0,5,3,8,2,0,0,0,3,2,2
../kbl_data/2024-2025,S45G01N207,울산 현대모비스,Home,이우석,18,4,5,80.0,3,7,42.9,7,12,58.3,1,1,100.0,1,10,11,6,0,0,0,0,1,2
../kbl_data/2024-2025,S45G01N207,울산 현대모비스,Home,이승우,0,0,0,0.0,0,0,0.0,0,0,0.0,0,0,0.0,0,0,0,0,0,0,0,0,0,0
../kbl_data/2024-2025,S45G01N207,울산 현대모비스,Home,신민석,0,0,0,0.0,0,1,0.0,0,1,0.0,0,0,0.0,2,1,3,0,1,0,1,0,0,1
../kbl_data/2024-2025,S45G01N207,울산 현대모비스,Home,게이지 프림,21,7,10,70.0,1,1,100.0,8,11,72.7,4,6,66.7,0,4,4,1,0,1,0,0,1,1
../kbl_data/2024-2025,S45G01N207,울산 현대모비스,Home,박무빈,10,3,3,100.0,1,1,100.0,4,4,100.0,1,2,50.0,0,4,4,4,0,0,0,0,2,3
../kbl_data/2024-2025,S45G01N207,원주 DB,Away,이관희,6,0,3,0.0,2,5,40.0,2,8,25.0,0,0,0.0,0,2,2,4,1,0,0,0,0,1
../kbl_data/2024-2025,S45G01N207,원주 DB,Away,김시래,1,0,1,0.0,0,0,0.0,0,1,0.0,1,2,50.0,0,0,0,0,0,0,0,0,0,1
../kbl_data/2024-2025,S45G01N207,원주 DB,Away,서민수,6,1,2,50.0,1,2,50.0,2,4,50.0,1,2,50.0,1,2,3,2,0,1,0,0,0,1
../kbl_data/2024-2025,S45G01N207,원주 DB,Away,정효근,15,3,7,42.9,2,6,33.3,5,13,38.5,3,7,42.9,4,1,5,1,0,0,0,0,1,4
../kbl_data/2024-2025,S45G01N207,원주 DB,Away,박봉진,0,0,0,0.0,0,0,0.0,0,0,0.0,0,0,0.0,0,0,0,0,0,0,0,0,0,0
../kbl_data/2024-2025,S45G01N207,원주 DB,Away,강상재,2,1,2,50.0,0,0,0.0,1,2,50.0,0,0,0.0,0,0,0,1,0,0,0,0,1,5
../kbl_data/2024-2025,S45G01N207,원주 DB,Away,최성원,6,3,3,100.0,0,2,0.0,3,5,60.0,0,0,0.0,0,1,1,1,1,0,0,0,0,2
../kbl_data/2024-2025,S45G01N207,원주 DB,Away,김훈,0,0,0,0.0,0,1,0.0,0,1,0.0,0,0,0.0,0,3,3,0,0,0,0,0,0,1
../kbl_data/2024-2025,S45G01N207,원주 DB,Away,이용우,3,0,0,0.0,1,2,50.0,1,2,50.0,0,0,0.0,0,0,0,1,1,0,0,0,0,1
../kbl_data/2024-2025,S45G01N207,원주 DB,Away,오마리 스펠맨,25,1,9,11.1,5,7,71.4,6,16,37.5,8,11,72.7,6,6,12,4,2,3,0,0,3,4
../kbl_data/2024-2025,S45G01N207,원주 DB,Away,이선 알바노,20,6,13,46.2,2,5,40.0,8,18,44.4,2,2,100.0,1,4,5,4,1,0,0,0,2,1
../kbl_data/2024-2025,S45G01N207,원주 DB,Away,로버트 카터,0,0,1,0.0,0,0,0.0,0,1,0.0,0,0,0.0,0,0,0,0,0,0,0,0,0,0
../kbl_data/2024-2025,S45G01N208,대구 한국가스공사,Home,차바위,0,0,1,0.0,0,2,0.0,0,3,0.0,0,0,0.0,2,1,3,0,0,0,0,0,0,3
../kbl_data/2024-2025,S45G01N208,대구 한국가스공사,Home,박지훈,0,0,0,0.0,0,0,0.0,0,0,0.0,0,0,0.0,0,0,0,0,0,0,0,0,0,0
../kbl_data/2024-2025,S45G01N208,대구 한국가스공사,Home,김준일,2,1,5,20.0,0,2,0.0,1,7,14.3,0,0,0.0,1,3,4,3,1,1,0,0,1,2
../kbl_data/2024-2025,S45G01N208,대구 한국가스공사,Home,정성우,2,1,1,100.0,0,1,0.0,1,2,50.0,0,0,0.0,0,0,0,2,2,0,0,0,1,1
../kbl_data/2024-2025,S45G01N208,대구 한국가스공사,Home,김낙현,2,0,3,0.0,0,2,0.0,0,5,0.0,2,2,100.0,0,1,1,2,1,0,0,0,2,3
../kbl_data/2024-2025,S45G01N208,대구 한국가스공사,Home,전현우,15,0,2,0.0,5,9,55.6,5,11,45.5,0,0,0.0,2,2,4,1,1,1,0,0,3,1
../kbl_data/2024-2025,S45G01N208,대구 한국가스공사,Home,양재혁,0,0,0,0.0,0,0,0.0,0,0,0.0,0,0,0.0,0,0,0,0,0,0,0,0,0,0
../kbl_data/2024-2025,S45G01N208,대구 한국가스공사,Home,곽정훈,0,0,0,0.0,0,1,0.0,0,1,0.0,0,0,0.0,0,0,0,0,0,0,0,0,0,2
../kbl_data/2024-2025,S45G01N208,대구 한국가스공사,Home,앤드류 니콜슨,20,6,10,60.0,2,6,33.3,8,16,50.0,2,2,100.0,0,6,6,0,1,0,0,1,0,4
../kbl_data/2024-2025,S45G01N208,대구 한국가스공사,Home,샘조세프 벨란겔,18,4,5,80.0,3,5,60.0,7,10,70.0,1,3,33.3,1,1,2,7,1,0,1,0,0,2
../kbl_data/2024-2025,S45G01N208,대구 한국가스공사,Home,유슈 은도예,6,3,7,42.9,0,1,0.0,3,8,37.5,0,0,0.0,2,3,5,0,0,2,0,0,0,1
../kbl_data/2024-2025,S45G01N208,대구 한국가스공사,Home,신주영,7,2,3,66.7,1,4,25.0,3,7,42.9,0,0,0.0,2,1,3,2,0,1,0,0,0,0
../kbl_data/2024-2025,S45G01N208,창원 LG,Away,허일영,0,0,0,0.0,0,0,0.0,0,0,0.0,0,0,0.0,0,2,2,0,0,0,0,0,1,0
../kbl_data/2024-2025,S45G01N208,창원 LG,Away,최진수,0,0,0,0.0,0,0,0.0,0,0,0.0,0,0,0.0,2,0,2,0,0,0,0,0,0,0
../kbl_data/2024-2025,S45G01N208,창원 LG,Away,전성현,3,1,3,33.3,0,3,0.0,1,6,16.7,1,1,100.0,2,1,3,0,1,0,0,0,1,1
../kbl_data/2024-2025,S45G01N208,창원 LG,Away,정인덕,9,1,1,100.0,2,4,50.0,3,5,60.0,1,2,50.0,0,4,4,1,0,1,0,0,0,1
../kbl_data/2024-2025,S45G01N208,창원 LG,Away,대릴 먼로,4,2,3,66.7,0,0,0.0,2,3,66.7,0,0,0.0,2,4,6,1,0,0,0,0,0,2
../kbl_data/2024-2025,S45G01N208,창원 LG,Away,박정현,5,1,4,25.0,1,2,50.0,2,6,33.3,0,0,0.0,1,1,2,0,0,0,0,0,0,3
../kbl_data/2024-2025,S45G01N208,창원 LG,Away,아셈 마레이,17,7,14,50.0,0,0,0.0,7,14,50.0,3,6,50.0,6,8,14,5,1,1,0,0,2,1
../kbl_data/2024-2025,S45G01N208,창원 LG,Away,양준석,5,1,4,25.0,1,2,50.0,2,6,33.3,0,0,0.0,3,2,5,4,0,0,0,0,4,4
../kbl_data/2024-2025,S45G01N208,창원 LG,Away,유기상,16,2,2,100.0,4,8,50.0,6,10,60.0,0,0,0.0,0,2,2,0,1,0,0,0,0,3
../kbl_data/2024-2025,S45G01N208,창원 LG,Away,이경도,4,0,3,0.0,1,2,50.0,1,5,20.0,1,2,50.0,0,2,2,1,1,0,0,0,0,3
../kbl_data/2024-2025,S45G01N208,창원 LG,Away,칼 타마요,16,6,9,66.7,1,3,33.3,7,12,58.3,1,2,50.0,1,4,5,4,1,0,0,0,4,0
../kbl_data/2024-2025,S45G01N208,창원 LG,Away,최형찬,0,0,0,0.0,0,0,0.0,0,0,0.0,0,0,0.0,0,0,0,0,0,0,0,0,0,0
../kbl_data/2024-2025,S45G01N209,고양 소노,Home,정희재,0,0,0,0.0,0,1,0.0,0,1,0.0,0,0,0.0,1,3,4,1,0,0,0,0,0,3
../kbl_data/2024-2025,S45G01N209,고양 소노,Home,임동섭,3,0,0,0.0,1,8,12.5,1,8,12.5,0,0,0.0,1,1,2,2,1,0,0,0,2,3
../kbl_data/2024-2025,S45G01N209,고양 소노,Home,이재도,6,3,4,75.0,0,2,0.0,3,6,50.0,0,0,0.0,2,3,5,1,0,0,0,0,2,0
../kbl_data/2024-2025,S45G01N209,고양 소노,Home,최승욱,0,0,1,0.0,0,0,0.0,0,1,0.0,0,0,0.0,0,4,4,1,1,0,0,0,1,1
../kbl_data/2024-2025,S45G01N209,고양 소노,Home,김진유,0,0,0,0.0,0,0,0.0,0,0,0.0,0,0,0.0,1,1,2,0,0,1,0,0,0,2
../kbl_data/2024-2025,S45G01N209,고양 소노,Home,이정현,19,2,7,28.6,5,10,50.0,7,17,41.2,0,0,0.0,0,2,2,1,1,0,2,0,1,4
../kbl_data/2024-2025,S45G01N209,고양 소노,Home,문시윤,0,0,1,0.0,0,0,0.0,0,1,0.0,0,0,0.0,1,1,2,0,0,0,0,0,0,0
../kbl_data/2024-2025,S45G01N209,고양 소노,Home,박종하,0,0,0,0.0,0,0,0.0,0,0,0.0,0,0,0.0,0,0,0,0,0,0,0,0,0,0
../kbl_data/2024-2025,S45G01N209,고양 소노,Home,민기남,0,0,0,0.0,0,0,0.0,0,0,0.0,0,0,0.0,0,0,0,0,0,0,0,0,0,0
../kbl_data/2024-2025,S45G01N209,고양 소노,Home,디제이 번즈 Jr,18,9,14,64.3,0,0,0.0,9,14,64.3,0,0,0.0,2,4,6,1,1,0,0,0,5,5
../kbl_data/2024-2025,S45G01N209,고양 소노,Home,이근준,3,0,1,0.0,1,5,20.0,1,6,16.7,0,0,0.0,2,2,4,0,1,0,0,0,0,1
../kbl_data/2024-2025,S45G01N209,고양 소노,Home,케빈 켐바오,7,2,6,33.3,1,7,14.3,3,13,23.1,0,0,0.0,2,1,3,2,1,0,0,0,4,0
../kbl_data/2024-2025,S45G01N209,서울 SK,Away,김선형,15,3,3,100.0,2,6,33.3,5,9,55.6,3,4,75.0,1,6,7,3,2,0,0,0,2,2
../kbl_data/2024-2025,S45G01N209,서울 SK,Away,오세근,2,1,3,33.3,0,3,0.0,1,6,16.7,0,0,0.0,0,1,1,1,1,0,0,0,0,0
../kbl_data/2024-2025,S45G01N209,서울 SK,Away,최부경,2,1,3,33.3,0,0,0.0,1,3,33.3,0,0,0.0,3,2,5,1,0,0,0,0,1,1
../kbl_data/2024-2025,S45G01N209,서울 SK,Away,최원혁,0,0,0,0.0,0,1,0.0,0,1,0.0,0,0,0.0,2,0,2,1,0,0,0,0,1,1
../kbl_data/2024-2025,S45G01N209,서울 SK,Away,김지후,0,0,0,0.0,0,0,0.0,0,0,0.0,0,0,0.0,0,0,0,0,0,0,0,0,0,0
../kbl_data/2024-2025,S45G01N209,서울 SK,Away,안영준,22,5,9,55.6,3,6,50.0,8,15,53.3,3,3,100.0,0,6,6,2,3,2,0,0,3,3
../kbl_data/2024-2025,S45G01N209,서울 SK,Away,자밀 워니,17,6,10,60.0,0,5,0.0,6,15,40.0,5,7,71.4,2,12,14,7,2,0,0,0,4,1
../kbl_data/2024-2025,S45G01N209,서울 SK,Away,김형빈,3,1,1,100.0,0,1,0.0,1,2,50.0,1,1,100.0,1,0,1,0,1,0,0,0,0,0
../kbl_data/2024-2025,S45G01N209,서울 SK,Away,아이재아 힉스,0,0,0,0.0,0,1,0.0,0,1,0.0,0,0,0.0,1,1,2,0,0,0,0,0,1,0
../kbl_data/2024-2025,S45G01N209,서울 SK,Away,오재현,7,2,3,66.7,1,5,20.0,3,8,37.5,0,0,0.0,0,1,1,6,1,0,1,0,1,2
../kbl_data/2024-2025,S45G01N209,서울 SK,Away,고메즈 델 리아노,0,0,0,0.0,0,0,0.0,0,0,0.0,0,0,0.0,0,0,0,0,0,0,0,0,0,0
../kbl_data/2024-2025,S45G01N209,서울 SK,Away,김태훈,3,0,0,0.0,1,2,50.0,1,2,50.0,0,0,0.0,1,1,2,0,0,0,1,0,1,2
../kbl_data/2024-2025,S45G01N210,원주 DB,Home,이관희,10,1,5,20.0,2,7,28.6,3,12,25.0,2,2,100.0,1,5,6,2,2,1,0,0,2,1
../kbl_data/2024-2025,S45G01N210,원주 DB,Home,김시래,0,0,0,0.0,0,0,0.0,0,0,0.0,0,0,0.0,0,1,1,1,0,0,0,0,1,1
../kbl_data/2024-2025,S45G01N210,원주 DB,Home,서민수,8,3,3,100.0,0,2,0.0,3,5,60.0,2,2,100.0,2,1,3,0,1,1,0,0,1,2
../kbl_data/2024-2025,S45G01N210,원주 DB,Home,정효근,10,5,8,62.5,0,2,0.0,5,10,50.0,0,0,0.0,2,4,6,0,0,1,0,0,2,5
../kbl_data/2024-2025,S45G01N210,원주 DB,Home,박봉진,0,0,0,0.0,0,0,0.0,0,0,0.0,0,0,0.0,0,0,0,0,0,0,0,0,0,0
../kbl_data/2024-2025,S45G01N210,원주 DB,Home,강상재,6,3,4,75.0,0,2,0.0,3,6,50.0,0,0,0.0,6,9,15,3,1,3,0,0,1,1
../kbl_data/2024-2025,S45G01N210,원주 DB,Home,최성원,8,1,2,50.0,2,3,66.7,3,5,60.0,0,0,0.0,1,1,2,1,0,0,0,0,1,2
../kbl_data/2024-2025,S45G01N210,원주 DB,Home,김훈,0,0,0,0.0,0,0,0.0,0,0,0.0,0,0,0.0,0,0,0,0,0,0,0,0,0,0
../kbl_data/2024-2025,S45G01N210,원주 DB,Home,이용우,0,0,0,0.0,0,0,0.0,0,0,0.0,0,0,0.0,0,0,0,0,0,0,0,0,0,0
../kbl_data/2024-2025,S45G01N210,원주 DB,Home,오마리 스펠맨,22,4,10,40.0,4,11,36.4,8,21,38.1,2,3,66.7,1,10,11,3,0,0,0,1,1,4
../kbl_data/2024-2025,S45G01N210,원주 DB,Home,이선 알바노,5,2,8,25.0,0,5,0.0,2,13,15.4,1,2,50.0,1,1,2,8,1,0,0,0,2,1
../kbl_data/2024-2025,S45G01N210,원주 DB,Home,로버트 카터,6,0,1,0.0,2,4,50.0,2,5,40.0,0,2,0.0,1,0,1,0,0,0,0,0,1,1
../kbl_data/2024-2025,S45G01N210,서울 삼성,Away,이정현,13,5,9,55.6,1,4,25.0,6,13,46.2,0,0,0.0,1,3,4,5,2,0,0,0,2,4
../kbl_data/2024-2025,S45G01N210,서울 삼성,Away,최현민,17,1,2,50.0,4,7,57.1,5,9,55.6,3,4,75.0,0,5,5,1,0,0,0,0,1,2
../kbl_data/2024-2025,S45G01N210,서울 삼성,Away,이원대,0,0,1,0.0,0,1,0.0,0,2,0.0,0,0,0.0,1,0,1,2,0,0,0,0,0,0
../kbl_data/2024-2025,S45G01N210,서울 삼성,Away,최성모,5,2,3,66.7,0,8,0.0,2,11,18.2,1,2,50.0,0,5,5,4,2,0,0,0,1,3
../kbl_data/2024-2025,S45G01N210,서울 삼성,Away,최승욱,0,0,0,0.0,0,0,0.0,0,0,0.0,0,0,0.0,1,0,1,2,1,0,0,0,0,0
../kbl_data/2024-2025,S45G01N210,서울 삼성,Away,윤성원,7,2,3,66.7,1,3,33.3,3,6,50.0,0,0,0.0,3,2,5,1,0,0,0,0,0,2
../kbl_data/2024-2025,S45G01N210,서울 삼성,Away,김한솔,0,0,0,0.0,0,0,0.0,0,0,0.0,0,0,0.0,0,0,0,0,0,0,0,0,0,0
../kbl_data/2024-2025,S45G01N210,서울 삼성,Away,차민석,1,0,0,0.0,0,1,0.0,0,1,0.0,1,2,50.0,0,1,1,1,0,0,0,0,0,1
../kbl_data/2024-2025,S45G01N210,서울 삼성,Away,저스틴 구탕,10,3,6,50.0,1,4,25.0,4,10,40.0,1,2,50.0,1,4,5,2,0,0,0,1,2,4
../kbl_data/2024-2025,S45G01N210,서울 삼성,Away,박승재,0,0,0,0.0,0,2,0.0,0,2,0.0,0,0,0.0,0,2,2,1,1,0,0,0,0,1
../kbl_data/2024-2025,S45G01N210,서울 삼성,Away,코피 코번,18,8,16,50.0,0,0,0.0,8,16,50.0,2,4,50.0,4,6,10,1,1,0,0,0,0,1
../kbl_data/2024-2025,S45G01N210,서울 삼성,Away,글렌 로빈슨 3세,12,3,6,50.0,2,4,50.0,5,10,50.0,0,1,0.0,1,2,3,0,0,0,0,0,0,2
../kbl_data/2024-2025,S45G01N211,안양 정관장,Home,배병준,1,0,0,0.0,0,0,0.0,0,0,0.0,1,2,50.0,0,0,0,1,0,0,0,0,0,1
../kbl_data/2024-2025,S45G01N211,안양 정관장,Home,김영현,0,0,0,0.0,0,2,0.0,0,2,0.0,0,0,0.0,0,0,0,0,0,0,0,0,0,1
../kbl_data/2024-2025,S45G01N211,안양 정관장,Home,김종규,0,0,0,0.0,0,0,0.0,0,0,0.0,0,0,0.0,0,0,0,0,0,0,0,0,0,1
../kbl_data/2024-2025,S45G01N211,안양 정관장,Home,이종현,0,0,0,0.0,0,0,0.0,0,0,0.0,0,0,0.0,0,1,1,1,0,0,0,0,1,1
../kbl_data/2024-2025,S45G01N211,안양 정관장,Home,박지훈,13,3,7,42.9,1,6,16.7,4,13,30.8,4,4,100.0,1,4,5,3,0,0,0,0,1,4
../kbl_data/2024-2025,S45G01N211,안양 정관장,Home,디온테 버튼,12,5,11,45.5,0,4,0.0,5,15,33.3,2,2,100.0,2,8,10,2,0,1,0,0,1,4
../kbl_data/2024-2025,S45G01N211,안양 정관장,Home,변준형,13,2,5,40.0,1,5,20.0,3,10,30.0,6,6,100.0,1,2,3,2,0,0,1,0,2,3
../kbl_data/2024-2025,S45G01N211,안양 정관장,Home,김경원,5,1,3,33.3,1,2,50.0,2,5,40.0,0,0,0.0,2,2,4,0,2,0,0,0,1,3
../kbl_data/2024-2025,S45G01N211,안양 정관장,Home,한승희,0,0,1,0.0,0,2,0.0,0,3,0.0,0,0,0.0,1,1,2,0,0,0,0,0,0,3
../kbl_data/2024-2025,S45G01N211,안양 정관장,Home,조니 오브라이언트,13,5,10,50.0,0,2,0.0,5,12,41.7,3,4,75.0,5,4,9,1,0,0,1,0,1,3
../kbl_data/2024-2025,S45G01N211,안양 정관장,Home,하비 고메즈,17,1,1,100.0,5,10,50.0,6,11,54.5,0,0,0.0,0,3,3,0,1,0,0,0,0,1
../kbl_data/2024-2025,S45G01N211,안양 정관장,Home,소준혁,0,0,0,0.0,0,1,0.0,0,1,0.0,0,0,0.0,0,0,0,0,0,0,0,0,0,0
../kbl_data/2024-2025,S45G01N211,울산 현대모비스,Away,함지훈,2,1,1,100.0,0,0,0.0,1,1,100.0,0,0,0.0,0,1,1,0,0,0,0,0,2,2
../kbl_data/2024-2025,S45G01N211,울산 현대모비스,Away,장재석,0,0,1,0.0,0,0,0.0,0,1,0.0,0,0,0.0,0,0,0,3,0,0,0,0,0,4
../kbl_data/2024-2025,S45G01N211,울산 현대모비스,Away,이대헌,9,1,1,100.0,2,6,33.3,3,7,42.9,1,2,50.0,0,1,1,2,1,0,0,0,1,1
../kbl_data/2024-2025,S45G01N211,울산 현대모비스,Away,한호빈,0,0,0,0.0,0,0,0.0,0,0,0.0,0,0,0.0,1,0,1,1,0,0,0,0,0,1
../kbl_data/2024-2025,S45G01N211,울산 현대모비스,Away,김국찬,7,0,1,0.0,2,6,33.3,2,7,28.6,1,2,50.0,0,4,4,0,0,0,0,0,0,3
../kbl_data/2024-2025,S45G01N211,울산 현대모비스,Away,서명진,9,2,2,100.0,1,3,33.3,3,5,60.0,2,2,100.0,0,3,3,3,0,0,0,0,1,4
../kbl_data/2024-2025,S45G01N211,울산 현대모비스,Away,이우석,12,3,6,50.0,1,5,20.0,4,11,36.4,3,4,75.0,4,5,9,8,1,0,0,0,0,3
../kbl_data/2024-2025,S45G01N211,울산 현대모비스,Away,이승우,0,0,0,0.0,0,0,0.0,0,0,0.0,0,0,0.0,0,0,0,0,0,0,0,0,0,0
../kbl_data/2024-2025,S45G01N211,울산 현대모비스,Away,신민석,0,0,0,0.0,0,1,0.0,0,1,0.0,0,0,0.0,0,0,0,0,0,0,0,0,0,0
../kbl_data/2024-2025,S45G01N211,울산 현대모비스,Away,김동준,0,0,0,0.0,0,0,0.0,0,0,0.0,0,0,0.0,0,0,0,0,0,0,0,0,0,0
../kbl_data/2024-2025,S45G01N211,울산 현대모비스,Away,게이지 프림,31,11,21,52.4,0,2,0.0,11,23,47.8,9,9,100.0,2,10,12,3,1,3,0,0,2,2
../kbl_data/2024-2025,S45G01N211,울산 현대모비스,Away,박무빈,11,2,4,50.0,2,5,40.0,4,9,44.4,1,2,50.0,0,5,5,2,1,0,0,0,1,3
../kbl_data/2024-2025,S45G01N212,서울 SK,Home,김선형,22,6,7,85.7,3,4,75.0,9,11,81.8,1,2,50.0,1,0,1,2,1,0,0,0,1,3
../kbl_data/2024-2025,S45G01N212,서울 SK,Home,오세근,4,2,4,50.0,0,2,0.0,2,6,33.3,0,0,0.0,0,6,6,1,1,1,0,0,0,1
../kbl_data/2024-2025,S45G01N212,서울 SK,Home,최부경,4,2,2,100.0,0,0,0.0,2,2,100.0,0,0,0.0,1,0,1,0,0,0,0,0,0,1
../kbl_data/2024-2025,S45G01N212,서울 SK,Home,최원혁,0,0,0,0.0,0,1,0.0,0,1,0.0,0,0,0.0,0,0,0,1,0,0,0,0,1,1
../kbl_data/2024-2025,S45G01N212,서울 SK,Home,김지후,1,0,0,0.0,0,0,0.0,0,0,0.0,1,3,33.3,0,1,1,0,0,0,0,0,1,0
../kbl_data/2024-2025,S45G01N212,서울 SK,Home,안영준,11,1,2,50.0,2,4,50.0,3,6,50.0,3,5,60.0,1,9,10,10,1,0,0,0,4,3
../kbl_data/2024-2025,S45G01N212,서울 SK,Home,자밀 워니,18,9,18,50.0,0,4,0.0,9,22,40.9,0,1,0.0,2,7,9,3,0,1,0,2,2,1
../kbl_data/2024-2025,S45G01N212,서울 SK,Home,김형빈,3,0,0,0.0,1,3,33.3,1,3,33.3,0,0,0.0,1,1,2,0,0,0,0,0,0,1
../kbl_data/2024-2025,S45G01N212,서울 SK,Home,아이재아 힉스,8,2,6,33.3,1,3,33.3,3,9,33.3,1,1,100.0,3,2,5,1,1,2,0,0,0,2
../kbl_data/2024-2025,S45G01N212,서울 SK,Home,오재현,10,2,3,66.7,2,4,50.0,4,7,57.1,0,0,0.0,0,5,5,4,2,0,0,0,0,1
../kbl_data/2024-2025,S45G01N212,서울 SK,Home,고메즈 델 리아노,3,1,1,100.0,0,0,0.0,1,1,100.0,1,2,50.0,0,1,1,0,1,0,0,0,2,1
../kbl_data/2024-2025,S45G01N212,서울 SK,Home,김태훈,5,0,0,0.0,1,1,100.0,1,1,100.0,2,2,100.0,0,1,1,0,1,1,0,0,0,2
../kbl_data/2024-2025,S45G01N212,대구 한국가스공사,Away,차바위,2,1,1,100.0,0,1,0.0,1,2,50.0,0,0,0.0,0,0,0,0,1,0,0,0,0,2
../kbl_data/2024-2025,S45G01N212,대구 한국가스공사,Away,박지훈,3,0,1,0.0,1,3,33.3,1,4,25.0,0,0,0.0,1,1,2,1,0,0,0,0,0,1
../kbl_data/2024-2025,S45G01N212,대구 한국가스공사,Away,김준일,10,5,10,50.0,0,1,0.0,5,11,45.5,0,0,0.0,6,5,11,0,2,1,0,0,3,1
../kbl_data/2024-2025,S45G01N212,대구 한국가스공사,Away,정성우,0,0,2,0.0,0,1,0.0,0,3,0.0,0,0,0.0,0,1,1,2,1,0,0,0,2,1
../kbl_data/2024-2025,S45G01N212,대구 한국가스공사,Away,김낙현,10,2,8,25.0,2,8,25.0,4,16,25.0,0,0,0.0,1,2,3,6,0,0,0,0,1,0
../kbl_data/2024-2025,S45G01N212,대구 한국가스공사,Away,전현우,2,1,1,100.0,0,1,0.0,1,2,50.0,0,0,0.0,1,0,1,0,0,0,0,0,1,2
../kbl_data/2024-2025,S45G01N212,대구 한국가스공사,Away,양재혁,0,0,0,0.0,0,1,0.0,0,1,0.0,0,0,0.0,0,0,0,0,0,0,0,0,0,1
../kbl_data/2024-2025,S45G01N212,대구 한국가스공사,Away,곽정훈,7,2,2,100.0,1,4,25.0,3,6,50.0,0,0,0.0,2,5,7,1,1,0,2,0,1,3
../kbl_data/2024-2025,S45G01N212,대구 한국가스공사,Away,앤드류 니콜슨,17,5,11,45.5,2,5,40.0,7,16,43.8,1,2,50.0,2,3,5,0,0,0,0,1,1,1
../kbl_data/2024-2025,S45G01N212,대구 한국가스공사,Away,샘조세프 벨란겔,4,2,6,33.3,0,2,0.0,2,8,25.0,0,0,0.0,2,0,2,6,1,0,0,0,1,1
../kbl_data/2024-2025,S45G01N212,대구 한국가스공사,Away,유슈 은도예,3,1,5,20.0,0,0,0.0,1,5,20.0,1,2,50.0,1,4,5,0,0,1,0,0,0,1
../kbl_data/2024-2025,S45G01N212,대구 한국가스공사,Away,신주영,11,1,2,50.0,3,7,42.9,4,9,44.4,0,0,0.0,2,2,4,0,1,0,0,0,1,5
../kbl_data/2024-2025,S45G01N213,창원 LG,Home,허일영,5,1,3,33.3,1,4,25.0,2,7,28.6,0,0,0.0,0,2,2,1,0,0,0,0,0,2
../kbl_data/2024-2025,S45G01N213,창원 LG,Home,최진수,0,0,0,0.0,0,0,0.0,0,0,0.0,0,0,0.0,1,0,1,1,0,0,0,0,0,2
../kbl_data/2024-2025,S45G01N213,창원 LG,Home,한상혁,0,0,0,0.0,0,0,0.0,0,0,0.0,0,0,0.0,0,0,0,0,0,0,0,0,0,0
../kbl_data/2024-2025,S45G01N213,창원 LG,Home,정인덕,7,0,2,0.0,2,4,50.0,2,6,33.3,1,1,100.0,1,1,2,3,0,0,0,0,1,3
../kbl_data/2024-2025,S45G01N213,창원 LG,Home,대릴 먼로,0,0,0,0.0,0,0,0.0,0,0,0.0,0,0,0.0,0,3,3,2,1,0,0,0,0,0
../kbl_data/2024-2025,S45G01N213,창원 LG,Home,박정현,0,0,0,0.0,0,0,0.0,0,0,0.0,0,0,0.0,0,0,0,0,0,0,0,0,0,0
../kbl_data/2024-2025,S45G01N213,창원 LG,Home,아셈 마레이,29,13,18,72.2,0,0,0.0,13,18,72.2,3,5,60.0,6,17,23,6,4,0,0,0,2,2
../kbl_data/2024-2025,S45G01N213,창원 LG,Home,양준석,13,5,6,83.3,1,4,25.0,6,10,60.0,0,0,0.0,0,2,2,9,1,0,1,0,2,1
../kbl_data/2024-2025,S45G01N213,창원 LG,Home,유기상,19,2,2,100.0,4,9,44.4,6,11,54.5,3,5,60.0,1,1,2,1,1,0,0,0,1,4
../kbl_data/2024-2025,S45G01N213,창원 LG,Home,이경도,0,0,0,0.0,0,0,0.0,0,0,0.0,0,0,0.0,0,0,0,0,0,0,0,0,2,1
../kbl_data/2024-2025,S45G01N213,창원 LG,Home,칼 타마요,12,5,9,55.6,0,2,0.0,5,11,45.5,2,2,100.0,1,1,2,4,0,0,0,0,2,2
../kbl_data/2024-2025,S45G01N213,창원 LG,Home,최형찬,6,0,0,0.0,2,3,66.7,2,3,66.7,0,0,0.0,0,0,0,0,0,0,0,0,1,4
../kbl_data/2024-2025,S45G01N213,고양 소노,Away,정희재,0,0,1,0.0,0,0,0.0,0,1,0.0,0,0,0.0,0,0,0,0,0,0,0,0,1,1
../kbl_data/2024-2025,S45G01N213,고양 소노,Away,임동섭,7,1,3,33.3,1,2,50.0,2,5,40.0,2,2,100.0,0,3,3,1,0,0,0,0,0,2
../kbl_data/2024-2025,S45G01N213,고양 소노,Away,이재도,11,3,3,100.0,1,1,100.0,4,4,100.0,2,2,100.0,1,2,3,0,0,0,0,0,3,1
../kbl_data/2024-2025,S45G01N213,고양 소노,Away,최승욱,2,1,2,50.0,0,1,0.0,1,3,33.3,0,0,0.0,4,0,4,0,0,0,0,0,1,0
../kbl_data/2024-2025,S45G01N213,고양 소노,Away,김진유,2,1,2,50.0,0,1,0.0,1,3,33.3,0,0,0.0,0,1,1,0,0,0,1,0,0,1
../kbl_data/2024-2025,S45G01N213,고양 소노,Away,이정현,9,0,3,0.0,1,5,20.0,1,8,12.5,6,6,100.0,0,2,2,4,3,0,0,0,2,3
../kbl_data/2024-2025,S45G01N213,고양 소노,Away,문시윤,0,0,0,0.0,0,1,0.0,0,1,0.0,0,0,0.0,0,0,0,0,0,0,0,0,0,0
../kbl_data/2024-2025,S45G01N213,고양 소노,Away,박종하,2,1,1,100.0,0,0,0.0,1,1,100.0,0,0,0.0,0,0,0,2,0,0,0,0,0,1
../kbl_data/2024-2025,S45G01N213,고양 소노,Away,민기남,0,0,0,0.0,0,0,0.0,0,0,0.0,0,0,0.0,0,0,0,0,0,0,0,0,0,0
../kbl_data/2024-2025,S45G01N213,고양 소노,Away,디제이 번즈 Jr,25,11,15,73.3,0,1,0.0,11,16,68.8,3,4,75.0,1,5,6,3,0,0,0,0,2,3
../kbl_data/2024-2025,S45G01N213,고양 소노,Away,이근준,6,0,0,0.0,2,6,33.3,2,6,33.3,0,0,0.0,1,3,4,0,0,0,0,0,0,4
../kbl_data/2024-2025,S45G01N213,고양 소노,Away,케빈 켐바오,15,1,4,25.0,3,8,37.5,4,12,33.3,4,8,50.0,0,5,5,6,3,0,0,0,2,0
../kbl_data/2024-2025,S45G01N214,안양 정관장,Home,정준원,5,2,3,66.7,0,0,0.0,2,3,66.7,1,2,50.0,1,0,1,0,0,0,0,0,0,1
../kbl_data/2024-2025,S45G01N214,안양 정관장,Home,배병준,13,2,2,100.0,3,7,42.9,5,9,55.6,0,0,0.0,0,1,1,2,1,0,0,0,1,0
../kbl_data/2024-2025,S45G01N214,안양 정관장,Home,김영현,0,0,0,0.0,0,0,0.0,0,0,0.0,0,0,0.0,0,0,0,0,0,0,0,0,0,0
../kbl_data/2024-2025,S45G01N214,안양 정관장,Home,김종규,0,0,2,0.0,0,0,0.0,0,2,0.0,0,0,0.0,2,1,3,1,0,0,0,0,0,1
../kbl_data/2024-2025,S45G01N214,안양 정관장,Home,박지훈,14,3,7,42.9,2,6,33.3,5,13,38.5,2,2,100.0,0,8,8,4,3,0,0,0,1,1
../kbl_data/2024-2025,S45G01N214,안양 정관장,Home,디온테 버튼,6,3,10,30.0,0,1,0.0,3,11,27.3,0,0,0.0,1,4,5,3,0,0,0,0,1,2
../kbl_data/2024-2025,S45G01N214,안양 정관장,Home,변준형,0,0,1,0.0,0,3,0.0,0,4,0.0,0,0,0.0,0,0,0,2,0,0,0,0,2,3
../kbl_data/2024-2025,S45G01N214,안양 정관장,Home,김경원,4,2,3,66.7,0,1,0.0,2,4,50.0,0,0,0.0,3,4,7,1,1,0,0,0,0,3
../kbl_data/2024-2025,S45G01N214,안양 정관장,Home,한승희,2,0,3,0.0,0,1,0.0,0,4,0.0,2,2,100.0,1,2,3,0,0,1,1,0,1,1
../kbl_data/2024-2025,S45G01N214,안양 정관장,Home,조니 오브라이언트,19,8,15,53.3,1,6,16.7,9,21,42.9,0,2,0.0,3,12,15,3,1,1,0,0,0,5
../kbl_data/2024-2025,S45G01N214,안양 정관장,Home,하비 고메즈,14,4,6,66.7,2,6,33.3,6,12,50.0,0,0,0.0,3,3,6,1,1,0,0,0,2,0
../kbl_data/2024-2025,S45G01N214,안양 정관장,Home,소준혁,0,0,0,0.0,0,1,0.0,0,1,0.0,0,0,0.0,1,0,1,0,0,0,0,0,0,0
../kbl_data/2024-2025,S45G01N214,원주 DB,Away,이관희,4,2,4,50.0,0,3,0.0,2,7,28.6,0,0,0.0,0,1,1,1,0,0,0,0,2,0
../kbl_data/2024-2025,S45G01N214,원주 DB,Away,김시래,3,0,1,0.0,1,1,100.0,1,2,50.0,0,0,0.0,0,0,0,1,1,0,0,0,0,1
../kbl_data/2024-2025,S45G01N214,원주 DB,Away,서민수,0,0,1,0.0,0,0,0.0,0,1,0.0,0,0,0.0,1,1,2,0,0,0,0,0,0,2
../kbl_data/2024-2025,S45G01N214,원주 DB,Away,정효근,9,3,6,50.0,1,4,25.0,4,10,40.0,0,2,0.0,1,4,5,1,1,3,0,0,1,3
../kbl_data/2024-2025,S45G01N214,원주 DB,Away,박봉진,0,0,0,0.0,0,0,0.0,0,0,0.0,0,0,0.0,0,0,0,0,0,0,0,0,0,0
../kbl_data/2024-2025,S45G01N214,원주 DB,Away,강상재,3,1,1,100.0,0,3,0.0,1,4,25.0,1,2,50.0,2,12,14,1,1,1,0,0,0,2
../kbl_data/2024-2025,S45G01N214,원주 DB,Away,최성원,5,1,3,33.3,1,1,100.0,2,4,50.0,0,0,0.0,0,2,2,0,0,0,0,0,0,1
../kbl_data/2024-2025,S45G01N214,원주 DB,Away,치나누 오누아쿠,4,1,3,33.3,0,1,0.0,1,4,25.0,2,2,100.0,1,2,3,2,1,0,0,0,1,2
../kbl_data/2024-2025,S45G01N214,원주 DB,Away,김훈,0,0,0,0.0,0,0,0.0,0,0,0.0,0,0,0.0,0,0,0,0,0,0,0,0,0,0
../kbl_data/2024-2025,S45G01N214,원주 DB,Away,오마리 스펠맨,31,10,15,66.7,2,6,33.3,12,21,57.1,5,7,71.4,0,9,9,2,2,0,0,1,3,1
../kbl_data/2024-2025,S45G01N214,원주 DB,Away,이선 알바노,10,3,8,37.5,1,5,20.0,4,13,30.8,1,2,50.0,0,1,1,5,1,1,0,0,3,3
../kbl_data/2024-2025,S45G01N214,원주 DB,Away,김보배,0,0,0,0.0,0,0,0.0,0,0,0.0,0,0,0.0,0,0,0,0,0,0,0,0,0,0
../kbl_data/2024-2025,S45G01N215,울산 현대모비스,Home,함지훈,9,3,4,75.0,0,2,0.0,3,6,50.0,3,4,75.0,2,5,7,0,1,0,0,0,2,1
../kbl_data/2024-2025,S45G01N215,울산 현대모비스,Home,장재석,0,0,0,0.0,0,0,0.0,0,0,0.0,0,0,0.0,1,0,1,0,1,0,0,0,0,2
../kbl_data/2024-2025,S45G01N215,울산 현대모비스,Home,이대헌,0,0,1,0.0,0,0,0.0,0,1,0.0,0,0,0.0,0,2,2,0,0,0,0,0,0,0
../kbl_data/2024-2025,S45G01N215,울산 현대모비스,Home,한호빈,2,1,2,50.0,0,6,0.0,1,8,12.5,0,0,0.0,0,2,2,1,0,0,0,0,1,3
../kbl_data/2024-2025,S45G01N215,울산 현대모비스,Home,김국찬,7,2,5,40.0,1,3,33.3,3,8,37.5,0,0,0.0,0,2,2,2,3,0,0,0,3,1
../kbl_data/2024-2025,S45G01N215,울산 현대모비스,Home,서명진,6,0,3,0.0,1,7,14.3,1,10,10.0,3,4,75.0,1,3,4,6,0,0,0,0,0,2
../kbl_data/2024-2025,S45G01N215,울산 현대모비스,Home,숀 롱,6,2,4,50.0,0,0,0.0,2,4,50.0,2,3,66.7,6,4,10,2,2,4,0,0,2,3
../kbl_data/2024-2025,S45G01N215,울산 현대모비스,Home,이우석,5,1,3,33.3,1,5,20.0,2,8,25.0,0,0,0.0,0,4,4,5,0,1,0,0,4,1
../kbl_data/2024-2025,S45G01N215,울산 현대모비스,Home,신민석,3,0,0,0.0,1,3,33.3,1,3,33.3,0,0,0.0,0,1,1,0,0,0,0,0,0,0
../kbl_data/2024-2025,S45G01N215,울산 현대모비스,Home,김동준,0,0,0,0.0,0,0,0.0,0,0,0.0,0,0,0.0,0,0,0,0,0,0,0,0,0,0
../kbl_data/2024-2025,S45G01N215,울산 현대모비스,Home,게이지 프림,21,8,17,47.1,0,1,0.0,8,18,44.4,5,5,100.0,4,7,11,4,2,2,0,0,1,3
../kbl_data/2024-2025,S45G01N215,울산 현대모비스,Home,박무빈,4,2,5,40.0,0,1,0.0,2,6,33.3,0,0,0.0,0,3,3,2,0,0,0,0,1,2
../kbl_data/2024-2025,S45G01N215,서울 삼성,Away,이정현,2,0,5,0.0,0,3,0.0,0,8,0.0,2,2,100.0,1,2,3,4,2,0,0,0,2,3
../kbl_data/2024-2025,S45G01N215,서울 삼성,Away,최현민,5,1,3,33.3,1,7,14.3,2,10,20.0,0,0,0.0,1,1,2,2,0,2,0,0,3,2
../kbl_data/2024-2025,S45G01N215,서울 삼성,Away,이원대,0,0,1,0.0,0,0,0.0,0,1,0.0,0,0,0.0,1,1,2,1,0,0,0,0,1,0
../kbl_data/2024-2025,S45G01N215,서울 삼성,Away,최성모,4,2,5,40.0,0,5,0.0,2,10,20.0,0,0,0.0,2,7,9,4,0,1,0,0,0,4
../kbl_data/2024-2025,S45G01N215,서울 삼성,Away,최승욱,4,2,2,100.0,0,0,0.0,2,2,100.0,0,0,0.0,1,0,1,0,2,0,1,0,1,2
../kbl_data/2024-2025,S45G01N215,서울 삼성,Away,윤성원,5,1,1,100.0,1,2,50.0,2,3,66.7,0,0,0.0,1,3,4,0,0,0,0,0,2,4
../kbl_data/2024-2025,S45G01N215,서울 삼성,Away,김한솔,0,0,0,0.0,0,0,0.0,0,0,0.0,0,0,0.0,0,0,0,0,0,0,0,0,0,0
../kbl_data/2024-2025,S45G01N215,서울 삼성,Away,차민석,0,0,3,0.0,0,0,0.0,0,3,0.0,0,0,0.0,0,3,3,0,1,0,0,0,0,2
../kbl_data/2024-2025,S45G01N215,서울 삼성,Away,저스틴 구탕,8,1,5,20.0,2,5,40.0,3,10,30.0,0,0,0.0,0,3,3,1,1,0,1,1,3,1
../kbl_data/2024-2025,S45G01N215,서울 삼성,Away,박승재,0,0,1,0.0,0,0,0.0,0,1,0.0,0,0,0.0,0,0,0,0,0,0,0,0,0,0
../kbl_data/2024-2025,S45G01N215,서울 삼성,Away,코피 코번,31,12,21,57.1,0,0,0.0,12,21,57.1,7,7,100.0,7,10,17,1,1,0,1,2,0,1
../kbl_data/2024-2025,S45G01N215,서울 삼성,Away,글렌 로빈슨 3세,2,1,6,16.7,0,2,0.0,1,8,12.5,0,0,0.0,0,2,2,2,1,0,0,0,0,3
../kbl_data/2024-2025,S45G01N216,대구 한국가스공사,Home,차바위,0,0,0,0.0,0,0,0.0,0,0,0.0,0,0,0.0,0,0,0,0,0,0,0,0,0,0
../kbl_data/2024-2025,S45G01N216,대구 한국가스공사,Home,박지훈,30,6,10,60.0,6,8,75.0,12,18,66.7,0,0,0.0,0,16,16,6,4,2,0,0,6,14
../kbl_data/2024-2025,S45G01N216,대구 한국가스공사,Home,김준일,8,2,4,50.0,0,0,0.0,2,4,50.0,4,4,100.0,1,3,4,2,1,3,1,1,2,1
../kbl_data/2024-2025,S45G01N216,대구 한국가스공사,Home,정성우,6,2,4,50.0,0,1,0.0,2,5,40.0,2,5,40.0,2,1,3,8,5,0,0,0,1,3
../kbl_data/2024-2025,S45G01N216,대구 한국가스공사,Home,김낙현,6,3,4,75.0,0,4,0.0,3,8,37.5,0,0,0.0,0,0,0,1,1,0,0,0,3,2
../kbl_data/2024-2025,S45G01N216,대구 한국가스공사,Home,전현우,0,0,0,0.0,0,1,0.0,0,1,0.0,0,0,0.0,0,0,0,1,0,0,0,0,0,1
../kbl_data/2024-2025,S45G01N216,대구 한국가스공사,Home,양재혁,0,0,0,0.0,0,0,0.0,0,0,0.0,0,0,0.0,0,0,0,1,1,0,0,0,0,1
../kbl_data/2024-2025,S45G01N216,대구 한국가스공사,Home,앤드류 니콜슨,31,10,15,66.7,3,6,50.0,13,21,61.9,2,3,66.7,0,6,6,0,1,1,0,0,0,1
../kbl_data/2024-2025,S45G01N216,대구 한국가스공사,Home,신승민,3,0,0,0.0,1,2,50.0,1,2,50.0,0,0,0.0,0,1,1,1,1,0,0,0,1,3
../kbl_data/2024-2025,S45G01N216,대구 한국가스공사,Home,샘조세프 벨란겔,18,1,3,33.3,3,5,60.0,4,8,50.0,7,9,77.8,0,2,2,3,0,0,0,0,1,3
../kbl_data/2024-2025,S45G01N216,대구 한국가스공사,Home,유슈 은도예,13,4,6,66.7,0,1,0.0,4,7,57.1,5,8,62.5,1,6,7,0,0,1,0,1,3,3
../kbl_data/2024-2025,S45G01N216,대구 한국가스공사,Home,신주영,0,0,0,0.0,0,0,0.0,0,0,0.0,0,0,0.0,0,0,0,1,0,0,0,0,0,0
../kbl_data/2024-2025,S45G01N216,안양 정관장,Away,정준원,0,0,0,0.0,0,0,0.0,0,0,0.0,0,0,0.0,0,0,0,0,0,0,0,0,0,0
../kbl_data/2024-2025,S45G01N216,안양 정관장,Away,배병준,4,2,2,100.0,0,2,0.0,2,4,50.0,0,0,0.0,0,2,2,1,0,0,0,0,0,1
../kbl_data/2024-2025,S45G01N216,안양 정관장,Away,김영현,0,0,0,0.0,0,1,0.0,0,1,0.0,0,0,0.0,2,1,3,0,0,0,0,0,2,4
../kbl_data/2024-2025,S45G01N216,안양 정관장,Away,김종규,6,1,2,50.0,0,1,0.0,1,3,33.3,4,4,100.0,1,1,2,2,0,0,0,0,0,4
../kbl_data/2024-2025,S45G01N216,안양 정관장,Away,이종현,2,0,1,0.0,0,0,0.0,0,1,0.0,2,2,100.0,0,1,1,1,0,1,0,0,0,1
../kbl_data/2024-2025,S45G01N216,안양 정관장,Away,박지훈,30,6,10,60.0,6,8,75.0,12,18,66.7,0,0,0.0,0,16,16,6,4,2,0,0,6,14
../kbl_data/2024-2025,S45G01N216,안양 정관장,Away,디온테 버튼,31,10,18,55.6,2,5,40.0,12,23,52.2,5,9,55.6,1,11,12,5,2,0,0,0,4,3
../kbl_data/2024-2025,S45G01N216,안양 정관장,Away,변준형,5,0,3,0.0,1,4,25.0,1,7,14.3,2,2,100.0,0,2,2,3,2,1,0,0,6,3
../kbl_data/2024-2025,S45G01N216,안양 정관장,Away,김경원,6,3,3,100.0,0,1,0.0,3,4,75.0,0,0,0.0,0,0,0,0,0,0,0,0,0,1
../kbl_data/2024-2025,S45G01N216,안양 정관장,Away,한승희,7,2,3,66.7,0,2,0.0,2,5,40.0,3,3,100.0,2,0,2,1,2,0,0,0,0,1
../kbl_data/2024-2025,S45G01N216,안양 정관장,Away,하비 고메즈,0,0,1,0.0,0,1,0.0,0,2,0.0,0,0,0.0,0,2,2,0,1,0,0,0,1,3
../kbl_data/2024-2025,S45G01N216,안양 정관장,Away,소준혁,3,0,0,0.0,1,4,25.0,1,4,25.0,0,1,0.0,0,2,2,0,0,0,0,0,0,1
../kbl_data/2024-2025,S45G01N217,부산 KCC,Home,정창영,8,1,4,25.0,2,4,50.0,3,8,37.5,0,0,0.0,0,2,2,3,0,0,0,0,2,1
../kbl_data/2024-2025,S45G01N217,부산 KCC,Home,전준범,0,0,0,0.0,0,1,0.0,0,1,0.0,0,0,0.0,1,0,1,1,3,0,0,0,0,1
../kbl_data/2024-2025,S45G01N217,부산 KCC,Home,허웅,14,3,4,75.0,2,8,25.0,5,12,41.7,2,3,66.7,0,0,0,3,1,0,0,0,0,2
../kbl_data/2024-2025,S45G01N217,부산 KCC,Home,이승현,12,3,6,50.0,0,0,0.0,3,6,50.0,6,6,100.0,1,2,3,3,2,0,0,0,2,4
../kbl_data/2024-2025,S45G01N217,부산 KCC,Home,이호현,2,0,3,0.0,0,0,0.0,0,3,0.0,2,2,100.0,0,7,7,0,0,0,0,0,3,2
../kbl_data/2024-2025,S45G01N217,부산 KCC,Home,전태영,0,0,0,0.0,0,0,0.0,0,0,0.0,0,0,0.0,0,0,0,0,0,0,0,0,0,0
../kbl_data/2024-2025,S45G01N217,부산 KCC,Home,캐디 라렌,17,8,9,88.9,0,4,0.0,8,13,61.5,1,3,33.3,4,8,12,0,0,0,0,2,2,4
../kbl_data/2024-2025,S45G01N217,부산 KCC,Home,이근휘,6,0,2,0.0,2,6,33.3,2,8,25.0,0,0,0.0,2,2,4,2,1,0,0,0,0,0
../kbl_data/2024-2025,S45G01N217,부산 KCC,Home,캘빈 제프리 에피스톨라,0,0,1,0.0,0,3,0.0,0,4,0.0,0,0,0.0,0,1,1,2,0,0,0,0,0,1
../kbl_data/2024-2025,S45G01N217,부산 KCC,Home,이주영,0,0,0,0.0,0,0,0.0,0,0,0.0,0,0,0.0,0,0,0,0,0,0,0,0,2,0
../kbl_data/2024-2025,S45G01N217,부산 KCC,Home,이찬영,2,1,1,100.0,0,0,0.0,1,1,100.0,0,0,0.0,0,0,0,0,0,0,0,0,0,0
../kbl_data/2024-2025,S45G01N217,부산 KCC,Home,도노반 스미스,16,7,11,63.6,0,2,0.0,7,13,53.8,2,4,50.0,2,1,3,1,2,1,0,0,2,4
../kbl_data/2024-2025,S45G01N217,서울 삼성,Away,이정현,10,0,3,0.0,3,7,42.9,3,10,30.0,1,1,100.0,1,6,7,8,3,0,0,0,5,3
../kbl_data/2024-2025,S45G01N217,서울 삼성,Away,최현민,5,0,0,0.0,1,5,20.0,1,5,20.0,2,2,100.0,3,2,5,3,0,0,0,0,0,4
../kbl_data/2024-2025,S45G01N217,서울 삼성,Away,이원대,3,0,0,0.0,1,3,33.3,1,3,33.3,0,0,0.0,0,0,0,1,0,0,0,0,0,0
../kbl_data/2024-2025,S45G01N217,서울 삼성,Away,최성모,11,1,5,20.0,3,5,60.0,4,10,40.0,0,0,0.0,3,5,8,7,1,0,3,0,2,4
../kbl_data/2024-2025,S45G01N217,서울 삼성,Away,최승욱,2,1,2,50.0,0,0,0.0,1,2,50.0,0,0,0.0,0,0,0,0,0,1,0,0,0,2
../kbl_data/2024-2025,S45G01N217,서울 삼성,Away,윤성원,2,1,1,100.0,0,1,0.0,1,2,50.0,0,0,0.0,1,0,1,0,0,0,0,0,1,1
../kbl_data/2024-2025,S45G01N217,서울 삼성,Away,차민석,0,0,0,0.0,0,0,0.0,0,0,0.0,0,0,0.0,0,0,0,0,0,0,0,0,0,0
../kbl_data/2024-2025,S45G01N217,서울 삼성,Away,이원석,2,0,2,0.0,0,2,0.0,0,4,0.0,2,2,100.0,0,0,0,0,0,0,0,0,1,2
../kbl_data/2024-2025,S45G01N217,서울 삼성,Away,저스틴 구탕,14,4,8,50.0,2,6,33.3,6,14,42.9,0,0,0.0,0,7,7,5,1,0,1,1,2,4
../kbl_data/2024-2025,S45G01N217,서울 삼성,Away,박승재,0,0,0,0.0,0,0,0.0,0,0,0.0,0,0,0.0,0,0,0,0,0,0,0,0,1,0
../kbl_data/2024-2025,S45G01N217,서울 삼성,Away,코피 코번,34,13,19,68.4,0,0,0.0,13,19,68.4,8,8,100.0,6,7,13,2,0,0,0,2,2,1
../kbl_data/2024-2025,S45G01N217,서울 삼성,Away,글렌 로빈슨 3세,0,0,0,0.0,0,0,0.0,0,0,0.0,0,0,0.0,0,1,1,1,0,0,0,0,0,1
../kbl_data/2024-2025,S45G01N218,수원 KT,Home,문성곤,7,2,2,100.0,1,8,12.5,3,10,30.0,0,0,0.0,1,0,1,1,3,2,0,0,0,3
../kbl_data/2024-2025,S45G01N218,수원 KT,Home,이현석,0,0,0,0.0,0,2,0.0,0,2,0.0,0,0,0.0,1,0,1,0,0,0,0,0,0,2
../kbl_data/2024-2025,S45G01N218,수원 KT,Home,허훈,13,1,6,16.7,3,10,30.0,4,16,25.0,2,4,50.0,0,5,5,7,2,0,0,0,8,0
../kbl_data/2024-2025,S45G01N218,수원 KT,Home,이윤기,0,0,0,0.0,0,0,0.0,0,0,0.0,0,0,0.0,0,0,0,0,0,0,0,0,0,0
../kbl_data/2024-2025,S45G01N218,수원 KT,Home,박지원,0,0,0,0.0,0,0,0.0,0,0,0.0,0,0,0.0,0,0,0,0,0,0,0,0,0,0
../kbl_data/2024-2025,S45G01N218,수원 KT,Home,하윤기,8,4,9,44.4,0,0,0.0,4,9,44.4,0,2,0.0,6,2,8,1,0,0,0,0,1,1
../kbl_data/2024-2025,S45G01N218,수원 KT,Home,이두원,0,0,0,0.0,0,0,0.0,0,0,0.0,0,0,0.0,0,0,0,0,0,0,0,0,1,0
../kbl_data/2024-2025,S45G01N218,수원 KT,Home,박선웅,0,0,0,0.0,0,0,0.0,0,0,0.0,0,0,0.0,0,0,0,0,0,0,0,0,0,0
../kbl_data/2024-2025,S45G01N218,수원 KT,Home,문정현,11,1,5,20.0,2,5,40.0,3,10,30.0,3,4,75.0,6,7,13,4,1,0,0,1,1,1
../kbl_data/2024-2025,S45G01N218,수원 KT,Home,레이션 해먼즈,17,5,8,62.5,1,5,20.0,6,13,46.2,4,5,80.0,4,10,14,3,0,0,0,0,1,4
../kbl_data/2024-2025,S45G01N218,수원 KT,Home,박성재,10,2,4,50.0,2,5,40.0,4,9,44.4,0,0,0.0,3,0,3,2,1,0,0,0,0,3
../kbl_data/2024-2025,S45G01N218,수원 KT,Home,조엘 카굴랑안,3,1,2,50.0,0,2,0.0,1,4,25.0,1,3,33.3,1,1,2,0,1,0,1,0,1,4
../kbl_data/2024-2025,S45G01N218,고양 소노,Away,정희재,0,0,1,0.0,0,2,0.0,0,3,0.0,0,0,0.0,1,3,4,2,1,2,0,0,1,2
../kbl_data/2024-2025,S45G01N218,고양 소노,Away,임동섭,0,0,0,0.0,0,1,0.0,0,1,0.0,0,0,0.0,1,0,1,0,0,0,0,0,0,4
../kbl_data/2024-2025,S45G01N218,고양 소노,Away,이재도,27,6,8,75.0,4,8,50.0,10,16,62.5,3,4,75.0,3,2,5,5,1,0,0,0,2,2
../kbl_data/2024-2025,S45G01N218,고양 소노,Away,최승욱,5,1,1,100.0,1,3,33.3,2,4,50.0,0,0,0.0,2,0,2,2,0,0,0,0,0,2
../kbl_data/2024-2025,S45G01N218,고양 소노,Away,김진유,0,0,0,0.0,0,0,0.0,0,0,0.0,0,0,0.0,0,1,1,0,0,0,0,0,0,2
../kbl_data/2024-2025,S45G01N218,고양 소노,Away,이정현,4,0,4,0.0,0,7,0.0,0,11,0.0,4,4,100.0,0,3,3,1,0,0,0,0,2,0
../kbl_data/2024-2025,S45G01N218,고양 소노,Away,문시윤,0,0,0,0.0,0,0,0.0,0,0,0.0,0,0,0.0,0,0,0,0,0,0,0,0,0,0
../kbl_data/2024-2025,S45G01N218,고양 소노,Away,박종하,0,0,0,0.0,0,0,0.0,0,0,0.0,0,0,0.0,0,0,0,0,0,0,0,0,0,0
../kbl_data/2024-2025,S45G01N218,고양 소노,Away,민기남,0,0,0,0.0,0,0,0.0,0,0,0.0,0,0,0.0,0,0,0,0,0,0,0,0,0,2
../kbl_data/2024-2025,S45G01N218,고양 소노,Away,디제이 번즈 Jr,10,5,11,45.5,0,0,0.0,5,11,45.5,0,0,0.0,1,2,3,2,0,0,0,0,1,2
../kbl_data/2024-2025,S45G01N218,고양 소노,Away,이근준,5,1,1,100.0,1,3,33.3,2,4,50.0,0,0,0.0,1,3,4,0,2,2,0,0,2,3
../kbl_data/2024-2025,S45G01N218,고양 소노,Away,케빈 켐바오,12,1,6,16.7,3,7,42.9,4,13,30.8,1,1,100.0,1,8,9,2,2,1,0,0,6,1
../kbl_data/2024-2025,S45G01N219,창원 LG,Home,허일영,0,0,1,0.0,0,1,0.0,0,2,0.0,0,0,0.0,0,0,0,0,0,0,0,0,0,1
../kbl_data/2024-2025,S45G01N219,창원 LG,Home,최진수,0,0,0,0.0,0,1,0.0,0,1,0.0,0,0,0.0,0,0,0,0,0,0,0,0,0,1
../kbl_data/2024-2025,S45G01N219,창원 LG,Home,두경민,8,1,2,50.0,2,5,40.0,3,7,42.9,0,0,0.0,0,4,4,4,0,0,0,0,1,1
../kbl_data/2024-2025,S45G01N219,창원 LG,Home,정인덕,10,0,1,0.0,2,5,40.0,2,6,33.3,4,4,100.0,1,3,4,1,0,0,0,0,0,3
../kbl_data/2024-2025,S45G01N219,창원 LG,Home,대릴 먼로,6,3,3,100.0,0,1,0.0,3,4,75.0,0,0,0.0,0,1,1,1,1,0,1,0,0,2
../kbl_data/2024-2025,S45G01N219,창원 LG,Home,박정현,2,1,2,50.0,0,0,0.0,1,2,50.0,0,0,0.0,0,0,0,1,0,0,0,0,0,0
../kbl_data/2024-2025,S45G01N219,창원 LG,Home,아셈 마레이,24,8,15,53.3,1,1,100.0,9,16,56.2,5,7,71.4,5,7,12,4,2,1,1,1,2,4
../kbl_data/2024-2025,S45G01N219,창원 LG,Home,양준석,7,2,7,28.6,1,5,20.0,3,12,25.0,0,0,0.0,1,3,4,6,0,0,1,0,0,3
../kbl_data/2024-2025,S45G01N219,창원 LG,Home,유기상,10,1,5,20.0,2,10,20.0,3,15,20.0,2,2,100.0,0,3,3,1,0,0,0,0,2,2
../kbl_data/2024-2025,S45G01N219,창원 LG,Home,이경도,0,0,0,0.0,0,0,0.0,0,0,0.0,0,0,0.0,0,0,0,0,0,0,0,0,0,0
../kbl_data/2024-2025,S45G01N219,창원 LG,Home,칼 타마요,17,5,9,55.6,2,4,50.0,7,13,53.8,1,1,100.0,2,6,8,3,0,0,0,0,2,3
../kbl_data/2024-2025,S45G01N219,창원 LG,Home,최형찬,0,0,0,0.0,0,0,0.0,0,0,0.0,0,0,0.0,0,0,0,0,0,0,0,0,0,0
../kbl_data/2024-2025,S45G01N219,울산 현대모비스,Away,함지훈,11,3,3,100.0,1,2,50.0,4,5,80.0,2,2,100.0,0,0,0,3,0,0,0,0,0,1
../kbl_data/2024-2025,S45G01N219,울산 현대모비스,Away,장재석,0,0,1,0.0,0,0,0.0,0,1,0.0,0,0,0.0,1,0,1,1,0,0,0,0,1,0
../kbl_data/2024-2025,S45G01N219,울산 현대모비스,Away,이대헌,8,2,4,50.0,1,2,50.0,3,6,50.0,1,4,25.0,0,3,3,1,2,0,0,0,1,2
../kbl_data/2024-2025,S45G01N219,울산 현대모비스,Away,한호빈,8,1,1,100.0,2,10,20.0,3,11,27.3,0,0,0.0,1,3,4,3,0,0,0,0,1,2
../kbl_data/2024-2025,S45G01N219,울산 현대모비스,Away,김국찬,3,0,0,0.0,1,3,33.3,1,3,33.3,0,0,0.0,0,0,0,1,1,1,0,0,0,2
../kbl_data/2024-2025,S45G01N219,울산 현대모비스,Away,서명진,2,1,3,33.3,0,2,0.0,1,5,20.0,0,0,0.0,0,1,1,1,0,0,0,0,0,2
../kbl_data/2024-2025,S45G01N219,울산 현대모비스,Away,숀 롱,14,4,8,50.0,1,2,50.0,5,10,50.0,3,3,100.0,4,9,13,4,0,0,0,0,3,4
../kbl_data/2024-2025,S45G01N219,울산 현대모비스,Away,이우석,18,3,7,42.9,3,6,50.0,6,13,46.2,3,4,75.0,1,4,5,4,0,0,0,0,3,2
../kbl_data/2024-2025,S45G01N219,울산 현대모비스,Away,신민석,2,1,1,100.0,0,0,0.0,1,1,100.0,0,0,0.0,0,0,0,0,0,0,0,0,0,0
../kbl_data/2024-2025,S45G01N219,울산 현대모비스,Away,김동준,0,0,0,0.0,0,0,0.0,0,0,0.0,0,0,0.0,0,0,0,0,0,0,0,0,0,0
../kbl_data/2024-2025,S45G01N219,울산 현대모비스,Away,게이지 프림,10,3,6,50.0,0,0,0.0,3,6,50.0,4,4,100.0,0,5,5,2,1,0,0,0,0,4
../kbl_data/2024-2025,S45G01N219,울산 현대모비스,Away,박무빈,5,2,4,50.0,0,4,0.0,2,8,25.0,1,2,50.0,4,2,6,2,0,0,0,0,0,1
../kbl_data/2024-2025,S45G01N220,서울 SK,Home,김선형,10,2,6,33.3,1,7,14.3,3,13,23.1,3,3,100.0,2,1,3,5,2,0,0,0,0,1
../kbl_data/2024-2025,S45G01N220,서울 SK,Home,오세근,4,1,3,33.3,0,1,0.0,1,4,25.0,2,2,100.0,1,1,2,0,1,0,0,0,0,1
../kbl_data/2024-2025,S45G01N220,서울 SK,Home,최부경,4,2,2,100.0,0,0,0.0,2,2,100.0,0,0,0.0,0,2,2,1,0,1,0,0,0,0
../kbl_data/2024-2025,S45G01N220,서울 SK,Home,최원혁,4,1,1,100.0,0,0,0.0,1,1,100.0,2,2,100.0,0,2,2,3,1,0,0,0,1,3
../kbl_data/2024-2025,S45G01N220,서울 SK,Home,김지후,0,0,0,0.0,0,0,0.0,0,0,0.0,0,0,0.0,0,0,0,0,0,0,0,0,0,0
../kbl_data/2024-2025,S45G01N220,서울 SK,Home,안영준,13,2,7,28.6,2,5,40.0,4,12,33.3,3,3,100.0,0,4,4,2,1,0,0,0,1,1
../kbl_data/2024-2025,S45G01N220,서울 SK,Home,자밀 워니,23,7,15,46.7,3,5,60.0,10,20,50.0,0,0,0.0,0,10,10,4,2,2,0,1,3,2
../kbl_data/2024-2025,S45G01N220,서울 SK,Home,김형빈,6,0,1,0.0,2,2,100.0,2,3,66.7,0,0,0.0,0,0,0,1,1,0,0,0,1,4
../kbl_data/2024-2025,S45G01N220,서울 SK,Home,아이재아 힉스,3,1,2,50.0,0,1,0.0,1,3,33.3,1,2,50.0,1,3,4,1,0,0,0,0,0,0
../kbl_data/2024-2025,S45G01N220,서울 SK,Home,오재현,13,5,8,62.5,1,5,20.0,6,13,46.2,0,0,0.0,1,3,4,2,1,0,0,0,0,3
../kbl_data/2024-2025,S45G01N220,서울 SK,Home,고메즈 델 리아노,0,0,0,0.0,0,0,0.0,0,0,0.0,0,0,0.0,0,0,0,0,0,0,0,0,0,0
../kbl_data/2024-2025,S45G01N220,서울 SK,Home,김태훈,0,0,0,0.0,0,0,0.0,0,0,0.0,0,0,0.0,0,0,0,0,0,0,0,0,1,1
../kbl_data/2024-2025,S45G01N220,원주 DB,Away,이관희,0,0,1,0.0,0,3,0.0,0,4,0.0,0,0,0.0,0,0,0,1,0,1,0,0,0,1
../kbl_data/2024-2025,S45G01N220,원주 DB,Away,김시래,14,1,2,50.0,4,6,66.7,5,8,62.5,0,0,0.0,0,0,0,0,0,0,0,0,1,2
../kbl_data/2024-2025,S45G01N220,원주 DB,Away,정효근,2,1,3,33.3,0,1,0.0,1,4,25.0,0,0,0.0,1,1,2,1,1,0,0,0,0,0
../kbl_data/2024-2025,S45G01N220,원주 DB,Away,박봉진,0,0,0,0.0,0,0,0.0,0,0,0.0,0,0,0.0,0,0,0,0,0,0,0,0,0,0
../kbl_data/2024-2025,S45G01N220,원주 DB,Away,강상재,0,0,5,0.0,0,2,0.0,0,7,0.0,0,0,0.0,10,12,22,3,1,1,0,0,2,2
../kbl_data/2024-2025,S45G01N220,원주 DB,Away,최성원,27,4,6,66.7,5,8,62.5,9,14,64.3,4,4,100.0,1,4,5,2,1,0,0,0,3,4
../kbl_data/2024-2025,S45G01N220,원주 DB,Away,치나누 오누아쿠,3,1,2,50.0,0,2,0.0,1,4,25.0,1,1,100.0,0,1,1,0,0,0,0,0,0,1
../kbl_data/2024-2025,S45G01N220,원주 DB,Away,오마리 스펠맨,15,3,6,50.0,3,9,33.3,6,15,40.0,0,0,0.0,0,6,6,4,0,0,0,0,1,0
../kbl_data/2024-2025,S45G01N220,원주 DB,Away,정호영,0,0,0,0.0,0,0,0.0,0,0,0.0,0,0,0.0,0,0,0,0,0,0,0,0,0,0
../kbl_data/2024-2025,S45G01N220,원주 DB,Away,이선 알바노,23,7,9,77.8,3,9,33.3,10,18,55.6,0,0,0.0,1,4,5,3,0,0,0,0,3,4
../kbl_data/2024-2025,S45G01N220,원주 DB,Away,박인웅,0,0,0,0.0,0,1,0.0,0,1,0.0,0,0,0.0,0,0,0,0,0,0,0,0,0,0
../kbl_data/2024-2025,S45G01N220,원주 DB,Away,김보배,4,2,5,40.0,0,0,0.0,2,5,40.0,0,0,0.0,4,3,7,2,0,5,1,1,1,2
../kbl_data/2024-2025,S45G01N221,대구 한국가스공사,Home,차바위,0,0,0,0.0,0,1,0.0,0,1,0.0,0,0,0.0,1,0,1,0,0,0,0,0,0,0
../kbl_data/2024-2025,S45G01N221,대구 한국가스공사,Home,박지훈,2,1,1,100.0,0,1,0.0,1,2,50.0,0,0,0.0,1,4,5,0,1,0,0,0,1,2
../kbl_data/2024-2025,S45G01N221,대구 한국가스공사,Home,김준일,4,2,5,40.0,0,0,0.0,2,5,40.0,0,0,0.0,4,5,9,4,0,0,0,0,2,3
../kbl_data/2024-2025,S45G01N221,대구 한국가스공사,Home,정성우,12,3,8,37.5,2,3,66.7,5,11,45.5,0,0,0.0,1,0,1,2,4,1,0,0,1,2
../kbl_data/2024-2025,S45G01N221,대구 한국가스공사,Home,김낙현,0,0,0,0.0,0,8,0.0,0,8,0.0,0,0,0.0,0,0,0,3,2,0,0,0,0,2
../kbl_data/2024-2025,S45G01N221,대구 한국가스공사,Home,곽정훈,3,0,0,0.0,1,4,25.0,1,4,25.0,0,0,0.0,2,1,3,1,0,0,0,0,1,3
../kbl_data/2024-2025,S45G01N221,대구 한국가스공사,Home,이도헌,0,0,1,0.0,0,2,0.0,0,3,0.0,0,0,0.0,0,0,0,0,1,0,0,0,0,2
../kbl_data/2024-2025,S45G01N221,대구 한국가스공사,Home,앤드류 니콜슨,31,7,14,50.0,4,8,50.0,11,22,50.0,5,6,83.3,3,7,10,2,1,0,0,1,3,0
../kbl_data/2024-2025,S45G01N221,대구 한국가스공사,Home,신승민,0,0,2,0.0,0,0,0.0,0,2,0.0,0,0,0.0,2,1,3,1,0,0,0,0,0,1
../kbl_data/2024-2025,S45G01N221,대구 한국가스공사,Home,샘조세프 벨란겔,10,2,4,50.0,1,5,20.0,3,9,33.3,3,3,100.0,1,5,6,3,1,2,0,0,1,2
../kbl_data/2024-2025,S45G01N221,대구 한국가스공사,Home,유슈 은도예,7,1,3,33.3,1,2,50.0,2,5,40.0,2,4,50.0,3,3,6,0,0,0,0,0,0,4
../kbl_data/2024-2025,S45G01N221,대구 한국가스공사,Home,신주영,1,0,1,0.0,0,2,0.0,0,3,0.0,1,2,50.0,1,3,4,1,0,0,0,0,0,1
../kbl_data/2024-2025,S45G01N221,부산 KCC,Away,정창영,4,2,5,40.0,0,0,0.0,2,5,40.0,0,0,0.0,0,1,1,0,1,0,0,0,0,3
../kbl_data/2024-2025,S45G01N221,부산 KCC,Away,전준범,0,0,0,0.0,0,2,0.0,0,2,0.0,0,0,0.0,0,4,4,0,1,1,0,0,1,4
../kbl_data/2024-2025,S45G01N221,부산 KCC,Away,허웅,2,1,4,25.0,0,4,0.0,1,8,12.5,0,0,0.0,0,3,3,4,1,0,0,0,3,1
../kbl_data/2024-2025,S45G01N221,부산 KCC,Away,이승현,4,2,6,33.3,0,0,0.0,2,6,33.3,0,2,0.0,2,5,7,4,1,2,0,0,1,1
../kbl_data/2024-2025,S45G01N221,부산 KCC,Away,이호현,9,3,6,50.0,1,1,100.0,4,7,57.1,0,1,0.0,0,3,3,2,0,0,0,0,2,0
../kbl_data/2024-2025,S45G01N221,부산 KCC,Away,전태영,0,0,0,0.0,0,0,0.0,0,0,0.0,0,0,0.0,0,0,0,0,0,0,0,0,0,0
../kbl_data/2024-2025,S45G01N221,부산 KCC,Away,캐디 라렌,8,4,7,57.1,0,0,0.0,4,7,57.1,0,0,0.0,0,1,1,0,0,0,0,1,3,2
../kbl_data/2024-2025,S45G01N221,부산 KCC,Away,이근휘,3,0,0,0.0,1,6,16.7,1,6,16.7,0,0,0.0,1,1,2,0,0,0,0,0,0,1
../kbl_data/2024-2025,S45G01N221,부산 KCC,Away,캘빈 제프리 에피스톨라,1,0,2,0.0,0,1,0.0,0,3,0.0,1,2,50.0,1,1,2,3,0,0,0,0,0,1
../kbl_data/2024-2025,S45G01N221,부산 KCC,Away,이주영,0,0,0,0.0,0,0,0.0,0,0,0.0,0,0,0.0,0,0,0,0,0,0,0,0,0,0
../kbl_data/2024-2025,S45G01N221,부산 KCC,Away,이찬영,2,1,1,100.0,0,0,0.0,1,1,100.0,0,1,0.0,1,0,1,0,0,0,0,0,1,0
../kbl_data/2024-2025,S45G01N221,부산 KCC,Away,도노반 스미스,24,7,12,58.3,1,4,25.0,8,16,50.0,7,10,70.0,6,8,14,1,4,1,0,2,2,4
../kbl_data/2024-2025,S45G01N222,서울 삼성,Home,이정현,11,3,10,30.0,1,3,33.3,4,13,30.8,2,2,100.0,1,1,2,7,1,0,0,0,3,3
../kbl_data/2024-2025,S45G01N222,서울 삼성,Home,최현민,0,0,1,0.0,0,1,0.0,0,2,0.0,0,0,0.0,0,3,3,2,2,0,0,0,1,4
../kbl_data/2024-2025,S45G01N222,서울 삼성,Home,이원대,0,0,0,0.0,0,0,0.0,0,0,0.0,0,0,0.0,0,0,0,0,0,0,0,0,0,0
../kbl_data/2024-2025,S45G01N222,서울 삼성,Home,최성모,13,2,5,40.0,3,6,50.0,5,11,45.5,0,1,0.0,0,5,5,2,0,0,1,0,5,2
../kbl_data/2024-2025,S45G01N222,서울 삼성,Home,최승욱,0,0,0,0.0,0,0,0.0,0,0,0.0,0,0,0.0,1,1,2,0,1,0,0,0,0,1
../kbl_data/2024-2025,S45G01N222,서울 삼성,Home,윤성원,0,0,1,0.0,0,1,0.0,0,2,0.0,0,0,0.0,0,0,0,0,0,0,0,0,0,0
../kbl_data/2024-2025,S45G01N222,서울 삼성,Home,차민석,0,0,0,0.0,0,0,0.0,0,0,0.0,0,0,0.0,0,0,0,0,0,0,0,0,0,0
../kbl_data/2024-2025,S45G01N222,서울 삼성,Home,이원석,10,2,5,40.0,1,1,100.0,3,6,50.0,3,4,75.0,1,1,2,1,0,0,0,0,3,1
../kbl_data/2024-2025,S45G01N222,서울 삼성,Home,저스틴 구탕,16,5,7,71.4,2,3,66.7,7,10,70.0,0,0,0.0,0,6,6,5,3,1,0,2,1,2
../kbl_data/2024-2025,S45G01N222,서울 삼성,Home,박승재,0,0,0,0.0,0,0,0.0,0,0,0.0,0,0,0.0,0,1,1,1,1,0,0,0,0,2
../kbl_data/2024-2025,S45G01N222,서울 삼성,Home,코피 코번,29,13,19,68.4,0,0,0.0,13,19,68.4,3,7,42.9,14,7,21,2,0,0,0,2,4,1
../kbl_data/2024-2025,S45G01N222,서울 삼성,Home,글렌 로빈슨 3세,4,1,4,25.0,0,1,0.0,1,5,20.0,2,2,100.0,0,5,5,1,0,0,0,1,2,0
../kbl_data/2024-2025,S45G01N222,수원 KT,Away,문성곤,2,1,1,100.0,0,3,0.0,1,4,25.0,0,0,0.0,0,2,2,1,1,0,0,0,1,2
../kbl_data/2024-2025,S45G01N222,수원 KT,Away,이현석,1,0,0,0.0,0,0,0.0,0,0,0.0,1,2,50.0,0,1,1,0,0,0,0,0,0,1
../kbl_data/2024-2025,S45G01N222,수원 KT,Away,허훈,6,1,6,16.7,1,6,16.7,2,12,16.7,1,2,50.0,0,0,0,4,4,0,0,0,5,0
../kbl_data/2024-2025,S45G01N222,수원 KT,Away,이윤기,3,0,0,0.0,1,1,100.0,1,1,100.0,0,0,0.0,0,0,0,0,0,0,0,0,0,0
../kbl_data/2024-2025,S45G01N222,수원 KT,Away,박지원,0,0,0,0.0,0,0,0.0,0,0,0.0,0,0,0.0,0,1,1,0,1,0,0,0,0,0
../kbl_data/2024-2025,S45G01N222,수원 KT,Away,하윤기,18,9,14,64.3,0,0,0.0,9,14,64.3,0,0,0.0,4,2,6,1,1,3,0,0,1,0
../kbl_data/2024-2025,S45G01N222,수원 KT,Away,이두원,0,0,0,0.0,0,0,0.0,0,0,0.0,0,0,0.0,0,0,0,0,0,0,0,0,0,5
../kbl_data/2024-2025,S45G01N222,수원 KT,Away,박선웅,0,0,0,0.0,0,0,0.0,0,0,0.0,0,0,0.0,0,0,0,0,0,0,0,0,0,0
../kbl_data/2024-2025,S45G01N222,수원 KT,Away,문정현,8,1,3,33.3,2,6,33.3,3,9,33.3,0,0,0.0,2,4,6,1,0,1,1,0,1,4
../kbl_data/2024-2025,S45G01N222,수원 KT,Away,레이션 해먼즈,17,5,10,50.0,2,6,33.3,7,16,43.8,1,2,50.0,1,4,5,2,2,0,0,0,0,4
../kbl_data/2024-2025,S45G01N222,수원 KT,Away,박성재,9,2,2,100.0,1,3,33.3,3,5,60.0,2,2,100.0,1,2,3,4,1,0,1,0,2,0
../kbl_data/2024-2025,S45G01N222,수원 KT,Away,조엘 카굴랑안,9,3,5,60.0,1,3,33.3,4,8,50.0,0,1,0.0,0,0,0,2,1,0,0,0,2,1
../kbl_data/2024-2025,S45G01N223,고양 소노,Home,정희재,3,1,1,100.0,0,0,0.0,1,1,100.0,1,2,50.0,0,0,0,0,1,0,0,0,0,2
../kbl_data/2024-2025,S45G01N223,고양 소노,Home,임동섭,8,0,2,0.0,2,5,40.0,2,7,28.6,2,2,100.0,0,4,4,0,0,0,0,0,0,2
../kbl_data/2024-2025,S45G01N223,고양 소노,Home,이재도,5,0,1,0.0,1,3,33.3,1,4,25.0,2,2,100.0,1,5,6,3,0,0,0,0,1,3
../kbl_data/2024-2025,S45G01N223,고양 소노,Home,최승욱,2,1,2,50.0,0,1,0.0,1,3,33.3,0,0,0.0,2,4,6,0,0,0,0,0,0,2
../kbl_data/2024-2025,S45G01N223,고양 소노,Home,김진유,0,0,0,0.0,0,0,0.0,0,0,0.0,0,0,0.0,0,0,0,0,0,0,0,0,0,0
../kbl_data/2024-2025,S45G01N223,고양 소노,Home,이정현,13,2,6,33.3,3,7,42.9,5,13,38.5,0,0,0.0,0,2,2,5,0,0,0,0,1,2
../kbl_data/2024-2025,S45G01N223,고양 소노,Home,문시윤,0,0,0,0.0,0,0,0.0,0,0,0.0,0,0,0.0,0,0,0,0,0,0,0,0,0,0
../kbl_data/2024-2025,S45G01N223,고양 소노,Home,박종하,0,0,0,0.0,0,0,0.0,0,0,0.0,0,0,0.0,0,0,0,0,0,0,0,0,0,2
../kbl_data/2024-2025,S45G01N223,고양 소노,Home,민기남,0,0,0,0.0,0,0,0.0,0,0,0.0,0,0,0.0,0,0,0,0,0,0,0,0,0,0
../kbl_data/2024-2025,S45G01N223,고양 소노,Home,디제이 번즈 Jr,27,13,20,65.0,0,0,0.0,13,20,65.0,1,3,33.3,3,2,5,4,1,1,0,0,1,3
../kbl_data/2024-2025,S45G01N223,고양 소노,Home,이근준,0,0,0,0.0,0,1,0.0,0,1,0.0,0,0,0.0,0,0,0,1,0,0,0,0,0,1
../kbl_data/2024-2025,S45G01N223,고양 소노,Home,케빈 켐바오,26,7,12,58.3,3,8,37.5,10,20,50.0,3,3,100.0,2,6,8,3,2,0,0,0,6,3
../kbl_data/2024-2025,S45G01N223,안양 정관장,Away,송창용,5,0,0,0.0,1,3,33.3,1,3,33.3,2,2,100.0,0,1,1,1,0,0,0,0,1,2
../kbl_data/2024-2025,S45G01N223,안양 정관장,Away,정준원,9,3,4,75.0,1,3,33.3,4,7,57.1,0,1,0.0,3,1,4,1,1,0,0,0,2,5
../kbl_data/2024-2025,S45G01N223,안양 정관장,Away,김영현,0,0,0,0.0,0,0,0.0,0,0,0.0,0,0,0.0,0,0,0,0,0,0,0,0,0,0
../kbl_data/2024-2025,S45G01N223,안양 정관장,Away,김종규,0,0,0,0.0,0,0,0.0,0,0,0.0,0,0,0.0,0,0,0,0,0,0,0,0,0,0
../kbl_data/2024-2025,S45G01N223,안양 정관장,Away,박지훈,20,8,10,80.0,1,5,20.0,9,15,60.0,1,1,100.0,0,3,3,6,2,0,0,0,0,2
../kbl_data/2024-2025,S45G01N223,안양 정관장,Away,디온테 버튼,6,2,3,66.7,0,1,0.0,2,4,50.0,2,4,50.0,0,2,2,4,1,1,0,1,1,0
../kbl_data/2024-2025,S45G01N223,안양 정관장,Away,변준형,5,1,3,33.3,1,3,33.3,2,6,33.3,0,0,0.0,1,0,1,1,2,0,0,0,1,1
../kbl_data/2024-2025,S45G01N223,안양 정관장,Away,김경원,0,0,0,0.0,0,0,0.0,0,0,0.0,0,0,0.0,0,0,0,0,0,0,0,0,0,0
../kbl_data/2024-2025,S45G01N223,안양 정관장,Away,한승희,9,3,6,50.0,1,4,25.0,4,10,40.0,0,0,0.0,1,4,5,1,0,0,0,0,1,2
../kbl_data/2024-2025,S45G01N223,안양 정관장,Away,조니 오브라이언트,21,10,14,71.4,0,4,0.0,10,18,55.6,1,2,50.0,5,5,10,1,0,0,0,0,0,3
../kbl_data/2024-2025,S45G01N223,안양 정관장,Away,하비 고메즈,11,0,0,0.0,3,8,37.5,3,8,37.5,2,2,100.0,1,5,6,2,1,1,0,0,3,4
../kbl_data/2024-2025,S45G01N223,안양 정관장,Away,소준혁,0,0,0,0.0,0,0,0.0,0,0,0.0,0,0,0.0,0,0,0,0,0,0,0,0,0,0
../kbl_data/2024-2025,S45G01N224,수원 KT,Home,문성곤,0,0,0,0.0,0,0,0.0,0,0,0.0,0,0,0.0,0,0,0,1,1,0,0,0,0,0
../kbl_data/2024-2025,S45G01N224,수원 KT,Home,이현석,0,0,0,0.0,0,0,0.0,0,0,0.0,0,0,0.0,0,1,1,0,0,0,0,0,0,1
../kbl_data/2024-2025,S45G01N224,수원 KT,Home,허훈,19,4,5,80.0,3,7,42.9,7,12,58.3,2,2,100.0,0,3,3,3,2,0,0,0,3,3
../kbl_data/2024-2025,S45G01N224,수원 KT,Home,최진광,0,0,1,0.0,0,0,0.0,0,1,0.0,0,0,0.0,0,0,0,0,0,0,0,0,0,0
../kbl_data/2024-2025,S45G01N224,수원 KT,Home,이윤기,0,0,0,0.0,0,0,0.0,0,0,0.0,0,0,0.0,0,0,0,0,0,0,0,0,0,0
../kbl_data/2024-2025,S45G01N224,수원 KT,Home,박지원,1,0,0,0.0,0,0,0.0,0,0,0.0,1,2,50.0,0,0,0,0,0,0,0,0,1,1
../kbl_data/2024-2025,S45G01N224,수원 KT,Home,하윤기,10,2,4,50.0,0,0,0.0,2,4,50.0,6,6,100.0,1,4,5,3,0,0,1,0,1,1
../kbl_data/2024-2025,S45G01N224,수원 KT,Home,이두원,1,0,0,0.0,0,1,0.0,0,1,0.0,1,2,50.0,0,0,0,2,1,1,0,0,0,2
../kbl_data/2024-2025,S45G01N224,수원 KT,Home,문정현,16,4,6,66.7,2,5,40.0,6,11,54.5,2,2,100.0,1,5,6,2,1,0,0,0,0,3
../kbl_data/2024-2025,S45G01N224,수원 KT,Home,레이션 해먼즈,26,7,9,77.8,2,6,33.3,9,15,60.0,6,8,75.0,2,10,12,1,3,0,0,1,3,2
../kbl_data/2024-2025,S45G01N224,수원 KT,Home,박성재,9,1,3,33.3,2,3,66.7,3,6,50.0,1,1,100.0,1,2,3,3,0,0,1,0,0,1
../kbl_data/2024-2025,S45G01N224,수원 KT,Home,조엘 카굴랑안,8,4,6,66.7,0,3,0.0,4,9,44.4,0,0,0.0,0,2,2,6,0,0,0,0,2,3
../kbl_data/2024-2025,S45G01N224,창원 LG,Away,허일영,7,2,3,66.7,1,3,33.3,3,6,50.0,0,2,0.0,2,4,6,1,0,0,0,0,0,4
../kbl_data/2024-2025,S45G01N224,창원 LG,Away,최진수,0,0,1,0.0,0,0,0.0,0,1,0.0,0,0,0.0,0,1,1,0,1,0,0,0,1,2
../kbl_data/2024-2025,S45G01N224,창원 LG,Away,두경민,7,1,1,100.0,1,7,14.3,2,8,25.0,2,2,100.0,0,3,3,2,0,1,0,0,2,0
../kbl_data/2024-2025,S45G01N224,창원 LG,Away,정인덕,5,0,1,0.0,1,5,20.0,1,6,16.7,2,2,100.0,2,1,3,1,1,0,0,0,1,1
../kbl_data/2024-2025,S45G01N224,창원 LG,Away,대릴 먼로,8,4,5,80.0,0,0,0.0,4,5,80.0,0,0,0.0,3,1,4,2,1,0,0,0,2,0
../kbl_data/2024-2025,S45G01N224,창원 LG,Away,박정현,4,1,2,50.0,0,0,0.0,1,2,50.0,2,3,66.7,1,2,3,0,0,0,0,0,0,1
../kbl_data/2024-2025,S45G01N224,창원 LG,Away,아셈 마레이,8,4,5,80.0,0,0,0.0,4,5,80.0,0,2,0.0,4,4,8,3,2,0,0,1,3,3
../kbl_data/2024-2025,S45G01N224,창원 LG,Away,양준석,9,3,3,100.0,1,5,20.0,4,8,50.0,0,0,0.0,0,1,1,3,0,0,0,0,1,4
../kbl_data/2024-2025,S45G01N224,창원 LG,Away,유기상,11,1,2,50.0,2,9,22.2,3,11,27.3,3,3,100.0,1,1,2,2,1,1,1,0,1,1
../kbl_data/2024-2025,S45G01N224,창원 LG,Away,이경도,0,0,1,0.0,0,1,0.0,0,2,0.0,0,0,0.0,0,0,0,0,0,0,0,0,2,0
../kbl_data/2024-2025,S45G01N224,창원 LG,Away,칼 타마요,0,0,3,0.0,0,2,0.0,0,5,0.0,0,0,0.0,0,0,0,1,1,0,0,0,1,2
../kbl_data/2024-2025,S45G01N224,창원 LG,Away,최형찬,3,0,1,0.0,1,3,33.3,1,4,25.0,0,0,0.0,1,0,1,0,0,0,0,0,0,4
../kbl_data/2024-2025,S45G01N225,울산 현대모비스,Home,함지훈,4,2,2,100.0,0,0,0.0,2,2,100.0,0,0,0.0,0,2,2,2,1,1,0,0,0,2
../kbl_data/2024-2025,S45G01N225,울산 현대모비스,Home,장재석,4,1,4,25.0,0,0,0.0,1,4,25.0,2,2,100.0,1,3,4,2,0,0,0,0,0,2
../kbl_data/2024-2025,S45G01N225,울산 현대모비스,Home,이대헌,7,2,3,66.7,1,3,33.3,3,6,50.0,0,2,0.0,1,2,3,1,0,0,0,0,0,2
../kbl_data/2024-2025,S45G01N225,울산 현대모비스,Home,한호빈,6,0,1,0.0,2,5,40.0,2,6,33.3,0,0,0.0,1,1,2,3,0,0,0,0,0,4
../kbl_data/2024-2025,S45G01N225,울산 현대모비스,Home,서명진,7,2,4,50.0,1,4,25.0,3,8,37.5,0,0,0.0,1,0,1,2,0,0,0,0,1,3
../kbl_data/2024-2025,S45G01N225,울산 현대모비스,Home,숀 롱,3,1,1,100.0,0,0,0.0,1,1,100.0,1,2,50.0,1,1,2,0,0,0,0,0,1,1
../kbl_data/2024-2025,S45G01N225,울산 현대모비스,Home,이우석,5,0,5,0.0,1,3,33.3,1,8,12.5,2,2,100.0,2,3,5,3,2,0,0,0,5,2
../kbl_data/2024-2025,S45G01N225,울산 현대모비스,Home,신민석,4,2,3,66.7,0,1,0.0,2,4,50.0,0,0,0.0,1,2,3,0,1,0,0,0,0,0
../kbl_data/2024-2025,S45G01N225,울산 현대모비스,Home,김동준,2,0,1,0.0,0,1,0.0,0,2,0.0,2,2,100.0,0,0,0,0,0,0,0,0,0,1
../kbl_data/2024-2025,S45G01N225,울산 현대모비스,Home,게이지 프림,26,12,21,57.1,0,1,0.0,12,22,54.5,2,2,100.0,4,3,7,3,1,0,0,0,3,4
../kbl_data/2024-2025,S45G01N225,울산 현대모비스,Home,박무빈,0,0,0,0.0,0,0,0.0,0,0,0.0,0,0,0.0,0,0,0,0,1,0,0,0,2,0
../kbl_data/2024-2025,S45G01N225,울산 현대모비스,Home,미구엘 안드레 옥존,8,2,3,66.7,1,5,20.0,3,8,37.5,1,2,50.0,1,1,2,2,0,1,0,0,1,0
../kbl_data/2024-2025,S45G01N225,부산 KCC,Away,정창영,6,2,4,50.0,0,1,0.0,2,5,40.0,2,4,50.0,0,2,2,4,0,0,0,0,0,3
../kbl_data/2024-2025,S45G01N225,부산 KCC,Away,전준범,9,3,3,100.0,1,2,50.0,4,5,80.0,0,0,0.0,0,2,2,6,0,0,0,0,1,4
../kbl_data/2024-2025,S45G01N225,부산 KCC,Away,이승현,25,10,14,71.4,1,4,25.0,11,18,61.1,2,2,100.0,1,5,6,4,1,1,1,0,2,2
../kbl_data/2024-2025,S45G01N225,부산 KCC,Away,이호현,8,4,5,80.0,0,1,0.0,4,6,66.7,0,0,0.0,0,0,0,8,1,0,1,0,1,2
../kbl_data/2024-2025,S45G01N225,부산 KCC,Away,전태영,2,1,1,100.0,0,0,0.0,1,1,100.0,0,0,0.0,1,0,1,0,0,0,0,0,0,1
../kbl_data/2024-2025,S45G01N225,부산 KCC,Away,캐디 라렌,24,10,15,66.7,0,1,0.0,10,16,62.5,4,5,80.0,2,7,9,2,1,0,0,1,2,1
../kbl_data/2024-2025,S45G01N225,부산 KCC,Away,이근휘,0,0,0,0.0,0,0,0.0,0,0,0.0,0,0,0.0,0,1,1,0,0,0,0,0,1,0
../kbl_data/2024-2025,S45G01N225,부산 KCC,Away,김동현,6,2,2,100.0,0,2,0.0,2,4,50.0,2,5,40.0,2,6,8,2,2,0,0,0,0,1
../kbl_data/2024-2025,S45G01N225,부산 KCC,Away,캘빈 제프리 에피스톨라,8,4,4,100.0,0,0,0.0,4,4,100.0,0,0,0.0,0,0,0,3,2,0,0,0,0,3
../kbl_data/2024-2025,S45G01N225,부산 KCC,Away,이주영,0,0,0,0.0,0,0,0.0,0,0,0.0,0,0,0.0,0,0,0,1,0,0,0,0,0,0
../kbl_data/2024-2025,S45G01N225,부산 KCC,Away,이찬영,2,1,3,33.3,0,0,0.0,1,3,33.3,0,0,0.0,1,0,1,0,1,0,0,0,0,0
../kbl_data/2024-2025,S45G01N225,부산 KCC,Away,도노반 스미스,12,6,9,66.7,0,1,0.0,6,10,60.0,0,0,0.0,3,2,5,1,0,0,0,1,1,2
../kbl_data/2024-2025,S45G01N226,원주 DB,Home,이관희,0,0,2,0.0,0,0,0.0,0,2,0.0,0,0,0.0,0,1,1,2,0,0,0,0,0,0
../kbl_data/2024-2025,S45G01N226,원주 DB,Home,김시래,0,0,0,0.0,0,3,0.0,0,3,0.0,0,0,0.0,0,1,1,2,0,0,0,0,1,3
../kbl_data/2024-2025,S45G01N226,원주 DB,Home,정효근,8,2,2,100.0,1,2,50.0,3,4,75.0,1,3,33.3,4,3,7,2,1,2,0,0,4,1
../kbl_data/2024-2025,S45G01N226,원주 DB,Home,강상재,0,0,3,0.0,0,0,0.0,0,3,0.0,0,0,0.0,1,2,3,1,0,0,0,0,0,1
../kbl_data/2024-2025,S45G01N226,원주 DB,Home,최성원,0,0,1,0.0,0,3,0.0,0,4,0.0,0,0,0.0,2,3,5,4,2,0,0,0,2,1
../kbl_data/2024-2025,S45G01N226,원주 DB,Home,치나누 오누아쿠,6,1,2,50.0,0,1,0.0,1,3,33.3,4,6,66.7,0,4,4,0,1,0,0,0,1,1
../kbl_data/2024-2025,S45G01N226,원주 DB,Home,김훈,8,1,1,100.0,2,3,66.7,3,4,75.0,0,0,0.0,1,1,2,0,0,0,0,0,2,1
../kbl_data/2024-2025,S45G01N226,원주 DB,Home,오마리 스펠맨,11,1,4,25.0,3,9,33.3,4,13,30.8,0,0,0.0,0,4,4,1,1,0,0,1,0,0
../kbl_data/2024-2025,S45G01N226,원주 DB,Home,정호영,0,0,0,0.0,0,0,0.0,0,0,0.0,0,0,0.0,0,0,0,0,0,0,0,0,0,0
../kbl_data/2024-2025,S45G01N226,원주 DB,Home,이선 알바노,12,3,11,27.3,2,8,25.0,5,19,26.3,0,0,0.0,0,5,5,4,1,0,0,0,3,2
../kbl_data/2024-2025,S45G01N226,원주 DB,Home,박인웅,12,2,4,50.0,2,4,50.0,4,8,50.0,2,2,100.0,2,4,6,0,1,0,0,0,2,3
../kbl_data/2024-2025,S45G01N226,원주 DB,Home,김보배,6,3,3,100.0,0,0,0.0,3,3,100.0,0,0,0.0,2,2,4,1,0,0,0,0,2,4
../kbl_data/2024-2025,S45G01N226,서울 SK,Away,김선형,17,4,8,50.0,3,7,42.9,7,15,46.7,0,0,0.0,3,3,6,4,1,0,0,0,2,3
../kbl_data/2024-2025,S45G01N226,서울 SK,Away,오세근,3,0,2,0.0,1,5,20.0,1,7,14.3,0,0,0.0,1,1,2,0,0,0,0,0,0,1
../kbl_data/2024-2025,S45G01N226,서울 SK,Away,최부경,5,1,2,50.0,1,2,50.0,2,4,50.0,0,0,0.0,1,3,4,2,2,0,0,0,0,3
../kbl_data/2024-2025,S45G01N226,서울 SK,Away,최원혁,3,1,1,100.0,0,1,0.0,1,2,50.0,1,2,50.0,1,2,3,3,3,0,0,0,0,2
../kbl_data/2024-2025,S45G01N226,서울 SK,Away,김지후,0,0,0,0.0,0,0,0.0,0,0,0.0,0,0,0.0,0,0,0,0,0,0,0,0,0,0
../kbl_data/2024-2025,S45G01N226,서울 SK,Away,안영준,19,2,4,50.0,3,8,37.5,5,12,41.7,6,8,75.0,3,4,7,2,1,4,0,0,1,2
../kbl_data/2024-2025,S45G01N226,서울 SK,Away,자밀 워니,15,5,12,41.7,1,6,16.7,6,18,33.3,2,2,100.0,1,9,10,4,1,1,0,0,1,0
../kbl_data/2024-2025,S45G01N226,서울 SK,Away,김형빈,3,0,0,0.0,1,2,50.0,1,2,50.0,0,0,0.0,0,0,0,0,0,1,0,0,0,0
../kbl_data/2024-2025,S45G01N226,서울 SK,Away,아이재아 힉스,0,0,2,0.0,0,1,0.0,0,3,0.0,0,0,0.0,1,0,1,1,0,0,0,0,1,3
../kbl_data/2024-2025,S45G01N226,서울 SK,Away,오재현,10,1,3,33.3,2,4,50.0,3,7,42.9,2,2,100.0,0,2,2,3,3,0,0,0,3,2
../kbl_data/2024-2025,S45G01N226,서울 SK,Away,고메즈 델 리아노,0,0,0,0.0,0,0,0.0,0,0,0.0,0,0,0.0,0,0,0,0,0,0,0,0,0,0
../kbl_data/2024-2025,S45G01N226,서울 SK,Away,김태훈,0,0,0,0.0,0,0,0.0,0,0,0.0,0,0,0.0,0,2,2,0,0,0,0,0,0,2
../kbl_data/2024-2025,S45G01N227,대구 한국가스공사,Home,차바위,0,0,0,0.0,0,0,0.0,0,0,0.0,0,0,0.0,0,0,0,0,0,0,0,0,0,0
../kbl_data/2024-2025,S45G01N227,대구 한국가스공사,Home,박지훈,20,6,12,50.0,2,4,50.0,8,16,50.0,2,4,50.0,4,4,8,10,0,0,0,0,12,4
../kbl_data/2024-2025,S45G01N227,대구 한국가스공사,Home,김준일,11,5,7,71.4,0,0,0.0,5,7,71.4,1,1,100.0,1,3,4,5,0,1,0,0,2,4
../kbl_data/2024-2025,S45G01N227,대구 한국가스공사,Home,정성우,13,2,4,50.0,2,3,66.7,4,7,57.1,3,3,100.0,0,1,1,6,3,0,0,0,1,3
../kbl_data/2024-2025,S45G01N227,대구 한국가스공사,Home,김낙현,2,1,3,33.3,0,7,0.0,1,10,10.0,0,0,0.0,1,1,2,4,1,0,0,0,2,2
../kbl_data/2024-2025,S45G01N227,대구 한국가스공사,Home,양재혁,0,0,0,0.0,0,2,0.0,0,2,0.0,0,0,0.0,0,0,0,0,0,0,0,0,0,0
../kbl_data/2024-2025,S45G01N227,대구 한국가스공사,Home,곽정훈,3,0,0,0.0,1,6,16.7,1,6,16.7,0,0,0.0,2,1,3,1,2,0,0,0,1,3
../kbl_data/2024-2025,S45G01N227,대구 한국가스공사,Home,앤드류 니콜슨,15,5,8,62.5,1,5,20.0,6,13,46.2,2,4,50.0,1,4,5,0,2,0,0,0,1,1
../kbl_data/2024-2025,S45G01N227,대구 한국가스공사,Home,신승민,3,1,2,50.0,0,1,0.0,1,3,33.3,1,2,50.0,1,1,2,1,0,0,0,0,0,2
../kbl_data/2024-2025,S45G01N227,대구 한국가스공사,Home,샘조세프 벨란겔,16,7,9,77.8,0,4,0.0,7,13,53.8,2,3,66.7,1,2,3,3,5,0,0,0,0,2
../kbl_data/2024-2025,S45G01N227,대구 한국가스공사,Home,유슈 은도예,5,1,1,100.0,0,2,0.0,1,3,33.3,3,6,50.0,1,5,6,0,0,0,0,1,2,2
../kbl_data/2024-2025,S45G01N227,대구 한국가스공사,Home,신주영,0,0,0,0.0,0,0,0.0,0,0,0.0,0,0,0.0,0,0,0,0,0,0,0,0,0,0
../kbl_data/2024-2025,S45G01N227,안양 정관장,Away,송창용,0,0,0,0.0,0,5,0.0,0,5,0.0,0,0,0.0,0,1,1,0,1,1,0,0,1,2
../kbl_data/2024-2025,S45G01N227,안양 정관장,Away,정준원,0,0,0,0.0,0,0,0.0,0,0,0.0,0,0,0.0,0,0,0,0,0,0,0,0,0,0
../kbl_data/2024-2025,S45G01N227,안양 정관장,Away,김영현,5,0,0,0.0,1,1,100.0,1,1,100.0,2,4,50.0,1,2,3,2,0,0,1,0,0,3
../kbl_data/2024-2025,S45G01N227,안양 정관장,Away,김종규,0,0,0,0.0,0,0,0.0,0,0,0.0,0,0,0.0,0,0,0,0,0,0,0,0,0,0
../kbl_data/2024-2025,S45G01N227,안양 정관장,Away,박지훈,20,6,12,50.0,2,4,50.0,8,16,50.0,2,4,50.0,4,4,8,10,0,0,0,0,12,4
../kbl_data/2024-2025,S45G01N227,안양 정관장,Away,디온테 버튼,17,6,11,54.5,1,1,100.0,7,12,58.3,2,2,100.0,4,4,8,0,0,0,0,0,1,2
../kbl_data/2024-2025,S45G01N227,안양 정관장,Away,변준형,0,0,2,0.0,0,2,0.0,0,4,0.0,0,0,0.0,1,3,4,3,0,1,0,0,4,4
../kbl_data/2024-2025,S45G01N227,안양 정관장,Away,김경원,4,1,1,100.0,0,0,0.0,1,1,100.0,2,3,66.7,0,1,1,0,0,0,0,0,0,1
../kbl_data/2024-2025,S45G01N227,안양 정관장,Away,한승희,5,2,3,66.7,0,3,0.0,2,6,33.3,1,2,50.0,4,5,9,2,1,0,1,0,2,3
../kbl_data/2024-2025,S45G01N227,안양 정관장,Away,조니 오브라이언트,26,6,12,50.0,4,6,66.7,10,18,55.6,2,2,100.0,1,3,4,1,2,0,0,0,4,2
../kbl_data/2024-2025,S45G01N227,안양 정관장,Away,하비 고메즈,4,2,3,66.7,0,2,0.0,2,5,40.0,0,0,0.0,0,2,2,0,0,0,0,0,1,0
../kbl_data/2024-2025,S45G01N227,안양 정관장,Away,소준혁,2,1,1,100.0,0,1,0.0,1,2,50.0,0,0,0.0,0,3,3,1,0,0,1,0,2,4
../kbl_data/2024-2025,S45G01N228,울산 현대모비스,Home,함지훈,4,2,4,50.0,0,1,0.0,2,5,40.0,0,0,0.0,3,3,6,5,0,1,0,0,3,3
../kbl_data/2024-2025,S45G01N228,울산 현대모비스,Home,장재석,6,3,5,60.0,0,0,0.0,3,5,60.0,0,0,0.0,1,0,1,2,0,0,0,0,1,1
../kbl_data/2024-2025,S45G01N228,울산 현대모비스,Home,이대헌,0,0,0,0.0,0,0,0.0,0,0,0.0,0,0,0.0,0,0,0,0,0,0,0,0,0,0
../kbl_data/2024-2025,S45G01N228,울산 현대모비스,Home,한호빈,2,1,1,100.0,0,3,0.0,1,4,25.0,0,0,0.0,2,1,3,2,1,0,0,0,0,2
../kbl_data/2024-2025,S45G01N228,울산 현대모비스,Home,서명진,10,2,4,50.0,2,7,28.6,4,11,36.4,0,0,0.0,0,2,2,6,0,0,0,0,2,3
../kbl_data/2024-2025,S45G01N228,울산 현대모비스,Home,숀 롱,24,11,13,84.6,0,2,0.0,11,15,73.3,2,4,50.0,2,2,4,0,1,2,0,0,2,1
../kbl_data/2024-2025,S45G01N228,울산 현대모비스,Home,이우석,11,1,3,33.3,3,8,37.5,4,11,36.4,0,0,0.0,0,9,9,3,2,0,0,0,3,2
../kbl_data/2024-2025,S45G01N228,울산 현대모비스,Home,이승우,0,0,0,0.0,0,0,0.0,0,0,0.0,0,0,0.0,0,0,0,0,0,0,0,0,0,0
../kbl_data/2024-2025,S45G01N228,울산 현대모비스,Home,신민석,0,0,0,0.0,0,1,0.0,0,1,0.0,0,0,0.0,0,0,0,0,0,0,0,0,0,0
../kbl_data/2024-2025,S45G01N228,울산 현대모비스,Home,게이지 프림,8,4,8,50.0,0,1,0.0,4,9,44.4,0,0,0.0,2,2,4,1,0,1,0,0,1,2
../kbl_data/2024-2025,S45G01N228,울산 현대모비스,Home,박무빈,9,3,3,100.0,0,1,0.0,3,4,75.0,3,3,100.0,2,3,5,2,0,0,2,0,2,2
../kbl_data/2024-2025,S45G01N228,울산 현대모비스,Home,미구엘 안드레 옥존,5,1,1,100.0,1,1,100.0,2,2,100.0,0,0,0.0,0,0,0,0,0,0,0,0,1,3
../kbl_data/2024-2025,S45G01N228,부산 KCC,Away,정창영,6,2,5,40.0,0,0,0.0,2,5,40.0,2,3,66.7,0,1,1,4,3,0,0,0,0,2
../kbl_data/2024-2025,S45G01N228,부산 KCC,Away,전준범,20,4,6,66.7,4,5,80.0,8,11,72.7,0,0,0.0,0,0,0,1,1,0,0,0,2,4
../kbl_data/2024-2025,S45G01N228,부산 KCC,Away,이승현,10,2,10,20.0,2,4,50.0,4,14,28.6,0,0,0.0,2,2,4,2,2,0,0,0,2,3
../kbl_data/2024-2025,S45G01N228,부산 KCC,Away,이호현,6,2,3,66.7,0,0,0.0,2,3,66.7,2,2,100.0,0,2,2,4,1,0,0,0,1,1
../kbl_data/2024-2025,S45G01N228,부산 KCC,Away,전태영,0,0,0,0.0,0,0,0.0,0,0,0.0,0,0,0.0,0,0,0,0,0,0,0,0,0,0
../kbl_data/2024-2025,S45G01N228,부산 KCC,Away,캐디 라렌,22,7,16,43.8,1,2,50.0,8,18,44.4,5,5,100.0,5,9,14,2,1,1,0,2,2,3
../kbl_data/2024-2025,S45G01N228,부산 KCC,Away,이근휘,0,0,0,0.0,0,0,0.0,0,0,0.0,0,0,0.0,0,0,0,0,0,0,0,0,0,0
../kbl_data/2024-2025,S45G01N228,부산 KCC,Away,김동현,3,1,2,50.0,0,3,0.0,1,5,20.0,1,2,50.0,0,2,2,0,2,0,0,0,1,3
../kbl_data/2024-2025,S45G01N228,부산 KCC,Away,캘빈 제프리 에피스톨라,6,3,5,60.0,0,2,0.0,3,7,42.9,0,0,0.0,0,4,4,3,1,0,0,0,1,3
../kbl_data/2024-2025,S45G01N228,부산 KCC,Away,이주영,2,1,1,100.0,0,1,0.0,1,2,50.0,0,0,0.0,1,0,1,0,0,0,0,0,0,0
../kbl_data/2024-2025,S45G01N228,부산 KCC,Away,이찬영,0,0,0,0.0,0,0,0.0,0,0,0.0,0,0,0.0,0,0,0,0,0,0,0,0,0,0
../kbl_data/2024-2025,S45G01N228,부산 KCC,Away,도노반 스미스,2,0,0,0.0,0,1,0.0,0,1,0.0,2,2,100.0,0,0,0,0,0,0,0,0,0,1
../kbl_data/2024-2025,S45G01N229,수원 KT,Home,문성곤,8,1,3,33.3,2,3,66.7,3,6,50.0,0,0,0.0,0,3,3,1,1,0,0,0,2,2
../kbl_data/2024-2025,S45G01N229,수원 KT,Home,이현석,0,0,0,0.0,0,0,0.0,0,0,0.0,0,0,0.0,0,0,0,0,0,0,0,0,0,0
../kbl_data/2024-2025,S45G01N229,수원 KT,Home,허훈,21,4,8,50.0,4,11,36.4,8,19,42.1,1,2,50.0,0,3,3,12,0,0,1,0,3,2
../kbl_data/2024-2025,S45G01N229,수원 KT,Home,최진광,0,0,0,0.0,0,0,0.0,0,0,0.0,0,0,0.0,0,0,0,0,0,0,0,0,0,1
../kbl_data/2024-2025,S45G01N229,수원 KT,Home,박지원,0,0,0,0.0,0,0,0.0,0,0,0.0,0,0,0.0,0,0,0,0,0,0,0,0,0,0
../kbl_data/2024-2025,S45G01N229,수원 KT,Home,하윤기,18,8,11,72.7,0,0,0.0,8,11,72.7,2,2,100.0,2,8,10,1,1,1,0,2,0,1
../kbl_data/2024-2025,S45G01N229,수원 KT,Home,이두원,0,0,0,0.0,0,0,0.0,0,0,0.0,0,0,0.0,0,0,0,0,0,0,0,0,0,0
../kbl_data/2024-2025,S45G01N229,수원 KT,Home,문정현,3,0,1,0.0,1,2,50.0,1,3,33.3,0,0,0.0,3,2,5,0,0,0,0,0,0,2
../kbl_data/2024-2025,S45G01N229,수원 KT,Home,레이션 해먼즈,11,1,5,20.0,2,6,33.3,3,11,27.3,3,3,100.0,2,2,4,2,1,0,0,0,2,5
../kbl_data/2024-2025,S45G01N229,수원 KT,Home,박성재,0,0,0,0.0,0,0,0.0,0,0,0.0,0,0,0.0,0,0,0,0,0,0,0,0,0,0
../kbl_data/2024-2025,S45G01N229,수원 KT,Home,조엘 카굴랑안,10,3,9,33.3,1,2,50.0,4,11,36.4,1,1,100.0,1,6,7,7,4,1,0,0,4,0
../kbl_data/2024-2025,S45G01N229,수원 KT,Home,자렐 마틴,6,0,2,0.0,2,5,40.0,2,7,28.6,0,0,0.0,0,2,2,0,0,0,0,0,0,3
../kbl_data/2024-2025,S45G01N229,서울 SK,Away,김선형,12,6,8,75.0,0,1,0.0,6,9,66.7,0,0,0.0,0,2,2,3,1,0,0,0,2,2
../kbl_data/2024-2025,S45G01N229,서울 SK,Away,오세근,0,0,1,0.0,0,3,0.0,0,4,0.0,0,0,0.0,0,3,3,1,0,0,0,0,0,3
../kbl_data/2024-2025,S45G01N229,서울 SK,Away,최원혁,2,1,1,100.0,0,0,0.0,1,1,100.0,0,0,0.0,2,2,4,3,1,0,0,0,1,3
../kbl_data/2024-2025,S45G01N229,서울 SK,Away,김지후,0,0,0,0.0,0,0,0.0,0,0,0.0,0,0,0.0,0,0,0,0,0,0,0,0,0,0
../kbl_data/2024-2025,S45G01N229,서울 SK,Away,안영준,11,0,0,0.0,3,5,60.0,3,5,60.0,2,2,100.0,0,5,5,3,0,1,0,0,3,2
../kbl_data/2024-2025,S45G01N229,서울 SK,Away,자밀 워니,24,7,17,41.2,1,4,25.0,8,21,38.1,7,7,100.0,0,12,12,2,1,1,0,0,2,0
../kbl_data/2024-2025,S45G01N229,서울 SK,Away,전성환,0,0,0,0.0,0,0,0.0,0,0,0.0,0,0,0.0,0,0,0,0,0,0,0,0,0,0
../kbl_data/2024-2025,S45G01N229,서울 SK,Away,김형빈,8,1,2,50.0,1,3,33.3,2,5,40.0,3,4,75.0,0,3,3,1,0,0,0,0,0,2
../kbl_data/2024-2025,S45G01N229,서울 SK,Away,아이재아 힉스,7,3,6,50.0,0,1,0.0,3,7,42.9,1,2,50.0,1,1,2,1,0,0,0,1,0,0
../kbl_data/2024-2025,S45G01N229,서울 SK,Away,문가온,0,0,0,0.0,0,0,0.0,0,0,0.0,0,0,0.0,0,0,0,0,0,0,0,0,0,0
../kbl_data/2024-2025,S45G01N229,서울 SK,Away,고메즈 델 리아노,12,4,5,80.0,1,2,50.0,5,7,71.4,1,2,50.0,1,1,2,2,1,0,0,0,1,3
../kbl_data/2024-2025,S45G01N229,서울 SK,Away,김태훈,2,1,2,50.0,0,1,0.0,1,3,33.3,0,0,0.0,1,0,1,0,1,0,1,0,1,2
../kbl_data/2024-2025,S45G01N230,고양 소노,Home,정희재,0,0,0,0.0,0,1,0.0,0,1,0.0,0,0,0.0,1,0,1,1,0,0,0,0,0,5
../kbl_data/2024-2025,S45G01N230,고양 소노,Home,임동섭,5,1,1,100.0,1,2,50.0,2,3,66.7,0,0,0.0,0,4,4,0,0,0,0,0,1,2
../kbl_data/2024-2025,S45G01N230,고양 소노,Home,이재도,6,2,3,66.7,0,3,0.0,2,6,33.3,2,2,100.0,0,0,0,0,1,0,0,0,1,1
../kbl_data/2024-2025,S45G01N230,고양 소노,Home,최승욱,9,3,4,75.0,1,2,50.0,4,6,66.7,0,0,0.0,0,1,1,3,1,0,0,0,0,3
../kbl_data/2024-2025,S45G01N230,고양 소노,Home,김진유,0,0,1,0.0,0,1,0.0,0,2,0.0,0,0,0.0,0,2,2,0,1,0,0,0,0,2
../kbl_data/2024-2025,S45G01N230,고양 소노,Home,이정현,23,5,7,71.4,3,9,33.3,8,16,50.0,4,5,80.0,0,1,1,4,2,0,0,0,2,2
../kbl_data/2024-2025,S45G01N230,고양 소노,Home,박종하,0,0,0,0.0,0,0,0.0,0,0,0.0,0,0,0.0,0,0,0,0,0,0,0,0,0,0
../kbl_data/2024-2025,S45G01N230,고양 소노,Home,민기남,0,0,0,0.0,0,0,0.0,0,0,0.0,0,0,0.0,0,0,0,0,0,0,0,0,0,0
../kbl_data/2024-2025,S45G01N230,고양 소노,Home,앨런 윌리엄스,19,7,13,53.8,0,0,0.0,7,13,53.8,5,6,83.3,7,8,15,5,1,0,0,0,3,0
../kbl_data/2024-2025,S45G01N230,고양 소노,Home,디제이 번즈 Jr,10,5,10,50.0,0,0,0.0,5,10,50.0,0,0,0.0,1,2,3,1,0,0,0,0,1,4
../kbl_data/2024-2025,S45G01N230,고양 소노,Home,이근준,6,3,4,75.0,0,0,0.0,3,4,75.0,0,2,0.0,2,5,7,2,2,2,0,0,1,2
../kbl_data/2024-2025,S45G01N230,고양 소노,Home,케빈 켐바오,12,6,9,66.7,0,0,0.0,6,9,66.7,0,0,0.0,2,3,5,5,0,1,0,0,3,0
../kbl_data/2024-2025,S45G01N230,대구 한국가스공사,Away,김동량,4,0,0,0.0,0,0,0.0,0,0,0.0,4,5,80.0,0,0,0,0,0,0,0,0,0,2
../kbl_data/2024-2025,S45G01N230,대구 한국가스공사,Away,차바위,0,0,0,0.0,0,0,0.0,0,0,0.0,0,0,0.0,0,0,0,0,0,0,0,0,0,0
../kbl_data/2024-2025,S45G01N230,대구 한국가스공사,Away,박지훈,12,0,0,0.0,4,6,66.7,4,6,66.7,0,0,0.0,2,2,4,1,0,0,0,0,0,2
../kbl_data/2024-2025,S45G01N230,대구 한국가스공사,Away,김준일,12,4,12,33.3,0,0,0.0,4,12,33.3,4,4,100.0,2,4,6,3,0,0,0,0,4,3
../kbl_data/2024-2025,S45G01N230,대구 한국가스공사,Away,정성우,5,1,2,50.0,0,2,0.0,1,4,25.0,3,3,100.0,2,0,2,5,2,0,1,0,2,3
../kbl_data/2024-2025,S45G01N230,대구 한국가스공사,Away,김낙현,33,4,6,66.7,8,10,80.0,12,16,75.0,1,2,50.0,0,1,1,4,2,0,0,0,2,3
../kbl_data/2024-2025,S45G01N230,대구 한국가스공사,Away,곽정훈,0,0,0,0.0,0,1,0.0,0,1,0.0,0,0,0.0,0,1,1,0,1,0,0,0,0,1
../kbl_data/2024-2025,S45G01N230,대구 한국가스공사,Away,이도헌,0,0,0,0.0,0,1,0.0,0,1,0.0,0,0,0.0,0,0,0,0,0,0,0,0,0,0
../kbl_data/2024-2025,S45G01N230,대구 한국가스공사,Away,앤드류 니콜슨,13,4,9,44.4,1,8,12.5,5,17,29.4,2,4,50.0,1,9,10,2,1,0,0,0,2,2
../kbl_data/2024-2025,S45G01N230,대구 한국가스공사,Away,신승민,0,0,1,0.0,0,1,0.0,0,2,0.0,0,0,0.0,0,1,1,1,0,0,0,0,0,1
../kbl_data/2024-2025,S45G01N230,대구 한국가스공사,Away,샘조세프 벨란겔,6,2,3,66.7,0,2,0.0,2,5,40.0,2,2,100.0,1,0,1,5,2,0,0,0,1,3
../kbl_data/2024-2025,S45G01N230,대구 한국가스공사,Away,신주영,0,0,0,0.0,0,0,0.0,0,0,0.0,0,0,0.0,0,0,0,0,0,0,0,0,0,0
../kbl_data/2024-2025,S45G01N231,창원 LG,Home,허일영,0,0,2,0.0,0,2,0.0,0,4,0.0,0,0,0.0,1,0,1,0,0,0,0,0,0,3
../kbl_data/2024-2025,S45G01N231,창원 LG,Home,최진수,0,0,0,0.0,0,0,0.0,0,0,0.0,0,0,0.0,0,0,0,0,0,0,0,0,0,0
../kbl_data/2024-2025,S45G01N231,창원 LG,Home,두경민,6,0,2,0.0,2,4,50.0,2,6,33.3,0,0,0.0,0,0,0,4,0,0,0,0,1,2
../kbl_data/2024-2025,S45G01N231,창원 LG,Home,정인덕,0,0,1,0.0,0,3,0.0,0,4,0.0,0,0,0.0,0,3,3,1,3,0,0,0,0,1
../kbl_data/2024-2025,S45G01N231,창원 LG,Home,대릴 먼로,5,2,3,66.7,0,1,0.0,2,4,50.0,1,2,50.0,0,2,2,4,0,0,0,0,1,1
../kbl_data/2024-2025,S45G01N231,창원 LG,Home,박정현,2,1,1,100.0,0,0,0.0,1,1,100.0,0,0,0.0,0,1,1,1,0,1,0,0,0,2
../kbl_data/2024-2025,S45G01N231,창원 LG,Home,아셈 마레이,15,6,7,85.7,0,1,0.0,6,8,75.0,3,4,75.0,3,11,14,12,5,1,1,0,3,1
../kbl_data/2024-2025,S45G01N231,창원 LG,Home,양준석,9,3,5,60.0,1,3,33.3,4,8,50.0,0,0,0.0,1,2,3,3,1,0,0,0,2,2
../kbl_data/2024-2025,S45G01N231,창원 LG,Home,유기상,12,2,3,66.7,2,7,28.6,4,10,40.0,2,2,100.0,0,1,1,0,0,0,0,0,4,2
../kbl_data/2024-2025,S45G01N231,창원 LG,Home,이경도,0,0,0,0.0,0,0,0.0,0,0,0.0,0,0,0.0,0,0,0,0,0,0,0,0,0,0
../kbl_data/2024-2025,S45G01N231,창원 LG,Home,칼 타마요,32,7,9,77.8,6,10,60.0,13,19,68.4,0,0,0.0,2,4,6,5,1,0,0,0,2,3
../kbl_data/2024-2025,S45G01N231,창원 LG,Home,최형찬,0,0,0,0.0,0,0,0.0,0,0,0.0,0,0,0.0,0,0,0,0,0,0,0,0,0,0
../kbl_data/2024-2025,S45G01N231,원주 DB,Away,김시래,6,0,0,0.0,2,2,100.0,2,2,100.0,0,0,0.0,0,1,1,0,1,0,0,0,1,1
../kbl_data/2024-2025,S45G01N231,원주 DB,Away,서민수,2,1,1,100.0,0,2,0.0,1,3,33.3,0,0,0.0,1,3,4,2,0,0,0,0,2,2
../kbl_data/2024-2025,S45G01N231,원주 DB,Away,정효근,7,2,4,50.0,1,3,33.3,3,7,42.9,0,0,0.0,1,3,4,2,1,0,0,0,2,2
../kbl_data/2024-2025,S45G01N231,원주 DB,Away,강상재,9,3,6,50.0,1,2,50.0,4,8,50.0,0,0,0.0,1,4,5,1,0,0,0,0,2,1
../kbl_data/2024-2025,S45G01N231,원주 DB,Away,최성원,9,0,1,0.0,3,5,60.0,3,6,50.0,0,0,0.0,1,2,3,0,0,0,0,0,1,1
../kbl_data/2024-2025,S45G01N231,원주 DB,Away,치나누 오누아쿠,9,2,4,50.0,1,3,33.3,3,7,42.9,2,2,100.0,2,3,5,3,0,1,0,0,5,2
../kbl_data/2024-2025,S45G01N231,원주 DB,Away,김훈,0,0,0,0.0,0,0,0.0,0,0,0.0,0,0,0.0,0,1,1,0,0,0,0,0,0,0
../kbl_data/2024-2025,S45G01N231,원주 DB,Away,이용우,0,0,0,0.0,0,0,0.0,0,0,0.0,0,0,0.0,0,0,0,0,0,0,0,0,0,0
../kbl_data/2024-2025,S45G01N231,원주 DB,Away,오마리 스펠맨,4,1,5,20.0,0,5,0.0,1,10,10.0,2,2,100.0,1,5,6,4,1,1,0,0,2,0
../kbl_data/2024-2025,S45G01N231,원주 DB,Away,이선 알바노,13,2,3,66.7,3,6,50.0,5,9,55.6,0,0,0.0,1,1,2,3,3,0,0,0,3,2
../kbl_data/2024-2025,S45G01N231,원주 DB,Away,박인웅,5,1,4,25.0,1,3,33.3,2,7,28.6,0,0,0.0,2,1,3,2,0,0,0,0,0,2
../kbl_data/2024-2025,S45G01N231,원주 DB,Away,김보배,4,2,3,66.7,0,0,0.0,2,3,66.7,0,0,0.0,1,0,1,0,0,0,0,0,1,1
../kbl_data/2024-2025,S45G01N232,서울 SK,Home,김선형,13,5,6,83.3,1,3,33.3,6,9,66.7,0,0,0.0,1,2,3,1,1,0,0,0,2,2
../kbl_data/2024-2025,S45G01N232,서울 SK,Home,오세근,3,0,3,0.0,1,3,33.3,1,6,16.7,0,0,0.0,1,1,2,0,0,0,0,0,2,2
../kbl_data/2024-2025,S45G01N232,서울 SK,Home,최원혁,5,2,3,66.7,0,0,0.0,2,3,66.7,1,1,100.0,3,1,4,2,1,0,1,0,1,1
../kbl_data/2024-2025,S45G01N232,서울 SK,Home,김지후,0,0,0,0.0,0,1,0.0,0,1,0.0,0,0,0.0,0,0,0,0,0,0,0,0,0,1
../kbl_data/2024-2025,S45G01N232,서울 SK,Home,안영준,9,2,4,50.0,1,4,25.0,3,8,37.5,2,2,100.0,0,3,3,1,0,0,0,0,0,0
../kbl_data/2024-2025,S45G01N232,서울 SK,Home,자밀 워니,18,5,7,71.4,2,5,40.0,7,12,58.3,2,2,100.0,2,10,12,3,0,0,0,0,1,1
../kbl_data/2024-2025,S45G01N232,서울 SK,Home,김형빈,3,0,2,0.0,1,2,50.0,1,4,25.0,0,0,0.0,2,1,3,0,1,2,0,0,0,1
../kbl_data/2024-2025,S45G01N232,서울 SK,Home,아이재아 힉스,18,6,12,50.0,2,6,33.3,8,18,44.4,0,1,0.0,3,4,7,1,0,0,0,0,1,4
../kbl_data/2024-2025,S45G01N232,서울 SK,Home,오재현,9,3,4,75.0,0,1,0.0,3,5,60.0,3,3,100.0,0,3,3,1,0,0,0,0,2,1
../kbl_data/2024-2025,S45G01N232,서울 SK,Home,문가온,0,0,1,0.0,0,0,0.0,0,1,0.0,0,0,0.0,0,1,1,0,0,0,0,0,0,0
../kbl_data/2024-2025,S45G01N232,서울 SK,Home,고메즈 델 리아노,7,2,6,33.3,1,1,100.0,3,7,42.9,0,0,0.0,0,3,3,4,0,0,0,0,2,3
../kbl_data/2024-2025,S45G01N232,서울 SK,Home,김태훈,0,0,0,0.0,0,0,0.0,0,0,0.0,0,0,0.0,1,4,5,2,1,0,0,0,0,3
../kbl_data/2024-2025,S45G01N232,울산 현대모비스,Away,함지훈,9,0,4,0.0,3,6,50.0,3,10,30.0,0,1,0.0,2,5,7,3,1,0,0,0,0,2
../kbl_data/2024-2025,S45G01N232,울산 현대모비스,Away,장재석,0,0,0,0.0,0,0,0.0,0,0,0.0,0,0,0.0,0,0,0,0,0,0,0,0,0,0
../kbl_data/2024-2025,S45G01N232,울산 현대모비스,Away,이대헌,6,3,4,75.0,0,0,0.0,3,4,75.0,0,2,0.0,1,1,2,0,1,0,0,1,0,0
../kbl_data/2024-2025,S45G01N232,울산 현대모비스,Away,한호빈,0,0,1,0.0,0,1,0.0,0,2,0.0,0,0,0.0,1,2,3,2,1,0,0,0,0,0
../kbl_data/2024-2025,S45G01N232,울산 현대모비스,Away,서명진,10,1,2,50.0,2,7,28.6,3,9,33.3,2,2,100.0,0,2,2,4,1,0,0,0,1,2
../kbl_data/2024-2025,S45G01N232,울산 현대모비스,Away,숀 롱,21,8,9,88.9,0,1,0.0,8,10,80.0,5,10,50.0,3,1,4,2,1,1,0,1,1,2
../kbl_data/2024-2025,S45G01N232,울산 현대모비스,Away,이우석,14,1,5,20.0,4,6,66.7,5,11,45.5,0,0,0.0,1,7,8,4,0,1,0,0,3,4
../kbl_data/2024-2025,S45G01N232,울산 현대모비스,Away,이승우,0,0,0,0.0,0,0,0.0,0,0,0.0,0,0,0.0,0,0,0,0,0,0,0,0,0,0
../kbl_data/2024-2025,S45G01N232,울산 현대모비스,Away,신민석,5,1,1,100.0,1,4,25.0,2,5,40.0,0,0,0.0,0,1,1,0,0,0,0,0,0,0
../kbl_data/2024-2025,S45G01N232,울산 현대모비스,Away,게이지 프림,10,5,11,45.5,0,2,0.0,5,13,38.5,0,0,0.0,0,2,2,1,0,0,0,0,0,2
../kbl_data/2024-2025,S45G01N232,울산 현대모비스,Away,박무빈,2,0,1,0.0,0,3,0.0,0,4,0.0,2,2,100.0,1,2,3,7,1,0,0,0,1,4
../kbl_data/2024-2025,S45G01N232,울산 현대모비스,Away,미구엘 안드레 옥존,2,1,2,50.0,0,2,0.0,1,4,25.0,0,0,0.0,0,2,2,1,0,0,0,0,0,1
../kbl_data/2024-2025,S45G01N233,안양 정관장,Home,송창용,0,0,0,0.0,0,0,0.0,0,0,0.0,0,0,0.0,0,0,0,0,1,0,0,0,0,0
../kbl_data/2024-2025,S45G01N233,안양 정관장,Home,정준원,4,2,3,66.7,0,1,0.0,2,4,50.0,0,0,0.0,1,0,1,1,1,0,0,0,0,1
../kbl_data/2024-2025,S45G01N233,안양 정관장,Home,김영현,6,0,0,0.0,2,5,40.0,2,5,40.0,0,0,0.0,0,0,0,1,1,0,0,0,0,1
../kbl_data/2024-2025,S45G01N233,안양 정관장,Home,김종규,0,0,0,0.0,0,0,0.0,0,0,0.0,0,0,0.0,0,1,1,0,0,0,0,0,0,1
../kbl_data/2024-2025,S45G01N233,안양 정관장,Home,박지훈,16,5,8,62.5,2,3,66.7,7,11,63.6,0,0,0.0,2,1,3,4,2,1,0,0,2,2
../kbl_data/2024-2025,S45G01N233,안양 정관장,Home,디온테 버튼,18,4,12,33.3,3,5,60.0,7,17,41.2,1,1,100.0,2,6,8,6,2,0,0,0,1,4
../kbl_data/2024-2025,S45G01N233,안양 정관장,Home,변준형,12,3,4,75.0,2,5,40.0,5,9,55.6,0,0,0.0,0,2,2,3,2,0,1,0,1,1
../kbl_data/2024-2025,S45G01N233,안양 정관장,Home,김경원,4,2,4,50.0,0,2,0.0,2,6,33.3,0,0,0.0,1,2,3,2,2,0,0,0,1,3
../kbl_data/2024-2025,S45G01N233,안양 정관장,Home,한승희,9,3,4,75.0,1,2,50.0,4,6,66.7,0,0,0.0,0,5,5,2,0,0,0,0,1,3
../kbl_data/2024-2025,S45G01N233,안양 정관장,Home,조니 오브라이언트,8,1,5,20.0,2,5,40.0,3,10,30.0,0,0,0.0,0,4,4,1,1,0,0,0,0,1
../kbl_data/2024-2025,S45G01N233,안양 정관장,Home,하비 고메즈,12,3,4,75.0,2,4,50.0,5,8,62.5,0,0,0.0,2,4,6,2,0,0,0,0,0,4
../kbl_data/2024-2025,S45G01N233,안양 정관장,Home,소준혁,2,1,4,25.0,0,0,0.0,1,4,25.0,0,0,0.0,1,0,1,0,0,0,0,0,0,1
../kbl_data/2024-2025,S45G01N233,부산 KCC,Away,정창영,0,0,1,0.0,0,0,0.0,0,1,0.0,0,0,0.0,1,0,1,2,0,0,0,0,1,2
../kbl_data/2024-2025,S45G01N233,부산 KCC,Away,전준범,8,1,1,100.0,2,5,40.0,3,6,50.0,0,0,0.0,0,2,2,2,0,0,0,0,1,2
../kbl_data/2024-2025,S45G01N233,부산 KCC,Away,이승현,9,4,9,44.4,0,3,0.0,4,12,33.3,1,2,50.0,0,7,7,1,0,1,0,0,4,1
../kbl_data/2024-2025,S45G01N233,부산 KCC,Away,이호현,10,2,4,50.0,2,3,66.7,4,7,57.1,0,0,0.0,0,3,3,1,1,0,0,0,0,1
../kbl_data/2024-2025,S45G01N233,부산 KCC,Away,캐디 라렌,16,5,8,62.5,1,1,100.0,6,9,66.7,3,7,42.9,3,2,5,3,0,0,0,1,2,0
../kbl_data/2024-2025,S45G01N233,부산 KCC,Away,이근휘,6,0,1,0.0,2,4,50.0,2,5,40.0,0,0,0.0,2,3,5,1,1,0,0,0,2,1
../kbl_data/2024-2025,S45G01N233,부산 KCC,Away,김동현,0,0,0,0.0,0,0,0.0,0,0,0.0,0,0,0.0,0,2,2,0,1,0,0,0,0,0
../kbl_data/2024-2025,S45G01N233,부산 KCC,Away,여준형,1,0,0,0.0,0,0,0.0,0,0,0.0,1,2,50.0,0,1,1,0,0,0,0,0,1,1
../kbl_data/2024-2025,S45G01N233,부산 KCC,Away,캘빈 제프리 에피스톨라,5,2,3,66.7,0,3,0.0,2,6,33.3,1,3,33.3,0,5,5,4,0,0,0,0,0,2
../kbl_data/2024-2025,S45G01N233,부산 KCC,Away,이주영,7,2,2,100.0,1,2,50.0,3,4,75.0,0,0,0.0,0,1,1,2,0,0,0,0,1,1
../kbl_data/2024-2025,S45G01N233,부산 KCC,Away,이찬영,0,0,0,0.0,0,0,0.0,0,0,0.0,0,0,0.0,0,0,0,0,0,0,0,0,0,0
../kbl_data/2024-2025,S45G01N233,부산 KCC,Away,도노반 스미스,8,3,7,42.9,0,1,0.0,3,8,37.5,2,2,100.0,1,3,4,1,1,0,0,1,6,3
../kbl_data/2024-2025,S45G01N234,창원 LG,Home,허일영,0,0,0,0.0,0,1,0.0,0,1,0.0,0,0,0.0,1,1,2,0,1,0,0,0,0,3
../kbl_data/2024-2025,S45G01N234,창원 LG,Home,최진수,0,0,0,0.0,0,0,0.0,0,0,0.0,0,0,0.0,0,0,0,0,0,0,0,0,0,0
../kbl_data/2024-2025,S45G01N234,창원 LG,Home,두경민,4,0,1,0.0,1,3,33.3,1,4,25.0,1,2,50.0,0,0,0,1,2,0,0,0,2,0
../kbl_data/2024-2025,S45G01N234,창원 LG,Home,정인덕,7,2,4,50.0,0,4,0.0,2,8,25.0,3,4,75.0,1,3,4,3,0,1,0,0,0,4
../kbl_data/2024-2025,S45G01N234,창원 LG,Home,대릴 먼로,0,0,0,0.0,0,1,0.0,0,1,0.0,0,0,0.0,1,0,1,0,0,0,0,0,1,2
../kbl_data/2024-2025,S45G01N234,창원 LG,Home,박정현,0,0,2,0.0,0,0,0.0,0,2,0.0,0,0,0.0,1,1,2,0,0,0,0,0,1,1
../kbl_data/2024-2025,S45G01N234,창원 LG,Home,아셈 마레이,18,7,18,38.9,0,0,0.0,7,18,38.9,4,4,100.0,9,6,15,5,2,0,0,0,3,1
../kbl_data/2024-2025,S45G01N234,창원 LG,Home,양준석,12,3,5,60.0,2,3,66.7,5,8,62.5,0,2,0.0,1,1,2,4,2,1,0,0,3,5
../kbl_data/2024-2025,S45G01N234,창원 LG,Home,유기상,7,0,2,0.0,2,8,25.0,2,10,20.0,1,2,50.0,3,0,3,1,1,0,1,0,1,2
../kbl_data/2024-2025,S45G01N234,창원 LG,Home,이경도,0,0,0,0.0,0,0,0.0,0,0,0.0,0,0,0.0,0,0,0,0,0,0,0,0,0,0
../kbl_data/2024-2025,S45G01N234,창원 LG,Home,칼 타마요,17,5,8,62.5,1,5,20.0,6,13,46.2,4,6,66.7,1,5,6,0,0,0,0,0,2,2
../kbl_data/2024-2025,S45G01N234,창원 LG,Home,최형찬,0,0,0,0.0,0,1,0.0,0,1,0.0,0,0,0.0,0,0,0,0,0,0,0,0,0,1
../kbl_data/2024-2025,S45G01N234,수원 KT,Away,문성곤,3,0,0,0.0,1,1,100.0,1,1,100.0,0,0,0.0,1,1,2,0,0,1,0,0,0,2
../kbl_data/2024-2025,S45G01N234,수원 KT,Away,이현석,0,0,0,0.0,0,0,0.0,0,0,0.0,0,0,0.0,0,0,0,0,0,0,0,0,0,1
../kbl_data/2024-2025,S45G01N234,수원 KT,Away,허훈,13,5,6,83.3,1,3,33.3,6,9,66.7,0,0,0.0,0,3,3,4,2,0,0,0,2,1
../kbl_data/2024-2025,S45G01N234,수원 KT,Away,최진광,0,0,0,0.0,0,0,0.0,0,0,0.0,0,0,0.0,0,0,0,0,0,0,0,0,0,0
../kbl_data/2024-2025,S45G01N234,수원 KT,Away,박지원,0,0,0,0.0,0,0,0.0,0,0,0.0,0,0,0.0,0,0,0,0,0,0,0,0,0,0
../kbl_data/2024-2025,S45G01N234,수원 KT,Away,하윤기,12,4,5,80.0,0,0,0.0,4,5,80.0,4,6,66.7,3,4,7,0,0,0,0,0,3,2
../kbl_data/2024-2025,S45G01N234,수원 KT,Away,이두원,0,0,0,0.0,0,0,0.0,0,0,0.0,0,0,0.0,1,0,1,0,0,0,0,0,1,2
../kbl_data/2024-2025,S45G01N234,수원 KT,Away,문정현,14,3,3,100.0,2,9,22.2,5,12,41.7,2,4,50.0,2,7,9,1,5,0,1,0,1,3
../kbl_data/2024-2025,S45G01N234,수원 KT,Away,레이션 해먼즈,10,3,6,50.0,0,4,0.0,3,10,30.0,4,6,66.7,0,5,5,2,1,0,0,0,0,3
../kbl_data/2024-2025,S45G01N234,수원 KT,Away,박성재,0,0,0,0.0,0,1,0.0,0,1,0.0,0,0,0.0,0,0,0,0,1,0,1,0,0,1
../kbl_data/2024-2025,S45G01N234,수원 KT,Away,조엘 카굴랑안,12,4,8,50.0,0,3,0.0,4,11,36.4,4,4,100.0,0,2,2,6,0,0,0,0,2,3
../kbl_data/2024-2025,S45G01N234,수원 KT,Away,자렐 마틴,5,0,1,0.0,1,2,50.0,1,3,33.3,2,2,100.0,0,3,3,0,0,0,0,0,1,3
../kbl_data/2024-2025,S45G01N235,대구 한국가스공사,Home,차바위,0,0,0,0.0,0,0,0.0,0,0,0.0,0,0,0.0,0,0,0,0,0,0,0,0,0,3
../kbl_data/2024-2025,S45G01N235,대구 한국가스공사,Home,박지훈,10,2,2,100.0,2,2,100.0,4,4,100.0,0,0,0.0,0,3,3,1,2,0,0,0,0,1
../kbl_data/2024-2025,S45G01N235,대구 한국가스공사,Home,김준일,9,3,4,75.0,0,0,0.0,3,4,75.0,3,4,75.0,4,3,7,1,0,2,0,0,1,4
../kbl_data/2024-2025,S45G01N235,대구 한국가스공사,Home,정성우,11,1,5,20.0,3,7,42.9,4,12,33.3,0,0,0.0,2,4,6,6,3,0,0,0,0,3
../kbl_data/2024-2025,S45G01N235,대구 한국가스공사,Home,김낙현,4,2,4,50.0,0,5,0.0,2,9,22.2,0,0,0.0,0,0,0,3,0,0,0,0,3,2
../kbl_data/2024-2025,S45G01N235,대구 한국가스공사,Home,양재혁,2,1,1,100.0,0,3,0.0,1,4,25.0,0,0,0.0,1,0,1,0,1,0,0,0,0,2
../kbl_data/2024-2025,S45G01N235,대구 한국가스공사,Home,이도헌,0,0,0,0.0,0,1,0.0,0,1,0.0,0,0,0.0,0,0,0,0,0,0,0,0,0,0
../kbl_data/2024-2025,S45G01N235,대구 한국가스공사,Home,앤드류 니콜슨,15,5,12,41.7,1,4,25.0,6,16,37.5,2,2,100.0,1,8,9,1,0,1,0,0,1,1
../kbl_data/2024-2025,S45G01N235,대구 한국가스공사,Home,신승민,0,0,0,0.0,0,2,0.0,0,2,0.0,0,0,0.0,0,1,1,1,2,0,0,0,1,1
../kbl_data/2024-2025,S45G01N235,대구 한국가스공사,Home,샘조세프 벨란겔,23,8,15,53.3,1,2,50.0,9,17,52.9,4,4,100.0,3,3,6,4,1,0,0,0,2,2
../kbl_data/2024-2025,S45G01N235,대구 한국가스공사,Home,유슈 은도예,0,0,2,0.0,0,1,0.0,0,3,0.0,0,0,0.0,0,1,1,0,0,1,0,0,1,1
../kbl_data/2024-2025,S45G01N235,대구 한국가스공사,Home,손준,0,0,0,0.0,0,1,0.0,0,1,0.0,0,0,0.0,0,0,0,0,0,0,0,0,0,1
../kbl_data/2024-2025,S45G01N235,원주 DB,Away,김시래,0,0,1,0.0,0,0,0.0,0,1,0.0,0,0,0.0,0,0,0,0,0,0,0,0,1,0
../kbl_data/2024-2025,S45G01N235,원주 DB,Away,서민수,0,0,0,0.0,0,1,0.0,0,1,0.0,0,0,0.0,0,5,5,2,0,0,0,0,0,0
../kbl_data/2024-2025,S45G01N235,원주 DB,Away,정효근,19,2,6,33.3,5,7,71.4,7,13,53.8,0,0,0.0,1,3,4,1,0,0,0,0,1,4
../kbl_data/2024-2025,S45G01N235,원주 DB,Away,박봉진,0,0,0,0.0,0,0,0.0,0,0,0.0,0,0,0.0,0,0,0,0,0,0,0,0,0,0
../kbl_data/2024-2025,S45G01N235,원주 DB,Away,강상재,4,2,2,100.0,0,1,0.0,2,3,66.7,0,0,0.0,1,6,7,2,1,0,0,0,3,1
../kbl_data/2024-2025,S45G01N235,원주 DB,Away,최성원,0,0,0,0.0,0,1,0.0,0,1,0.0,0,0,0.0,0,0,0,0,0,0,0,0,1,2
../kbl_data/2024-2025,S45G01N235,원주 DB,Away,치나누 오누아쿠,2,1,2,50.0,0,1,0.0,1,3,33.3,0,0,0.0,0,2,2,3,0,0,0,0,0,1
../kbl_data/2024-2025,S45G01N235,원주 DB,Away,김훈,0,0,0,0.0,0,0,0.0,0,0,0.0,0,0,0.0,0,0,0,0,0,0,0,0,0,0
../kbl_data/2024-2025,S45G01N235,원주 DB,Away,이용우,2,1,2,50.0,0,2,0.0,1,4,25.0,0,0,0.0,1,0,1,1,1,0,0,0,1,2
../kbl_data/2024-2025,S45G01N235,원주 DB,Away,오마리 스펠맨,20,7,12,58.3,0,4,0.0,7,16,43.8,6,8,75.0,2,8,10,3,0,0,0,3,1,1
../kbl_data/2024-2025,S45G01N235,원주 DB,Away,이선 알바노,30,11,14,78.6,2,3,66.7,13,17,76.5,2,5,40.0,3,4,7,6,2,0,0,0,2,3
../kbl_data/2024-2025,S45G01N235,원주 DB,Away,박인웅,2,1,1,100.0,0,4,0.0,1,5,20.0,0,0,0.0,0,2,2,0,1,0,1,0,2,2
../kbl_data/2024-2025,S45G01N236,고양 소노,Home,정희재,2,1,2,50.0,0,0,0.0,1,2,50.0,0,0,0.0,0,3,3,0,0,0,0,0,0,1
../kbl_data/2024-2025,S45G01N236,고양 소노,Home,임동섭,7,2,5,40.0,1,3,33.3,3,8,37.5,0,0,0.0,3,2,5,2,1,0,0,0,1,2
../kbl_data/2024-2025,S45G01N236,고양 소노,Home,이재도,0,0,1,0.0,0,1,0.0,0,2,0.0,0,0,0.0,0,5,5,2,1,0,0,0,1,0
../kbl_data/2024-2025,S45G01N236,고양 소노,Home,최승욱,22,8,10,80.0,2,8,25.0,10,18,55.6,0,0,0.0,10,10,20,4,0,0,0,0,2,10
../kbl_data/2024-2025,S45G01N236,고양 소노,Home,김진유,8,1,1,100.0,2,3,66.7,3,4,75.0,0,0,0.0,1,3,4,1,1,0,0,0,2,4
../kbl_data/2024-2025,S45G01N236,고양 소노,Home,이정현,54,12,22,54.5,6,22,27.3,18,44,40.9,12,12,100.0,2,16,18,16,10,0,0,0,8,4
../kbl_data/2024-2025,S45G01N236,고양 소노,Home,조은후,3,0,1,0.0,1,2,50.0,1,3,33.3,0,0,0.0,1,1,2,1,0,0,0,0,1,0
../kbl_data/2024-2025,S45G01N236,고양 소노,Home,민기남,0,0,1,0.0,0,1,0.0,0,2,0.0,0,0,0.0,0,0,0,1,0,0,0,0,0,1
../kbl_data/2024-2025,S45G01N236,고양 소노,Home,앨런 윌리엄스,6,2,5,40.0,0,1,0.0,2,6,33.3,2,2,100.0,0,6,6,3,1,0,0,0,0,1
../kbl_data/2024-2025,S45G01N236,고양 소노,Home,디제이 번즈 Jr,10,5,12,41.7,0,0,0.0,5,12,41.7,0,0,0.0,3,2,5,2,3,1,0,0,1,0
../kbl_data/2024-2025,S45G01N236,고양 소노,Home,이근준,6,0,2,0.0,2,6,33.3,2,8,25.0,0,0,0.0,1,1,2,1,1,0,1,0,3,4
../kbl_data/2024-2025,S45G01N236,고양 소노,Home,케빈 켐바오,12,3,5,60.0,1,4,25.0,4,9,44.4,3,3,100.0,2,4,6,3,0,0,0,0,3,2
../kbl_data/2024-2025,S45G01N236,서울 삼성,Away,이정현,54,12,22,54.5,6,22,27.3,18,44,40.9,12,12,100.0,2,16,18,16,10,0,0,0,8,4
../kbl_data/2024-2025,S45G01N236,서울 삼성,Away,최현민,3,0,1,0.0,1,7,14.3,1,8,12.5,0,0,0.0,0,3,3,1,2,0,0,0,1,1
../kbl_data/2024-2025,S45G01N236,서울 삼성,Away,이원대,2,1,3,33.3,0,2,0.0,1,5,20.0,0,0,0.0,0,4,4,3,0,0,0,0,0,1
../kbl_data/2024-2025,S45G01N236,서울 삼성,Away,최성모,0,0,2,0.0,0,1,0.0,0,3,0.0,0,0,0.0,0,2,2,1,0,0,0,0,1,4
../kbl_data/2024-2025,S45G01N236,서울 삼성,Away,최승욱,22,8,10,80.0,2,8,25.0,10,18,55.6,0,0,0.0,10,10,20,4,0,0,0,0,2,10
../kbl_data/2024-2025,S45G01N236,서울 삼성,Away,윤성원,0,0,0,0.0,0,1,0.0,0,1,0.0,0,0,0.0,0,0,0,0,0,0,0,0,0,0
../kbl_data/2024-2025,S45G01N236,서울 삼성,Away,차민석,0,0,0,0.0,0,0,0.0,0,0,0.0,0,0,0.0,0,0,0,0,0,0,0,0,0,0
../kbl_data/2024-2025,S45G01N236,서울 삼성,Away,이원석,6,3,7,42.9,0,0,0.0,3,7,42.9,0,0,0.0,0,2,2,0,0,1,1,0,0,2
../kbl_data/2024-2025,S45G01N236,서울 삼성,Away,저스틴 구탕,13,4,8,50.0,1,4,25.0,5,12,41.7,2,2,100.0,0,3,3,1,2,0,0,1,1,3
../kbl_data/2024-2025,S45G01N236,서울 삼성,Away,박승재,4,2,2,100.0,0,1,0.0,2,3,66.7,0,0,0.0,0,1,1,1,1,0,0,0,2,1
../kbl_data/2024-2025,S45G01N236,서울 삼성,Away,코피 코번,14,6,9,66.7,0,0,0.0,6,9,66.7,2,4,50.0,3,3,6,0,2,0,0,2,8,1
../kbl_data/2024-2025,S45G01N236,서울 삼성,Away,글렌 로빈슨 3세,9,3,5,60.0,1,2,50.0,4,7,57.1,0,0,0.0,1,3,4,2,0,2,0,0,3,1
../kbl_data/2024-2025,S45G01N237,서울 SK,Home,김선형,9,3,5,60.0,1,4,25.0,4,9,44.4,0,0,0.0,1,3,4,1,1,0,0,0,1,1
../kbl_data/2024-2025,S45G01N237,서울 SK,Home,오세근,3,0,1,0.0,1,3,33.3,1,4,25.0,0,0,0.0,2,4,6,1,1,0,0,0,1,2
../kbl_data/2024-2025,S45G01N237,서울 SK,Home,최원혁,6,3,3,100.0,0,1,0.0,3,4,75.0,0,0,0.0,0,0,0,2,0,1,0,0,1,0
../kbl_data/2024-2025,S45G01N237,서울 SK,Home,김지후,0,0,0,0.0,0,0,0.0,0,0,0.0,0,0,0.0,0,0,0,0,0,0,0,0,0,0
../kbl_data/2024-2025,S45G01N237,서울 SK,Home,안영준,7,1,3,33.3,1,5,20.0,2,8,25.0,2,2,100.0,1,5,6,3,0,0,0,0,2,2
../kbl_data/2024-2025,S45G01N237,서울 SK,Home,자밀 워니,8,1,3,33.3,1,5,20.0,2,8,25.0,3,4,75.0,0,5,5,4,2,2,0,0,3,2
../kbl_data/2024-2025,S45G01N237,서울 SK,Home,김형빈,10,2,3,66.7,2,6,33.3,4,9,44.4,0,0,0.0,0,1,1,1,1,0,0,0,0,2
../kbl_data/2024-2025,S45G01N237,서울 SK,Home,아이재아 힉스,12,3,5,60.0,1,5,20.0,4,10,40.0,3,3,100.0,1,4,5,2,0,2,0,1,1,3
../kbl_data/2024-2025,S45G01N237,서울 SK,Home,오재현,11,4,6,66.7,1,3,33.3,5,9,55.6,0,0,0.0,2,2,4,4,3,0,1,0,4,1
../kbl_data/2024-2025,S45G01N237,서울 SK,Home,문가온,0,0,0,0.0,0,0,0.0,0,0,0.0,0,0,0.0,0,0,0,0,0,0,0,0,0,0
../kbl_data/2024-2025,S45G01N237,서울 SK,Home,고메즈 델 리아노,2,1,2,50.0,0,1,0.0,1,3,33.3,0,0,0.0,0,0,0,3,0,0,0,0,4,2
../kbl_data/2024-2025,S45G01N237,서울 SK,Home,김태훈,3,0,0,0.0,1,2,50.0,1,2,50.0,0,0,0.0,1,2,3,2,2,0,0,0,0,2
../kbl_data/2024-2025,S45G01N237,부산 KCC,Away,정창영,13,3,5,60.0,1,3,33.3,4,8,50.0,4,4,100.0,0,3,3,5,3,1,0,0,1,1
../kbl_data/2024-2025,S45G01N237,부산 KCC,Away,전준범,9,0,3,0.0,3,5,60.0,3,8,37.5,0,0,0.0,0,4,4,1,0,0,0,0,3,2
../kbl_data/2024-2025,S45G01N237,부산 KCC,Away,이승현,12,6,11,54.5,0,2,0.0,6,13,46.2,0,0,0.0,3,7,10,5,1,1,0,0,1,2
../kbl_data/2024-2025,S45G01N237,부산 KCC,Away,이호현,13,4,7,57.1,1,3,33.3,5,10,50.0,2,2,100.0,1,2,3,4,3,0,0,0,1,1
../kbl_data/2024-2025,S45G01N237,부산 KCC,Away,캐디 라렌,18,8,13,61.5,0,4,0.0,8,17,47.1,2,2,100.0,4,6,10,1,0,0,0,0,3,2
../kbl_data/2024-2025,S45G01N237,부산 KCC,Away,이근휘,5,1,1,100.0,1,4,25.0,2,5,40.0,0,0,0.0,0,1,1,1,2,0,1,0,1,0
../kbl_data/2024-2025,S45G01N237,부산 KCC,Away,김동현,0,0,1,0.0,0,1,0.0,0,2,0.0,0,0,0.0,1,0,1,1,2,1,0,0,0,2
../kbl_data/2024-2025,S45G01N237,부산 KCC,Away,여준형,0,0,0,0.0,0,0,0.0,0,0,0.0,0,0,0.0,0,0,0,0,0,0,0,0,0,0
../kbl_data/2024-2025,S45G01N237,부산 KCC,Away,캘빈 제프리 에피스톨라,11,1,2,50.0,3,3,100.0,4,5,80.0,0,0,0.0,0,2,2,2,2,0,0,0,3,3
../kbl_data/2024-2025,S45G01N237,부산 KCC,Away,이주영,0,0,0,0.0,0,0,0.0,0,0,0.0,0,0,0.0,0,0,0,0,0,0,0,0,0,0
../kbl_data/2024-2025,S45G01N237,부산 KCC,Away,이찬영,0,0,0,0.0,0,0,0.0,0,0,0.0,0,0,0.0,0,0,0,0,0,0,0,0,0,0
../kbl_data/2024-2025,S45G01N237,부산 KCC,Away,도노반 스미스,0,0,0,0.0,0,0,0.0,0,0,0.0,0,0,0.0,0,0,0,0,0,0,0,0,1,0
../kbl_data/2024-2025,S45G01N238,안양 정관장,Home,송창용,0,0,0,0.0,0,0,0.0,0,0,0.0,0,0,0.0,0,0,0,0,0,0,0,0,0,1
../kbl_data/2024-2025,S45G01N238,안양 정관장,Home,정준원,0,0,1,0.0,0,1,0.0,0,2,0.0,0,0,0.0,0,0,0,0,0,0,0,0,0,0
../kbl_data/2024-2025,S45G01N238,안양 정관장,Home,김영현,2,1,1,100.0,0,0,0.0,1,1,100.0,0,0,0.0,1,1,2,1,1,1,1,0,1,2
../kbl_data/2024-2025,S45G01N238,안양 정관장,Home,김종규,0,0,0,0.0,0,0,0.0,0,0,0.0,0,0,0.0,0,0,0,0,0,0,0,0,0,0
../kbl_data/2024-2025,S45G01N238,안양 정관장,Home,박지훈,21,3,6,50.0,4,5,80.0,7,11,63.6,3,4,75.0,1,6,7,4,0,0,0,0,2,3
../kbl_data/2024-2025,S45G01N238,안양 정관장,Home,디온테 버튼,9,4,8,50.0,0,2,0.0,4,10,40.0,1,4,25.0,0,1,1,3,2,0,1,0,1,1
../kbl_data/2024-2025,S45G01N238,안양 정관장,Home,변준형,1,0,2,0.0,0,2,0.0,0,4,0.0,1,2,50.0,1,6,7,5,0,1,0,0,1,2
../kbl_data/2024-2025,S45G01N238,안양 정관장,Home,김경원,6,1,3,33.3,1,2,50.0,2,5,40.0,1,1,100.0,1,2,3,1,0,0,0,0,0,3
../kbl_data/2024-2025,S45G01N238,안양 정관장,Home,한승희,11,2,6,33.3,2,3,66.7,4,9,44.4,1,2,50.0,2,3,5,1,0,0,0,0,0,3
../kbl_data/2024-2025,S45G01N238,안양 정관장,Home,조니 오브라이언트,27,7,18,38.9,4,6,66.7,11,24,45.8,1,2,50.0,5,3,8,3,0,0,0,0,0,3
../kbl_data/2024-2025,S45G01N238,안양 정관장,Home,하비 고메즈,10,2,4,50.0,2,5,40.0,4,9,44.4,0,0,0.0,0,1,1,0,1,0,0,0,0,1
../kbl_data/2024-2025,S45G01N238,안양 정관장,Home,소준혁,0,0,0,0.0,0,0,0.0,0,0,0.0,0,0,0.0,0,0,0,0,0,0,0,0,0,0
../kbl_data/2024-2025,S45G01N238,울산 현대모비스,Away,함지훈,10,2,4,50.0,2,4,50.0,4,8,50.0,0,0,0.0,2,6,8,4,1,0,0,0,0,2
../kbl_data/2024-2025,S45G01N238,울산 현대모비스,Away,장재석,10,5,5,100.0,0,0,0.0,5,5,100.0,0,3,0.0,0,2,2,1,0,0,0,0,2,2
../kbl_data/2024-2025,S45G01N238,울산 현대모비스,Away,이대헌,0,0,0,0.0,0,0,0.0,0,0,0.0,0,0,0.0,0,0,0,0,0,0,0,0,0,0
../kbl_data/2024-2025,S45G01N238,울산 현대모비스,Away,한호빈,5,0,1,0.0,1,2,50.0,1,3,33.3,2,2,100.0,2,2,4,3,1,0,0,0,3,3
../kbl_data/2024-2025,S45G01N238,울산 현대모비스,Away,서명진,19,2,3,66.7,5,8,62.5,7,11,63.6,0,0,0.0,1,2,3,4,1,0,0,0,0,3
../kbl_data/2024-2025,S45G01N238,울산 현대모비스,Away,숀 롱,7,3,4,75.0,0,0,0.0,3,4,75.0,1,2,50.0,2,2,4,0,0,3,0,0,1,3
../kbl_data/2024-2025,S45G01N238,울산 현대모비스,Away,이우석,9,1,3,33.3,2,7,28.6,3,10,30.0,1,2,50.0,3,6,9,2,0,0,0,0,2,2
../kbl_data/2024-2025,S45G01N238,울산 현대모비스,Away,이승우,2,1,1,100.0,0,0,0.0,1,1,100.0,0,0,0.0,0,1,1,0,0,1,0,0,0,0
../kbl_data/2024-2025,S45G01N238,울산 현대모비스,Away,신민석,3,0,0,0.0,1,1,100.0,1,1,100.0,0,0,0.0,0,0,0,0,0,0,0,0,0,0
../kbl_data/2024-2025,S45G01N238,울산 현대모비스,Away,게이지 프림,17,8,20,40.0,0,0,0.0,8,20,40.0,1,1,100.0,2,7,9,3,0,1,0,0,3,2
../kbl_data/2024-2025,S45G01N238,울산 현대모비스,Away,박무빈,0,0,2,0.0,0,0,0.0,0,2,0.0,0,0,0.0,0,1,1,2,0,0,0,0,2,2
../kbl_data/2024-2025,S45G01N238,울산 현대모비스,Away,미구엘 안드레 옥존,2,0,0,0.0,0,1,0.0,0,1,0.0,2,2,100.0,0,0,0,0,0,0,0,0,0,1
../kbl_data/2024-2025,S45G01N239,창원 LG,Home,허일영,10,0,2,0.0,3,4,75.0,3,6,50.0,1,2,50.0,1,1,2,0,0,0,0,0,0,1
../kbl_data/2024-2025,S45G01N239,창원 LG,Home,장민국,0,0,0,0.0,0,0,0.0,0,0,0.0,0,0,0.0,0,0,0,0,0,0,0,0,0,0
../kbl_data/2024-2025,S45G01N239,창원 LG,Home,한상혁,0,0,0,0.0,0,0,0.0,0,0,0.0,0,0,0.0,0,0,0,0,0,0,0,0,0,0
../kbl_data/2024-2025,S45G01N239,창원 LG,Home,정인덕,0,0,2,0.0,0,0,0.0,0,2,0.0,0,0,0.0,0,6,6,0,2,0,1,0,0,1
../kbl_data/2024-2025,S45G01N239,창원 LG,Home,대릴 먼로,8,4,7,57.1,0,0,0.0,4,7,57.1,0,0,0.0,2,1,3,4,1,0,0,0,1,2
../kbl_data/2024-2025,S45G01N239,창원 LG,Home,박정현,0,0,1,0.0,0,0,0.0,0,1,0.0,0,0,0.0,0,0,0,1,0,0,0,0,1,0
../kbl_data/2024-2025,S45G01N239,창원 LG,Home,아셈 마레이,13,4,9,44.4,0,0,0.0,4,9,44.4,5,10,50.0,5,8,13,6,2,0,0,0,1,2
../kbl_data/2024-2025,S45G01N239,창원 LG,Home,양준석,11,4,6,66.7,0,3,0.0,4,9,44.4,3,3,100.0,0,1,1,6,0,0,0,0,1,3
../kbl_data/2024-2025,S45G01N239,창원 LG,Home,유기상,17,0,1,0.0,5,9,55.6,5,10,50.0,2,2,100.0,1,2,3,2,0,0,0,0,1,1
../kbl_data/2024-2025,S45G01N239,창원 LG,Home,이경도,7,2,3,66.7,1,1,100.0,3,4,75.0,0,0,0.0,1,1,2,2,2,0,0,0,0,1
../kbl_data/2024-2025,S45G01N239,창원 LG,Home,칼 타마요,19,7,12,58.3,1,2,50.0,8,14,57.1,2,4,50.0,0,2,2,1,0,0,0,1,1,5
../kbl_data/2024-2025,S45G01N239,창원 LG,Home,최형찬,0,0,0,0.0,0,1,0.0,0,1,0.0,0,0,0.0,0,0,0,0,0,0,0,0,0,3
../kbl_data/2024-2025,S45G01N239,대구 한국가스공사,Away,차바위,0,0,0,0.0,0,0,0.0,0,0,0.0,0,0,0.0,0,0,0,0,0,0,0,0,0,0
../kbl_data/2024-2025,S45G01N239,대구 한국가스공사,Away,박지훈,5,1,3,33.3,1,3,33.3,2,6,33.3,0,0,0.0,0,0,0,2,0,0,0,0,0,2
../kbl_data/2024-2025,S45G01N239,대구 한국가스공사,Away,김준일,1,0,5,0.0,0,0,0.0,0,5,0.0,1,2,50.0,4,2,6,0,0,0,0,0,0,2
../kbl_data/2024-2025,S45G01N239,대구 한국가스공사,Away,정성우,6,0,2,0.0,2,5,40.0,2,7,28.6,0,0,0.0,7,0,7,3,1,0,1,0,1,4
../kbl_data/2024-2025,S45G01N239,대구 한국가스공사,Away,김낙현,0,0,0,0.0,0,2,0.0,0,2,0.0,0,0,0.0,0,0,0,1,0,0,0,0,0,1
../kbl_data/2024-2025,S45G01N239,대구 한국가스공사,Away,곽정훈,4,1,2,50.0,0,4,0.0,1,6,16.7,2,2,100.0,2,3,5,1,0,0,0,0,1,2
../kbl_data/2024-2025,S45G01N239,대구 한국가스공사,Away,이도헌,0,0,0,0.0,0,0,0.0,0,0,0.0,0,0,0.0,0,0,0,1,0,0,0,0,0,1
../kbl_data/2024-2025,S45G01N239,대구 한국가스공사,Away,앤드류 니콜슨,35,10,15,66.7,4,5,80.0,14,20,70.0,3,3,100.0,1,11,12,2,1,1,0,0,1,2
../kbl_data/2024-2025,S45G01N239,대구 한국가스공사,Away,신승민,10,1,3,33.3,2,4,50.0,3,7,42.9,2,4,50.0,2,2,4,5,0,0,0,0,1,5
../kbl_data/2024-2025,S45G01N239,대구 한국가스공사,Away,샘조세프 벨란겔,17,3,7,42.9,3,7,42.9,6,14,42.9,2,2,100.0,2,2,4,6,0,0,0,0,2,2
../kbl_data/2024-2025,S45G01N239,대구 한국가스공사,Away,신주영,3,0,1,0.0,1,2,50.0,1,3,33.3,0,0,0.0,0,2,2,0,0,0,0,0,2,0
../kbl_data/2024-2025,S45G01N239,대구 한국가스공사,Away,손준,0,0,1,0.0,0,2,0.0,0,3,0.0,0,0,0.0,1,0,1,0,0,0,0,0,0,0
../kbl_data/2024-2025,S45G01N240,서울 삼성,Home,이정현,3,1,3,33.3,0,2,0.0,1,5,20.0,1,1,100.0,1,4,5,1,2,0,0,0,1,3
../kbl_data/2024-2025,S45G01N240,서울 삼성,Home,최현민,7,0,1,0.0,2,9,22.2,2,10,20.0,1,2,50.0,1,2,3,2,0,0,0,0,1,3
../kbl_data/2024-2025,S45G01N240,서울 삼성,Home,이원대,0,0,1,0.0,0,0,0.0,0,1,0.0,0,0,0.0,0,0,0,1,0,0,0,0,0,1
../kbl_data/2024-2025,S45G01N240,서울 삼성,Home,최성모,8,0,3,0.0,2,5,40.0,2,8,25.0,2,2,100.0,1,3,4,0,0,0,1,0,2,4
../kbl_data/2024-2025,S45G01N240,서울 삼성,Home,최승욱,1,0,0,0.0,0,2,0.0,0,2,0.0,1,2,50.0,1,1,2,0,0,1,0,0,0,0
../kbl_data/2024-2025,S45G01N240,서울 삼성,Home,윤성원,3,0,0,0.0,1,1,100.0,1,1,100.0,0,0,0.0,0,1,1,0,0,0,0,0,0,3
../kbl_data/2024-2025,S45G01N240,서울 삼성,Home,차민석,1,0,2,0.0,0,0,0.0,0,2,0.0,1,2,50.0,0,2,2,0,0,0,0,0,0,1
../kbl_data/2024-2025,S45G01N240,서울 삼성,Home,이원석,8,2,11,18.2,1,1,100.0,3,12,25.0,1,2,50.0,1,0,1,1,0,1,1,0,1,2
../kbl_data/2024-2025,S45G01N240,서울 삼성,Home,저스틴 구탕,6,3,4,75.0,0,2,0.0,3,6,50.0,0,0,0.0,1,1,2,2,2,0,0,0,0,2
../kbl_data/2024-2025,S45G01N240,서울 삼성,Home,박승재,0,0,0,0.0,0,0,0.0,0,0,0.0,0,0,0.0,0,0,0,1,0,0,0,0,0,0
../kbl_data/2024-2025,S45G01N240,서울 삼성,Home,코피 코번,9,4,7,57.1,0,0,0.0,4,7,57.1,1,2,50.0,5,4,9,3,0,0,0,1,1,1
../kbl_data/2024-2025,S45G01N240,서울 삼성,Home,글렌 로빈슨 3세,8,2,7,28.6,1,3,33.3,3,10,30.0,1,2,50.0,0,6,6,1,0,0,0,0,3,0
../kbl_data/2024-2025,S45G01N240,수원 KT,Away,문성곤,7,2,3,66.7,1,5,20.0,3,8,37.5,0,0,0.0,2,3,5,1,2,1,0,0,1,3
../kbl_data/2024-2025,S45G01N240,수원 KT,Away,이현석,0,0,0,0.0,0,1,0.0,0,1,0.0,0,0,0.0,0,0,0,1,0,0,0,0,0,2
../kbl_data/2024-2025,S45G01N240,수원 KT,Away,허훈,2,1,3,33.3,0,1,0.0,1,4,25.0,0,2,0.0,0,1,1,4,1,0,1,0,2,0
../kbl_data/2024-2025,S45G01N240,수원 KT,Away,박준영,6,2,3,66.7,0,0,0.0,2,3,66.7,2,4,50.0,0,2,2,0,0,0,0,0,0,3
../kbl_data/2024-2025,S45G01N240,수원 KT,Away,최진광,0,0,1,0.0,0,1,0.0,0,2,0.0,0,0,0.0,0,0,0,0,0,0,0,0,0,0
../kbl_data/2024-2025,S45G01N240,수원 KT,Away,박지원,2,1,1,100.0,0,1,0.0,1,2,50.0,0,0,0.0,3,1,4,1,0,0,0,0,0,1
../kbl_data/2024-2025,S45G01N240,수원 KT,Away,하윤기,18,8,11,72.7,0,0,0.0,8,11,72.7,2,4,50.0,2,7,9,0,0,1,0,1,3,2
../kbl_data/2024-2025,S45G01N240,수원 KT,Away,이두원,0,0,2,0.0,0,0,0.0,0,2,0.0,0,0,0.0,3,1,4,0,0,0,0,0,0,2
../kbl_data/2024-2025,S45G01N240,수원 KT,Away,문정현,6,0,4,0.0,2,5,40.0,2,9,22.2,0,0,0.0,2,6,8,4,0,0,0,0,0,1
../kbl_data/2024-2025,S45G01N240,수원 KT,Away,레이션 해먼즈,18,4,4,100.0,3,6,50.0,7,10,70.0,1,2,50.0,0,6,6,2,1,0,0,0,1,3
../kbl_data/2024-2025,S45G01N240,수원 KT,Away,박성재,10,2,2,100.0,2,3,66.7,4,5,80.0,0,0,0.0,1,3,4,0,1,0,0,0,1,2
../kbl_data/2024-2025,S45G01N240,수원 KT,Away,조엘 카굴랑안,3,0,6,0.0,1,3,33.3,1,9,11.1,0,0,0.0,3,3,6,6,0,0,0,0,0,1
../kbl_data/2024-2025,S45G01N241,안양 정관장,Home,송창용,8,0,3,0.0,2,3,66.7,2,6,33.3,2,3,66.7,0,3,3,0,0,0,1,0,1,3
../kbl_data/2024-2025,S45G01N241,안양 정관장,Home,정준원,3,0,0,0.0,1,3,33.3,1,3,33.3,0,0,0.0,0,1,1,0,1,0,0,0,1,0
../kbl_data/2024-2025,S45G01N241,안양 정관장,Home,김영현,8,1,2,50.0,2,2,100.0,3,4,75.0,0,0,0.0,0,0,0,0,0,0,0,0,1,4
../kbl_data/2024-2025,S45G01N241,안양 정관장,Home,김종규,0,0,0,0.0,0,0,0.0,0,0,0.0,0,0,0.0,0,0,0,0,0,0,0,0,0,0
../kbl_data/2024-2025,S45G01N241,안양 정관장,Home,박지훈,20,4,6,66.7,3,4,75.0,7,10,70.0,3,3,100.0,0,3,3,6,2,0,0,0,2,4
../kbl_data/2024-2025,S45G01N241,안양 정관장,Home,디온테 버튼,14,5,10,50.0,0,1,0.0,5,11,45.5,4,4,100.0,3,6,9,5,0,0,0,0,3,3
../kbl_data/2024-2025,S45G01N241,안양 정관장,Home,변준형,10,1,3,33.3,2,6,33.3,3,9,33.3,2,2,100.0,2,2,4,3,0,0,1,0,3,3
../kbl_data/2024-2025,S45G01N241,안양 정관장,Home,김경원,0,0,0,0.0,0,0,0.0,0,0,0.0,0,0,0.0,0,0,0,0,0,0,0,0,0,0
../kbl_data/2024-2025,S45G01N241,안양 정관장,Home,한승희,7,2,3,66.7,1,2,50.0,3,5,60.0,0,0,0.0,1,2,3,1,2,1,0,0,1,3
../kbl_data/2024-2025,S45G01N241,안양 정관장,Home,조니 오브라이언트,6,2,5,40.0,0,2,0.0,2,7,28.6,2,2,100.0,0,5,5,2,2,0,0,0,2,3
../kbl_data/2024-2025,S45G01N241,안양 정관장,Home,하비 고메즈,17,1,2,50.0,5,9,55.6,6,11,54.5,0,0,0.0,2,6,8,0,0,0,0,0,1,3
../kbl_data/2024-2025,S45G01N241,안양 정관장,Home,소준혁,0,0,0,0.0,0,0,0.0,0,0,0.0,0,0,0.0,0,0,0,0,0,0,0,0,0,0
../kbl_data/2024-2025,S45G01N241,고양 소노,Away,정희재,3,0,0,0.0,0,1,0.0,0,1,0.0,3,4,75.0,0,1,1,0,0,0,1,0,0,3
../kbl_data/2024-2025,S45G01N241,고양 소노,Away,임동섭,8,0,1,0.0,2,6,33.3,2,7,28.6,2,4,50.0,2,3,5,0,0,0,0,0,1,2
../kbl_data/2024-2025,S45G01N241,고양 소노,Away,이재도,13,5,6,83.3,0,3,0.0,5,9,55.6,3,3,100.0,1,3,4,2,1,0,0,0,0,3
../kbl_data/2024-2025,S45G01N241,고양 소노,Away,최승욱,0,0,0,0.0,0,0,0.0,0,0,0.0,0,0,0.0,0,1,1,0,0,0,0,0,0,0
../kbl_data/2024-2025,S45G01N241,고양 소노,Away,김진유,2,1,1,100.0,0,1,0.0,1,2,50.0,0,0,0.0,5,1,6,2,1,0,0,0,0,3
../kbl_data/2024-2025,S45G01N241,고양 소노,Away,이정현,21,5,6,83.3,2,8,25.0,7,14,50.0,5,6,83.3,1,0,1,2,0,1,1,0,4,2
../kbl_data/2024-2025,S45G01N241,고양 소노,Away,조은후,2,1,1,100.0,0,1,0.0,1,2,50.0,0,0,0.0,0,0,0,0,1,0,0,0,0,1
../kbl_data/2024-2025,S45G01N241,고양 소노,Away,박종하,0,0,0,0.0,0,0,0.0,0,0,0.0,0,0,0.0,0,0,0,0,0,0,0,0,0,0
../kbl_data/2024-2025,S45G01N241,고양 소노,Away,앨런 윌리엄스,14,6,16,37.5,0,0,0.0,6,16,37.5,2,3,66.7,3,10,13,4,0,0,0,0,5,3
../kbl_data/2024-2025,S45G01N241,고양 소노,Away,디제이 번즈 Jr,2,1,2,50.0,0,1,0.0,1,3,33.3,0,0,0.0,0,0,0,0,0,0,0,0,0,1
../kbl_data/2024-2025,S45G01N241,고양 소노,Away,이근준,0,0,0,0.0,0,6,0.0,0,6,0.0,0,0,0.0,0,0,0,2,1,0,1,0,0,2
../kbl_data/2024-2025,S45G01N241,고양 소노,Away,케빈 켐바오,19,4,7,57.1,1,4,25.0,5,11,45.5,8,8,100.0,3,5,8,4,4,1,0,0,1,0
../kbl_data/2024-2025,S45G01N242,서울 삼성,Home,이정현,6,0,2,0.0,1,4,25.0,1,6,16.7,3,3,100.0,0,4,4,4,0,0,0,0,1,2
../kbl_data/2024-2025,S45G01N242,서울 삼성,Home,최현민,3,0,0,0.0,1,3,33.3,1,3,33.3,0,0,0.0,1,1,2,2,0,1,0,0,0,1
../kbl_data/2024-2025,S45G01N242,서울 삼성,Home,이원대,0,0,0,0.0,0,0,0.0,0,0,0.0,0,0,0.0,0,1,1,0,0,0,0,0,1,0
../kbl_data/2024-2025,S45G01N242,서울 삼성,Home,최성모,10,1,4,25.0,2,6,33.3,3,10,30.0,2,2,100.0,1,2,3,3,0,0,0,0,1,5
../kbl_data/2024-2025,S45G01N242,서울 삼성,Home,최승욱,8,4,6,66.7,0,0,0.0,4,6,66.7,0,0,0.0,0,1,1,1,2,0,0,0,1,2
../kbl_data/2024-2025,S45G01N242,서울 삼성,Home,윤성원,0,0,0,0.0,0,1,0.0,0,1,0.0,0,0,0.0,0,0,0,1,0,0,0,0,0,0
../kbl_data/2024-2025,S45G01N242,서울 삼성,Home,김한솔,0,0,2,0.0,0,0,0.0,0,2,0.0,0,0,0.0,1,1,2,0,0,1,0,0,2,2
../kbl_data/2024-2025,S45G01N242,서울 삼성,Home,차민석,4,2,4,50.0,0,0,0.0,2,4,50.0,0,0,0.0,1,1,2,0,0,0,2,0,1,5
../kbl_data/2024-2025,S45G01N242,서울 삼성,Home,저스틴 구탕,19,8,10,80.0,1,5,20.0,9,15,60.0,0,0,0.0,1,3,4,3,3,1,0,0,3,2
../kbl_data/2024-2025,S45G01N242,서울 삼성,Home,조준희,0,0,1,0.0,0,1,0.0,0,2,0.0,0,0,0.0,0,1,1,0,0,0,0,0,0,0
../kbl_data/2024-2025,S45G01N242,서울 삼성,Home,박승재,0,0,1,0.0,0,2,0.0,0,3,0.0,0,0,0.0,0,0,0,0,2,0,0,0,0,0
../kbl_data/2024-2025,S45G01N242,서울 삼성,Home,글렌 로빈슨 3세,19,8,14,57.1,0,3,0.0,8,17,47.1,3,4,75.0,1,5,6,2,2,0,0,3,3,0
../kbl_data/2024-2025,S45G01N242,창원 LG,Away,허일영,3,0,1,0.0,1,3,33.3,1,4,25.0,0,0,0.0,3,3,6,0,0,0,0,0,0,1
../kbl_data/2024-2025,S45G01N242,창원 LG,Away,장민국,0,0,0,0.0,0,0,0.0,0,0,0.0,0,0,0.0,0,0,0,0,0,0,0,0,0,0
../kbl_data/2024-2025,S45G01N242,창원 LG,Away,두경민,2,1,2,50.0,0,1,0.0,1,3,33.3,0,0,0.0,0,2,2,0,0,0,0,0,0,0
../kbl_data/2024-2025,S45G01N242,창원 LG,Away,정인덕,8,0,0,0.0,2,3,66.7,2,3,66.7,2,2,100.0,0,3,3,3,0,0,0,0,3,1
../kbl_data/2024-2025,S45G01N242,창원 LG,Away,대릴 먼로,6,3,8,37.5,0,0,0.0,3,8,37.5,0,0,0.0,2,5,7,4,0,0,1,1,3,2
../kbl_data/2024-2025,S45G01N242,창원 LG,Away,박정현,0,0,1,0.0,0,1,0.0,0,2,0.0,0,0,0.0,0,1,1,0,0,0,0,0,1,0
../kbl_data/2024-2025,S45G01N242,창원 LG,Away,아셈 마레이,27,11,14,78.6,0,0,0.0,11,14,78.6,5,8,62.5,7,8,15,5,3,0,0,1,2,4
../kbl_data/2024-2025,S45G01N242,창원 LG,Away,양준석,8,0,1,0.0,2,4,50.0,2,5,40.0,2,2,100.0,0,3,3,3,1,0,1,0,1,4
../kbl_data/2024-2025,S45G01N242,창원 LG,Away,유기상,23,4,5,80.0,5,10,50.0,9,15,60.0,0,0,0.0,0,2,2,2,1,0,0,0,1,3
../kbl_data/2024-2025,S45G01N242,창원 LG,Away,이경도,0,0,0,0.0,0,1,0.0,0,1,0.0,0,0,0.0,1,0,1,2,1,0,0,0,0,0
../kbl_data/2024-2025,S45G01N242,창원 LG,Away,칼 타마요,15,6,10,60.0,1,2,50.0,7,12,58.3,0,1,0.0,0,5,5,4,0,0,0,0,3,2
../kbl_data/2024-2025,S45G01N242,창원 LG,Away,최형찬,0,0,2,0.0,0,3,0.0,0,5,0.0,0,0,0.0,0,1,1,1,2,0,0,0,1,3
../kbl_data/2024-2025,S45G01N243,수원 KT,Home,한희원,6,3,4,75.0,0,1,0.0,3,5,60.0,0,0,0.0,2,0,2,0,0,0,0,0,0,2
../kbl_data/2024-2025,S45G01N243,수원 KT,Home,문성곤,5,1,1,100.0,1,2,50.0,2,3,66.7,0,0,0.0,1,0,1,3,0,0,0,0,1,2
../kbl_data/2024-2025,S45G01N243,수원 KT,Home,이현석,3,0,0,0.0,1,1,100.0,1,1,100.0,0,0,0.0,0,1,1,0,0,0,0,0,0,1
../kbl_data/2024-2025,S45G01N243,수원 KT,Home,허훈,25,4,7,57.1,4,6,66.7,8,13,61.5,5,6,83.3,0,0,0,10,1,0,0,0,5,1
../kbl_data/2024-2025,S45G01N243,수원 KT,Home,박준영,4,1,3,33.3,0,1,0.0,1,4,25.0,2,2,100.0,2,1,3,2,1,0,0,0,1,0
../kbl_data/2024-2025,S45G01N243,수원 KT,Home,최진광,0,0,1,0.0,0,1,0.0,0,2,0.0,0,0,0.0,0,0,0,0,0,0,0,0,0,2
../kbl_data/2024-2025,S45G01N243,수원 KT,Home,하윤기,4,2,9,22.2,0,0,0.0,2,9,22.2,0,0,0.0,2,2,4,1,0,1,0,0,0,3
../kbl_data/2024-2025,S45G01N243,수원 KT,Home,이두원,2,0,0,0.0,0,0,0.0,0,0,0.0,2,2,100.0,2,1,3,0,0,0,0,0,1,1
../kbl_data/2024-2025,S45G01N243,수원 KT,Home,문정현,7,2,2,100.0,1,4,25.0,3,6,50.0,0,0,0.0,2,3,5,1,1,0,0,0,0,2
../kbl_data/2024-2025,S45G01N243,수원 KT,Home,레이션 해먼즈,19,8,10,80.0,1,3,33.3,9,13,69.2,0,2,0.0,2,8,10,0,4,0,0,0,4,3
../kbl_data/2024-2025,S45G01N243,수원 KT,Home,박성재,6,0,0,0.0,2,3,66.7,2,3,66.7,0,0,0.0,1,2,3,1,0,0,0,0,1,2
../kbl_data/2024-2025,S45G01N243,수원 KT,Home,조엘 카굴랑안,9,2,5,40.0,1,4,25.0,3,9,33.3,2,3,66.7,0,0,0,3,0,0,0,0,1,1
../kbl_data/2024-2025,S45G01N243,고양 소노,Away,함준후,0,0,0,0.0,0,0,0.0,0,0,0.0,0,0,0.0,0,1,1,0,0,0,0,0,0,0
../kbl_data/2024-2025,S45G01N243,고양 소노,Away,정희재,0,0,0,0.0,0,1,0.0,0,1,0.0,0,0,0.0,0,0,0,2,0,0,0,0,0,2
../kbl_data/2024-2025,S45G01N243,고양 소노,Away,임동섭,6,3,3,100.0,0,5,0.0,3,8,37.5,0,0,0.0,2,0,2,0,1,0,0,0,0,2
../kbl_data/2024-2025,S45G01N243,고양 소노,Away,이재도,3,0,0,0.0,1,4,25.0,1,4,25.0,0,0,0.0,1,1,2,1,2,0,0,0,1,1
../kbl_data/2024-2025,S45G01N243,고양 소노,Away,김진유,7,2,2,100.0,1,3,33.3,3,5,60.0,0,0,0.0,0,2,2,4,1,1,0,0,1,2
../kbl_data/2024-2025,S45G01N243,고양 소노,Away,이정현,25,1,4,25.0,7,10,70.0,8,14,57.1,2,2,100.0,0,1,1,3,2,0,2,0,1,2
../kbl_data/2024-2025,S45G01N243,고양 소노,Away,조은후,5,2,2,100.0,0,1,0.0,2,3,66.7,1,2,50.0,2,0,2,0,0,0,0,0,1,2
../kbl_data/2024-2025,S45G01N243,고양 소노,Away,민기남,3,0,0,0.0,1,1,100.0,1,1,100.0,0,0,0.0,1,1,2,1,0,0,0,0,1,1
../kbl_data/2024-2025,S45G01N243,고양 소노,Away,앨런 윌리엄스,16,5,10,50.0,0,0,0.0,5,10,50.0,6,8,75.0,3,6,9,3,2,1,0,0,3,1
../kbl_data/2024-2025,S45G01N243,고양 소노,Away,디제이 번즈 Jr,2,1,3,33.3,0,0,0.0,1,3,33.3,0,0,0.0,1,1,2,1,0,0,0,0,1,2
../kbl_data/2024-2025,S45G01N243,고양 소노,Away,이근준,2,1,2,50.0,0,2,0.0,1,4,25.0,0,0,0.0,4,2,6,2,2,0,0,0,0,4
../kbl_data/2024-2025,S45G01N243,고양 소노,Away,케빈 켐바오,12,2,6,33.3,1,3,33.3,3,9,33.3,5,6,83.3,0,1,1,2,1,0,0,0,2,0
../kbl_data/2024-2025,S45G01N244,원주 DB,Home,이관희,0,0,0,0.0,0,0,0.0,0,0,0.0,0,0,0.0,0,0,0,0,0,0,0,0,0,0
../kbl_data/2024-2025,S45G01N244,원주 DB,Home,김시래,2,1,3,33.3,0,0,0.0,1,3,33.3,0,0,0.0,0,2,2,2,0,0,0,0,2,1
../kbl_data/2024-2025,S45G01N244,원주 DB,Home,서민수,0,0,1,0.0,0,0,0.0,0,1,0.0,0,0,0.0,1,1,2,1,0,1,0,0,1,5
../kbl_data/2024-2025,S45G01N244,원주 DB,Home,정효근,4,0,3,0.0,0,1,0.0,0,4,0.0,4,4,100.0,4,3,7,3,0,0,0,0,1,4
../kbl_data/2024-2025,S45G01N244,원주 DB,Home,강상재,0,0,2,0.0,0,2,0.0,0,4,0.0,0,0,0.0,0,5,5,0,0,1,0,0,2,4
../kbl_data/2024-2025,S45G01N244,원주 DB,Home,최성원,10,2,4,50.0,2,3,66.7,4,7,57.1,0,0,0.0,1,0,1,0,0,0,0,0,1,1
../kbl_data/2024-2025,S45G01N244,원주 DB,Home,치나누 오누아쿠,4,2,3,66.7,0,0,0.0,2,3,66.7,0,0,0.0,0,4,4,0,0,0,0,1,1,0
../kbl_data/2024-2025,S45G01N244,원주 DB,Home,이용우,3,0,0,0.0,1,4,25.0,1,4,25.0,0,0,0.0,0,1,1,0,0,0,0,0,0,1
../kbl_data/2024-2025,S45G01N244,원주 DB,Home,오마리 스펠맨,23,4,9,44.4,3,7,42.9,7,16,43.8,6,7,85.7,1,11,12,2,0,0,0,1,1,2
../kbl_data/2024-2025,S45G01N244,원주 DB,Home,이선 알바노,8,4,11,36.4,0,5,0.0,4,16,25.0,0,0,0.0,1,3,4,2,0,0,0,0,2,3
../kbl_data/2024-2025,S45G01N244,원주 DB,Home,박인웅,8,1,4,25.0,2,4,50.0,3,8,37.5,0,0,0.0,0,1,1,1,0,0,0,0,0,0
../kbl_data/2024-2025,S45G01N244,원주 DB,Home,김보배,0,0,0,0.0,0,0,0.0,0,0,0.0,0,0,0.0,0,1,1,0,1,0,0,0,1,1
../kbl_data/2024-2025,S45G01N244,울산 현대모비스,Away,함지훈,11,4,5,80.0,1,2,50.0,5,7,71.4,0,0,0.0,1,2,3,0,1,0,0,0,0,1
../kbl_data/2024-2025,S45G01N244,울산 현대모비스,Away,장재석,12,5,10,50.0,0,0,0.0,5,10,50.0,2,3,66.7,2,1,3,2,2,0,0,1,1,0
../kbl_data/2024-2025,S45G01N244,울산 현대모비스,Away,이대헌,0,0,0,0.0,0,0,0.0,0,0,0.0,0,0,0.0,0,0,0,0,0,0,0,0,0,0
../kbl_data/2024-2025,S45G01N244,울산 현대모비스,Away,한호빈,2,1,3,33.3,0,1,0.0,1,4,25.0,0,0,0.0,0,2,2,3,1,0,1,0,2,1
../kbl_data/2024-2025,S45G01N244,울산 현대모비스,Away,김국찬,5,1,3,33.3,1,3,33.3,2,6,33.3,0,0,0.0,0,4,4,1,1,0,0,0,2,3
../kbl_data/2024-2025,S45G01N244,울산 현대모비스,Away,서명진,0,0,2,0.0,0,1,0.0,0,3,0.0,0,0,0.0,1,0,1,1,0,0,0,0,1,4
../kbl_data/2024-2025,S45G01N244,울산 현대모비스,Away,숀 롱,9,4,8,50.0,0,1,0.0,4,9,44.4,1,1,100.0,3,3,6,2,0,3,0,0,1,0
../kbl_data/2024-2025,S45G01N244,울산 현대모비스,Away,이우석,7,1,7,14.3,1,5,20.0,2,12,16.7,2,4,50.0,1,5,6,9,0,1,0,0,1,4
../kbl_data/2024-2025,S45G01N244,울산 현대모비스,Away,신민석,0,0,0,0.0,0,0,0.0,0,0,0.0,0,0,0.0,0,0,0,0,0,0,0,0,0,0
../kbl_data/2024-2025,S45G01N244,울산 현대모비스,Away,게이지 프림,21,10,17,58.8,0,1,0.0,10,18,55.6,1,3,33.3,4,4,8,0,0,0,1,0,0,1
../kbl_data/2024-2025,S45G01N244,울산 현대모비스,Away,박무빈,4,2,6,33.3,0,0,0.0,2,6,33.3,0,0,0.0,1,4,5,2,1,0,0,0,0,3
../kbl_data/2024-2025,S45G01N244,울산 현대모비스,Away,미구엘 안드레 옥존,0,0,0,0.0,0,0,0.0,0,0,0.0,0,0,0.0,0,0,0,0,0,0,0,0,0,0
../kbl_data/2024-2025,S45G01N245,부산 KCC,Home,정창영,0,0,2,0.0,0,1,0.0,0,3,0.0,0,0,0.0,0,0,0,1,0,0,0,0,1,4
../kbl_data/2024-2025,S45G01N245,부산 KCC,Home,전준범,3,0,1,0.0,1,2,50.0,1,3,33.3,0,0,0.0,0,0,0,1,0,0,0,0,1,1
../kbl_data/2024-2025,S45G01N245,부산 KCC,Home,허웅,6,2,2,100.0,0,1,0.0,2,3,66.7,2,2,100.0,0,1,1,1,0,0,0,0,2,0
../kbl_data/2024-2025,S45G01N245,부산 KCC,Home,이승현,2,1,5,20.0,0,0,0.0,1,5,20.0,0,0,0.0,1,2,3,3,0,0,0,0,2,2
../kbl_data/2024-2025,S45G01N245,부산 KCC,Home,이호현,9,4,7,57.1,0,0,0.0,4,7,57.1,1,2,50.0,0,4,4,2,0,0,0,0,2,2
../kbl_data/2024-2025,S45G01N245,부산 KCC,Home,캐디 라렌,20,6,10,60.0,1,3,33.3,7,13,53.8,5,6,83.3,0,4,4,2,0,0,0,0,1,1
../kbl_data/2024-2025,S45G01N245,부산 KCC,Home,이근휘,9,0,0,0.0,3,5,60.0,3,5,60.0,0,0,0.0,0,2,2,0,2,0,0,0,0,1
../kbl_data/2024-2025,S45G01N245,부산 KCC,Home,김동현,6,2,2,100.0,0,1,0.0,2,3,66.7,2,2,100.0,0,3,3,1,0,0,1,0,1,2
../kbl_data/2024-2025,S45G01N245,부산 KCC,Home,여준형,6,2,2,100.0,0,0,0.0,2,2,100.0,2,3,66.7,0,0,0,0,0,0,0,0,1,2
../kbl_data/2024-2025,S45G01N245,부산 KCC,Home,캘빈 제프리 에피스톨라,0,0,1,0.0,0,2,0.0,0,3,0.0,0,0,0.0,0,2,2,2,0,0,0,0,1,1
../kbl_data/2024-2025,S45G01N245,부산 KCC,Home,이주영,0,0,1,0.0,0,0,0.0,0,1,0.0,0,0,0.0,0,0,0,2,0,0,0,0,0,1
../kbl_data/2024-2025,S45G01N245,부산 KCC,Home,도노반 스미스,6,3,6,50.0,0,2,0.0,3,8,37.5,0,0,0.0,1,4,5,4,0,0,0,1,0,1
../kbl_data/2024-2025,S45G01N245,대구 한국가스공사,Away,차바위,0,0,0,0.0,0,1,0.0,0,1,0.0,0,0,0.0,1,0,1,1,0,0,0,0,0,0
../kbl_data/2024-2025,S45G01N245,대구 한국가스공사,Away,박지훈,5,1,1,100.0,1,4,25.0,2,5,40.0,0,0,0.0,1,2,3,1,0,0,0,0,0,1
../kbl_data/2024-2025,S45G01N245,대구 한국가스공사,Away,김준일,13,5,6,83.3,0,0,0.0,5,6,83.3,3,3,100.0,3,3,6,5,1,0,0,0,0,3
../kbl_data/2024-2025,S45G01N245,대구 한국가스공사,Away,정성우,4,0,0,0.0,1,2,50.0,1,2,50.0,1,3,33.3,0,2,2,6,1,0,0,0,1,3
../kbl_data/2024-2025,S45G01N245,대구 한국가스공사,Away,김낙현,5,1,3,33.3,1,6,16.7,2,9,22.2,0,0,0.0,1,2,3,9,2,0,0,0,2,1
../kbl_data/2024-2025,S45G01N245,대구 한국가스공사,Away,양재혁,0,0,0,0.0,0,1,0.0,0,1,0.0,0,0,0.0,0,0,0,0,0,0,0,0,1,0
../kbl_data/2024-2025,S45G01N245,대구 한국가스공사,Away,곽정훈,5,1,1,100.0,0,0,0.0,1,1,100.0,3,3,100.0,0,2,2,0,1,0,0,0,0,1
../kbl_data/2024-2025,S45G01N245,대구 한국가스공사,Away,앤드류 니콜슨,23,7,10,70.0,3,5,60.0,10,15,66.7,0,0,0.0,0,5,5,4,1,0,0,0,0,0
../kbl_data/2024-2025,S45G01N245,대구 한국가스공사,Away,신승민,7,2,3,66.7,1,2,50.0,3,5,60.0,0,0,0.0,0,1,1,0,0,0,0,0,0,2
../kbl_data/2024-2025,S45G01N245,대구 한국가스공사,Away,샘조세프 벨란겔,17,5,9,55.6,0,2,0.0,5,11,45.5,7,7,100.0,1,4,5,4,2,0,0,0,0,4
../kbl_data/2024-2025,S45G01N245,대구 한국가스공사,Away,유슈 은도예,14,5,6,83.3,0,1,0.0,5,7,71.4,4,4,100.0,2,4,6,0,1,3,0,1,1,2
../kbl_data/2024-2025,S45G01N245,대구 한국가스공사,Away,신주영,3,0,0,0.0,1,3,33.3,1,3,33.3,0,0,0.0,0,2,2,0,0,0,0,0,1,2
../kbl_data/2024-2025,S45G01N246,서울 SK,Home,김선형,2,1,5,20.0,0,0,0.0,1,5,20.0,0,0,0.0,0,0,0,3,0,0,0,0,1,1
../kbl_data/2024-2025,S45G01N246,서울 SK,Home,오세근,3,0,2,0.0,1,2,50.0,1,4,25.0,0,0,0.0,2,3,5,1,0,0,0,0,0,1
../kbl_data/2024-2025,S45G01N246,서울 SK,Home,최원혁,2,1,4,25.0,0,1,0.0,1,5,20.0,0,0,0.0,2,3,5,1,0,0,0,0,0,0
../kbl_data/2024-2025,S45G01N246,서울 SK,Home,김지후,0,0,0,0.0,0,0,0.0,0,0,0.0,0,0,0.0,0,0,0,0,0,0,0,0,0,0
../kbl_data/2024-2025,S45G01N246,서울 SK,Home,장문호,0,0,0,0.0,0,0,0.0,0,0,0.0,0,0,0.0,0,0,0,0,0,0,0,0,0,0
../kbl_data/2024-2025,S45G01N246,서울 SK,Home,안영준,16,2,3,66.7,4,6,66.7,6,9,66.7,0,0,0.0,1,1,2,4,1,0,0,0,2,2
../kbl_data/2024-2025,S45G01N246,서울 SK,Home,자밀 워니,22,9,14,64.3,1,5,20.0,10,19,52.6,1,1,100.0,1,8,9,1,2,0,0,0,2,1
../kbl_data/2024-2025,S45G01N246,서울 SK,Home,김형빈,5,0,1,0.0,1,4,25.0,1,5,20.0,2,2,100.0,1,1,2,1,0,0,0,0,0,3
../kbl_data/2024-2025,S45G01N246,서울 SK,Home,아이재아 힉스,7,3,4,75.0,0,1,0.0,3,5,60.0,1,1,100.0,1,1,2,1,1,0,0,1,1,1
../kbl_data/2024-2025,S45G01N246,서울 SK,Home,오재현,10,5,6,83.3,0,4,0.0,5,10,50.0,0,0,0.0,0,5,5,1,4,0,0,0,0,2
../kbl_data/2024-2025,S45G01N246,서울 SK,Home,고메즈 델 리아노,7,3,6,50.0,0,3,0.0,3,9,33.3,1,1,100.0,0,3,3,2,1,0,0,0,2,1
../kbl_data/2024-2025,S45G01N246,서울 SK,Home,김태훈,5,1,1,100.0,1,2,50.0,2,3,66.7,0,0,0.0,1,2,3,0,0,0,0,0,0,1
../kbl_data/2024-2025,S45G01N246,창원 LG,Away,허일영,3,0,2,0.0,1,3,33.3,1,5,20.0,0,0,0.0,0,1,1,0,0,0,0,0,0,2
../kbl_data/2024-2025,S45G01N246,창원 LG,Away,장민국,0,0,0,0.0,0,0,0.0,0,0,0.0,0,0,0.0,0,0,0,0,0,0,0,0,0,0
../kbl_data/2024-2025,S45G01N246,창원 LG,Away,두경민,2,1,1,100.0,0,0,0.0,1,1,100.0,0,0,0.0,0,0,0,0,0,0,0,0,1,0
../kbl_data/2024-2025,S45G01N246,창원 LG,Away,정인덕,5,1,1,100.0,1,2,50.0,2,3,66.7,0,0,0.0,1,4,5,0,2,0,0,0,0,2
../kbl_data/2024-2025,S45G01N246,창원 LG,Away,대릴 먼로,2,1,3,33.3,0,0,0.0,1,3,33.3,0,0,0.0,3,4,7,3,0,0,0,0,1,0
../kbl_data/2024-2025,S45G01N246,창원 LG,Away,박정현,0,0,0,0.0,0,0,0.0,0,0,0.0,0,0,0.0,0,0,0,1,0,0,0,0,0,1
../kbl_data/2024-2025,S45G01N246,창원 LG,Away,아셈 마레이,13,5,9,55.6,0,0,0.0,5,9,55.6,3,5,60.0,0,7,7,7,2,0,0,1,1,4
../kbl_data/2024-2025,S45G01N246,창원 LG,Away,양준석,15,3,3,100.0,3,6,50.0,6,9,66.7,0,0,0.0,0,0,0,6,0,0,0,0,1,3
../kbl_data/2024-2025,S45G01N246,창원 LG,Away,유기상,27,4,6,66.7,5,10,50.0,9,16,56.2,4,4,100.0,0,4,4,3,2,1,0,0,1,3
../kbl_data/2024-2025,S45G01N246,창원 LG,Away,이경도,0,0,0,0.0,0,0,0.0,0,0,0.0,0,0,0.0,0,0,0,0,0,0,0,0,0,0
../kbl_data/2024-2025,S45G01N246,창원 LG,Away,칼 타마요,9,3,10,30.0,1,6,16.7,4,16,25.0,0,0,0.0,0,8,8,0,0,0,0,0,5,1
../kbl_data/2024-2025,S45G01N246,창원 LG,Away,최형찬,2,1,1,100.0,0,0,0.0,1,1,100.0,0,0,0.0,0,0,0,0,0,0,0,0,0,0
../kbl_data/2024-2025,S45G01N247,울산 현대모비스,Home,함지훈,0,0,0,0.0,0,0,0.0,0,0,0.0,0,0,0.0,0,0,0,0,0,0,0,0,0,0
../kbl_data/2024-2025,S45G01N247,울산 현대모비스,Home,장재석,10,5,8,62.5,0,0,0.0,5,8,62.5,0,1,0.0,4,6,10,8,0,0,0,0,2,2
../kbl_data/2024-2025,S45G01N247,울산 현대모비스,Home,이대헌,4,2,4,50.0,0,0,0.0,2,4,50.0,0,0,0.0,1,1,2,0,0,0,0,0,0,0
../kbl_data/2024-2025,S45G01N247,울산 현대모비스,Home,한호빈,0,0,0,0.0,0,2,0.0,0,2,0.0,0,0,0.0,1,0,1,3,0,0,0,0,0,4
../kbl_data/2024-2025,S45G01N247,울산 현대모비스,Home,김국찬,0,0,0,0.0,0,5,0.0,0,5,0.0,0,0,0.0,0,0,0,0,2,0,0,0,0,0
../kbl_data/2024-2025,S45G01N247,울산 현대모비스,Home,서명진,17,1,2,50.0,5,7,71.4,6,9,66.7,0,0,0.0,1,4,5,7,1,0,0,0,2,3
../kbl_data/2024-2025,S45G01N247,울산 현대모비스,Home,숀 롱,20,8,13,61.5,0,2,0.0,8,15,53.3,4,4,100.0,2,8,10,1,0,1,0,0,3,2
../kbl_data/2024-2025,S45G01N247,울산 현대모비스,Home,이우석,11,4,6,66.7,1,3,33.3,5,9,55.6,0,0,0.0,1,1,2,3,0,0,0,0,0,2
../kbl_data/2024-2025,S45G01N247,울산 현대모비스,Home,신민석,0,0,0,0.0,0,0,0.0,0,0,0.0,0,0,0.0,0,1,1,0,0,0,0,0,1,0
../kbl_data/2024-2025,S45G01N247,울산 현대모비스,Home,게이지 프림,23,8,16,50.0,0,0,0.0,8,16,50.0,7,7,100.0,0,3,3,2,4,1,0,0,2,2
../kbl_data/2024-2025,S45G01N247,울산 현대모비스,Home,박무빈,9,2,3,66.7,1,1,100.0,3,4,75.0,2,5,40.0,1,2,3,4,0,0,0,0,0,2
../kbl_data/2024-2025,S45G01N247,울산 현대모비스,Home,미구엘 안드레 옥존,0,0,0,0.0,0,0,0.0,0,0,0.0,0,0,0.0,0,0,0,0,0,0,0,0,0,0
../kbl_data/2024-2025,S45G01N247,고양 소노,Away,함준후,0,0,0,0.0,0,0,0.0,0,0,0.0,0,0,0.0,0,0,0,0,0,0,0,0,0,0
../kbl_data/2024-2025,S45G01N247,고양 소노,Away,정희재,3,0,2,0.0,1,2,50.0,1,4,25.0,0,0,0.0,0,2,2,0,2,0,0,0,0,1
../kbl_data/2024-2025,S45G01N247,고양 소노,Away,임동섭,8,1,1,100.0,2,4,50.0,3,5,60.0,0,0,0.0,0,2,2,0,0,0,0,0,2,3
../kbl_data/2024-2025,S45G01N247,고양 소노,Away,이재도,14,3,4,75.0,2,5,40.0,5,9,55.6,2,2,100.0,1,2,3,3,0,0,0,0,2,0
../kbl_data/2024-2025,S45G01N247,고양 소노,Away,김진유,0,0,1,0.0,0,2,0.0,0,3,0.0,0,0,0.0,0,3,3,1,1,0,0,0,3,1
../kbl_data/2024-2025,S45G01N247,고양 소노,Away,이정현,12,3,5,60.0,0,3,0.0,3,8,37.5,6,6,100.0,1,0,1,3,0,0,0,0,1,2
../kbl_data/2024-2025,S45G01N247,고양 소노,Away,조은후,8,4,4,100.0,0,3,0.0,4,7,57.1,0,0,0.0,0,2,2,1,1,0,0,0,0,3
../kbl_data/2024-2025,S45G01N247,고양 소노,Away,민기남,3,0,1,0.0,1,2,50.0,1,3,33.3,0,0,0.0,0,0,0,1,0,0,0,0,0,1
../kbl_data/2024-2025,S45G01N247,고양 소노,Away,앨런 윌리엄스,8,4,11,36.4,0,0,0.0,4,11,36.4,0,0,0.0,0,1,1,0,0,1,0,0,0,3
../kbl_data/2024-2025,S45G01N247,고양 소노,Away,디제이 번즈 Jr,16,7,11,63.6,0,0,0.0,7,11,63.6,2,2,100.0,1,3,4,4,0,2,0,0,1,3
../kbl_data/2024-2025,S45G01N247,고양 소노,Away,이근준,4,0,0,0.0,1,3,33.3,1,3,33.3,1,2,50.0,3,1,4,0,0,0,0,0,0,3
../kbl_data/2024-2025,S45G01N247,고양 소노,Away,케빈 켐바오,3,0,3,0.0,1,2,50.0,1,5,20.0,0,0,0.0,0,6,6,2,0,1,0,0,1,1
../kbl_data/2024-2025,S45G01N248,서울 삼성,Home,이정현,8,1,4,25.0,2,6,33.3,3,10,30.0,0,0,0.0,1,1,2,11,1,0,0,0,0,2
../kbl_data/2024-2025,S45G01N248,서울 삼성,Home,최현민,5,1,1,100.0,1,2,50.0,2,3,66.7,0,0,0.0,0,0,0,0,0,0,0,0,0,1
../kbl_data/2024-2025,S45G01N248,서울 삼성,Home,이원대,0,0,0,0.0,0,0,0.0,0,0,0.0,0,0,0.0,0,0,0,0,0,0,0,0,0,0
../kbl_data/2024-2025,S45G01N248,서울 삼성,Home,최성모,9,0,0,0.0,3,6,50.0,3,6,50.0,0,0,0.0,0,4,4,3,0,0,0,0,0,4
../kbl_data/2024-2025,S45G01N248,서울 삼성,Home,최승욱,4,1,4,25.0,0,1,0.0,1,5,20.0,2,2,100.0,1,3,4,0,0,0,0,0,0,0
../kbl_data/2024-2025,S45G01N248,서울 삼성,Home,윤성원,0,0,0,0.0,0,0,0.0,0,0,0.0,0,0,0.0,0,0,0,1,0,0,0,0,0,0
../kbl_data/2024-2025,S45G01N248,서울 삼성,Home,김한솔,0,0,0,0.0,0,0,0.0,0,0,0.0,0,0,0.0,0,0,0,0,0,0,0,0,0,0
../kbl_data/2024-2025,S45G01N248,서울 삼성,Home,차민석,2,1,2,50.0,0,0,0.0,1,2,50.0,0,0,0.0,0,1,1,0,1,0,0,0,1,4
../kbl_data/2024-2025,S45G01N248,서울 삼성,Home,이원석,9,3,5,60.0,0,1,0.0,3,6,50.0,3,3,100.0,0,6,6,0,0,0,0,0,5,4
../kbl_data/2024-2025,S45G01N248,서울 삼성,Home,저스틴 구탕,17,1,7,14.3,4,5,80.0,5,12,41.7,3,4,75.0,0,5,5,0,5,0,0,0,1,1
../kbl_data/2024-2025,S45G01N248,서울 삼성,Home,박승재,2,1,2,50.0,0,0,0.0,1,2,50.0,0,0,0.0,0,0,0,0,0,0,0,0,0,0
../kbl_data/2024-2025,S45G01N248,서울 삼성,Home,글렌 로빈슨 3세,16,5,11,45.5,1,4,25.0,6,15,40.0,3,4,75.0,1,12,13,2,1,1,0,1,4,2
../kbl_data/2024-2025,S45G01N248,안양 정관장,Away,송창용,0,0,1,0.0,0,3,0.0,0,4,0.0,0,0,0.0,0,1,1,0,0,0,0,0,0,1
../kbl_data/2024-2025,S45G01N248,안양 정관장,Away,정준원,2,1,1,100.0,0,0,0.0,1,1,100.0,0,0,0.0,0,0,0,0,1,0,0,0,0,1
../kbl_data/2024-2025,S45G01N248,안양 정관장,Away,김영현,0,0,0,0.0,0,0,0.0,0,0,0.0,0,0,0.0,1,0,1,0,0,0,0,0,0,1
../kbl_data/2024-2025,S45G01N248,안양 정관장,Away,김종규,0,0,2,0.0,0,0,0.0,0,2,0.0,0,0,0.0,0,0,0,0,0,0,0,0,0,0
../kbl_data/2024-2025,S45G01N248,안양 정관장,Away,박지훈,17,4,5,80.0,2,7,28.6,6,12,50.0,3,3,100.0,2,2,4,6,1,0,1,0,1,4
../kbl_data/2024-2025,S45G01N248,안양 정관장,Away,디온테 버튼,20,4,7,57.1,4,10,40.0,8,17,47.1,0,1,0.0,1,11,12,1,0,1,1,0,3,0
../kbl_data/2024-2025,S45G01N248,안양 정관장,Away,변준형,3,0,0,0.0,1,4,25.0,1,4,25.0,0,0,0.0,0,0,0,3,0,0,0,0,1,2
../kbl_data/2024-2025,S45G01N248,안양 정관장,Away,김경원,6,3,3,100.0,0,0,0.0,3,3,100.0,0,0,0.0,2,2,4,2,1,2,0,0,0,3
../kbl_data/2024-2025,S45G01N248,안양 정관장,Away,한승희,8,4,8,50.0,0,2,0.0,4,10,40.0,0,1,0.0,1,6,7,2,1,0,0,0,2,4
../kbl_data/2024-2025,S45G01N248,안양 정관장,Away,조니 오브라이언트,9,3,6,50.0,1,3,33.3,4,9,44.4,0,1,0.0,2,4,6,1,0,0,0,0,2,1
../kbl_data/2024-2025,S45G01N248,안양 정관장,Away,하비 고메즈,17,3,4,75.0,3,9,33.3,6,13,46.2,2,2,100.0,1,2,3,2,1,0,0,0,0,1
../kbl_data/2024-2025,S45G01N248,안양 정관장,Away,소준혁,0,0,0,0.0,0,0,0.0,0,0,0.0,0,0,0.0,1,0,1,0,0,0,0,0,0,0
../kbl_data/2024-2025,S45G01N249,수원 KT,Home,한희원,0,0,0,0.0,0,0,0.0,0,0,0.0,0,0,0.0,0,2,2,1,0,0,0,0,1,0
../kbl_data/2024-2025,S45G01N249,수원 KT,Home,문성곤,0,0,0,0.0,0,4,0.0,0,4,0.0,0,0,0.0,2,2,4,1,1,0,0,0,1,5
../kbl_data/2024-2025,S45G01N249,수원 KT,Home,이현석,0,0,0,0.0,0,0,0.0,0,0,0.0,0,0,0.0,0,0,0,0,0,0,0,0,0,0
../kbl_data/2024-2025,S45G01N249,수원 KT,Home,허훈,20,7,13,53.8,2,7,28.6,9,20,45.0,0,0,0.0,1,4,5,8,1,0,0,0,2,0
../kbl_data/2024-2025,S45G01N249,수원 KT,Home,박준영,2,1,1,100.0,0,0,0.0,1,1,100.0,0,1,0.0,0,0,0,0,0,0,0,0,0,2
../kbl_data/2024-2025,S45G01N249,수원 KT,Home,최진광,0,0,0,0.0,0,0,0.0,0,0,0.0,0,0,0.0,0,0,0,0,0,0,0,0,0,0
../kbl_data/2024-2025,S45G01N249,수원 KT,Home,하윤기,6,3,7,42.9,0,0,0.0,3,7,42.9,0,0,0.0,2,2,4,1,0,2,0,0,1,2
../kbl_data/2024-2025,S45G01N249,수원 KT,Home,이두원,0,0,0,0.0,0,0,0.0,0,0,0.0,0,0,0.0,0,0,0,0,0,0,0,0,0,0
../kbl_data/2024-2025,S45G01N249,수원 KT,Home,문정현,7,3,6,50.0,0,3,0.0,3,9,33.3,1,2,50.0,5,6,11,1,0,0,0,0,0,4
../kbl_data/2024-2025,S45G01N249,수원 KT,Home,레이션 해먼즈,26,8,11,72.7,2,7,28.6,10,18,55.6,4,4,100.0,1,10,11,0,0,1,0,0,2,2
../kbl_data/2024-2025,S45G01N249,수원 KT,Home,박성재,5,2,3,66.7,0,1,0.0,2,4,50.0,1,1,100.0,0,0,0,0,0,0,0,0,1,1
../kbl_data/2024-2025,S45G01N249,수원 KT,Home,조엘 카굴랑안,3,1,3,33.3,0,5,0.0,1,8,12.5,1,2,50.0,1,1,2,5,2,0,1,0,1,1
../kbl_data/2024-2025,S45G01N249,원주 DB,Away,이관희,12,2,6,33.3,2,5,40.0,4,11,36.4,2,2,100.0,0,4,4,2,2,2,0,0,1,2
../kbl_data/2024-2025,S45G01N249,원주 DB,Away,김시래,0,0,0,0.0,0,0,0.0,0,0,0.0,0,0,0.0,0,0,0,0,0,0,0,0,0,0
../kbl_data/2024-2025,S45G01N249,원주 DB,Away,서민수,2,1,2,50.0,0,3,0.0,1,5,20.0,0,0,0.0,3,2,5,3,1,0,0,0,0,4
../kbl_data/2024-2025,S45G01N249,원주 DB,Away,정효근,5,1,2,50.0,1,3,33.3,2,5,40.0,0,0,0.0,0,3,3,0,0,1,0,0,1,4
../kbl_data/2024-2025,S45G01N249,원주 DB,Away,박봉진,0,0,0,0.0,0,0,0.0,0,0,0.0,0,0,0.0,0,0,0,0,0,0,0,0,0,0
../kbl_data/2024-2025,S45G01N249,원주 DB,Away,강상재,5,2,3,66.7,0,0,0.0,2,3,66.7,1,2,50.0,4,5,9,1,2,1,0,0,1,2
../kbl_data/2024-2025,S45G01N249,원주 DB,Away,최성원,0,0,0,0.0,0,0,0.0,0,0,0.0,0,0,0.0,1,1,2,1,1,0,0,0,1,1
../kbl_data/2024-2025,S45G01N249,원주 DB,Away,치나누 오누아쿠,9,3,6,50.0,0,0,0.0,3,6,50.0,3,4,75.0,2,5,7,1,0,1,0,0,2,2
../kbl_data/2024-2025,S45G01N249,원주 DB,Away,이용우,0,0,0,0.0,0,0,0.0,0,0,0.0,0,0,0.0,0,0,0,0,0,0,0,0,0,0
../kbl_data/2024-2025,S45G01N249,원주 DB,Away,오마리 스펠맨,11,4,10,40.0,0,3,0.0,4,13,30.8,3,3,100.0,2,7,9,2,0,1,0,1,3,1
../kbl_data/2024-2025,S45G01N249,원주 DB,Away,이선 알바노,14,3,6,50.0,2,9,22.2,5,15,33.3,2,2,100.0,0,2,2,4,2,0,0,0,1,2
../kbl_data/2024-2025,S45G01N249,원주 DB,Away,박인웅,9,2,2,100.0,1,4,25.0,3,6,50.0,2,3,66.7,1,0,1,0,0,0,0,0,0,1
../kbl_data/2024-2025,S45G01N250,부산 KCC,Home,정창영,0,0,3,0.0,0,2,0.0,0,5,0.0,0,0,0.0,0,1,1,1,1,0,0,0,0,1
../kbl_data/2024-2025,S45G01N250,부산 KCC,Home,전준범,0,0,2,0.0,0,2,0.0,0,4,0.0,0,0,0.0,0,0,0,1,0,0,0,0,0,0
../kbl_data/2024-2025,S45G01N250,부산 KCC,Home,허웅,20,1,5,20.0,5,8,62.5,6,13,46.2,3,3,100.0,3,1,4,4,1,0,0,0,2,3
../kbl_data/2024-2025,S45G01N250,부산 KCC,Home,이승현,4,2,6,33.3,0,0,0.0,2,6,33.3,0,0,0.0,2,3,5,4,1,0,0,0,2,4
../kbl_data/2024-2025,S45G01N250,부산 KCC,Home,이호현,6,3,3,100.0,0,0,0.0,3,3,100.0,0,0,0.0,0,1,1,3,1,0,0,0,2,2
../kbl_data/2024-2025,S45G01N250,부산 KCC,Home,캐디 라렌,15,4,7,57.1,1,3,33.3,5,10,50.0,4,4,100.0,1,3,4,0,1,1,0,0,0,4
../kbl_data/2024-2025,S45G01N250,부산 KCC,Home,이근휘,3,0,0,0.0,1,3,33.3,1,3,33.3,0,0,0.0,0,3,3,2,0,0,0,0,0,0
../kbl_data/2024-2025,S45G01N250,부산 KCC,Home,김동현,5,2,2,100.0,0,1,0.0,2,3,66.7,1,2,50.0,1,1,2,0,0,0,0,0,0,3
../kbl_data/2024-2025,S45G01N250,부산 KCC,Home,여준형,0,0,1,0.0,0,0,0.0,0,1,0.0,0,0,0.0,0,1,1,2,0,0,0,0,0,3
../kbl_data/2024-2025,S45G01N250,부산 KCC,Home,캘빈 제프리 에피스톨라,5,1,1,100.0,1,2,50.0,2,3,66.7,0,0,0.0,0,1,1,4,0,0,0,0,1,1
../kbl_data/2024-2025,S45G01N250,부산 KCC,Home,이주영,0,0,0,0.0,0,0,0.0,0,0,0.0,0,0,0.0,0,0,0,0,0,0,0,0,1,0
../kbl_data/2024-2025,S45G01N250,부산 KCC,Home,도노반 스미스,14,5,10,50.0,1,2,50.0,6,12,50.0,1,2,50.0,2,4,6,0,0,0,0,1,4,1
../kbl_data/2024-2025,S45G01N250,창원 LG,Away,허일영,5,1,2,50.0,1,4,25.0,2,6,33.3,0,0,0.0,1,2,3,0,0,0,0,0,0,3
../kbl_data/2024-2025,S45G01N250,창원 LG,Away,장민국,0,0,0,0.0,0,1,0.0,0,1,0.0,0,0,0.0,0,0,0,0,0,0,0,0,0,0
../kbl_data/2024-2025,S45G01N250,창원 LG,Away,두경민,3,0,0,0.0,1,2,50.0,1,2,50.0,0,0,0.0,0,0,0,0,0,0,0,0,1,1
../kbl_data/2024-2025,S45G01N250,창원 LG,Away,정인덕,0,0,0,0.0,0,2,0.0,0,2,0.0,0,0,0.0,0,2,2,2,0,0,1,0,0,1
../kbl_data/2024-2025,S45G01N250,창원 LG,Away,대릴 먼로,11,3,4,75.0,1,2,50.0,4,6,66.7,2,2,100.0,2,5,7,1,0,0,0,0,0,1
../kbl_data/2024-2025,S45G01N250,창원 LG,Away,박정현,7,3,5,60.0,0,2,0.0,3,7,42.9,1,2,50.0,1,0,1,1,1,0,0,0,0,4
../kbl_data/2024-2025,S45G01N250,창원 LG,Away,아셈 마레이,13,6,13,46.2,0,0,0.0,6,13,46.2,1,2,50.0,6,9,15,6,0,1,0,1,2,3
../kbl_data/2024-2025,S45G01N250,창원 LG,Away,양준석,6,2,2,100.0,0,0,0.0,2,2,100.0,2,2,100.0,0,1,1,1,0,0,0,0,0,1
../kbl_data/2024-2025,S45G01N250,창원 LG,Away,유기상,18,1,1,100.0,5,8,62.5,6,9,66.7,1,2,50.0,1,1,2,3,3,0,1,0,2,1
../kbl_data/2024-2025,S45G01N250,창원 LG,Away,이경도,7,2,5,40.0,1,2,50.0,3,7,42.9,0,0,0.0,2,0,2,4,2,0,0,0,0,3
../kbl_data/2024-2025,S45G01N250,창원 LG,Away,칼 타마요,19,8,13,61.5,1,4,25.0,9,17,52.9,0,0,0.0,2,5,7,0,0,0,0,0,0,2
../kbl_data/2024-2025,S45G01N250,창원 LG,Away,최형찬,8,1,3,33.3,2,2,100.0,3,5,60.0,0,0,0.0,0,1,1,0,1,0,0,0,0,1
../kbl_data/2024-2025,S45G01N251,대구 한국가스공사,Home,차바위,0,0,0,0.0,0,0,0.0,0,0,0.0,0,0,0.0,0,0,0,0,0,0,0,0,0,0
../kbl_data/2024-2025,S45G01N251,대구 한국가스공사,Home,박지훈,0,0,0,0.0,0,4,0.0,0,4,0.0,0,0,0.0,1,2,3,6,1,0,0,0,0,3
../kbl_data/2024-2025,S45G01N251,대구 한국가스공사,Home,김준일,18,8,14,57.1,0,0,0.0,8,14,57.1,2,2,100.0,2,3,5,2,0,1,0,0,3,1
../kbl_data/2024-2025,S45G01N251,대구 한국가스공사,Home,정성우,11,1,2,50.0,3,5,60.0,4,7,57.1,0,0,0.0,0,3,3,4,2,0,0,0,2,3
../kbl_data/2024-2025,S45G01N251,대구 한국가스공사,Home,김낙현,2,1,5,20.0,0,3,0.0,1,8,12.5,0,0,0.0,0,1,1,2,1,0,0,0,0,2
../kbl_data/2024-2025,S45G01N251,대구 한국가스공사,Home,양재혁,0,0,0,0.0,0,0,0.0,0,0,0.0,0,0,0.0,0,0,0,0,0,0,0,0,0,0
../kbl_data/2024-2025,S45G01N251,대구 한국가스공사,Home,곽정훈,3,0,0,0.0,1,1,100.0,1,1,100.0,0,0,0.0,1,0,1,1,2,0,0,0,0,1
../kbl_data/2024-2025,S45G01N251,대구 한국가스공사,Home,앤드류 니콜슨,27,9,13,69.2,1,6,16.7,10,19,52.6,6,6,100.0,1,7,8,0,1,0,0,3,1,2
../kbl_data/2024-2025,S45G01N251,대구 한국가스공사,Home,신승민,0,0,1,0.0,0,1,0.0,0,2,0.0,0,0,0.0,0,2,2,0,1,0,0,0,1,2
../kbl_data/2024-2025,S45G01N251,대구 한국가스공사,Home,샘조세프 벨란겔,14,6,9,66.7,0,3,0.0,6,12,50.0,2,4,50.0,0,2,2,8,3,0,0,0,0,2
../kbl_data/2024-2025,S45G01N251,대구 한국가스공사,Home,유슈 은도예,0,0,2,0.0,0,1,0.0,0,3,0.0,0,0,0.0,1,5,6,0,0,0,0,0,0,2
../kbl_data/2024-2025,S45G01N251,대구 한국가스공사,Home,신주영,0,0,0,0.0,0,0,0.0,0,0,0.0,0,0,0.0,0,0,0,1,0,0,0,0,1,0
../kbl_data/2024-2025,S45G01N251,서울 SK,Away,김선형,10,3,6,50.0,1,6,16.7,4,12,33.3,1,2,50.0,1,0,1,3,0,0,0,0,3,2
../kbl_data/2024-2025,S45G01N251,서울 SK,Away,오세근,0,0,1,0.0,0,2,0.0,0,3,0.0,0,0,0.0,0,2,2,0,1,0,0,0,0,0
../kbl_data/2024-2025,S45G01N251,서울 SK,Away,최원혁,6,0,1,0.0,2,2,100.0,2,3,66.7,0,0,0.0,1,1,2,1,2,0,0,0,2,3
../kbl_data/2024-2025,S45G01N251,서울 SK,Away,김지후,0,0,0,0.0,0,0,0.0,0,0,0.0,0,0,0.0,0,0,0,0,0,0,0,0,0,0
../kbl_data/2024-2025,S45G01N251,서울 SK,Away,장문호,0,0,1,0.0,0,1,0.0,0,2,0.0,0,0,0.0,0,0,0,0,0,0,0,0,0,0
../kbl_data/2024-2025,S45G01N251,서울 SK,Away,안영준,12,3,5,60.0,2,6,33.3,5,11,45.5,0,0,0.0,1,8,9,3,1,0,0,0,2,1
../kbl_data/2024-2025,S45G01N251,서울 SK,Away,자밀 워니,21,7,11,63.6,2,5,40.0,9,16,56.2,1,2,50.0,5,9,14,7,0,0,0,2,3,1
../kbl_data/2024-2025,S45G01N251,서울 SK,Away,김형빈,2,1,1,100.0,0,3,0.0,1,4,25.0,0,0,0.0,1,3,4,0,1,0,0,0,0,2
../kbl_data/2024-2025,S45G01N251,서울 SK,Away,아이재아 힉스,10,3,6,50.0,0,2,0.0,3,8,37.5,4,5,80.0,2,2,4,2,0,1,0,1,1,1
../kbl_data/2024-2025,S45G01N251,서울 SK,Away,오재현,8,4,6,66.7,0,4,0.0,4,10,40.0,0,0,0.0,0,5,5,1,2,0,0,0,2,5
../kbl_data/2024-2025,S45G01N251,서울 SK,Away,고메즈 델 리아노,5,0,1,0.0,1,1,100.0,1,2,50.0,2,2,100.0,1,3,4,3,1,0,0,0,0,0
../kbl_data/2024-2025,S45G01N251,서울 SK,Away,김태훈,0,0,0,0.0,0,2,0.0,0,2,0.0,0,0,0.0,1,0,1,1,0,0,0,0,1,1
../kbl_data/2024-2025,S45G01N252,서울 삼성,Home,이정현,16,0,1,0.0,4,8,50.0,4,9,44.4,4,5,80.0,0,4,4,5,1,0,0,0,2,0
../kbl_data/2024-2025,S45G01N252,서울 삼성,Home,최현민,0,0,0,0.0,0,0,0.0,0,0,0.0,0,0,0.0,0,0,0,0,0,0,0,0,1,0
../kbl_data/2024-2025,S45G01N252,서울 삼성,Home,이원대,2,1,1,100.0,0,2,0.0,1,3,33.3,0,0,0.0,0,0,0,3,0,0,0,0,0,0
../kbl_data/2024-2025,S45G01N252,서울 삼성,Home,최성모,4,2,3,66.7,0,4,0.0,2,7,28.6,0,0,0.0,0,1,1,0,1,0,0,0,1,5
../kbl_data/2024-2025,S45G01N252,서울 삼성,Home,최승욱,2,1,3,33.3,0,1,0.0,1,4,25.0,0,0,0.0,2,3,5,1,1,0,0,0,1,2
../kbl_data/2024-2025,S45G01N252,서울 삼성,Home,윤성원,0,0,0,0.0,0,0,0.0,0,0,0.0,0,0,0.0,0,0,0,0,0,0,0,0,0,0
../kbl_data/2024-2025,S45G01N252,서울 삼성,Home,김한솔,0,0,0,0.0,0,0,0.0,0,0,0.0,0,0,0.0,0,0,0,0,0,0,0,0,0,0
../kbl_data/2024-2025,S45G01N252,서울 삼성,Home,차민석,0,0,0,0.0,0,0,0.0,0,0,0.0,0,2,0.0,0,0,0,0,0,0,0,0,0,2
../kbl_data/2024-2025,S45G01N252,서울 삼성,Home,이원석,16,5,10,50.0,0,1,0.0,5,11,45.5,6,8,75.0,4,1,5,0,1,0,0,0,0,2
../kbl_data/2024-2025,S45G01N252,서울 삼성,Home,저스틴 구탕,7,2,9,22.2,1,3,33.3,3,12,25.0,0,0,0.0,1,2,3,2,2,0,0,0,0,3
../kbl_data/2024-2025,S45G01N252,서울 삼성,Home,박승재,0,0,0,0.0,0,0,0.0,0,0,0.0,0,0,0.0,0,0,0,0,0,0,0,0,0,0
../kbl_data/2024-2025,S45G01N252,서울 삼성,Home,글렌 로빈슨 3세,29,4,11,36.4,4,9,44.4,8,20,40.0,9,9,100.0,1,5,6,3,3,0,0,0,1,4
../kbl_data/2024-2025,S45G01N252,원주 DB,Away,이관희,20,2,4,50.0,4,12,33.3,6,16,37.5,4,4,100.0,0,7,7,0,1,0,0,0,3,4
../kbl_data/2024-2025,S45G01N252,원주 DB,Away,김시래,5,1,1,100.0,1,1,100.0,2,2,100.0,0,0,0.0,0,0,0,0,0,0,0,0,0,1
../kbl_data/2024-2025,S45G01N252,원주 DB,Away,서민수,0,0,0,0.0,0,1,0.0,0,1,0.0,0,0,0.0,2,3,5,1,0,1,0,0,0,1
../kbl_data/2024-2025,S45G01N252,원주 DB,Away,정효근,12,3,4,75.0,2,5,40.0,5,9,55.6,0,1,0.0,7,5,12,6,1,1,0,0,1,4
../kbl_data/2024-2025,S45G01N252,원주 DB,Away,박봉진,2,0,0,0.0,0,2,0.0,0,2,0.0,2,2,100.0,0,3,3,1,1,0,0,0,1,4
../kbl_data/2024-2025,S45G01N252,원주 DB,Away,최성원,0,0,0,0.0,0,0,0.0,0,0,0.0,0,0,0.0,0,0,0,0,0,0,0,0,0,0
../kbl_data/2024-2025,S45G01N252,원주 DB,Away,치나누 오누아쿠,14,6,9,66.7,0,2,0.0,6,11,54.5,2,2,100.0,2,9,11,4,0,1,0,0,5,2
../kbl_data/2024-2025,S45G01N252,원주 DB,Away,이용우,0,0,0,0.0,0,2,0.0,0,2,0.0,0,0,0.0,0,0,0,0,0,0,0,0,0,0
../kbl_data/2024-2025,S45G01N252,원주 DB,Away,정호영,0,0,0,0.0,0,0,0.0,0,0,0.0,0,0,0.0,0,0,0,0,0,0,0,0,0,0
../kbl_data/2024-2025,S45G01N252,원주 DB,Away,이선 알바노,25,6,13,46.2,4,6,66.7,10,19,52.6,1,2,50.0,2,2,4,6,0,1,0,0,4,3
../kbl_data/2024-2025,S45G01N252,원주 DB,Away,박인웅,7,2,2,100.0,1,3,33.3,3,5,60.0,0,0,0.0,0,1,1,0,0,0,0,0,0,3
../kbl_data/2024-2025,S45G01N252,원주 DB,Away,김보배,0,0,0,0.0,0,0,0.0,0,0,0.0,0,0,0.0,1,1,2,2,1,0,0,0,0,2
../kbl_data/2024-2025,S45G01N253,안양 정관장,Home,송창용,0,0,0,0.0,0,1,0.0,0,1,0.0,0,0,0.0,0,0,0,0,0,0,0,0,0,1
../kbl_data/2024-2025,S45G01N253,안양 정관장,Home,정준원,0,0,1,0.0,0,0,0.0,0,1,0.0,0,0,0.0,1,0,1,1,1,0,0,0,0,4
../kbl_data/2024-2025,S45G01N253,안양 정관장,Home,배병준,0,0,0,0.0,0,2,0.0,0,2,0.0,0,0,0.0,0,1,1,0,0,0,0,0,0,3
../kbl_data/2024-2025,S45G01N253,안양 정관장,Home,김영현,0,0,1,0.0,0,0,0.0,0,1,0.0,0,0,0.0,0,0,0,1,1,0,0,0,0,4
../kbl_data/2024-2025,S45G01N253,안양 정관장,Home,김종규,2,1,1,100.0,0,0,0.0,1,1,100.0,0,0,0.0,0,1,1,0,0,0,0,0,1,0
../kbl_data/2024-2025,S45G01N253,안양 정관장,Home,박지훈,16,4,8,50.0,2,4,50.0,6,12,50.0,2,2,100.0,1,1,2,4,2,0,2,0,4,1
../kbl_data/2024-2025,S45G01N253,안양 정관장,Home,디온테 버튼,21,6,11,54.5,1,3,33.3,7,14,50.0,6,6,100.0,1,3,4,3,0,0,0,0,3,0
../kbl_data/2024-2025,S45G01N253,안양 정관장,Home,변준형,3,0,0,0.0,1,2,50.0,1,2,50.0,0,0,0.0,1,1,2,1,0,0,0,0,0,1
../kbl_data/2024-2025,S45G01N253,안양 정관장,Home,김경원,6,2,4,50.0,0,1,0.0,2,5,40.0,2,4,50.0,2,1,3,0,2,0,0,0,1,4
../kbl_data/2024-2025,S45G01N253,안양 정관장,Home,한승희,9,3,6,50.0,1,2,50.0,4,8,50.0,0,0,0.0,0,3,3,3,0,1,2,0,0,3
../kbl_data/2024-2025,S45G01N253,안양 정관장,Home,조니 오브라이언트,17,5,10,50.0,2,6,33.3,7,16,43.8,1,1,100.0,1,3,4,1,0,0,0,0,1,0
../kbl_data/2024-2025,S45G01N253,안양 정관장,Home,하비 고메즈,11,3,5,60.0,1,4,25.0,4,9,44.4,2,2,100.0,5,3,8,1,1,1,0,0,0,0
../kbl_data/2024-2025,S45G01N253,수원 KT,Away,한희원,3,0,1,0.0,1,2,50.0,1,3,33.3,0,0,0.0,0,2,2,0,0,1,0,0,0,0
../kbl_data/2024-2025,S45G01N253,수원 KT,Away,문성곤,6,0,0,0.0,2,4,50.0,2,4,50.0,0,0,0.0,1,0,1,0,1,0,0,0,0,3
../kbl_data/2024-2025,S45G01N253,수원 KT,Away,이현석,0,0,0,0.0,0,0,0.0,0,0,0.0,0,0,0.0,0,0,0,0,0,0,0,0,0,0
../kbl_data/2024-2025,S45G01N253,수원 KT,Away,허훈,17,6,10,60.0,0,5,0.0,6,15,40.0,5,6,83.3,0,2,2,3,1,0,0,0,3,1
../kbl_data/2024-2025,S45G01N253,수원 KT,Away,박준영,3,1,1,100.0,0,1,0.0,1,2,50.0,1,1,100.0,1,4,5,1,0,0,0,0,0,0
../kbl_data/2024-2025,S45G01N253,수원 KT,Away,최진광,0,0,0,0.0,0,0,0.0,0,0,0.0,0,0,0.0,0,0,0,0,0,0,0,0,0,0
../kbl_data/2024-2025,S45G01N253,수원 KT,Away,하윤기,19,8,10,80.0,0,0,0.0,8,10,80.0,3,3,100.0,3,4,7,1,0,0,0,0,2,1
../kbl_data/2024-2025,S45G01N253,수원 KT,Away,문정현,4,0,1,0.0,1,1,100.0,1,2,50.0,1,4,25.0,1,2,3,2,1,0,0,0,2,3
../kbl_data/2024-2025,S45G01N253,수원 KT,Away,레이션 해먼즈,20,7,8,87.5,1,4,25.0,8,12,66.7,3,5,60.0,4,8,12,0,1,0,0,0,1,3
../kbl_data/2024-2025,S45G01N253,수원 KT,Away,박성재,2,1,1,100.0,0,0,0.0,1,1,100.0,0,0,0.0,0,0,0,0,0,0,0,0,3,1
../kbl_data/2024-2025,S45G01N253,수원 KT,Away,조엘 카굴랑안,11,4,8,50.0,1,4,25.0,5,12,41.7,0,0,0.0,1,3,4,8,2,0,0,0,6,3
../kbl_data/2024-2025,S45G01N253,수원 KT,Away,데릭 컬버,3,1,2,50.0,0,0,0.0,1,2,50.0,1,4,25.0,1,3,4,0,0,0,0,0,1,2
../kbl_data/2024-2025,S45G01N254,서울 삼성,Home,이정현,6,0,6,0.0,2,3,66.7,2,9,22.2,0,0,0.0,2,2,4,8,0,0,0,0,1,3
../kbl_data/2024-2025,S45G01N254,서울 삼성,Home,최현민,2,0,2,0.0,0,3,0.0,0,5,0.0,2,2,100.0,1,0,1,2,1,0,0,0,1,1
../kbl_data/2024-2025,S45G01N254,서울 삼성,Home,이원대,0,0,0,0.0,0,2,0.0,0,2,0.0,0,0,0.0,0,0,0,0,0,0,0,0,0,1
../kbl_data/2024-2025,S45G01N254,서울 삼성,Home,최성모,7,1,2,50.0,1,5,20.0,2,7,28.6,2,2,100.0,0,2,2,1,1,0,0,0,0,1
../kbl_data/2024-2025,S45G01N254,서울 삼성,Home,최승욱,2,1,3,33.3,0,2,0.0,1,5,20.0,0,0,0.0,1,2,3,0,1,0,0,0,0,0
../kbl_data/2024-2025,S45G01N254,서울 삼성,Home,윤성원,0,0,0,0.0,0,0,0.0,0,0,0.0,0,0,0.0,0,0,0,0,0,0,0,0,0,1
../kbl_data/2024-2025,S45G01N254,서울 삼성,Home,김한솔,0,0,0,0.0,0,1,0.0,0,1,0.0,0,0,0.0,0,0,0,0,0,0,0,0,0,2
../kbl_data/2024-2025,S45G01N254,서울 삼성,Home,차민석,0,0,1,0.0,0,0,0.0,0,1,0.0,0,0,0.0,1,1,2,0,0,0,0,0,0,2
../kbl_data/2024-2025,S45G01N254,서울 삼성,Home,이원석,8,4,5,80.0,0,1,0.0,4,6,66.7,0,0,0.0,3,2,5,2,0,2,2,0,2,3
../kbl_data/2024-2025,S45G01N254,서울 삼성,Home,저스틴 구탕,14,5,10,50.0,1,6,16.7,6,16,37.5,1,1,100.0,0,2,2,0,2,0,1,4,2,1
../kbl_data/2024-2025,S45G01N254,서울 삼성,Home,박승재,3,0,2,0.0,1,2,50.0,1,4,25.0,0,0,0.0,0,1,1,1,1,0,0,0,0,0
../kbl_data/2024-2025,S45G01N254,서울 삼성,Home,글렌 로빈슨 3세,19,8,12,66.7,1,4,25.0,9,16,56.2,0,0,0.0,1,5,6,2,0,0,0,1,2,5
../kbl_data/2024-2025,S45G01N254,대구 한국가스공사,Away,차바위,0,0,0,0.0,0,0,0.0,0,0,0.0,0,0,0.0,0,0,0,0,0,0,0,0,0,0
../kbl_data/2024-2025,S45G01N254,대구 한국가스공사,Away,박지훈,0,0,0,0.0,0,0,0.0,0,0,0.0,0,0,0.0,0,0,0,0,0,0,0,0,0,0
../kbl_data/2024-2025,S45G01N254,대구 한국가스공사,Away,김준일,0,0,1,0.0,0,0,0.0,0,1,0.0,0,0,0.0,3,2,5,1,0,2,0,0,3,3
../kbl_data/2024-2025,S45G01N254,대구 한국가스공사,Away,정성우,0,0,0,0.0,0,0,0.0,0,0,0.0,0,0,0.0,0,1,1,1,0,0,0,0,0,0
../kbl_data/2024-2025,S45G01N254,대구 한국가스공사,Away,김낙현,17,3,5,60.0,3,9,33.3,6,14,42.9,2,2,100.0,0,2,2,4,2,0,0,0,2,2
../kbl_data/2024-2025,S45G01N254,대구 한국가스공사,Away,우동현,10,2,4,50.0,2,7,28.6,4,11,36.4,0,0,0.0,2,2,4,4,0,0,1,0,0,3
../kbl_data/2024-2025,S45G01N254,대구 한국가스공사,Away,곽정훈,16,5,5,100.0,2,7,28.6,7,12,58.3,0,0,0.0,2,3,5,0,1,0,0,0,2,4
../kbl_data/2024-2025,S45G01N254,대구 한국가스공사,Away,앤드류 니콜슨,5,1,2,50.0,1,2,50.0,2,4,50.0,0,0,0.0,0,0,0,0,0,0,0,0,0,0
../kbl_data/2024-2025,S45G01N254,대구 한국가스공사,Away,신승민,4,2,5,40.0,0,2,0.0,2,7,28.6,0,0,0.0,1,4,5,2,1,0,1,0,0,1
../kbl_data/2024-2025,S45G01N254,대구 한국가스공사,Away,샘조세프 벨란겔,19,1,1,100.0,5,8,62.5,6,9,66.7,2,2,100.0,0,3,3,1,1,0,0,0,1,0
../kbl_data/2024-2025,S45G01N254,대구 한국가스공사,Away,유슈 은도예,16,5,6,83.3,0,0,0.0,5,6,83.3,6,8,75.0,4,11,15,2,0,1,0,1,3,2
../kbl_data/2024-2025,S45G01N254,대구 한국가스공사,Away,신주영,5,1,3,33.3,1,5,20.0,2,8,25.0,0,0,0.0,2,3,5,3,0,0,0,0,2,5
../kbl_data/2024-2025,S45G01N255,부산 KCC,Home,정창영,19,4,10,40.0,2,4,50.0,6,14,42.9,5,5,100.0,2,2,4,5,2,0,0,0,0,3
../kbl_data/2024-2025,S45G01N255,부산 KCC,Home,전준범,3,0,1,0.0,1,4,25.0,1,5,20.0,0,0,0.0,0,0,0,1,0,0,0,0,1,2
../kbl_data/2024-2025,S45G01N255,부산 KCC,Home,이승현,0,0,1,0.0,0,0,0.0,0,1,0.0,0,0,0.0,1,1,2,3,0,1,0,0,0,1
../kbl_data/2024-2025,S45G01N255,부산 KCC,Home,이호현,17,5,9,55.6,1,4,25.0,6,13,46.2,4,6,66.7,1,1,2,4,2,0,0,0,3,2
../kbl_data/2024-2025,S45G01N255,부산 KCC,Home,캐디 라렌,12,5,7,71.4,0,2,0.0,5,9,55.6,2,4,50.0,2,3,5,1,1,0,0,0,1,5
../kbl_data/2024-2025,S45G01N255,부산 KCC,Home,이근휘,14,0,1,0.0,4,7,57.1,4,8,50.0,2,2,100.0,1,1,2,2,0,0,1,0,1,0
../kbl_data/2024-2025,S45G01N255,부산 KCC,Home,김동현,15,4,4,100.0,2,5,40.0,6,9,66.7,1,2,50.0,1,3,4,4,1,0,0,0,2,2
../kbl_data/2024-2025,S45G01N255,부산 KCC,Home,여준형,0,0,0,0.0,0,0,0.0,0,0,0.0,0,2,0.0,0,0,0,0,1,0,0,0,0,0
../kbl_data/2024-2025,S45G01N255,부산 KCC,Home,캘빈 제프리 에피스톨라,0,0,0,0.0,0,0,0.0,0,0,0.0,0,0,0.0,0,1,1,0,0,0,0,0,0,2
../kbl_data/2024-2025,S45G01N255,부산 KCC,Home,이주영,0,0,0,0.0,0,0,0.0,0,0,0.0,0,0,0.0,0,0,0,0,0,0,0,0,0,1
../kbl_data/2024-2025,S45G01N255,부산 KCC,Home,이찬영,0,0,0,0.0,0,0,0.0,0,0,0.0,0,0,0.0,0,0,0,0,0,0,0,0,0,0
../kbl_data/2024-2025,S45G01N255,부산 KCC,Home,도노반 스미스,18,5,5,100.0,2,3,66.7,7,8,87.5,2,2,100.0,0,9,9,1,2,0,0,1,2,5
../kbl_data/2024-2025,S45G01N255,고양 소노,Away,정희재,2,1,1,100.0,0,1,0.0,1,2,50.0,0,0,0.0,1,2,3,2,0,0,0,0,0,0
../kbl_data/2024-2025,S45G01N255,고양 소노,Away,임동섭,4,1,1,100.0,0,1,0.0,1,2,50.0,2,4,50.0,2,2,4,0,0,0,0,0,1,3
../kbl_data/2024-2025,S45G01N255,고양 소노,Away,이재도,6,2,4,50.0,0,2,0.0,2,6,33.3,2,3,66.7,1,0,1,1,0,0,0,0,0,3
../kbl_data/2024-2025,S45G01N255,고양 소노,Away,김진유,7,2,2,100.0,1,1,100.0,3,3,100.0,0,0,0.0,1,1,2,2,1,0,0,0,0,5
../kbl_data/2024-2025,S45G01N255,고양 소노,Away,이정현,15,4,7,57.1,1,8,12.5,5,15,33.3,4,4,100.0,1,4,5,6,3,0,1,0,3,1
../kbl_data/2024-2025,S45G01N255,고양 소노,Away,조은후,6,3,3,100.0,0,0,0.0,3,3,100.0,0,0,0.0,0,1,1,1,0,0,0,0,0,3
../kbl_data/2024-2025,S45G01N255,고양 소노,Away,민기남,0,0,0,0.0,0,0,0.0,0,0,0.0,0,0,0.0,0,0,0,0,0,0,1,0,0,0
../kbl_data/2024-2025,S45G01N255,고양 소노,Away,앨런 윌리엄스,11,4,9,44.4,0,0,0.0,4,9,44.4,3,4,75.0,2,7,9,7,1,0,0,0,2,3
../kbl_data/2024-2025,S45G01N255,고양 소노,Away,디제이 번즈 Jr,9,3,5,60.0,0,0,0.0,3,5,60.0,3,5,60.0,0,0,0,2,0,0,0,0,1,2
../kbl_data/2024-2025,S45G01N255,고양 소노,Away,이근준,6,1,1,100.0,1,6,16.7,2,7,28.6,1,2,50.0,2,0,2,1,0,0,0,0,0,3
../kbl_data/2024-2025,S45G01N255,고양 소노,Away,정성조,0,0,0,0.0,0,0,0.0,0,0,0.0,0,0,0.0,0,0,0,0,0,0,0,0,0,0
../kbl_data/2024-2025,S45G01N255,고양 소노,Away,케빈 켐바오,19,4,5,80.0,3,6,50.0,7,11,63.6,2,4,50.0,2,4,6,2,1,0,0,0,4,2
../kbl_data/2024-2025,S45G01N256,창원 LG,Home,허일영,0,0,0,0.0,0,2,0.0,0,2,0.0,0,0,0.0,0,2,2,0,0,0,0,0,0,2
../kbl_data/2024-2025,S45G01N256,창원 LG,Home,장민국,0,0,0,0.0,0,0,0.0,0,0,0.0,0,0,0.0,0,0,0,0,0,0,0,0,0,0
../kbl_data/2024-2025,S45G01N256,창원 LG,Home,두경민,5,1,3,33.3,1,2,50.0,2,5,40.0,0,0,0.0,0,0,0,2,1,0,0,0,3,2
../kbl_data/2024-2025,S45G01N256,창원 LG,Home,정인덕,5,1,2,50.0,1,3,33.3,2,5,40.0,0,0,0.0,1,1,2,0,1,0,1,0,0,2
../kbl_data/2024-2025,S45G01N256,창원 LG,Home,대릴 먼로,10,4,7,57.1,0,3,0.0,4,10,40.0,2,2,100.0,4,10,14,4,0,1,0,2,1,2
../kbl_data/2024-2025,S45G01N256,창원 LG,Home,박정현,0,0,0,0.0,0,0,0.0,0,0,0.0,0,0,0.0,0,2,2,0,0,0,0,0,0,0
../kbl_data/2024-2025,S45G01N256,창원 LG,Home,아셈 마레이,11,4,8,50.0,0,0,0.0,4,8,50.0,3,7,42.9,4,6,10,1,1,0,0,0,4,2
../kbl_data/2024-2025,S45G01N256,창원 LG,Home,양준석,15,3,6,50.0,3,4,75.0,6,10,60.0,0,1,0.0,1,2,3,6,1,0,0,0,2,1
../kbl_data/2024-2025,S45G01N256,창원 LG,Home,유기상,13,0,4,0.0,4,11,36.4,4,15,26.7,1,1,100.0,0,1,1,0,2,0,0,0,3,2
../kbl_data/2024-2025,S45G01N256,창원 LG,Home,이경도,2,1,2,50.0,0,0,0.0,1,2,50.0,0,0,0.0,0,1,1,0,0,0,0,0,0,0
../kbl_data/2024-2025,S45G01N256,창원 LG,Home,칼 타마요,16,4,7,57.1,2,4,50.0,6,11,54.5,2,2,100.0,3,3,6,0,1,0,0,0,1,3
../kbl_data/2024-2025,S45G01N256,창원 LG,Home,최형찬,0,0,0,0.0,0,2,0.0,0,2,0.0,0,0,0.0,2,0,2,2,0,0,0,0,0,4
../kbl_data/2024-2025,S45G01N256,안양 정관장,Away,송창용,0,0,2,0.0,0,1,0.0,0,3,0.0,0,0,0.0,0,0,0,0,0,0,0,0,0,0
../kbl_data/2024-2025,S45G01N256,안양 정관장,Away,정준원,0,0,0,0.0,0,0,0.0,0,0,0.0,0,0,0.0,0,0,0,0,0,0,0,0,0,0
../kbl_data/2024-2025,S45G01N256,안양 정관장,Away,김영현,3,0,3,0.0,1,7,14.3,1,10,10.0,0,0,0.0,6,2,8,2,1,0,0,0,1,2
../kbl_data/2024-2025,S45G01N256,안양 정관장,Away,이종현,0,0,2,0.0,0,0,0.0,0,2,0.0,0,0,0.0,0,0,0,0,0,0,0,0,0,1
../kbl_data/2024-2025,S45G01N256,안양 정관장,Away,박지훈,10,3,7,42.9,0,3,0.0,3,10,30.0,4,6,66.7,3,2,5,4,0,1,0,0,2,2
../kbl_data/2024-2025,S45G01N256,안양 정관장,Away,디온테 버튼,8,3,5,60.0,0,2,0.0,3,7,42.9,2,4,50.0,0,3,3,4,2,1,0,0,4,2
../kbl_data/2024-2025,S45G01N256,안양 정관장,Away,이우정,0,0,0,0.0,0,0,0.0,0,0,0.0,0,0,0.0,0,0,0,0,0,0,0,0,1,1
../kbl_data/2024-2025,S45G01N256,안양 정관장,Away,김경원,0,0,1,0.0,0,1,0.0,0,2,0.0,0,0,0.0,0,1,1,1,0,0,0,0,1,2
../kbl_data/2024-2025,S45G01N256,안양 정관장,Away,한승희,6,3,7,42.9,0,0,0.0,3,7,42.9,0,0,0.0,1,1,2,0,0,0,1,0,0,5
../kbl_data/2024-2025,S45G01N256,안양 정관장,Away,조니 오브라이언트,5,2,6,33.3,0,3,0.0,2,9,22.2,1,4,25.0,0,3,3,0,2,0,0,0,1,3
../kbl_data/2024-2025,S45G01N256,안양 정관장,Away,하비 고메즈,26,4,6,66.7,6,8,75.0,10,14,71.4,0,0,0.0,1,4,5,0,2,0,0,0,1,0
../kbl_data/2024-2025,S45G01N256,안양 정관장,Away,소준혁,4,2,2,100.0,0,2,0.0,2,4,50.0,0,0,0.0,1,3,4,1,0,0,2,0,0,1
../kbl_data/2024-2025,S45G01N257,울산 현대모비스,Home,함지훈,4,2,2,100.0,0,0,0.0,2,2,100.0,0,0,0.0,5,4,9,2,2,0,0,0,0,2
../kbl_data/2024-2025,S45G01N257,울산 현대모비스,Home,장재석,12,6,7,85.7,0,0,0.0,6,7,85.7,0,0,0.0,1,3,4,3,0,0,0,2,1,2
../kbl_data/2024-2025,S45G01N257,울산 현대모비스,Home,이대헌,0,0,0,0.0,0,0,0.0,0,0,0.0,0,0,0.0,0,0,0,0,0,0,0,0,0,0
../kbl_data/2024-2025,S45G01N257,울산 현대모비스,Home,한호빈,0,0,1,0.0,0,1,0.0,0,2,0.0,0,0,0.0,0,1,1,4,0,0,0,0,2,1
../kbl_data/2024-2025,S45G01N257,울산 현대모비스,Home,김국찬,6,0,0,0.0,2,3,66.7,2,3,66.7,0,0,0.0,0,3,3,2,1,0,0,0,1,3
../kbl_data/2024-2025,S45G01N257,울산 현대모비스,Home,서명진,17,5,11,45.5,2,4,50.0,7,15,46.7,1,2,50.0,1,5,6,5,0,0,0,0,1,0
../kbl_data/2024-2025,S45G01N257,울산 현대모비스,Home,숀 롱,23,6,9,66.7,3,3,100.0,9,12,75.0,2,2,100.0,0,3,3,1,0,2,0,2,2,1
../kbl_data/2024-2025,S45G01N257,울산 현대모비스,Home,이우석,5,1,1,100.0,1,2,50.0,2,3,66.7,0,0,0.0,0,5,5,2,1,1,0,0,4,4
../kbl_data/2024-2025,S45G01N257,울산 현대모비스,Home,신민석,0,0,0,0.0,0,1,0.0,0,1,0.0,0,0,0.0,1,1,2,0,0,0,0,0,0,0
../kbl_data/2024-2025,S45G01N257,울산 현대모비스,Home,게이지 프림,22,9,22,40.9,0,0,0.0,9,22,40.9,4,5,80.0,6,6,12,0,0,0,0,0,1,1
../kbl_data/2024-2025,S45G01N257,울산 현대모비스,Home,박무빈,2,1,2,50.0,0,0,0.0,1,2,50.0,0,0,0.0,0,2,2,1,1,0,0,0,1,4
../kbl_data/2024-2025,S45G01N257,울산 현대모비스,Home,미구엘 안드레 옥존,0,0,0,0.0,0,0,0.0,0,0,0.0,0,0,0.0,0,0,0,0,0,0,0,0,0,0
../kbl_data/2024-2025,S45G01N257,수원 KT,Away,한희원,0,0,0,0.0,0,0,0.0,0,0,0.0,0,0,0.0,0,1,1,1,1,0,0,0,1,3
../kbl_data/2024-2025,S45G01N257,수원 KT,Away,문성곤,0,0,0,0.0,0,2,0.0,0,2,0.0,0,0,0.0,0,1,1,0,0,0,0,0,0,0
../kbl_data/2024-2025,S45G01N257,수원 KT,Away,이현석,0,0,0,0.0,0,0,0.0,0,0,0.0,0,0,0.0,0,0,0,0,0,0,0,0,0,0
../kbl_data/2024-2025,S45G01N257,수원 KT,Away,허훈,5,1,8,12.5,1,7,14.3,2,15,13.3,0,0,0.0,2,1,3,6,0,1,0,0,2,1
../kbl_data/2024-2025,S45G01N257,수원 KT,Away,박준영,0,0,2,0.0,0,0,0.0,0,2,0.0,0,0,0.0,0,0,0,0,1,0,0,0,1,2
../kbl_data/2024-2025,S45G01N257,수원 KT,Away,최진광,0,0,0,0.0,0,0,0.0,0,0,0.0,0,0,0.0,0,0,0,0,0,0,0,0,0,0
../kbl_data/2024-2025,S45G01N257,수원 KT,Away,하윤기,23,9,11,81.8,0,0,0.0,9,11,81.8,5,6,83.3,3,1,4,0,1,2,0,0,0,1
../kbl_data/2024-2025,S45G01N257,수원 KT,Away,문정현,7,2,6,33.3,0,4,0.0,2,10,20.0,3,4,75.0,2,2,4,2,0,0,0,0,0,3
../kbl_data/2024-2025,S45G01N257,수원 KT,Away,레이션 해먼즈,20,3,5,60.0,3,9,33.3,6,14,42.9,5,5,100.0,3,9,12,0,1,1,0,0,0,2
../kbl_data/2024-2025,S45G01N257,수원 KT,Away,박성재,8,1,2,50.0,2,4,50.0,3,6,50.0,0,0,0.0,2,1,3,0,4,0,2,0,0,1
../kbl_data/2024-2025,S45G01N257,수원 KT,Away,조엘 카굴랑안,6,0,5,0.0,2,7,28.6,2,12,16.7,0,0,0.0,0,0,0,5,0,0,0,0,1,2
../kbl_data/2024-2025,S45G01N257,수원 KT,Away,데릭 컬버,2,1,2,50.0,0,0,0.0,1,2,50.0,0,0,0.0,0,0,0,0,1,0,0,0,0,0
../kbl_data/2024-2025,S45G01N258,부산 KCC,Home,정창영,15,3,5,60.0,3,5,60.0,6,10,60.0,0,0,0.0,1,2,3,3,1,0,0,0,1,2
../kbl_data/2024-2025,S45G01N258,부산 KCC,Home,전준범,0,0,0,0.0,0,2,0.0,0,2,0.0,0,0,0.0,0,0,0,1,0,0,0,0,0,0
../kbl_data/2024-2025,S45G01N258,부산 KCC,Home,이승현,11,4,10,40.0,1,2,50.0,5,12,41.7,0,0,0.0,3,1,4,4,2,0,0,0,2,2
../kbl_data/2024-2025,S45G01N258,부산 KCC,Home,이호현,4,1,3,33.3,0,0,0.0,1,3,33.3,2,2,100.0,0,0,0,1,0,0,0,0,2,1
../kbl_data/2024-2025,S45G01N258,부산 KCC,Home,캐디 라렌,14,4,5,80.0,1,1,100.0,5,6,83.3,3,4,75.0,1,6,7,3,1,1,0,1,1,0
../kbl_data/2024-2025,S45G01N258,부산 KCC,Home,이근휘,3,0,0,0.0,1,7,14.3,1,7,14.3,0,0,0.0,1,2,3,1,0,0,0,0,2,4
../kbl_data/2024-2025,S45G01N258,부산 KCC,Home,김동현,2,1,1,100.0,0,3,0.0,1,4,25.0,0,0,0.0,1,2,3,4,1,0,0,0,2,3
../kbl_data/2024-2025,S45G01N258,부산 KCC,Home,여준형,0,0,0,0.0,0,0,0.0,0,0,0.0,0,0,0.0,0,0,0,0,0,0,0,0,0,0
../kbl_data/2024-2025,S45G01N258,부산 KCC,Home,캘빈 제프리 에피스톨라,11,1,2,50.0,3,4,75.0,4,6,66.7,0,0,0.0,0,3,3,6,0,0,0,0,0,4
../kbl_data/2024-2025,S45G01N258,부산 KCC,Home,이주영,2,1,1,100.0,0,2,0.0,1,3,33.3,0,0,0.0,0,0,0,0,0,0,0,0,0,1
../kbl_data/2024-2025,S45G01N258,부산 KCC,Home,이찬영,0,0,0,0.0,0,0,0.0,0,0,0.0,0,0,0.0,0,0,0,0,0,0,0,0,0,0
../kbl_data/2024-2025,S45G01N258,부산 KCC,Home,도노반 스미스,21,10,15,66.7,0,0,0.0,10,15,66.7,1,2,50.0,4,6,10,1,1,0,0,1,2,1
../kbl_data/2024-2025,S45G01N258,서울 삼성,Away,이정현,15,2,4,50.0,3,8,37.5,5,12,41.7,2,3,66.7,0,5,5,6,2,0,0,0,3,2
../kbl_data/2024-2025,S45G01N258,서울 삼성,Away,최현민,15,2,3,66.7,3,4,75.0,5,7,71.4,2,2,100.0,4,4,8,1,0,1,0,0,0,4
../kbl_data/2024-2025,S45G01N258,서울 삼성,Away,이원대,0,0,0,0.0,0,0,0.0,0,0,0.0,0,0,0.0,0,0,0,0,0,0,0,0,0,1
../kbl_data/2024-2025,S45G01N258,서울 삼성,Away,최성모,10,1,1,100.0,2,5,40.0,3,6,50.0,2,2,100.0,0,3,3,5,1,1,0,0,1,4
../kbl_data/2024-2025,S45G01N258,서울 삼성,Away,최승욱,0,0,0,0.0,0,0,0.0,0,0,0.0,0,0,0.0,0,0,0,0,0,0,0,0,0,0
../kbl_data/2024-2025,S45G01N258,서울 삼성,Away,윤성원,6,1,1,100.0,1,2,50.0,2,3,66.7,1,2,50.0,1,1,2,2,0,0,0,0,0,0
../kbl_data/2024-2025,S45G01N258,서울 삼성,Away,김한솔,0,0,0,0.0,0,0,0.0,0,0,0.0,0,0,0.0,0,0,0,0,0,0,0,0,0,0
../kbl_data/2024-2025,S45G01N258,서울 삼성,Away,차민석,0,0,1,0.0,0,0,0.0,0,1,0.0,0,0,0.0,0,0,0,0,0,0,0,0,0,1
../kbl_data/2024-2025,S45G01N258,서울 삼성,Away,이원석,5,2,6,33.3,0,0,0.0,2,6,33.3,1,1,100.0,1,0,1,0,0,0,0,0,1,2
../kbl_data/2024-2025,S45G01N258,서울 삼성,Away,저스틴 구탕,18,4,5,80.0,3,6,50.0,7,11,63.6,1,2,50.0,1,3,4,2,3,0,0,0,2,2
../kbl_data/2024-2025,S45G01N258,서울 삼성,Away,박승재,0,0,0,0.0,0,0,0.0,0,0,0.0,0,0,0.0,0,0,0,1,0,0,0,0,0,0
../kbl_data/2024-2025,S45G01N258,서울 삼성,Away,글렌 로빈슨 3세,22,8,15,53.3,2,4,50.0,10,19,52.6,0,0,0.0,1,6,7,7,2,0,0,1,1,2
../kbl_data/2024-2025,S45G01N259,고양 소노,Home,정희재,0,0,0,0.0,0,0,0.0,0,0,0.0,0,0,0.0,0,0,0,0,0,0,0,0,1,1
../kbl_data/2024-2025,S45G01N259,고양 소노,Home,임동섭,0,0,0,0.0,0,0,0.0,0,0,0.0,0,0,0.0,0,0,0,0,0,0,0,0,0,0
../kbl_data/2024-2025,S45G01N259,고양 소노,Home,이재도,13,2,3,66.7,3,7,42.9,5,10,50.0,0,0,0.0,1,4,5,6,2,0,0,0,2,1
../kbl_data/2024-2025,S45G01N259,고양 소노,Home,김진유,5,2,3,66.7,0,3,0.0,2,6,33.3,1,1,100.0,6,3,9,2,2,1,0,0,0,5
../kbl_data/2024-2025,S45G01N259,고양 소노,Home,이정현,15,4,6,66.7,2,7,28.6,6,13,46.2,1,1,100.0,0,1,1,2,1,0,0,0,3,2
../kbl_data/2024-2025,S45G01N259,고양 소노,Home,조은후,2,1,1,100.0,0,0,0.0,1,1,100.0,0,0,0.0,1,0,1,0,1,0,0,0,0,1
../kbl_data/2024-2025,S45G01N259,고양 소노,Home,민기남,2,0,0,0.0,0,1,0.0,0,1,0.0,2,2,100.0,0,0,0,0,0,0,0,0,0,0
../kbl_data/2024-2025,S45G01N259,고양 소노,Home,앨런 윌리엄스,17,8,14,57.1,0,0,0.0,8,14,57.1,1,5,20.0,4,8,12,5,3,0,0,0,3,3
../kbl_data/2024-2025,S45G01N259,고양 소노,Home,디제이 번즈 Jr,0,0,1,0.0,0,0,0.0,0,1,0.0,0,0,0.0,0,0,0,0,0,0,0,0,0,0
../kbl_data/2024-2025,S45G01N259,고양 소노,Home,이근준,15,5,9,55.6,1,7,14.3,6,16,37.5,2,3,66.7,5,3,8,0,2,1,0,0,1,4
../kbl_data/2024-2025,S45G01N259,고양 소노,Home,정성조,0,0,0,0.0,0,0,0.0,0,0,0.0,0,0,0.0,1,1,2,1,0,0,0,0,0,0
../kbl_data/2024-2025,S45G01N259,고양 소노,Home,케빈 켐바오,17,6,12,50.0,1,6,16.7,7,18,38.9,2,2,100.0,0,5,5,5,4,0,0,2,2,2
../kbl_data/2024-2025,S45G01N259,원주 DB,Away,이관희,5,0,1,0.0,1,4,25.0,1,5,20.0,2,2,100.0,0,3,3,0,0,0,0,0,5,3
../kbl_data/2024-2025,S45G01N259,원주 DB,Away,김시래,0,0,0,0.0,0,0,0.0,0,0,0.0,0,0,0.0,0,0,0,0,0,0,0,0,0,0
../kbl_data/2024-2025,S45G01N259,원주 DB,Away,서민수,3,0,0,0.0,1,3,33.3,1,3,33.3,0,0,0.0,1,2,3,2,1,0,0,0,1,5
../kbl_data/2024-2025,S45G01N259,원주 DB,Away,정효근,7,3,4,75.0,0,0,0.0,3,4,75.0,1,1,100.0,0,1,1,0,0,0,0,0,0,1
../kbl_data/2024-2025,S45G01N259,원주 DB,Away,박봉진,0,0,1,0.0,0,2,0.0,0,3,0.0,0,0,0.0,1,1,2,0,1,0,0,0,0,2
../kbl_data/2024-2025,S45G01N259,원주 DB,Away,강상재,0,0,0,0.0,0,0,0.0,0,0,0.0,0,0,0.0,0,0,0,0,0,0,0,0,0,0
../kbl_data/2024-2025,S45G01N259,원주 DB,Away,최성원,3,0,1,0.0,1,2,50.0,1,3,33.3,0,0,0.0,0,2,2,2,0,0,1,0,2,1
../kbl_data/2024-2025,S45G01N259,원주 DB,Away,치나누 오누아쿠,5,1,1,100.0,0,0,0.0,1,1,100.0,3,3,100.0,0,1,1,1,0,0,0,0,0,0
../kbl_data/2024-2025,S45G01N259,원주 DB,Away,이용우,0,0,0,0.0,0,1,0.0,0,1,0.0,0,0,0.0,0,0,0,0,0,0,0,0,0,0
../kbl_data/2024-2025,S45G01N259,원주 DB,Away,오마리 스펠맨,12,3,3,100.0,2,5,40.0,5,8,62.5,0,0,0.0,0,11,11,7,1,2,0,1,5,1
../kbl_data/2024-2025,S45G01N259,원주 DB,Away,이선 알바노,20,5,10,50.0,2,8,25.0,7,18,38.9,4,5,80.0,0,2,2,6,5,0,0,0,4,2
../kbl_data/2024-2025,S45G01N259,원주 DB,Away,박인웅,15,3,3,100.0,2,6,33.3,5,9,55.6,3,4,75.0,1,4,5,0,0,0,0,0,1,4
../kbl_data/2024-2025,S45G01N260,울산 현대모비스,Home,함지훈,13,3,6,50.0,2,4,50.0,5,10,50.0,1,2,50.0,0,2,2,4,2,0,0,0,0,2
../kbl_data/2024-2025,S45G01N260,울산 현대모비스,Home,장재석,6,3,4,75.0,0,0,0.0,3,4,75.0,0,0,0.0,2,2,4,2,1,0,1,0,0,4
../kbl_data/2024-2025,S45G01N260,울산 현대모비스,Home,이대헌,0,0,0,0.0,0,0,0.0,0,0,0.0,0,0,0.0,0,0,0,0,0,0,0,0,0,0
../kbl_data/2024-2025,S45G01N260,울산 현대모비스,Home,한호빈,5,1,1,100.0,1,2,50.0,2,3,66.7,0,0,0.0,0,2,2,0,0,0,0,0,0,2
../kbl_data/2024-2025,S45G01N260,울산 현대모비스,Home,김국찬,0,0,0,0.0,0,1,0.0,0,1,0.0,0,0,0.0,0,0,0,0,0,0,0,0,0,1
../kbl_data/2024-2025,S45G01N260,울산 현대모비스,Home,서명진,0,0,1,0.0,0,5,0.0,0,6,0.0,0,0,0.0,1,1,2,3,0,0,0,0,1,3
../kbl_data/2024-2025,S45G01N260,울산 현대모비스,Home,숀 롱,2,1,4,25.0,0,0,0.0,1,4,25.0,0,2,0.0,1,1,2,0,0,1,0,0,0,2
../kbl_data/2024-2025,S45G01N260,울산 현대모비스,Home,이우석,14,3,5,60.0,2,7,28.6,5,12,41.7,2,2,100.0,0,7,7,4,2,0,0,0,0,0
../kbl_data/2024-2025,S45G01N260,울산 현대모비스,Home,신민석,0,0,0,0.0,0,0,0.0,0,0,0.0,0,0,0.0,0,0,0,0,0,0,0,0,0,0
../kbl_data/2024-2025,S45G01N260,울산 현대모비스,Home,게이지 프림,19,7,17,41.2,0,2,0.0,7,19,36.8,5,6,83.3,2,7,9,4,1,2,0,0,3,3
../kbl_data/2024-2025,S45G01N260,울산 현대모비스,Home,박무빈,17,7,9,77.8,0,2,0.0,7,11,63.6,3,4,75.0,1,4,5,2,1,0,0,0,1,2
../kbl_data/2024-2025,S45G01N260,울산 현대모비스,Home,미구엘 안드레 옥존,0,0,0,0.0,0,0,0.0,0,0,0.0,0,0,0.0,0,0,0,0,0,0,0,0,0,0
../kbl_data/2024-2025,S45G01N260,창원 LG,Away,허일영,0,0,0,0.0,0,0,0.0,0,0,0.0,0,0,0.0,0,0,0,0,0,0,0,0,0,0
../kbl_data/2024-2025,S45G01N260,창원 LG,Away,장민국,0,0,0,0.0,0,0,0.0,0,0,0.0,0,0,0.0,0,0,0,1,0,0,0,0,0,0
../kbl_data/2024-2025,S45G01N260,창원 LG,Away,한상혁,0,0,0,0.0,0,0,0.0,0,0,0.0,0,0,0.0,0,0,0,0,0,0,0,0,0,0
../kbl_data/2024-2025,S45G01N260,창원 LG,Away,정인덕,3,0,2,0.0,1,3,33.3,1,5,20.0,0,0,0.0,0,1,1,1,0,0,1,0,1,3
../kbl_data/2024-2025,S45G01N260,창원 LG,Away,대릴 먼로,2,1,4,25.0,0,1,0.0,1,5,20.0,0,0,0.0,2,4,6,5,0,0,0,0,1,0
../kbl_data/2024-2025,S45G01N260,창원 LG,Away,박정현,4,2,7,28.6,0,1,0.0,2,8,25.0,0,2,0.0,0,2,2,0,0,0,0,0,0,3
../kbl_data/2024-2025,S45G01N260,창원 LG,Away,아셈 마레이,24,10,19,52.6,0,0,0.0,10,19,52.6,4,7,57.1,7,14,21,3,1,1,0,0,3,3
../kbl_data/2024-2025,S45G01N260,창원 LG,Away,양준석,18,1,3,33.3,5,7,71.4,6,10,60.0,1,2,50.0,2,0,2,6,2,1,0,0,3,3
../kbl_data/2024-2025,S45G01N260,창원 LG,Away,유기상,7,1,6,16.7,1,4,25.0,2,10,20.0,2,2,100.0,0,0,0,2,0,0,0,0,1,2
../kbl_data/2024-2025,S45G01N260,창원 LG,Away,이경도,2,1,1,100.0,0,0,0.0,1,1,100.0,0,0,0.0,0,0,0,1,0,0,0,0,0,1
../kbl_data/2024-2025,S45G01N260,창원 LG,Away,칼 타마요,23,6,9,66.7,3,5,60.0,9,14,64.3,2,2,100.0,3,5,8,4,0,0,0,0,0,4
../kbl_data/2024-2025,S45G01N260,창원 LG,Away,최형찬,0,0,0,0.0,0,0,0.0,0,0,0.0,0,0,0.0,1,0,1,0,0,0,0,0,0,3
../kbl_data/2024-2025,S45G01N261,안양 정관장,Home,송창용,0,0,0,0.0,0,0,0.0,0,0,0.0,0,0,0.0,0,0,0,0,0,0,0,0,0,0
../kbl_data/2024-2025,S45G01N261,안양 정관장,Home,정준원,2,1,1,100.0,0,1,0.0,1,2,50.0,0,0,0.0,1,0,1,0,1,0,0,0,1,0
../kbl_data/2024-2025,S45G01N261,안양 정관장,Home,김영현,3,0,3,0.0,1,3,33.3,1,6,16.7,0,0,0.0,0,2,2,3,0,0,1,0,1,2
../kbl_data/2024-2025,S45G01N261,안양 정관장,Home,김종규,0,0,0,0.0,0,0,0.0,0,0,0.0,0,0,0.0,0,0,0,0,0,0,0,0,0,0
../kbl_data/2024-2025,S45G01N261,안양 정관장,Home,박지훈,11,2,3,66.7,1,3,33.3,3,6,50.0,4,5,80.0,1,1,2,4,3,0,1,0,3,4
../kbl_data/2024-2025,S45G01N261,안양 정관장,Home,디온테 버튼,0,0,2,0.0,0,0,0.0,0,2,0.0,0,0,0.0,1,0,1,2,0,0,0,0,3,0
../kbl_data/2024-2025,S45G01N261,안양 정관장,Home,이우정,0,0,0,0.0,0,0,0.0,0,0,0.0,0,0,0.0,0,0,0,2,0,0,0,0,1,1
../kbl_data/2024-2025,S45G01N261,안양 정관장,Home,김경원,0,0,1,0.0,0,1,0.0,0,2,0.0,0,0,0.0,0,0,0,0,0,0,0,0,0,0
../kbl_data/2024-2025,S45G01N261,안양 정관장,Home,한승희,14,4,6,66.7,2,3,66.7,6,9,66.7,0,0,0.0,3,5,8,1,0,0,0,0,0,3
../kbl_data/2024-2025,S45G01N261,안양 정관장,Home,조니 오브라이언트,25,5,11,45.5,5,9,55.6,10,20,50.0,0,0,0.0,2,15,17,3,1,0,0,0,6,3
../kbl_data/2024-2025,S45G01N261,안양 정관장,Home,하비 고메즈,19,2,4,50.0,5,12,41.7,7,16,43.8,0,0,0.0,2,3,5,1,0,0,0,0,0,1
../kbl_data/2024-2025,S45G01N261,안양 정관장,Home,소준혁,7,1,1,100.0,1,3,33.3,2,4,50.0,2,3,66.7,0,1,1,1,0,1,0,0,0,3
../kbl_data/2024-2025,S45G01N261,서울 SK,Away,김선형,7,1,5,20.0,1,5,20.0,2,10,20.0,2,2,100.0,1,3,4,5,1,0,0,0,1,0
../kbl_data/2024-2025,S45G01N261,서울 SK,Away,오세근,5,1,1,100.0,1,4,25.0,2,5,40.0,0,0,0.0,1,5,6,2,1,0,0,0,0,1
../kbl_data/2024-2025,S45G01N261,서울 SK,Away,최원혁,0,0,2,0.0,0,1,0.0,0,3,0.0,0,0,0.0,1,2,3,2,0,1,0,0,0,2
../kbl_data/2024-2025,S45G01N261,서울 SK,Away,김지후,0,0,0,0.0,0,0,0.0,0,0,0.0,0,0,0.0,0,0,0,0,0,0,0,0,0,0
../kbl_data/2024-2025,S45G01N261,서울 SK,Away,장문호,1,0,0,0.0,0,0,0.0,0,0,0.0,1,2,50.0,0,0,0,0,0,0,0,0,0,0
../kbl_data/2024-2025,S45G01N261,서울 SK,Away,안영준,19,4,6,66.7,3,7,42.9,7,13,53.8,2,2,100.0,2,3,5,1,2,1,0,0,3,2
../kbl_data/2024-2025,S45G01N261,서울 SK,Away,자밀 워니,13,2,9,22.2,3,5,60.0,5,14,35.7,0,0,0.0,1,6,7,1,3,0,0,0,1,0
../kbl_data/2024-2025,S45G01N261,서울 SK,Away,김형빈,2,0,1,0.0,0,1,0.0,0,2,0.0,2,2,100.0,0,1,1,1,0,2,0,0,0,1
../kbl_data/2024-2025,S45G01N261,서울 SK,Away,아이재아 힉스,6,3,4,75.0,0,3,0.0,3,7,42.9,0,0,0.0,2,1,3,1,2,0,0,1,2,4
../kbl_data/2024-2025,S45G01N261,서울 SK,Away,오재현,14,4,9,44.4,2,5,40.0,6,14,42.9,0,0,0.0,1,1,2,1,1,0,1,0,0,3
../kbl_data/2024-2025,S45G01N261,서울 SK,Away,고메즈 델 리아노,6,3,5,60.0,0,1,0.0,3,6,50.0,0,0,0.0,3,1,4,2,0,0,0,0,1,0
../kbl_data/2024-2025,S45G01N261,서울 SK,Away,김태훈,3,0,0,0.0,1,2,50.0,1,2,50.0,0,0,0.0,1,0,1,0,0,0,0,0,2,2
../kbl_data/2024-2025,S45G01N262,대구 한국가스공사,Home,차바위,0,0,0,0.0,0,0,0.0,0,0,0.0,0,0,0.0,0,0,0,0,0,0,0,0,0,0
../kbl_data/2024-2025,S45G01N262,대구 한국가스공사,Home,박지훈,5,1,2,50.0,1,1,100.0,2,3,66.7,0,1,0.0,2,0,2,0,0,1,0,0,2,3
../kbl_data/2024-2025,S45G01N262,대구 한국가스공사,Home,김준일,9,3,6,50.0,1,1,100.0,4,7,57.1,0,0,0.0,2,1,3,5,0,1,0,0,3,1
../kbl_data/2024-2025,S45G01N262,대구 한국가스공사,Home,정성우,3,0,1,0.0,1,4,25.0,1,5,20.0,0,0,0.0,0,1,1,7,0,0,1,0,3,4
../kbl_data/2024-2025,S45G01N262,대구 한국가스공사,Home,김낙현,7,2,5,40.0,1,3,33.3,3,8,37.5,0,0,0.0,1,5,6,3,0,0,0,0,1,1
../kbl_data/2024-2025,S45G01N262,대구 한국가스공사,Home,우동현,4,1,2,50.0,0,0,0.0,1,2,50.0,2,2,100.0,0,1,1,1,2,0,1,0,2,3
../kbl_data/2024-2025,S45G01N262,대구 한국가스공사,Home,곽정훈,3,0,0,0.0,1,2,50.0,1,2,50.0,0,0,0.0,0,2,2,0,1,0,0,0,0,0
../kbl_data/2024-2025,S45G01N262,대구 한국가스공사,Home,앤드류 니콜슨,24,8,13,61.5,2,6,33.3,10,19,52.6,2,2,100.0,2,5,7,0,0,0,0,0,1,0
../kbl_data/2024-2025,S45G01N262,대구 한국가스공사,Home,신승민,8,0,1,0.0,2,5,40.0,2,6,33.3,2,2,100.0,2,1,3,2,0,0,0,0,0,2
../kbl_data/2024-2025,S45G01N262,대구 한국가스공사,Home,샘조세프 벨란겔,9,3,7,42.9,1,5,20.0,4,12,33.3,0,0,0.0,2,1,3,2,1,0,0,0,0,2
../kbl_data/2024-2025,S45G01N262,대구 한국가스공사,Home,유슈 은도예,9,3,6,50.0,0,0,0.0,3,6,50.0,3,4,75.0,3,8,11,1,0,1,0,2,0,2
../kbl_data/2024-2025,S45G01N262,대구 한국가스공사,Home,신주영,2,1,1,100.0,0,0,0.0,1,1,100.0,0,0,0.0,2,1,3,0,0,0,0,0,3,3
../kbl_data/2024-2025,S45G01N262,수원 KT,Away,한희원,2,1,1,100.0,0,3,0.0,1,4,25.0,0,0,0.0,0,0,0,1,2,0,0,0,0,1
../kbl_data/2024-2025,S45G01N262,수원 KT,Away,문성곤,0,0,1,0.0,0,2,0.0,0,3,0.0,0,0,0.0,1,1,2,0,0,0,0,0,0,1
../kbl_data/2024-2025,S45G01N262,수원 KT,Away,이현석,0,0,0,0.0,0,0,0.0,0,0,0.0,0,0,0.0,0,0,0,0,1,0,0,0,0,2
../kbl_data/2024-2025,S45G01N262,수원 KT,Away,허훈,22,4,8,50.0,4,8,50.0,8,16,50.0,2,2,100.0,0,5,5,3,1,0,1,0,1,0
../kbl_data/2024-2025,S45G01N262,수원 KT,Away,박준영,0,0,2,0.0,0,2,0.0,0,4,0.0,0,0,0.0,1,1,2,1,0,0,0,0,0,2
../kbl_data/2024-2025,S45G01N262,수원 KT,Away,최진광,0,0,0,0.0,0,2,0.0,0,2,0.0,0,0,0.0,1,1,2,1,0,0,0,0,0,1
../kbl_data/2024-2025,S45G01N262,수원 KT,Away,하윤기,2,1,3,33.3,0,0,0.0,1,3,33.3,0,0,0.0,0,1,1,3,0,0,0,0,3,3
../kbl_data/2024-2025,S45G01N262,수원 KT,Away,문정현,11,4,7,57.1,0,1,0.0,4,8,50.0,3,4,75.0,2,3,5,2,2,0,0,1,1,1
../kbl_data/2024-2025,S45G01N262,수원 KT,Away,레이션 해먼즈,11,4,11,36.4,1,5,20.0,5,16,31.2,0,0,0.0,1,5,6,4,0,1,0,0,0,3
../kbl_data/2024-2025,S45G01N262,수원 KT,Away,박성재,14,2,2,100.0,2,6,33.3,4,8,50.0,4,4,100.0,1,1,2,1,0,0,1,0,1,0
../kbl_data/2024-2025,S45G01N262,수원 KT,Away,조엘 카굴랑안,8,1,2,50.0,2,6,33.3,3,8,37.5,0,0,0.0,1,2,3,2,2,0,0,0,1,3
../kbl_data/2024-2025,S45G01N262,수원 KT,Away,데릭 컬버,4,1,2,50.0,0,0,0.0,1,2,50.0,2,2,100.0,1,0,1,0,0,0,0,0,0,1
../kbl_data/2024-2025,S45G01N263,서울 SK,Home,김선형,12,3,6,50.0,2,5,40.0,5,11,45.5,0,0,0.0,1,4,5,2,0,0,1,0,3,1
../kbl_data/2024-2025,S45G01N263,서울 SK,Home,오세근,5,1,2,50.0,1,2,50.0,2,4,50.0,0,0,0.0,2,3,5,2,0,0,0,0,0,3
../kbl_data/2024-2025,S45G01N263,서울 SK,Home,최원혁,0,0,0,0.0,0,0,0.0,0,0,0.0,0,0,0.0,1,1,2,1,0,0,0,0,1,1
../kbl_data/2024-2025,S45G01N263,서울 SK,Home,김지후,0,0,0,0.0,0,0,0.0,0,0,0.0,0,0,0.0,0,0,0,0,0,0,0,0,0,0
../kbl_data/2024-2025,S45G01N263,서울 SK,Home,장문호,0,0,0,0.0,0,0,0.0,0,0,0.0,0,0,0.0,0,1,1,0,0,0,0,0,0,0
../kbl_data/2024-2025,S45G01N263,서울 SK,Home,안영준,17,2,3,66.7,4,10,40.0,6,13,46.2,1,2,50.0,0,4,4,2,1,1,1,0,1,0
../kbl_data/2024-2025,S45G01N263,서울 SK,Home,자밀 워니,15,7,14,50.0,0,6,0.0,7,20,35.0,1,2,50.0,1,8,9,8,1,0,0,1,3,1
../kbl_data/2024-2025,S45G01N263,서울 SK,Home,김형빈,5,0,0,0.0,1,2,50.0,1,2,50.0,2,2,100.0,0,1,1,0,0,0,0,0,0,5
../kbl_data/2024-2025,S45G01N263,서울 SK,Home,아이재아 힉스,2,1,1,100.0,0,0,0.0,1,1,100.0,0,0,0.0,0,0,0,1,0,0,0,0,0,0
../kbl_data/2024-2025,S45G01N263,서울 SK,Home,오재현,9,1,4,25.0,2,6,33.3,3,10,30.0,1,2,50.0,1,3,4,0,2,0,0,0,4,2
../kbl_data/2024-2025,S45G01N263,서울 SK,Home,고메즈 델 리아노,0,0,0,0.0,0,0,0.0,0,0,0.0,0,0,0.0,0,0,0,0,0,0,0,0,0,0
../kbl_data/2024-2025,S45G01N263,서울 SK,Home,김태훈,6,0,0,0.0,2,6,33.3,2,6,33.3,0,0,0.0,0,1,1,0,0,0,0,0,1,1
../kbl_data/2024-2025,S45G01N263,고양 소노,Away,정희재,0,0,0,0.0,0,0,0.0,0,0,0.0,0,0,0.0,0,0,0,1,0,0,0,0,1,0
../kbl_data/2024-2025,S45G01N263,고양 소노,Away,임동섭,9,0,0,0.0,3,8,37.5,3,8,37.5,0,0,0.0,1,4,5,0,0,0,0,0,1,3
../kbl_data/2024-2025,S45G01N263,고양 소노,Away,이재도,0,0,1,0.0,0,0,0.0,0,1,0.0,0,0,0.0,0,4,4,2,1,0,0,0,2,1
../kbl_data/2024-2025,S45G01N263,고양 소노,Away,김진유,2,1,3,33.3,0,0,0.0,1,3,33.3,0,0,0.0,3,1,4,4,2,0,0,0,0,0
../kbl_data/2024-2025,S45G01N263,고양 소노,Away,이정현,34,4,5,80.0,8,15,53.3,12,20,60.0,2,2,100.0,0,0,0,5,4,0,0,0,1,2
../kbl_data/2024-2025,S45G01N263,고양 소노,Away,조은후,0,0,0,0.0,0,0,0.0,0,0,0.0,0,0,0.0,0,2,2,0,0,0,0,0,0,0
../kbl_data/2024-2025,S45G01N263,고양 소노,Away,민기남,0,0,0,0.0,0,1,0.0,0,1,0.0,0,0,0.0,0,0,0,0,0,0,0,0,0,0
../kbl_data/2024-2025,S45G01N263,고양 소노,Away,앨런 윌리엄스,12,5,11,45.5,0,0,0.0,5,11,45.5,2,2,100.0,3,9,12,5,1,0,0,0,3,3
../kbl_data/2024-2025,S45G01N263,고양 소노,Away,디제이 번즈 Jr,0,0,4,0.0,0,0,0.0,0,4,0.0,0,0,0.0,0,4,4,3,0,0,0,0,0,2
../kbl_data/2024-2025,S45G01N263,고양 소노,Away,이근준,11,0,0,0.0,3,5,60.0,3,5,60.0,2,4,50.0,0,1,1,2,2,0,0,0,0,4
../kbl_data/2024-2025,S45G01N263,고양 소노,Away,정성조,6,3,7,42.9,0,2,0.0,3,9,33.3,0,0,0.0,0,3,3,2,0,0,0,0,0,3
../kbl_data/2024-2025,S45G01N263,고양 소노,Away,케빈 켐바오,22,7,11,63.6,1,5,20.0,8,16,50.0,5,6,83.3,5,5,10,3,1,0,0,0,2,2
../kbl_data/2024-2025,S45G01N264,울산 현대모비스,Home,함지훈,0,0,0,0.0,0,0,0.0,0,0,0.0,0,0,0.0,0,1,1,0,0,0,0,0,0,0
../kbl_data/2024-2025,S45G01N264,울산 현대모비스,Home,장재석,14,5,7,71.4,0,0,0.0,5,7,71.4,4,4,100.0,3,3,6,0,1,0,0,0,1,1
../kbl_data/2024-2025,S45G01N264,울산 현대모비스,Home,이대헌,12,6,9,66.7,0,3,0.0,6,12,50.0,0,0,0.0,1,2,3,2,0,0,0,0,1,2
../kbl_data/2024-2025,S45G01N264,울산 현대모비스,Home,한호빈,0,0,0,0.0,0,0,0.0,0,0,0.0,0,0,0.0,0,0,0,0,0,0,0,0,0,0
../kbl_data/2024-2025,S45G01N264,울산 현대모비스,Home,김국찬,3,0,0,0.0,1,3,33.3,1,3,33.3,0,0,0.0,0,0,0,1,2,0,0,0,1,2
../kbl_data/2024-2025,S45G01N264,울산 현대모비스,Home,서명진,8,1,1,100.0,2,8,25.0,3,9,33.3,0,0,0.0,1,2,3,6,1,0,0,0,2,1
../kbl_data/2024-2025,S45G01N264,울산 현대모비스,Home,숀 롱,20,8,11,72.7,0,0,0.0,8,11,72.7,4,4,100.0,3,7,10,7,2,3,0,2,6,2
../kbl_data/2024-2025,S45G01N264,울산 현대모비스,Home,이우석,5,2,2,100.0,0,2,0.0,2,4,50.0,1,2,50.0,1,4,5,4,0,0,1,0,1,2
../kbl_data/2024-2025,S45G01N264,울산 현대모비스,Home,신민석,3,0,0,0.0,1,4,25.0,1,4,25.0,0,0,0.0,1,3,4,1,0,0,0,0,0,2
../kbl_data/2024-2025,S45G01N264,울산 현대모비스,Home,게이지 프림,11,4,9,44.4,0,0,0.0,4,9,44.4,3,3,100.0,0,1,1,0,0,0,0,0,1,5
../kbl_data/2024-2025,S45G01N264,울산 현대모비스,Home,박무빈,9,3,5,60.0,1,2,50.0,4,7,57.1,0,0,0.0,0,6,6,3,0,0,0,0,2,3
../kbl_data/2024-2025,S45G01N264,울산 현대모비스,Home,미구엘 안드레 옥존,3,0,0,0.0,1,2,50.0,1,2,50.0,0,0,0.0,0,0,0,0,0,0,0,0,1,0
../kbl_data/2024-2025,S45G01N264,서울 삼성,Away,이정현,8,3,6,50.0,0,6,0.0,3,12,25.0,2,2,100.0,2,4,6,5,0,0,0,0,1,4
../kbl_data/2024-2025,S45G01N264,서울 삼성,Away,최현민,6,0,1,0.0,2,7,28.6,2,8,25.0,0,0,0.0,1,6,7,0,1,0,0,0,0,3
../kbl_data/2024-2025,S45G01N264,서울 삼성,Away,이원대,0,0,0,0.0,0,2,0.0,0,2,0.0,0,0,0.0,0,0,0,2,1,0,0,0,0,0
../kbl_data/2024-2025,S45G01N264,서울 삼성,Away,최성모,9,2,4,50.0,1,3,33.3,3,7,42.9,2,2,100.0,2,1,3,4,0,0,1,0,5,3
../kbl_data/2024-2025,S45G01N264,서울 삼성,Away,최승욱,0,0,0,0.0,0,0,0.0,0,0,0.0,0,0,0.0,0,0,0,0,0,0,0,0,0,0
../kbl_data/2024-2025,S45G01N264,서울 삼성,Away,윤성원,10,2,2,100.0,2,3,66.7,4,5,80.0,0,0,0.0,1,1,2,0,0,0,1,0,1,2
../kbl_data/2024-2025,S45G01N264,서울 삼성,Away,차민석,0,0,0,0.0,0,0,0.0,0,0,0.0,0,0,0.0,0,0,0,0,0,0,0,0,0,0
../kbl_data/2024-2025,S45G01N264,서울 삼성,Away,이원석,9,2,5,40.0,0,2,0.0,2,7,28.6,5,10,50.0,5,3,8,0,1,1,1,0,1,4
../kbl_data/2024-2025,S45G01N264,서울 삼성,Away,저스틴 구탕,13,2,4,50.0,3,9,33.3,5,13,38.5,0,0,0.0,1,0,1,5,3,0,0,1,0,3
../kbl_data/2024-2025,S45G01N264,서울 삼성,Away,조준희,0,0,0,0.0,0,0,0.0,0,0,0.0,0,0,0.0,0,0,0,0,0,0,0,0,0,0
../kbl_data/2024-2025,S45G01N264,서울 삼성,Away,박승재,0,0,0,0.0,0,0,0.0,0,0,0.0,0,0,0.0,0,0,0,0,0,0,0,0,0,0
../kbl_data/2024-2025,S45G01N264,서울 삼성,Away,글렌 로빈슨 3세,23,4,9,44.4,4,9,44.4,8,18,44.4,3,4,75.0,1,6,7,6,1,0,0,0,4,2
../kbl_data/2024-2025,S45G01N265,원주 DB,Home,이관희,15,6,10,60.0,1,5,20.0,7,15,46.7,0,0,0.0,1,1,2,3,1,0,0,0,1,3
../kbl_data/2024-2025,S45G01N265,원주 DB,Home,김시래,2,1,1,100.0,0,1,0.0,1,2,50.0,0,0,0.0,0,1,1,1,1,0,0,0,0,1
../kbl_data/2024-2025,S45G01N265,원주 DB,Home,서민수,0,0,0,0.0,0,0,0.0,0,0,0.0,0,0,0.0,0,0,0,0,0,0,0,0,0,0
../kbl_data/2024-2025,S45G01N265,원주 DB,Home,정효근,10,3,6,50.0,1,4,25.0,4,10,40.0,1,2,50.0,5,6,11,3,0,1,0,0,1,3
../kbl_data/2024-2025,S45G01N265,원주 DB,Home,박봉진,0,0,0,0.0,0,0,0.0,0,0,0.0,0,0,0.0,0,0,0,0,0,0,0,0,0,0
../kbl_data/2024-2025,S45G01N265,원주 DB,Home,강상재,12,4,6,66.7,1,2,50.0,5,8,62.5,1,2,50.0,2,6,8,1,2,0,0,0,0,1
../kbl_data/2024-2025,S45G01N265,원주 DB,Home,최성원,3,0,1,0.0,1,2,50.0,1,3,33.3,0,0,0.0,1,0,1,0,1,0,0,0,1,2
../kbl_data/2024-2025,S45G01N265,원주 DB,Home,치나누 오누아쿠,20,6,10,60.0,1,3,33.3,7,13,53.8,5,6,83.3,3,5,8,3,0,0,0,0,4,2
../kbl_data/2024-2025,S45G01N265,원주 DB,Home,이용우,0,0,0,0.0,0,0,0.0,0,0,0.0,0,0,0.0,0,0,0,0,0,0,0,0,0,0
../kbl_data/2024-2025,S45G01N265,원주 DB,Home,이선 알바노,22,8,12,66.7,0,4,0.0,8,16,50.0,6,8,75.0,0,5,5,11,2,0,0,0,0,1
../kbl_data/2024-2025,S45G01N265,원주 DB,Home,박인웅,0,0,3,0.0,0,0,0.0,0,3,0.0,0,0,0.0,1,0,1,0,0,0,0,0,0,0
../kbl_data/2024-2025,S45G01N265,원주 DB,Home,김보배,0,0,0,0.0,0,0,0.0,0,0,0.0,0,0,0.0,1,0,1,0,1,0,0,0,0,3
../kbl_data/2024-2025,S45G01N265,부산 KCC,Away,정창영,3,0,1,0.0,1,2,50.0,1,3,33.3,0,0,0.0,0,1,1,1,0,0,0,0,1,1
../kbl_data/2024-2025,S45G01N265,부산 KCC,Away,전준범,5,1,1,100.0,1,5,20.0,2,6,33.3,0,0,0.0,0,2,2,3,2,1,0,0,0,1
../kbl_data/2024-2025,S45G01N265,부산 KCC,Away,이승현,4,2,3,66.7,0,0,0.0,2,3,66.7,0,0,0.0,0,0,0,0,0,0,0,0,1,1
../kbl_data/2024-2025,S45G01N265,부산 KCC,Away,이호현,13,5,7,71.4,1,1,100.0,6,8,75.0,0,0,0.0,0,3,3,5,0,0,0,0,2,1
../kbl_data/2024-2025,S45G01N265,부산 KCC,Away,캐디 라렌,19,8,13,61.5,0,6,0.0,8,19,42.1,3,4,75.0,4,7,11,0,0,1,0,0,1,1
../kbl_data/2024-2025,S45G01N265,부산 KCC,Away,이근휘,8,1,1,100.0,2,4,50.0,3,5,60.0,0,0,0.0,1,0,1,2,0,0,0,0,0,1
../kbl_data/2024-2025,S45G01N265,부산 KCC,Away,김동현,13,2,3,66.7,2,3,66.7,4,6,66.7,3,5,60.0,0,3,3,2,2,0,0,0,2,5
../kbl_data/2024-2025,S45G01N265,부산 KCC,Away,여준형,5,1,4,25.0,0,0,0.0,1,4,25.0,3,4,75.0,3,1,4,1,1,0,0,0,1,5
../kbl_data/2024-2025,S45G01N265,부산 KCC,Away,캘빈 제프리 에피스톨라,0,0,2,0.0,0,1,0.0,0,3,0.0,0,0,0.0,0,0,0,4,0,0,0,0,2,3
../kbl_data/2024-2025,S45G01N265,부산 KCC,Away,이주영,0,0,0,0.0,0,0,0.0,0,0,0.0,0,0,0.0,0,0,0,0,0,0,0,0,0,0
../kbl_data/2024-2025,S45G01N265,부산 KCC,Away,이찬영,0,0,0,0.0,0,0,0.0,0,0,0.0,0,0,0.0,0,0,0,0,0,0,0,0,0,0
../kbl_data/2024-2025,S45G01N265,부산 KCC,Away,도노반 스미스,6,3,6,50.0,0,2,0.0,3,8,37.5,0,1,0.0,2,2,4,0,1,1,0,0,1,2
../kbl_data/2024-2025,S45G01N266,수원 KT,Home,한희원,9,3,3,100.0,1,2,50.0,4,5,80.0,0,0,0.0,1,2,3,1,1,0,0,0,0,4
../kbl_data/2024-2025,S45G01N266,수원 KT,Home,최창진,0,0,3,0.0,0,1,0.0,0,4,0.0,0,0,0.0,2,3,5,3,0,0,1,0,1,2
../kbl_data/2024-2025,S45G01N266,수원 KT,Home,문성곤,5,1,1,100.0,1,5,20.0,2,6,33.3,0,0,0.0,1,5,6,1,1,1,0,0,0,3
../kbl_data/2024-2025,S45G01N266,수원 KT,Home,박준영,9,3,6,50.0,1,5,20.0,4,11,36.4,0,0,0.0,0,4,4,1,1,0,0,0,2,3
../kbl_data/2024-2025,S45G01N266,수원 KT,Home,최진광,0,0,2,0.0,0,1,0.0,0,3,0.0,0,0,0.0,0,0,0,1,1,0,0,0,1,0
../kbl_data/2024-2025,S45G01N266,수원 KT,Home,하윤기,6,2,3,66.7,0,0,0.0,2,3,66.7,2,4,50.0,1,2,3,2,0,0,0,1,0,0
../kbl_data/2024-2025,S45G01N266,수원 KT,Home,이두원,4,2,5,40.0,0,2,0.0,2,7,28.6,0,0,0.0,2,0,2,1,0,1,0,0,0,2
../kbl_data/2024-2025,S45G01N266,수원 KT,Home,문정현,9,3,5,60.0,1,4,25.0,4,9,44.4,0,0,0.0,1,5,6,2,0,0,0,0,0,1
../kbl_data/2024-2025,S45G01N266,수원 KT,Home,레이션 해먼즈,15,3,4,75.0,3,6,50.0,6,10,60.0,0,0,0.0,1,2,3,0,1,0,0,0,0,1
../kbl_data/2024-2025,S45G01N266,수원 KT,Home,박성재,6,2,4,50.0,0,0,0.0,2,4,50.0,2,2,100.0,2,1,3,1,0,0,0,0,1,0
../kbl_data/2024-2025,S45G01N266,수원 KT,Home,조엘 카굴랑안,5,1,2,50.0,1,4,25.0,2,6,33.3,0,1,0.0,0,6,6,7,0,0,0,0,3,1
../kbl_data/2024-2025,S45G01N266,수원 KT,Home,데릭 컬버,0,0,4,0.0,0,0,0.0,0,4,0.0,0,0,0.0,1,1,2,0,0,1,0,0,0,0
../kbl_data/2024-2025,S45G01N266,부산 KCC,Away,정창영,6,1,5,20.0,1,1,100.0,2,6,33.3,1,2,50.0,1,3,4,3,1,0,0,0,0,2
../kbl_data/2024-2025,S45G01N266,부산 KCC,Away,전준범,8,3,4,75.0,0,4,0.0,3,8,37.5,2,2,100.0,2,0,2,2,1,1,0,0,0,3
../kbl_data/2024-2025,S45G01N266,부산 KCC,Away,이승현,7,1,9,11.1,1,3,33.3,2,12,16.7,2,2,100.0,2,5,7,1,0,0,0,0,1,0
../kbl_data/2024-2025,S45G01N266,부산 KCC,Away,이호현,13,6,10,60.0,0,2,0.0,6,12,50.0,1,1,100.0,3,2,5,4,2,0,0,0,0,1
../kbl_data/2024-2025,S45G01N266,부산 KCC,Away,캐디 라렌,11,4,9,44.4,1,5,20.0,5,14,35.7,0,0,0.0,1,9,10,2,0,1,0,1,0,2
../kbl_data/2024-2025,S45G01N266,부산 KCC,Away,이근휘,3,0,0,0.0,1,1,100.0,1,1,100.0,0,0,0.0,0,1,1,1,0,0,0,0,2,0
../kbl_data/2024-2025,S45G01N266,부산 KCC,Away,김동현,2,1,1,100.0,0,1,0.0,1,2,50.0,0,0,0.0,0,4,4,1,0,0,0,0,2,3
../kbl_data/2024-2025,S45G01N266,부산 KCC,Away,여준형,1,0,1,0.0,0,0,0.0,0,1,0.0,1,4,25.0,0,0,0,1,0,0,0,0,0,3
../kbl_data/2024-2025,S45G01N266,부산 KCC,Away,캘빈 제프리 에피스톨라,7,2,2,100.0,1,2,50.0,3,4,75.0,0,0,0.0,1,3,4,4,0,0,1,0,2,3
../kbl_data/2024-2025,S45G01N266,부산 KCC,Away,이주영,0,0,0,0.0,0,0,0.0,0,0,0.0,0,0,0.0,0,0,0,0,0,0,0,0,0,0
../kbl_data/2024-2025,S45G01N266,부산 KCC,Away,이찬영,0,0,0,0.0,0,0,0.0,0,0,0.0,0,0,0.0,0,0,0,0,0,0,0,0,0,0
../kbl_data/2024-2025,S45G01N266,부산 KCC,Away,도노반 스미스,6,3,5,60.0,0,1,0.0,3,6,50.0,0,0,0.0,0,2,2,0,0,0,0,0,1,0
../kbl_data/2024-2025,S45G01N267,원주 DB,Home,이관희,7,2,4,50.0,0,3,0.0,2,7,28.6,3,3,100.0,0,1,1,1,0,0,0,0,3,2
../kbl_data/2024-2025,S45G01N267,원주 DB,Home,김시래,0,0,0,0.0,0,0,0.0,0,0,0.0,0,0,0.0,0,0,0,0,0,0,0,0,0,0
../kbl_data/2024-2025,S45G01N267,원주 DB,Home,서민수,2,1,2,50.0,0,0,0.0,1,2,50.0,0,0,0.0,3,2,5,0,1,0,1,0,0,4
../kbl_data/2024-2025,S45G01N267,원주 DB,Home,정효근,9,1,2,50.0,1,6,16.7,2,8,25.0,4,4,100.0,1,3,4,2,1,1,0,0,1,2
../kbl_data/2024-2025,S45G01N267,원주 DB,Home,박봉진,0,0,0,0.0,0,0,0.0,0,0,0.0,0,0,0.0,0,0,0,0,0,0,0,0,0,0
../kbl_data/2024-2025,S45G01N267,원주 DB,Home,강상재,17,2,7,28.6,2,7,28.6,4,14,28.6,7,8,87.5,3,8,11,1,1,0,0,0,2,2
../kbl_data/2024-2025,S45G01N267,원주 DB,Home,최성원,6,0,1,0.0,2,3,66.7,2,4,50.0,0,0,0.0,1,0,1,3,0,0,0,0,0,4
../kbl_data/2024-2025,S45G01N267,원주 DB,Home,치나누 오누아쿠,8,4,9,44.4,0,3,0.0,4,12,33.3,0,0,0.0,2,7,9,1,1,3,0,0,3,3
../kbl_data/2024-2025,S45G01N267,원주 DB,Home,김훈,0,0,0,0.0,0,0,0.0,0,0,0.0,0,0,0.0,0,0,0,0,0,0,0,0,0,0
../kbl_data/2024-2025,S45G01N267,원주 DB,Home,이용우,0,0,0,0.0,0,0,0.0,0,0,0.0,0,0,0.0,0,0,0,0,0,0,0,0,0,0
../kbl_data/2024-2025,S45G01N267,원주 DB,Home,이선 알바노,16,2,7,28.6,4,8,50.0,6,15,40.0,0,0,0.0,0,4,4,4,1,0,0,0,2,1
../kbl_data/2024-2025,S45G01N267,원주 DB,Home,박인웅,2,1,1,100.0,0,0,0.0,1,1,100.0,0,0,0.0,0,0,0,0,0,0,0,0,0,0
../kbl_data/2024-2025,S45G01N267,안양 정관장,Away,송창용,0,0,0,0.0,0,1,0.0,0,1,0.0,0,0,0.0,1,1,2,0,0,0,0,0,0,0
../kbl_data/2024-2025,S45G01N267,안양 정관장,Away,정준원,0,0,0,0.0,0,0,0.0,0,0,0.0,0,0,0.0,0,0,0,0,0,0,0,0,0,0
../kbl_data/2024-2025,S45G01N267,안양 정관장,Away,김영현,9,0,1,0.0,3,7,42.9,3,8,37.5,0,0,0.0,2,1,3,2,0,0,0,0,2,3
../kbl_data/2024-2025,S45G01N267,안양 정관장,Away,김종규,0,0,0,0.0,0,0,0.0,0,0,0.0,0,0,0.0,0,0,0,0,0,0,0,0,0,0
../kbl_data/2024-2025,S45G01N267,안양 정관장,Away,박지훈,10,3,4,75.0,1,2,50.0,4,6,66.7,1,2,50.0,0,7,7,11,2,0,0,0,0,3
../kbl_data/2024-2025,S45G01N267,안양 정관장,Away,디온테 버튼,14,4,7,57.1,1,3,33.3,5,10,50.0,3,3,100.0,1,6,7,2,2,0,0,0,1,1
../kbl_data/2024-2025,S45G01N267,안양 정관장,Away,이우정,0,0,0,0.0,0,0,0.0,0,0,0.0,0,0,0.0,0,0,0,1,0,0,0,0,0,0
../kbl_data/2024-2025,S45G01N267,안양 정관장,Away,김경원,4,2,3,66.7,0,2,0.0,2,5,40.0,0,0,0.0,0,1,1,0,0,1,0,0,0,1
../kbl_data/2024-2025,S45G01N267,안양 정관장,Away,한승희,9,3,8,37.5,1,3,33.3,4,11,36.4,0,0,0.0,2,3,5,0,3,1,0,0,0,5
../kbl_data/2024-2025,S45G01N267,안양 정관장,Away,조니 오브라이언트,16,3,7,42.9,2,7,28.6,5,14,35.7,4,4,100.0,1,9,10,3,1,0,0,0,4,3
../kbl_data/2024-2025,S45G01N267,안양 정관장,Away,하비 고메즈,14,4,6,66.7,2,6,33.3,6,12,50.0,0,0,0.0,0,0,0,0,0,0,0,0,0,3
../kbl_data/2024-2025,S45G01N267,안양 정관장,Away,소준혁,2,1,1,100.0,0,1,0.0,1,2,50.0,0,0,0.0,0,1,1,0,1,0,0,0,0,0
../kbl_data/2024-2025,S45G01N268,서울 SK,Home,김선형,12,4,6,66.7,1,9,11.1,5,15,33.3,1,2,50.0,2,1,3,2,2,0,0,0,1,1
../kbl_data/2024-2025,S45G01N268,서울 SK,Home,오세근,6,3,3,100.0,0,4,0.0,3,7,42.9,0,0,0.0,0,0,0,2,0,0,0,0,0,2
../kbl_data/2024-2025,S45G01N268,서울 SK,Home,최원혁,5,1,1,100.0,1,1,100.0,2,2,100.0,0,0,0.0,0,1,1,2,4,0,1,0,0,2
../kbl_data/2024-2025,S45G01N268,서울 SK,Home,김지후,0,0,0,0.0,0,0,0.0,0,0,0.0,0,0,0.0,0,0,0,0,0,0,0,0,0,0
../kbl_data/2024-2025,S45G01N268,서울 SK,Home,장문호,0,0,0,0.0,0,0,0.0,0,0,0.0,0,0,0.0,0,0,0,0,0,0,0,0,0,0
../kbl_data/2024-2025,S45G01N268,서울 SK,Home,안영준,9,2,4,50.0,1,7,14.3,3,11,27.3,2,3,66.7,0,6,6,3,3,3,1,0,3,2
../kbl_data/2024-2025,S45G01N268,서울 SK,Home,자밀 워니,20,8,14,57.1,1,1,100.0,9,15,60.0,1,2,50.0,0,9,9,5,0,0,0,1,2,0
../kbl_data/2024-2025,S45G01N268,서울 SK,Home,김형빈,0,0,0,0.0,0,0,0.0,0,0,0.0,0,0,0.0,0,2,2,1,0,0,0,0,0,2
../kbl_data/2024-2025,S45G01N268,서울 SK,Home,아이재아 힉스,16,7,8,87.5,0,1,0.0,7,9,77.8,2,4,50.0,3,0,3,1,1,0,0,0,1,2
../kbl_data/2024-2025,S45G01N268,서울 SK,Home,오재현,11,1,2,50.0,3,8,37.5,4,10,40.0,0,0,0.0,0,3,3,7,2,1,0,0,2,2
../kbl_data/2024-2025,S45G01N268,서울 SK,Home,고메즈 델 리아노,0,0,0,0.0,0,0,0.0,0,0,0.0,0,0,0.0,0,0,0,0,0,0,0,0,0,0
../kbl_data/2024-2025,S45G01N268,서울 SK,Home,김태훈,0,0,0,0.0,0,0,0.0,0,0,0.0,0,0,0.0,0,1,1,0,0,0,0,0,0,1
../kbl_data/2024-2025,S45G01N268,서울 삼성,Away,이정현,2,1,3,33.3,0,3,0.0,1,6,16.7,0,0,0.0,0,3,3,7,0,0,0,0,4,3
../kbl_data/2024-2025,S45G01N268,서울 삼성,Away,최현민,5,2,4,50.0,0,5,0.0,2,9,22.2,1,1,100.0,1,2,3,0,2,0,0,0,1,3
../kbl_data/2024-2025,S45G01N268,서울 삼성,Away,이원대,0,0,0,0.0,0,0,0.0,0,0,0.0,0,0,0.0,0,0,0,0,0,0,0,0,0,0
../kbl_data/2024-2025,S45G01N268,서울 삼성,Away,최성모,15,2,3,66.7,3,6,50.0,5,9,55.6,2,2,100.0,1,4,5,3,2,0,0,0,3,2
../kbl_data/2024-2025,S45G01N268,서울 삼성,Away,최승욱,2,1,3,33.3,0,0,0.0,1,3,33.3,0,0,0.0,0,1,1,0,0,0,0,0,0,2
../kbl_data/2024-2025,S45G01N268,서울 삼성,Away,윤성원,0,0,0,0.0,0,0,0.0,0,0,0.0,0,0,0.0,0,0,0,0,0,0,0,0,0,1
../kbl_data/2024-2025,S45G01N268,서울 삼성,Away,차민석,0,0,0,0.0,0,0,0.0,0,0,0.0,0,0,0.0,0,0,0,0,0,0,0,0,0,0
../kbl_data/2024-2025,S45G01N268,서울 삼성,Away,이원석,7,1,5,20.0,1,1,100.0,2,6,33.3,2,2,100.0,1,3,4,1,0,0,0,0,1,5
../kbl_data/2024-2025,S45G01N268,서울 삼성,Away,저스틴 구탕,14,4,7,57.1,2,5,40.0,6,12,50.0,0,0,0.0,0,3,3,0,3,0,0,1,2,0
../kbl_data/2024-2025,S45G01N268,서울 삼성,Away,조준희,0,0,0,0.0,0,0,0.0,0,0,0.0,0,0,0.0,0,0,0,0,0,0,0,0,0,0
../kbl_data/2024-2025,S45G01N268,서울 삼성,Away,박승재,0,0,0,0.0,0,0,0.0,0,0,0.0,0,0,0.0,0,0,0,1,0,0,0,0,1,0
../kbl_data/2024-2025,S45G01N268,서울 삼성,Away,글렌 로빈슨 3세,31,7,10,70.0,5,9,55.6,12,19,63.2,2,2,100.0,3,18,21,4,0,1,0,1,4,1
../kbl_data/2024-2025,S45G01N269,대구 한국가스공사,Home,차바위,0,0,0,0.0,0,1,0.0,0,1,0.0,0,0,0.0,1,0,1,0,1,0,0,0,1,1
../kbl_data/2024-2025,S45G01N269,대구 한국가스공사,Home,김준일,2,1,5,20.0,0,1,0.0,1,6,16.7,0,0,0.0,1,3,4,0,0,0,0,0,1,5
../kbl_data/2024-2025,S45G01N269,대구 한국가스공사,Home,정성우,9,3,3,100.0,1,4,25.0,4,7,57.1,0,0,0.0,0,0,0,3,0,0,0,0,1,1
../kbl_data/2024-2025,S45G01N269,대구 한국가스공사,Home,김철욱,3,0,1,0.0,1,3,33.3,1,4,25.0,0,0,0.0,2,3,5,0,0,0,0,0,0,3
../kbl_data/2024-2025,S45G01N269,대구 한국가스공사,Home,김낙현,14,4,7,57.1,2,7,28.6,6,14,42.9,0,0,0.0,0,4,4,2,0,0,0,0,2,0
../kbl_data/2024-2025,S45G01N269,대구 한국가스공사,Home,우동현,2,1,1,100.0,0,4,0.0,1,5,20.0,0,0,0.0,0,1,1,3,0,0,0,0,1,5
../kbl_data/2024-2025,S45G01N269,대구 한국가스공사,Home,전현우,5,1,1,100.0,1,5,20.0,2,6,33.3,0,0,0.0,0,2,2,1,1,0,0,0,0,0
../kbl_data/2024-2025,S45G01N269,대구 한국가스공사,Home,곽정훈,0,0,0,0.0,0,1,0.0,0,1,0.0,0,0,0.0,0,3,3,0,0,0,0,0,0,2
../kbl_data/2024-2025,S45G01N269,대구 한국가스공사,Home,신승민,17,7,7,100.0,1,2,50.0,8,9,88.9,0,0,0.0,0,1,1,1,1,0,0,0,0,2
../kbl_data/2024-2025,S45G01N269,대구 한국가스공사,Home,샘조세프 벨란겔,13,4,5,80.0,1,3,33.3,5,8,62.5,2,2,100.0,0,1,1,5,5,0,0,0,2,0
../kbl_data/2024-2025,S45G01N269,대구 한국가스공사,Home,신주영,10,2,3,66.7,2,6,33.3,4,9,44.4,0,0,0.0,1,2,3,1,2,0,1,0,0,3
../kbl_data/2024-2025,S45G01N269,대구 한국가스공사,Home,손준,5,1,1,100.0,1,3,33.3,2,4,50.0,0,0,0.0,1,1,2,1,0,0,0,0,0,3
../kbl_data/2024-2025,S45G01N269,울산 현대모비스,Away,함지훈,3,1,3,33.3,0,1,0.0,1,4,25.0,1,2,50.0,1,0,1,1,0,0,0,0,0,1
../kbl_data/2024-2025,S45G01N269,울산 현대모비스,Away,장재석,6,2,4,50.0,0,0,0.0,2,4,50.0,2,5,40.0,2,1,3,0,1,0,0,0,0,0
../kbl_data/2024-2025,S45G01N269,울산 현대모비스,Away,이대헌,8,3,3,100.0,0,0,0.0,3,3,100.0,2,2,100.0,0,1,1,0,0,0,0,0,0,1
../kbl_data/2024-2025,S45G01N269,울산 현대모비스,Away,한호빈,3,0,1,0.0,1,2,50.0,1,3,33.3,0,0,0.0,0,1,1,2,1,0,1,0,4,3
../kbl_data/2024-2025,S45G01N269,울산 현대모비스,Away,김국찬,9,0,1,0.0,3,6,50.0,3,7,42.9,0,0,0.0,0,5,5,4,1,0,0,0,0,0
../kbl_data/2024-2025,S45G01N269,울산 현대모비스,Away,서명진,3,0,1,0.0,1,4,25.0,1,5,20.0,0,0,0.0,0,3,3,6,1,0,0,0,1,2
../kbl_data/2024-2025,S45G01N269,울산 현대모비스,Away,숀 롱,21,4,6,66.7,2,2,100.0,6,8,75.0,7,8,87.5,3,3,6,5,0,1,0,0,3,2
../kbl_data/2024-2025,S45G01N269,울산 현대모비스,Away,이우석,0,0,1,0.0,0,2,0.0,0,3,0.0,0,0,0.0,0,3,3,0,0,0,0,0,0,0
../kbl_data/2024-2025,S45G01N269,울산 현대모비스,Away,이승우,5,1,3,33.3,1,2,50.0,2,5,40.0,0,0,0.0,0,3,3,0,0,0,0,0,3,3
../kbl_data/2024-2025,S45G01N269,울산 현대모비스,Away,신민석,0,0,0,0.0,0,2,0.0,0,2,0.0,0,0,0.0,1,3,4,1,0,0,0,0,0,0
../kbl_data/2024-2025,S45G01N269,울산 현대모비스,Away,게이지 프림,19,7,10,70.0,0,1,0.0,7,11,63.6,5,5,100.0,1,5,6,4,0,0,0,0,1,1
../kbl_data/2024-2025,S45G01N269,울산 현대모비스,Away,박무빈,7,1,3,33.3,1,2,50.0,2,5,40.0,2,2,100.0,1,1,2,1,0,0,0,0,1,1
../kbl_data/2024-2025,S45G01N270,고양 소노,Home,정희재,0,0,1,0.0,0,1,0.0,0,2,0.0,0,0,0.0,1,3,4,1,0,0,0,0,0,1
../kbl_data/2024-2025,S45G01N270,고양 소노,Home,임동섭,9,3,3,100.0,1,6,16.7,4,9,44.4,0,0,0.0,1,5,6,0,2,0,0,0,0,4
../kbl_data/2024-2025,S45G01N270,고양 소노,Home,이재도,13,2,4,50.0,3,4,75.0,5,8,62.5,0,0,0.0,0,0,0,2,1,0,0,0,0,2
../kbl_data/2024-2025,S45G01N270,고양 소노,Home,김진유,9,2,2,100.0,1,3,33.3,3,5,60.0,2,2,100.0,2,3,5,3,1,0,0,0,1,1
../kbl_data/2024-2025,S45G01N270,고양 소노,Home,이정현,16,1,2,50.0,4,9,44.4,5,11,45.5,2,3,66.7,0,3,3,6,1,0,0,0,2,2
../kbl_data/2024-2025,S45G01N270,고양 소노,Home,조은후,4,2,3,66.7,0,0,0.0,2,3,66.7,0,0,0.0,0,0,0,0,0,1,0,0,0,0
../kbl_data/2024-2025,S45G01N270,고양 소노,Home,앨런 윌리엄스,12,5,10,50.0,0,1,0.0,5,11,45.5,2,2,100.0,2,6,8,2,0,1,0,0,1,2
../kbl_data/2024-2025,S45G01N270,고양 소노,Home,디제이 번즈 Jr,8,4,6,66.7,0,0,0.0,4,6,66.7,0,0,0.0,0,1,1,5,0,2,0,0,1,1
../kbl_data/2024-2025,S45G01N270,고양 소노,Home,이근준,3,0,0,0.0,1,1,100.0,1,1,100.0,0,0,0.0,1,0,1,1,0,1,1,0,0,2
../kbl_data/2024-2025,S45G01N270,고양 소노,Home,정성조,0,0,2,0.0,0,1,0.0,0,3,0.0,0,0,0.0,1,0,1,0,0,1,0,0,0,1
../kbl_data/2024-2025,S45G01N270,고양 소노,Home,김도은,2,0,0,0.0,0,0,0.0,0,0,0.0,2,2,100.0,0,0,0,0,0,0,0,0,0,0
../kbl_data/2024-2025,S45G01N270,고양 소노,Home,케빈 켐바오,25,7,11,63.6,2,5,40.0,9,16,56.2,5,6,83.3,2,2,4,2,0,1,1,1,2,2
../kbl_data/2024-2025,S45G01N270,창원 LG,Away,허일영,28,7,8,87.5,4,6,66.7,11,14,78.6,2,2,100.0,2,1,3,0,0,1,0,0,0,0
../kbl_data/2024-2025,S45G01N270,창원 LG,Away,최진수,0,0,0,0.0,0,0,0.0,0,0,0.0,0,0,0.0,0,1,1,0,0,0,0,0,1,1
../kbl_data/2024-2025,S45G01N270,창원 LG,Away,장민국,16,2,2,100.0,4,5,80.0,6,7,85.7,0,0,0.0,1,3,4,0,0,0,0,0,0,5
../kbl_data/2024-2025,S45G01N270,창원 LG,Away,한상혁,2,0,4,0.0,0,1,0.0,0,5,0.0,2,2,100.0,0,1,1,3,0,0,0,0,2,1
../kbl_data/2024-2025,S45G01N270,창원 LG,Away,정인덕,5,1,1,100.0,1,3,33.3,2,4,50.0,0,0,0.0,0,2,2,3,1,0,0,0,1,0
../kbl_data/2024-2025,S45G01N270,창원 LG,Away,대릴 먼로,13,6,8,75.0,0,0,0.0,6,8,75.0,1,2,50.0,4,11,15,10,1,0,0,0,5,2
../kbl_data/2024-2025,S45G01N270,창원 LG,Away,박정현,10,3,6,50.0,1,2,50.0,4,8,50.0,1,2,50.0,1,3,4,1,0,0,0,0,2,2
../kbl_data/2024-2025,S45G01N270,창원 LG,Away,김종호,0,0,2,0.0,0,2,0.0,0,4,0.0,0,0,0.0,0,0,0,0,0,0,0,0,0,1
../kbl_data/2024-2025,S45G01N270,창원 LG,Away,양준석,0,0,0,0.0,0,0,0.0,0,0,0.0,0,0,0.0,0,0,0,1,0,0,0,0,0,3
../kbl_data/2024-2025,S45G01N270,창원 LG,Away,이경도,11,1,5,20.0,2,3,66.7,3,8,37.5,3,4,75.0,0,1,1,2,2,0,0,0,2,1
../kbl_data/2024-2025,S45G01N270,창원 LG,Away,이강현,2,1,3,33.3,0,1,0.0,1,4,25.0,0,0,0.0,0,1,1,0,0,0,0,0,0,1
../kbl_data/2024-2025,S45G01N270,창원 LG,Away,최형찬,12,0,4,0.0,4,5,80.0,4,9,44.4,0,0,0.0,0,0,0,1,2,0,0,0,0,2
